5 Minutes,Lane 1 Flow (Veh/5 Minutes),Lane 1 Speed (mph),Lane 2 Flow (Veh/5 Minutes),Lane 2 Speed (mph),Flow (Veh/5 Minutes),Speed (mph),# Lane Points,% Observed,Holiday
9/18/2017 0:00,14,68.9,28,64.7,42,66.1,2,0,0
9/18/2017 0:05,11,68.8,25,64.6,36,65.9,2,0,0
9/18/2017 0:10,12,68.9,26,64.7,38,66,2,0,0
9/18/2017 0:15,16,69,31,64.8,47,66.2,2,0,0
9/18/2017 0:20,9,68.9,24,64.7,33,65.9,2,0,0
9/18/2017 0:25,8,68.8,23,64.6,31,65.7,2,0,0
9/18/2017 0:30,12,68.5,27,64.3,39,65.6,2,0,0
9/18/2017 0:35,9,68.7,23,64.5,32,65.7,2,0,0
9/18/2017 0:40,11,68.8,26,64.6,37,65.8,2,0,0
9/18/2017 0:45,7,68.7,22,64.5,29,65.5,2,0,0
9/18/2017 0:50,10,68.8,25,64.6,35,65.8,2,0,0
9/18/2017 0:55,8,68.6,23,64.4,31,65.5,2,0,0
9/18/2017 1:00,7,68.7,22,64.5,29,65.5,2,0,0
9/18/2017 1:05,10,68.7,24,64.5,34,65.8,2,0,0
9/18/2017 1:10,10,68.9,25,64.7,35,65.9,2,0,0
9/18/2017 1:15,9,68.8,24,64.6,33,65.8,2,0,0
9/18/2017 1:20,10,68.8,24,64.6,34,65.8,2,0,0
9/18/2017 1:25,9,68.7,24,64.5,33,65.6,2,0,0
9/18/2017 1:30,7,68.7,22,64.5,29,65.5,2,0,0
9/18/2017 1:35,7,68.8,22,64.6,29,65.6,2,0,0
9/18/2017 1:40,9,68.9,24,64.7,33,65.8,2,0,0
9/18/2017 1:45,7,68.7,22,64.5,29,65.5,2,0,0
9/18/2017 1:50,7,68.8,22,64.6,29,65.6,2,0,0
9/18/2017 1:55,9,68.5,23,64.3,32,65.4,2,0,0
9/18/2017 2:00,7,68.6,21,64.4,28,65.5,2,0,0
9/18/2017 2:05,7,68.7,22,64.5,29,65.6,2,0,0
9/18/2017 2:10,9,68.7,24,64.5,33,65.7,2,0,0
9/18/2017 2:15,9,68.8,24,64.6,33,65.8,2,0,0
9/18/2017 2:20,7,68.6,22,64.4,29,65.4,2,0,0
9/18/2017 2:25,6,68.6,21,64.4,27,65.4,2,0,0
9/18/2017 2:30,9,68.8,24,64.6,33,65.7,2,0,0
9/18/2017 2:35,10,68.9,25,64.7,35,65.9,2,0,0
9/18/2017 2:40,9,68.6,24,64.4,33,65.5,2,0,0
9/18/2017 2:45,11,68.7,26,64.5,37,65.8,2,0,0
9/18/2017 2:50,12,68.3,26,64.1,38,65.4,2,0,0
9/18/2017 2:55,7,68.5,22,64.3,29,65.4,2,0,0
9/18/2017 3:00,10,68.5,25,64.3,35,65.5,2,0,0
9/18/2017 3:05,10,68.7,25,64.5,35,65.7,2,0,0
9/18/2017 3:10,7,68.8,21,64.6,28,65.7,2,0,0
9/18/2017 3:15,10,68.8,25,64.6,35,65.8,2,0,0
9/18/2017 3:20,10,68.8,25,64.6,35,65.8,2,0,0
9/18/2017 3:25,11,68.8,26,64.6,37,65.9,2,0,0
9/18/2017 3:30,9,68.7,24,64.5,33,65.7,2,0,0
9/18/2017 3:35,13,68.8,28,64.6,41,65.9,2,0,0
9/18/2017 3:40,14,68.7,29,64.5,43,65.8,2,0,0
9/18/2017 3:45,12,68.7,27,64.5,39,65.8,2,0,0
9/18/2017 3:50,11,68.8,26,64.6,37,65.9,2,0,0
9/18/2017 3:55,16,68.8,31,64.6,47,66,2,0,0
9/18/2017 4:00,13,68.9,28,64.7,41,66,2,0,0
9/18/2017 4:05,19,68.9,34,64.7,53,66.2,2,0,0
9/18/2017 4:10,18,68.9,33,64.7,51,66.2,2,0,0
9/18/2017 4:15,13,68.7,28,64.5,41,65.8,2,0,0
9/18/2017 4:20,23,68.7,38,64.5,61,66.1,2,0,0
9/18/2017 4:25,22,68.4,37,64.2,59,65.7,2,0,0
9/18/2017 4:30,15,68.6,30,64.4,45,65.8,2,0,0
9/18/2017 4:35,19,68.9,33,64.7,52,66.3,2,0,0
9/18/2017 4:40,41,68.9,55,64.7,96,66.5,2,0,0
9/18/2017 4:45,53,68.5,68,64.3,121,66.2,2,0,0
9/18/2017 4:50,41,69.1,55,64.9,96,66.7,2,0,0
9/18/2017 4:55,51,68.2,66,63.9,117,65.8,2,0,0
9/18/2017 5:00,47,68.5,62,64.2,109,66.1,2,0,0
9/18/2017 5:05,38,68.4,52,64.2,90,65.9,2,0,0
9/18/2017 5:10,50,68.2,65,64,115,65.9,2,0,0
9/18/2017 5:15,50,68.2,65,63.9,115,65.8,2,0,0
9/18/2017 5:20,47,67.6,62,63.4,109,65.2,2,0,0
9/18/2017 5:25,44,68.1,59,63.8,103,65.6,2,0,0
9/18/2017 5:30,54,66.8,69,62.5,123,64.4,2,0,0
9/18/2017 5:35,61,67,77,62.6,138,64.6,2,0,0
9/18/2017 5:40,68,68,84,63.8,152,65.7,2,0,0
9/18/2017 5:45,65,67.5,80,63.2,145,65.1,2,0,0
9/18/2017 5:50,64,68,79,63.6,143,65.6,2,0,0
9/18/2017 5:55,64,66.9,80,62.6,144,64.5,2,0,0
9/18/2017 6:00,75,66.9,91,62.6,166,64.5,2,0,0
9/18/2017 6:05,64,66.7,79,62.4,143,64.3,2,0,0
9/18/2017 6:10,71,65.3,87,60.9,158,62.9,2,0,0
9/18/2017 6:15,61,66,76,61.6,137,63.6,2,0,0
9/18/2017 6:20,69,66.1,85,61.7,154,63.7,2,0,0
9/18/2017 6:25,78,66.4,94,62,172,64,2,0,0
9/18/2017 6:30,68,65.7,85,61.4,153,63.3,2,0,0
9/18/2017 6:35,71,65.8,88,61.5,159,63.4,2,0,0
9/18/2017 6:40,75,66.5,92,62.2,167,64.1,2,0,0
9/18/2017 6:45,83,66.1,98,61.7,181,63.7,2,0,0
9/18/2017 6:50,65,66.3,81,61.9,146,63.8,2,0,0
9/18/2017 6:55,74,67.2,90,62.9,164,64.8,2,0,0
9/18/2017 7:00,73,66.4,89,62,162,64,2,0,0
9/18/2017 7:05,79,67,95,62.6,174,64.6,2,0,0
9/18/2017 7:10,69,66.4,85,62.1,154,64,2,0,0
9/18/2017 7:15,78,67.3,94,63,172,64.9,2,0,0
9/18/2017 7:20,85,67.8,101,63.5,186,65.5,2,0,0
9/18/2017 7:25,83,66.8,99,62.4,182,64.4,2,0,0
9/18/2017 7:30,79,66.9,96,62.6,175,64.5,2,0,0
9/18/2017 7:35,74,66.4,89,62.1,163,64.1,2,0,0
9/18/2017 7:40,80,66.6,96,62.3,176,64.2,2,0,0
9/18/2017 7:45,80,67.3,96,63,176,65,2,0,0
9/18/2017 7:50,94,67.3,109,62.9,203,64.9,2,0,0
9/18/2017 7:55,78,66,96,61.7,174,63.6,2,0,0
9/18/2017 8:00,76,66.5,92,62.1,168,64.1,2,0,0
9/18/2017 8:05,91,66.2,107,61.9,198,63.9,2,0,0
9/18/2017 8:10,73,66.4,89,62.1,162,64,2,0,0
9/18/2017 8:15,87,65.4,103,61.1,190,63,2,0,0
9/18/2017 8:20,85,64.8,101,60.5,186,62.5,2,0,0
9/18/2017 8:25,84,64.4,101,60.1,185,62.1,2,0,0
9/18/2017 8:30,88,65.6,104,61.3,192,63.3,2,0,0
9/18/2017 8:35,88,65.3,104,60.9,192,62.9,2,0,0
9/18/2017 8:40,83,65.5,98,61.2,181,63.1,2,0,0
9/18/2017 8:45,82,65.2,97,60.8,179,62.8,2,0,0
9/18/2017 8:50,82,64.9,98,60.5,180,62.5,2,0,0
9/18/2017 8:55,86,64.5,101,60.1,187,62.2,2,0,0
9/18/2017 9:00,78,63.9,94,59.6,172,61.5,2,0,0
9/18/2017 9:05,83,64.7,98,60.3,181,62.3,2,0,0
9/18/2017 9:10,80,64.2,96,59.8,176,61.8,2,0,0
9/18/2017 9:15,85,64.3,100,60,185,62,2,0,0
9/18/2017 9:20,88,65.1,103,60.8,191,62.8,2,0,0
9/18/2017 9:25,76,65.7,93,61.3,169,63.3,2,0,0
9/18/2017 9:30,76,66.5,91,62.2,167,64.2,2,0,0
9/18/2017 9:35,81,65.1,96,60.8,177,62.7,2,0,0
9/18/2017 9:40,87,64.9,103,60.6,190,62.6,2,0,0
9/18/2017 9:45,76,64.9,91,60.5,167,62.5,2,0,0
9/18/2017 9:50,82,64.4,97,60,179,62,2,0,0
9/18/2017 9:55,70,63.7,85,59.3,155,61.3,2,0,0
9/18/2017 10:00,64,64,80,59.7,144,61.6,2,0,0
9/18/2017 10:05,78,63.5,92,59.2,170,61.2,2,0,0
9/18/2017 10:10,69,63.9,84,59.7,153,61.6,2,0,0
9/18/2017 10:15,63,64.1,76,59.8,139,61.8,2,0,0
9/18/2017 10:20,70,63.8,83,59.5,153,61.5,2,0,0
9/18/2017 10:25,57,65.5,72,61.2,129,63.1,2,0,0
9/18/2017 10:30,65,65.1,79,60.9,144,62.8,2,0,0
9/18/2017 10:35,58,64.6,73,60.3,131,62.2,2,0,0
9/18/2017 10:40,65,63.3,80,59,145,61,2,0,0
9/18/2017 10:45,73,63,87,58.7,160,60.7,2,0,0
9/18/2017 10:50,51,64.4,65,60.1,116,62,2,0,0
9/18/2017 10:55,59,63.2,73,58.9,132,60.9,2,0,0
9/18/2017 11:00,51,64.2,65,59.9,116,61.8,2,0,0
9/18/2017 11:05,63,63.6,77,59.3,140,61.2,2,0,0
9/18/2017 11:10,58,63.6,72,59.3,130,61.2,2,0,0
9/18/2017 11:15,45,64.8,59,60.4,104,62.3,2,0,0
9/18/2017 11:20,56,65.3,69,61,125,62.9,2,0,0
9/18/2017 11:25,54,65.9,68,61.6,122,63.5,2,0,0
9/18/2017 11:30,69,65,83,60.7,152,62.7,2,0,0
9/18/2017 11:35,58,65.3,73,61,131,62.9,2,0,0
9/18/2017 11:40,61,65.4,75,61.2,136,63.1,2,0,0
9/18/2017 11:45,69,66.4,83,62.2,152,64.1,2,0,0
9/18/2017 11:50,54,66.4,68,62.1,122,64,2,0,0
9/18/2017 11:55,50,66.2,64,62,114,63.8,2,0,0
9/18/2017 12:00,48,67.5,63,63.3,111,65.1,2,0,0
9/18/2017 12:05,45,66.7,59,62.6,104,64.4,2,0,0
9/18/2017 12:10,53,65.8,67,61.6,120,63.4,2,0,0
9/18/2017 12:15,45,66.3,59,62.1,104,63.9,2,0,0
9/18/2017 12:20,54,64.7,68,60.4,122,62.3,2,0,0
9/18/2017 12:25,59,65.1,74,60.8,133,62.7,2,0,0
9/18/2017 12:30,50,64,64,59.8,114,61.6,2,0,0
9/18/2017 12:35,55,64.4,70,60.1,125,62,2,0,0
9/18/2017 12:40,48,63.6,63,59.4,111,61.2,2,0,0
9/18/2017 12:45,56,65,70,60.8,126,62.7,2,0,0
9/18/2017 12:50,53,65.7,67,61.4,120,63.3,2,0,0
9/18/2017 12:55,54,67.2,68,63,122,64.9,2,0,0
9/18/2017 13:00,46,65.8,61,61.5,107,63.3,2,0,0
9/18/2017 13:05,48,65.7,62,61.4,110,63.3,2,0,0
9/18/2017 13:10,49,65.2,63,60.9,112,62.8,2,0,0
9/18/2017 13:15,47,64.9,61,60.6,108,62.5,2,0,0
9/18/2017 13:20,50,64.3,65,60.1,115,61.9,2,0,0
9/18/2017 13:25,52,65.2,67,60.9,119,62.8,2,0,0
9/18/2017 13:30,56,64.8,71,60.5,127,62.4,2,0,0
9/18/2017 13:35,53,64.9,66,60.7,119,62.5,2,0,0
9/18/2017 13:40,48,64.8,62,60.6,110,62.4,2,0,0
9/18/2017 13:45,47,66,61,61.8,108,63.6,2,0,0
9/18/2017 13:50,53,66.2,67,62,120,63.9,2,0,0
9/18/2017 13:55,54,66.1,69,61.8,123,63.7,2,0,0
9/18/2017 14:00,48,65.1,63,60.8,111,62.7,2,0,0
9/18/2017 14:05,54,65.7,68,61.4,122,63.3,2,0,0
9/18/2017 14:10,48,65.2,62,61,110,62.8,2,0,0
9/18/2017 14:15,48,66,62,61.7,110,63.6,2,0,0
9/18/2017 14:20,50,65.8,65,61.5,115,63.4,2,0,0
9/18/2017 14:25,60,64.3,75,60,135,61.9,2,0,0
9/18/2017 14:30,46,64.2,60,59.9,106,61.8,2,0,0
9/18/2017 14:35,53,64.1,67,59.8,120,61.7,2,0,0
9/18/2017 14:40,43,65.8,57,61.6,100,63.4,2,0,0
9/18/2017 14:45,58,66.5,73,62.2,131,64.1,2,0,0
9/18/2017 14:50,47,66.6,61,62.3,108,64.2,2,0,0
9/18/2017 14:55,46,65.9,60,61.6,106,63.5,2,0,0
9/18/2017 15:00,45,65.1,59,60.8,104,62.7,2,0,0
9/18/2017 15:05,53,64,67,59.6,120,61.6,2,0,0
9/18/2017 15:10,50,64.8,65,60.5,115,62.4,2,0,0
9/18/2017 15:15,45,65.4,59,61.1,104,63,2,0,0
9/18/2017 15:20,52,65.8,67,61.5,119,63.4,2,0,0
9/18/2017 15:25,52,66.4,66,62.1,118,64,2,0,0
9/18/2017 15:30,56,66,71,61.8,127,63.6,2,0,0
9/18/2017 15:35,54,66.5,68,62.3,122,64.2,2,0,0
9/18/2017 15:40,64,66.2,79,61.9,143,63.8,2,0,0
9/18/2017 15:45,56,66.9,70,62.7,126,64.6,2,0,0
9/18/2017 15:50,63,65.3,76,61,139,63,2,0,0
9/18/2017 15:55,62,65.6,75,61.3,137,63.3,2,0,0
9/18/2017 16:00,56,65,70,60.6,126,62.6,2,0,0
9/18/2017 16:05,56,66,70,61.6,126,63.6,2,0,0
9/18/2017 16:10,56,65.6,70,61.3,126,63.2,2,0,0
9/18/2017 16:15,55,64.2,69,59.8,124,61.7,2,0,0
9/18/2017 16:20,49,65.5,63,61.2,112,63.1,2,0,0
9/18/2017 16:25,58,66.1,72,61.7,130,63.6,2,0,0
9/18/2017 16:30,53,65.9,67,61.6,120,63.5,2,0,0
9/18/2017 16:35,65,64.9,79,60.5,144,62.5,2,0,0
9/18/2017 16:40,61,65.2,75,60.8,136,62.8,2,0,0
9/18/2017 16:45,53,63.8,68,59.5,121,61.4,2,0,0
9/18/2017 16:50,57,65,71,60.6,128,62.5,2,0,0
9/18/2017 16:55,53,65.3,68,61,121,62.9,2,0,0
9/18/2017 17:00,52,65,66,60.6,118,62.5,2,0,0
9/18/2017 17:05,47,65.6,61,61.2,108,63.1,2,0,0
9/18/2017 17:10,50,66.5,64,62.2,114,64.1,2,0,0
9/18/2017 17:15,56,65,71,60.7,127,62.6,2,0,0
9/18/2017 17:20,51,65.3,65,61,116,62.9,2,0,0
9/18/2017 17:25,47,64.9,61,60.6,108,62.5,2,0,0
9/18/2017 17:30,43,66.2,57,61.9,100,63.8,2,0,0
9/18/2017 17:35,47,65.5,61,61.1,108,63,2,0,0
9/18/2017 17:40,48,65.3,63,61,111,62.9,2,0,0
9/18/2017 17:45,49,66.1,62,61.8,111,63.7,2,0,0
9/18/2017 17:50,53,66.1,68,61.9,121,63.8,2,0,0
9/18/2017 17:55,50,65.3,64,61,114,62.9,2,0,0
9/18/2017 18:00,45,66.5,59,62.3,104,64.1,2,0,0
9/18/2017 18:05,40,66.8,53,62.6,93,64.4,2,0,0
9/18/2017 18:10,45,67.4,59,63.2,104,65,2,0,0
9/18/2017 18:15,44,66.9,58,62.8,102,64.6,2,0,0
9/18/2017 18:20,49,67,62,62.8,111,64.6,2,0,0
9/18/2017 18:25,49,67.5,62,63.3,111,65.2,2,0,0
9/18/2017 18:30,43,67.9,57,63.6,100,65.5,2,0,0
9/18/2017 18:35,45,68.5,59,64.3,104,66.1,2,0,0
9/18/2017 18:40,36,68.1,51,63.9,87,65.6,2,0,0
9/18/2017 18:45,41,67.1,56,62.9,97,64.7,2,0,0
9/18/2017 18:50,40,66.5,54,62.2,94,64,2,0,0
9/18/2017 18:55,36,66.8,51,62.5,87,64.3,2,0,0
9/18/2017 19:00,37,67.2,51,63,88,64.8,2,0,0
9/18/2017 19:05,35,67.3,49,63.1,84,64.8,2,0,0
9/18/2017 19:10,36,68,51,63.8,87,65.6,2,0,0
9/18/2017 19:15,35,66.8,49,62.7,84,64.4,2,0,0
9/18/2017 19:20,44,68,58,63.8,102,65.6,2,0,0
9/18/2017 19:25,43,66,57,61.7,100,63.6,2,0,0
9/18/2017 19:30,43,66.3,57,62,100,63.9,2,0,0
9/18/2017 19:35,39,66.6,53,62.4,92,64.2,2,0,0
9/18/2017 19:40,37,66.1,52,61.8,89,63.6,2,0,0
9/18/2017 19:45,42,66.9,56,62.6,98,64.5,2,0,0
9/18/2017 19:50,35,67.5,49,63.3,84,65,2,0,0
9/18/2017 19:55,36,67.2,50,63,86,64.8,2,0,0
9/18/2017 20:00,35,67,49,62.7,84,64.5,2,0,0
9/18/2017 20:05,35,67.6,49,63.4,84,65.1,2,0,0
9/18/2017 20:10,36,68.3,51,64.1,87,65.8,2,0,0
9/18/2017 20:15,40,67.8,54,63.6,94,65.4,2,0,0
9/18/2017 20:20,41,67.2,55,62.9,96,64.8,2,0,0
9/18/2017 20:25,34,67.9,48,63.6,82,65.4,2,0,0
9/18/2017 20:30,33,68.1,47,63.9,80,65.7,2,0,0
9/18/2017 20:35,34,67.6,48,63.4,82,65.1,2,0,0
9/18/2017 20:40,36,68,50,63.8,86,65.5,2,0,0
9/18/2017 20:45,35,67.9,49,63.6,84,65.4,2,0,0
9/18/2017 20:50,34,68,49,63.7,83,65.4,2,0,0
9/18/2017 20:55,34,68.8,48,64.5,82,66.3,2,0,0
9/18/2017 21:00,13,68.8,28,64.5,41,65.9,2,0,0
9/18/2017 21:05,43,68.4,58,64.2,101,66,2,0,0
9/18/2017 21:10,33,68.7,47,64.5,80,66.2,2,0,0
9/18/2017 21:15,35,69,50,64.8,85,66.5,2,0,0
9/18/2017 21:20,31,69,45,64.7,76,66.5,2,0,0
9/18/2017 21:25,28,69.2,43,65,71,66.6,2,0,0
9/18/2017 21:30,33,68.9,47,64.7,80,66.4,2,0,0
9/18/2017 21:35,30,68.9,44,64.6,74,66.3,2,0,0
9/18/2017 21:40,31,68.8,46,64.6,77,66.3,2,0,0
9/18/2017 21:45,31,68.3,46,64,77,65.7,2,0,0
9/18/2017 21:50,25,68.8,39,64.6,64,66.3,2,0,0
9/18/2017 21:55,26,68.8,41,64.5,67,66.2,2,0,0
9/18/2017 22:00,24,67.6,39,63.4,63,65,2,0,0
9/18/2017 22:05,30,68.2,45,64,75,65.6,2,0,0
9/18/2017 22:10,25,68.3,39,64.1,64,65.7,2,0,0
9/18/2017 22:15,21,68.5,35,64.3,56,65.9,2,0,0
9/18/2017 22:20,19,68.5,33,64.3,52,65.8,2,0,0
9/18/2017 22:25,21,68.8,36,64.6,57,66.2,2,0,0
9/18/2017 22:30,24,68.8,38,64.6,62,66.2,2,0,0
9/18/2017 22:35,23,68.7,38,64.5,61,66.1,2,0,0
9/18/2017 22:40,16,68.4,31,64.2,47,65.7,2,0,0
9/18/2017 22:45,15,68.7,30,64.5,45,65.9,2,0,0
9/18/2017 22:50,15,68.8,29,64.6,44,66,2,0,0
9/18/2017 22:55,19,68.4,34,64.2,53,65.7,2,0,0
9/18/2017 23:00,19,68.4,33,64.2,52,65.8,2,0,0
9/18/2017 23:05,17,68.2,32,64,49,65.4,2,0,0
9/18/2017 23:10,19,67.8,33,63.7,52,65.2,2,0,0
9/18/2017 23:15,18,68.4,33,64.2,51,65.7,2,0,0
9/18/2017 23:20,23,68.2,37,64,60,65.6,2,0,0
9/18/2017 23:25,17,68.5,32,64.3,49,65.8,2,0,0
9/18/2017 23:30,16,68.7,31,64.5,47,65.9,2,0,0
9/18/2017 23:35,15,68.8,30,64.6,45,66,2,0,0
9/18/2017 23:40,18,68.7,33,64.5,51,66,2,0,0
9/18/2017 23:45,15,68.5,30,64.3,45,65.7,2,0,0
9/18/2017 23:50,13,68.6,28,64.4,41,65.7,2,0,0
9/18/2017 23:55,15,68.7,29,64.5,44,66,2,0,0
9/19/2017 0:00,12,68.9,27,64.7,39,66,2,0,0
9/19/2017 0:05,11,68.9,26,64.7,37,65.9,2,0,0
9/19/2017 0:10,11,68.8,26,64.6,37,65.9,2,0,0
9/19/2017 0:15,11,68.9,25,64.7,36,66,2,0,0
9/19/2017 0:20,11,68.7,26,64.4,37,65.7,2,0,0
9/19/2017 0:25,9,68.7,24,64.5,33,65.7,2,0,0
9/19/2017 0:30,11,68.8,26,64.6,37,65.9,2,0,0
9/19/2017 0:35,9,68.9,23,64.7,32,65.9,2,0,0
9/19/2017 0:40,13,68.8,28,64.6,41,65.9,2,0,0
9/19/2017 0:45,9,68.6,24,64.4,33,65.6,2,0,0
9/19/2017 0:50,8,68.7,23,64.5,31,65.6,2,0,0
9/19/2017 0:55,10,68.8,25,64.6,35,65.8,2,0,0
9/19/2017 1:00,9,68.9,24,64.8,33,65.9,2,0,0
9/19/2017 1:05,10,68.8,24,64.6,34,65.9,2,0,0
9/19/2017 1:10,9,68.8,24,64.6,33,65.7,2,0,0
9/19/2017 1:15,9,68.6,24,64.4,33,65.5,2,0,0
9/19/2017 1:20,9,68.7,24,64.5,33,65.7,2,0,0
9/19/2017 1:25,10,68.7,24,64.5,34,65.7,2,0,0
9/19/2017 1:30,9,68.8,24,64.6,33,65.8,2,0,0
9/19/2017 1:35,13,68.7,28,64.5,41,65.8,2,0,0
9/19/2017 1:40,9,68.8,24,64.6,33,65.7,2,0,0
9/19/2017 1:45,7,68.8,22,64.6,29,65.6,2,0,0
9/19/2017 1:50,8,68.8,23,64.6,31,65.7,2,0,0
9/19/2017 1:55,7,68.9,22,64.7,29,65.7,2,0,0
9/19/2017 2:00,9,68.9,24,64.7,33,65.9,2,0,0
9/19/2017 2:05,7,68.8,22,64.6,29,65.6,2,0,0
9/19/2017 2:10,9,68.8,24,64.6,33,65.7,2,0,0
9/19/2017 2:15,8,68.9,23,64.7,31,65.8,2,0,0
9/19/2017 2:20,8,68.8,23,64.6,31,65.7,2,0,0
9/19/2017 2:25,9,68.9,24,64.7,33,65.9,2,0,0
9/19/2017 2:30,9,68.8,24,64.6,33,65.8,2,0,0
9/19/2017 2:35,11,68.8,26,64.6,37,65.8,2,0,0
9/19/2017 2:40,8,68.7,24,64.5,32,65.5,2,0,0
9/19/2017 2:45,14,68.6,28,64.4,42,65.8,2,0,0
9/19/2017 2:50,12,68.7,26,64.5,38,65.8,2,0,0
9/19/2017 2:55,11,68.8,26,64.6,37,65.9,2,0,0
9/19/2017 3:00,12,68.7,27,64.5,39,65.8,2,0,0
9/19/2017 3:05,13,68.7,28,64.5,41,65.8,2,0,0
9/19/2017 3:10,11,68.9,27,64.7,38,65.9,2,0,0
9/19/2017 3:15,12,69,27,64.8,39,66.1,2,0,0
9/19/2017 3:20,10,68.7,25,64.5,35,65.7,2,0,0
9/19/2017 3:25,10,68.7,25,64.5,35,65.7,2,0,0
9/19/2017 3:30,13,68.7,29,64.5,42,65.8,2,0,0
9/19/2017 3:35,14,68.8,29,64.6,43,66,2,0,0
9/19/2017 3:40,12,68.8,27,64.6,39,65.9,2,0,0
9/19/2017 3:45,16,68.9,31,64.7,47,66.2,2,0,0
9/19/2017 3:50,14,68.9,29,64.7,43,66,2,0,0
9/19/2017 3:55,15,68.8,29,64.6,44,66.1,2,0,0
9/19/2017 4:00,16,68.9,31,64.8,47,66.2,2,0,0
9/19/2017 4:05,16,68.8,30,64.6,46,66.1,2,0,0
9/19/2017 4:10,18,68.7,33,64.5,51,66,2,0,0
9/19/2017 4:15,21,68.5,36,64.3,57,65.8,2,0,0
9/19/2017 4:20,25,68,40,63.8,65,65.4,2,0,0
9/19/2017 4:25,25,68.1,40,63.8,65,65.5,2,0,0
9/19/2017 4:30,28,67.8,43,63.6,71,65.3,2,0,0
9/19/2017 4:35,33,68.3,48,64.1,81,65.8,2,0,0
9/19/2017 4:40,44,68.1,59,63.9,103,65.7,2,0,0
9/19/2017 4:45,46,68.7,61,64.5,107,66.3,2,0,0
9/19/2017 4:50,42,69.4,57,65.2,99,67,2,0,0
9/19/2017 4:55,47,67.8,62,63.6,109,65.4,2,0,0
9/19/2017 5:00,42,68.8,57,64.6,99,66.4,2,0,0
9/19/2017 5:05,41,68.4,56,64.2,97,66,2,0,0
9/19/2017 5:10,55,67.6,70,63.3,125,65.2,2,0,0
9/19/2017 5:15,40,68.5,56,64.3,96,66.1,2,0,0
9/19/2017 5:20,55,67.6,71,63.4,126,65.2,2,0,0
9/19/2017 5:25,83,66.9,100,62.6,183,64.5,2,0,0
9/19/2017 5:30,63,67.1,79,62.8,142,64.7,2,0,0
9/19/2017 5:35,62,67.8,78,63.6,140,65.4,2,0,0
9/19/2017 5:40,74,68,91,63.7,165,65.6,2,0,0
9/19/2017 5:45,68,67.5,84,63.2,152,65.2,2,0,0
9/19/2017 5:50,72,67.5,87,63.2,159,65.1,2,0,0
9/19/2017 5:55,76,66.7,92,62.4,168,64.4,2,0,0
9/19/2017 6:00,60,65.2,76,60.9,136,62.8,2,0,0
9/19/2017 6:05,58,64.6,74,60.2,132,62.1,2,0,0
9/19/2017 6:10,72,64.4,88,60,160,62,2,0,0
9/19/2017 6:15,68,64,84,59.6,152,61.5,2,0,0
9/19/2017 6:20,70,64.7,86,60.3,156,62.3,2,0,0
9/19/2017 6:25,59,66.5,74,62.1,133,64.1,2,0,0
9/19/2017 6:30,75,67.1,91,62.6,166,64.6,2,0,0
9/19/2017 6:35,77,66.4,93,62,170,64,2,0,0
9/19/2017 6:40,64,67.1,80,62.7,144,64.6,2,0,0
9/19/2017 6:45,74,66.8,89,62.4,163,64.4,2,0,0
9/19/2017 6:50,70,66.8,86,62.4,156,64.4,2,0,0
9/19/2017 6:55,70,67.9,86,63.5,156,65.5,2,0,0
9/19/2017 7:00,73,67.4,89,63.1,162,65,2,0,0
9/19/2017 7:05,74,67,89,62.6,163,64.6,2,0,0
9/19/2017 7:10,82,67,98,62.7,180,64.6,2,0,0
9/19/2017 7:15,90,66.7,106,62.4,196,64.4,2,0,0
9/19/2017 7:20,80,66.8,96,62.5,176,64.4,2,0,0
9/19/2017 7:25,93,65.8,108,61.4,201,63.4,2,0,0
9/19/2017 7:30,80,66.6,96,62.3,176,64.3,2,0,0
9/19/2017 7:35,88,66.6,104,62.3,192,64.3,2,0,0
9/19/2017 7:40,88,66.1,104,61.7,192,63.7,2,0,0
9/19/2017 7:45,91,66.2,108,61.8,199,63.8,2,0,0
9/19/2017 7:50,87,65.6,103,61.2,190,63.2,2,0,0
9/19/2017 7:55,84,66.5,101,62.2,185,64.1,2,0,0
9/19/2017 8:00,80,66.6,96,62.2,176,64.2,2,0,0
9/19/2017 8:05,89,65.3,104,61,193,63,2,0,0
9/19/2017 8:10,81,65.6,98,61.3,179,63.2,2,0,0
9/19/2017 8:15,89,65.5,106,61.1,195,63.1,2,0,0
9/19/2017 8:20,79,65.8,95,61.4,174,63.4,2,0,0
9/19/2017 8:25,84,65.5,100,61.2,184,63.2,2,0,0
9/19/2017 8:30,79,67.1,94,62.7,173,64.7,2,0,0
9/19/2017 8:35,85,66.3,100,62,185,64,2,0,0
9/19/2017 8:40,74,65.4,88,61.1,162,63.1,2,0,0
9/19/2017 8:45,85,65.8,100,61.4,185,63.4,2,0,0
9/19/2017 8:50,86,65.7,101,61.3,187,63.3,2,0,0
9/19/2017 8:55,81,64.5,97,60.1,178,62.1,2,0,0
9/19/2017 9:00,76,65.1,91,60.7,167,62.7,2,0,0
9/19/2017 9:05,75,64.7,90,60.3,165,62.3,2,0,0
9/19/2017 9:10,72,64.1,87,59.7,159,61.7,2,0,0
9/19/2017 9:15,73,63.9,88,59.5,161,61.5,2,0,0
9/19/2017 9:20,61,64.3,76,60,137,61.9,2,0,0
9/19/2017 9:25,60,64.4,75,60.1,135,62,2,0,0
9/19/2017 9:30,69,65,85,60.7,154,62.7,2,0,0
9/19/2017 9:35,67,65.1,82,60.8,149,62.8,2,0,0
9/19/2017 9:40,58,64.9,75,60.5,133,62.4,2,0,0
9/19/2017 9:45,69,63.7,84,59.4,153,61.4,2,0,0
9/19/2017 9:50,63,63.1,78,58.7,141,60.7,2,0,0
9/19/2017 9:55,60,63.3,76,59,136,60.9,2,0,0
9/19/2017 10:00,50,65.3,65,61,115,62.9,2,0,0
9/19/2017 10:05,58,65.8,73,61.5,131,63.4,2,0,0
9/19/2017 10:10,63,65.4,78,61.1,141,63,2,0,0
9/19/2017 10:15,68,66.2,83,62,151,63.9,2,0,0
9/19/2017 10:20,66,66.7,79,62.5,145,64.4,2,0,0
9/19/2017 10:25,68,66.2,82,62,150,63.9,2,0,0
9/19/2017 10:30,66,67.8,79,63.6,145,65.5,2,0,0
9/19/2017 10:35,64,65,79,60.8,143,62.7,2,0,0
9/19/2017 10:40,61,65.5,74,61.3,135,63.2,2,0,0
9/19/2017 10:45,55,66.4,68,62.2,123,64.1,2,0,0
9/19/2017 10:50,63,65.6,78,61.3,141,63.2,2,0,0
9/19/2017 10:55,50,65.8,65,61.7,115,63.5,2,0,0
9/19/2017 11:00,55,67.9,69,63.7,124,65.6,2,0,0
9/19/2017 11:05,67,64.8,81,60.6,148,62.5,2,0,0
9/19/2017 11:10,54,64.7,67,60.4,121,62.3,2,0,0
9/19/2017 11:15,68,65.3,83,61,151,62.9,2,0,0
9/19/2017 11:20,56,64,70,59.7,126,61.6,2,0,0
9/19/2017 11:25,58,65.1,72,60.8,130,62.7,2,0,0
9/19/2017 11:30,60,65.8,74,61.5,134,63.4,2,0,0
9/19/2017 11:35,58,66.2,72,61.9,130,63.8,2,0,0
9/19/2017 11:40,51,66.7,65,62.5,116,64.3,2,0,0
9/19/2017 11:45,58,67.2,73,63,131,64.9,2,0,0
9/19/2017 11:50,58,67.3,72,63.1,130,65,2,0,0
9/19/2017 11:55,60,67.2,75,63,135,64.8,2,0,0
9/19/2017 12:00,62,67.6,77,63.3,139,65.2,2,0,0
9/19/2017 12:05,48,68.4,62,64.1,110,66,2,0,0
9/19/2017 12:10,53,67.1,67,62.8,120,64.7,2,0,0
9/19/2017 12:15,56,67.2,70,62.9,126,64.8,2,0,0
9/19/2017 12:20,50,67.2,64,62.9,114,64.8,2,0,0
9/19/2017 12:25,60,67.3,75,63,135,64.9,2,0,0
9/19/2017 12:30,58,67.3,73,63,131,64.9,2,0,0
9/19/2017 12:35,49,66.5,62,62.3,111,64.2,2,0,0
9/19/2017 12:40,51,68.4,65,64.1,116,66,2,0,0
9/19/2017 12:45,57,68.2,71,63.9,128,65.8,2,0,0
9/19/2017 12:50,56,68.6,70,64.3,126,66.2,2,0,0
9/19/2017 12:55,50,69.1,64,64.9,114,66.8,2,0,0
9/19/2017 13:00,46,68.8,61,64.6,107,66.4,2,0,0
9/19/2017 13:05,56,69.1,69,64.8,125,66.7,2,0,0
9/19/2017 13:10,46,68.9,60,64.7,106,66.5,2,0,0
9/19/2017 13:15,63,66.9,77,62.6,140,64.5,2,0,0
9/19/2017 13:20,51,67.4,66,63.2,117,65,2,0,0
9/19/2017 13:25,52,66.6,67,62.4,119,64.2,2,0,0
9/19/2017 13:30,55,66.8,70,62.6,125,64.5,2,0,0
9/19/2017 13:35,53,67.2,67,63,120,64.9,2,0,0
9/19/2017 13:40,58,67.4,72,63.1,130,65,2,0,0
9/19/2017 13:45,52,66.9,66,62.6,118,64.5,2,0,0
9/19/2017 13:50,52,65.6,66,61.5,118,63.3,2,0,0
9/19/2017 13:55,53,67.3,67,63.1,120,65,2,0,0
9/19/2017 14:00,48,68,63,63.8,111,65.6,2,0,0
9/19/2017 14:05,55,68,69,63.7,124,65.6,2,0,0
9/19/2017 14:10,59,68.1,72,63.9,131,65.8,2,0,0
9/19/2017 14:15,57,67.8,72,63.6,129,65.5,2,0,0
9/19/2017 14:20,59,67.9,73,63.6,132,65.5,2,0,0
9/19/2017 14:25,50,67.9,64,63.6,114,65.5,2,0,0
9/19/2017 14:30,61,69.3,75,65.1,136,66.9,2,0,0
9/19/2017 14:35,56,68,70,63.8,126,65.7,2,0,0
9/19/2017 14:40,71,68.1,85,63.9,156,65.8,2,0,0
9/19/2017 14:45,56,67.1,70,62.9,126,64.8,2,0,0
9/19/2017 14:50,62,67.5,76,63.3,138,65.2,2,0,0
9/19/2017 14:55,54,68.4,68,64.2,122,66.1,2,0,0
9/19/2017 15:00,57,68.9,71,64.8,128,66.6,2,0,0
9/19/2017 15:05,57,68.3,72,64.2,129,66,2,0,0
9/19/2017 15:10,68,67.6,82,63.4,150,65.3,2,0,0
9/19/2017 15:15,60,67.1,75,62.9,135,64.7,2,0,0
9/19/2017 15:20,57,67.4,71,63.2,128,65.1,2,0,0
9/19/2017 15:25,64,67.6,78,63.4,142,65.3,2,0,0
9/19/2017 15:30,72,67.2,86,63,158,64.9,2,0,0
9/19/2017 15:35,58,67.6,72,63.4,130,65.3,2,0,0
9/19/2017 15:40,60,66.5,75,62.3,135,64.1,2,0,0
9/19/2017 15:45,63,66.7,77,62.5,140,64.4,2,0,0
9/19/2017 15:50,67,66.3,81,62.1,148,64,2,0,0
9/19/2017 15:55,69,66.6,83,62.4,152,64.4,2,0,0
9/19/2017 16:00,62,66.6,76,62.4,138,64.3,2,0,0
9/19/2017 16:05,69,66.5,83,62.2,152,64.2,2,0,0
9/19/2017 16:10,66,66.1,80,61.8,146,63.7,2,0,0
9/19/2017 16:15,57,66.3,71,62.1,128,64,2,0,0
9/19/2017 16:20,55,67.8,69,63.6,124,65.5,2,0,0
9/19/2017 16:25,55,68.4,69,64.3,124,66.1,2,0,0
9/19/2017 16:30,54,67.1,68,62.8,122,64.7,2,0,0
9/19/2017 16:35,55,67.3,70,63.1,125,64.9,2,0,0
9/19/2017 16:40,55,68,69,63.8,124,65.7,2,0,0
9/19/2017 16:45,48,68,63,63.8,111,65.6,2,0,0
9/19/2017 16:50,58,67.7,72,63.6,130,65.4,2,0,0
9/19/2017 16:55,56,67.6,69,63.4,125,65.3,2,0,0
9/19/2017 17:00,51,67.5,65,63.2,116,65.1,2,0,0
9/19/2017 17:05,62,67.9,76,63.6,138,65.5,2,0,0
9/19/2017 17:10,58,67.8,73,63.6,131,65.5,2,0,0
9/19/2017 17:15,48,68.9,63,64.7,111,66.5,2,0,0
9/19/2017 17:20,41,68.6,55,64.4,96,66.2,2,0,0
9/19/2017 17:25,61,68.5,75,64.2,136,66.1,2,0,0
9/19/2017 17:30,57,68,71,63.8,128,65.7,2,0,0
9/19/2017 17:35,59,68.7,74,64.5,133,66.3,2,0,0
9/19/2017 17:40,55,68.7,69,64.5,124,66.3,2,0,0
9/19/2017 17:45,55,66.9,70,62.7,125,64.6,2,0,0
9/19/2017 17:50,62,67,76,62.8,138,64.7,2,0,0
9/19/2017 17:55,48,66.8,63,62.5,111,64.4,2,0,0
9/19/2017 18:00,47,67.1,61,62.9,108,64.8,2,0,0
9/19/2017 18:05,48,68.7,63,64.5,111,66.3,2,0,0
9/19/2017 18:10,52,68.2,66,64,118,65.9,2,0,0
9/19/2017 18:15,44,67.9,58,63.7,102,65.5,2,0,0
9/19/2017 18:20,54,68.9,67,64.7,121,66.6,2,0,0
9/19/2017 18:25,50,69,63,64.8,113,66.7,2,0,0
9/19/2017 18:30,51,68.9,66,64.7,117,66.5,2,0,0
9/19/2017 18:35,42,68.1,56,64,98,65.8,2,0,0
9/19/2017 18:40,54,68.6,68,64.5,122,66.3,2,0,0
9/19/2017 18:45,47,68.8,61,64.6,108,66.5,2,0,0
9/19/2017 18:50,44,68.6,58,64.3,102,66.2,2,0,0
9/19/2017 18:55,59,69.1,73,64.8,132,66.7,2,0,0
9/19/2017 19:00,50,68.4,64,64.2,114,66,2,0,0
9/19/2017 19:05,43,69.5,58,65.3,101,67.1,2,0,0
9/19/2017 19:10,49,67.5,64,63.3,113,65.1,2,0,0
9/19/2017 19:15,53,67.6,67,63.4,120,65.3,2,0,0
9/19/2017 19:20,43,67.9,58,63.7,101,65.5,2,0,0
9/19/2017 19:25,38,68.6,52,64.4,90,66.1,2,0,0
9/19/2017 19:30,39,68.3,53,64.2,92,65.9,2,0,0
9/19/2017 19:35,43,68,58,63.8,101,65.6,2,0,0
9/19/2017 19:40,44,67.1,59,62.9,103,64.7,2,0,0
9/19/2017 19:45,39,68,53,63.8,92,65.5,2,0,0
9/19/2017 19:50,45,66.9,59,62.7,104,64.5,2,0,0
9/19/2017 19:55,42,67.1,56,62.9,98,64.7,2,0,0
9/19/2017 20:00,43,67.7,57,63.5,100,65.3,2,0,0
9/19/2017 20:05,40,68.8,54,64.6,94,66.4,2,0,0
9/19/2017 20:10,39,69.1,53,64.9,92,66.6,2,0,0
9/19/2017 20:15,31,68.6,45,64.4,76,66.1,2,0,0
9/19/2017 20:20,33,69.1,47,64.9,80,66.6,2,0,0
9/19/2017 20:25,36,68.8,51,64.5,87,66.3,2,0,0
9/19/2017 20:30,38,68.3,52,64.1,90,65.9,2,0,0
9/19/2017 20:35,32,68,47,63.7,79,65.5,2,0,0
9/19/2017 20:40,35,68.1,48,63.9,83,65.7,2,0,0
9/19/2017 20:45,31,68.3,46,64.1,77,65.8,2,0,0
9/19/2017 20:50,32,68.5,47,64.3,79,66,2,0,0
9/19/2017 20:55,27,68.6,41,64.4,68,66.1,2,0,0
9/19/2017 21:00,33,68.4,47,64.2,80,66,2,0,0
9/19/2017 21:05,34,69.1,48,64.9,82,66.6,2,0,0
9/19/2017 21:10,36,68.1,51,63.9,87,65.7,2,0,0
9/19/2017 21:15,38,69.2,52,65,90,66.8,2,0,0
9/19/2017 21:20,31,69.3,45,65.1,76,66.8,2,0,0
9/19/2017 21:25,34,69.5,49,65.3,83,67,2,0,0
9/19/2017 21:30,34,69.4,49,65.2,83,66.9,2,0,0
9/19/2017 21:35,24,69.4,38,65.2,62,66.8,2,0,0
9/19/2017 21:40,31,69.1,46,64.9,77,66.6,2,0,0
9/19/2017 21:45,22,68.9,37,64.7,59,66.3,2,0,0
9/19/2017 21:50,37,68.5,51,64.3,88,66,2,0,0
9/19/2017 21:55,27,67.8,41,63.6,68,65.2,2,0,0
9/19/2017 22:00,24,67.6,39,63.4,63,65,2,0,0
9/19/2017 22:05,21,68.4,36,64.2,57,65.7,2,0,0
9/19/2017 22:10,21,68.8,35,64.6,56,66.2,2,0,0
9/19/2017 22:15,27,69.1,41,64.9,68,66.6,2,0,0
9/19/2017 22:20,22,69.1,37,64.9,59,66.5,2,0,0
9/19/2017 22:25,22,69.1,36,64.9,58,66.5,2,0,0
9/19/2017 22:30,19,69,33,64.8,52,66.3,2,0,0
9/19/2017 22:35,20,69,34,64.8,54,66.4,2,0,0
9/19/2017 22:40,20,69.2,34,65,54,66.5,2,0,0
9/19/2017 22:45,23,68.9,38,64.7,61,66.3,2,0,0
9/19/2017 22:50,18,68.7,33,64.5,51,66,2,0,0
9/19/2017 22:55,16,68.8,31,64.6,47,66,2,0,0
9/19/2017 23:00,19,68.8,33,64.6,52,66.1,2,0,0
9/19/2017 23:05,16,68.9,31,64.7,47,66.1,2,0,0
9/19/2017 23:10,15,68.9,30,64.7,45,66.1,2,0,0
9/19/2017 23:15,16,68.9,31,64.6,47,66.1,2,0,0
9/19/2017 23:20,15,68.9,29,64.7,44,66.1,2,0,0
9/19/2017 23:25,14,68.7,29,64.5,43,65.8,2,0,0
9/19/2017 23:30,19,68.8,33,64.6,52,66.1,2,0,0
9/19/2017 23:35,18,69,32,64.8,50,66.3,2,0,0
9/19/2017 23:40,16,68.8,30,64.6,46,66,2,0,0
9/19/2017 23:45,14,68.8,29,64.6,43,66,2,0,0
9/19/2017 23:50,14,68.8,28,64.6,42,66,2,0,0
9/19/2017 23:55,13,68.9,28,64.7,41,66,2,0,0
9/20/2017 0:00,10,68.9,25,64.7,35,65.9,2,0,0
9/20/2017 0:05,10,68.9,24,64.8,34,66,2,0,0
9/20/2017 0:10,11,69.1,26,64.9,37,66.2,2,0,0
9/20/2017 0:15,14,68.9,29,64.8,43,66.1,2,0,0
9/20/2017 0:20,10,68.8,25,64.6,35,65.8,2,0,0
9/20/2017 0:25,10,68.9,24,64.7,34,65.9,2,0,0
9/20/2017 0:30,12,68.9,26,64.7,38,66,2,0,0
9/20/2017 0:35,9,68.8,24,64.6,33,65.8,2,0,0
9/20/2017 0:40,12,68.7,27,64.5,39,65.8,2,0,0
9/20/2017 0:45,7,68.7,22,64.5,29,65.6,2,0,0
9/20/2017 0:50,7,68.8,22,64.6,29,65.6,2,0,0
9/20/2017 0:55,11,68.8,26,64.6,37,65.8,2,0,0
9/20/2017 1:00,7,68.8,21,64.6,28,65.6,2,0,0
9/20/2017 1:05,5,68.8,20,64.6,25,65.4,2,0,0
9/20/2017 1:10,6,68.8,21,64.6,27,65.6,2,0,0
9/20/2017 1:15,7,68.9,22,64.7,29,65.7,2,0,0
9/20/2017 1:20,7,68.7,22,64.5,29,65.5,2,0,0
9/20/2017 1:25,10,68.7,25,64.5,35,65.7,2,0,0
9/20/2017 1:30,10,68.1,25,63.9,35,65.1,2,0,0
9/20/2017 1:35,13,68.5,28,64.3,41,65.6,2,0,0
9/20/2017 1:40,8,68.6,24,64.4,32,65.5,2,0,0
9/20/2017 1:45,6,68.7,21,64.5,27,65.5,2,0,0
9/20/2017 1:50,8,68.7,23,64.5,31,65.6,2,0,0
9/20/2017 1:55,7,68.8,22,64.6,29,65.6,2,0,0
9/20/2017 2:00,8,68.8,23,64.6,31,65.7,2,0,0
9/20/2017 2:05,8,68.9,23,64.7,31,65.8,2,0,0
9/20/2017 2:10,9,69,24,64.8,33,65.9,2,0,0
9/20/2017 2:15,8,68.9,23,64.7,31,65.8,2,0,0
9/20/2017 2:20,7,69,22,64.8,29,65.8,2,0,0
9/20/2017 2:25,7,69,22,64.8,29,65.8,2,0,0
9/20/2017 2:30,10,69,25,64.8,35,66,2,0,0
9/20/2017 2:35,9,68.9,24,64.8,33,65.9,2,0,0
9/20/2017 2:40,10,68.9,25,64.7,35,65.9,2,0,0
9/20/2017 2:45,9,68.9,24,64.7,33,65.9,2,0,0
9/20/2017 2:50,12,68.8,27,64.6,39,65.9,2,0,0
9/20/2017 2:55,12,68.8,27,64.6,39,65.9,2,0,0
9/20/2017 3:00,14,69,29,64.8,43,66.2,2,0,0
9/20/2017 3:05,9,68.7,24,64.5,33,65.7,2,0,0
9/20/2017 3:10,9,68.8,24,64.6,33,65.8,2,0,0
9/20/2017 3:15,9,68.9,25,64.7,34,65.8,2,0,0
9/20/2017 3:20,11,68.8,26,64.6,37,65.9,2,0,0
9/20/2017 3:25,9,68.9,24,64.7,33,65.8,2,0,0
9/20/2017 3:30,13,68.3,27,64.1,40,65.5,2,0,0
9/20/2017 3:35,17,68.6,32,64.4,49,65.8,2,0,0
9/20/2017 3:40,12,68.8,27,64.6,39,65.9,2,0,0
9/20/2017 3:45,18,68.8,33,64.6,51,66.1,2,0,0
9/20/2017 3:50,13,69,28,64.8,41,66.1,2,0,0
9/20/2017 3:55,15,69.1,30,64.9,45,66.3,2,0,0
9/20/2017 4:00,16,68.9,31,64.7,47,66.1,2,0,0
9/20/2017 4:05,13,68.9,29,64.7,42,66,2,0,0
9/20/2017 4:10,21,69,36,64.8,57,66.4,2,0,0
9/20/2017 4:15,22,68.8,37,64.7,59,66.2,2,0,0
9/20/2017 4:20,24,68.6,39,64.4,63,66,2,0,0
9/20/2017 4:25,24,68.4,39,64.2,63,65.8,2,0,0
9/20/2017 4:30,29,68.8,44,64.7,73,66.3,2,0,0
9/20/2017 4:35,34,68.9,50,64.7,84,66.4,2,0,0
9/20/2017 4:40,32,67.6,47,63.5,79,65.2,2,0,0
9/20/2017 4:45,44,68.4,59,64.2,103,66,2,0,0
9/20/2017 4:50,38,69.1,53,64.9,91,66.7,2,0,0
9/20/2017 4:55,40,69,56,64.8,96,66.5,2,0,0
9/20/2017 5:00,40,68.5,55,64.3,95,66.1,2,0,0
9/20/2017 5:05,46,67.9,61,63.7,107,65.5,2,0,0
9/20/2017 5:10,46,68.2,61,64,107,65.8,2,0,0
9/20/2017 5:15,53,67.5,67,63.3,120,65.2,2,0,0
9/20/2017 5:20,52,67.7,67,63.5,119,65.3,2,0,0
9/20/2017 5:25,61,67.8,77,63.6,138,65.4,2,0,0
9/20/2017 5:30,66,67.5,82,63.3,148,65.2,2,0,0
9/20/2017 5:35,63,67.8,79,63.6,142,65.4,2,0,0
9/20/2017 5:40,75,68.1,91,63.7,166,65.7,2,0,0
9/20/2017 5:45,75,66.6,91,62.3,166,64.3,2,0,0
9/20/2017 5:50,83,67.5,99,63.2,182,65.2,2,0,0
9/20/2017 5:55,64,68.4,80,64.1,144,66,2,0,0
9/20/2017 6:00,54,68.1,69,63.8,123,65.7,2,0,0
9/20/2017 6:05,55,67.8,70,63.5,125,65.4,2,0,0
9/20/2017 6:10,60,66.9,75,62.6,135,64.5,2,0,0
9/20/2017 6:15,69,66.7,85,62.4,154,64.3,2,0,0
9/20/2017 6:20,70,67,86,62.7,156,64.6,2,0,0
9/20/2017 6:25,58,65.9,74,61.6,132,63.5,2,0,0
9/20/2017 6:30,62,67,78,62.8,140,64.7,2,0,0
9/20/2017 6:35,70,67.5,86,63.2,156,65.1,2,0,0
9/20/2017 6:40,69,67.3,84,63,153,64.9,2,0,0
9/20/2017 6:45,64,65.9,80,61.6,144,63.5,2,0,0
9/20/2017 6:50,78,67.4,94,63.1,172,65,2,0,0
9/20/2017 6:55,69,67.9,86,63.7,155,65.6,2,0,0
9/20/2017 7:00,71,67.9,87,63.7,158,65.6,2,0,0
9/20/2017 7:05,72,67,88,62.7,160,64.6,2,0,0
9/20/2017 7:10,86,66.9,103,62.7,189,64.6,2,0,0
9/20/2017 7:15,67,67.2,83,63,150,64.9,2,0,0
9/20/2017 7:20,83,66.4,101,62.1,184,64,2,0,0
9/20/2017 7:25,85,67.1,101,62.8,186,64.8,2,0,0
9/20/2017 7:30,82,66.7,98,62.4,180,64.4,2,0,0
9/20/2017 7:35,81,66.6,98,62.4,179,64.3,2,0,0
9/20/2017 7:40,93,67,109,62.8,202,64.7,2,0,0
9/20/2017 7:45,95,66,111,61.7,206,63.7,2,0,0
9/20/2017 7:50,88,66.1,104,61.8,192,63.8,2,0,0
9/20/2017 7:55,97,66.6,114,62.3,211,64.2,2,0,0
9/20/2017 8:00,84,66.3,100,62,184,64,2,0,0
9/20/2017 8:05,79,65,95,60.7,174,62.7,2,0,0
9/20/2017 8:10,80,65.6,96,61.3,176,63.3,2,0,0
9/20/2017 8:15,83,65.8,100,61.6,183,63.5,2,0,0
9/20/2017 8:20,81,66.2,97,61.9,178,63.9,2,0,0
9/20/2017 8:25,82,65.3,96,61,178,63,2,0,0
9/20/2017 8:30,82,65.1,98,60.8,180,62.8,2,0,0
9/20/2017 8:35,85,65.2,100,60.9,185,62.9,2,0,0
9/20/2017 8:40,87,64,102,59.7,189,61.7,2,0,0
9/20/2017 8:45,84,63.8,100,59.5,184,61.4,2,0,0
9/20/2017 8:50,74,63.1,89,58.8,163,60.8,2,0,0
9/20/2017 8:55,72,63.9,87,59.5,159,61.5,2,0,0
9/20/2017 9:00,71,64.6,86,60.3,157,62.2,2,0,0
9/20/2017 9:05,79,64.8,96,60.5,175,62.5,2,0,0
9/20/2017 9:10,67,65.1,83,60.8,150,62.7,2,0,0
9/20/2017 9:15,73,64.7,88,60.5,161,62.4,2,0,0
9/20/2017 9:20,79,65.1,93,60.9,172,62.8,2,0,0
9/20/2017 9:25,73,65.6,88,61.4,161,63.3,2,0,0
9/20/2017 9:30,80,65.7,95,61.5,175,63.4,2,0,0
9/20/2017 9:35,75,65.6,91,61.4,166,63.3,2,0,0
9/20/2017 9:40,75,63.8,89,59.6,164,61.5,2,0,0
9/20/2017 9:45,72,64.7,88,60.4,160,62.3,2,0,0
9/20/2017 9:50,76,64.4,92,60.2,168,62.1,2,0,0
9/20/2017 9:55,69,65.6,84,61.4,153,63.3,2,0,0
9/20/2017 10:00,69,65.8,82,61.5,151,63.5,2,0,0
9/20/2017 10:05,62,65.8,76,61.6,138,63.5,2,0,0
9/20/2017 10:10,64,65.6,78,61.3,142,63.2,2,0,0
9/20/2017 10:15,59,64.2,73,60,132,61.8,2,0,0
9/20/2017 10:20,65,63.1,80,58.8,145,60.7,2,0,0
9/20/2017 10:25,70,64.5,85,60.3,155,62.2,2,0,0
9/20/2017 10:30,67,64.9,82,60.8,149,62.6,2,0,0
9/20/2017 10:35,71,65,86,60.8,157,62.7,2,0,0
9/20/2017 10:40,65,64.5,80,60.3,145,62.2,2,0,0
9/20/2017 10:45,65,64.7,79,60.5,144,62.4,2,0,0
9/20/2017 10:50,60,65.2,75,61,135,62.8,2,0,0
9/20/2017 10:55,54,65.9,69,61.7,123,63.5,2,0,0
9/20/2017 11:00,59,65,75,60.8,134,62.6,2,0,0
9/20/2017 11:05,61,64.9,75,60.7,136,62.6,2,0,0
9/20/2017 11:10,57,64.4,72,60.2,129,62.1,2,0,0
9/20/2017 11:15,55,64.3,70,60.1,125,61.9,2,0,0
9/20/2017 11:20,59,66.4,73,62.2,132,64,2,0,0
9/20/2017 11:25,50,65.1,65,60.9,115,62.8,2,0,0
9/20/2017 11:30,51,66.1,64,61.9,115,63.8,2,0,0
9/20/2017 11:35,57,65.4,72,61.3,129,63.1,2,0,0
9/20/2017 11:40,57,65.7,70,61.6,127,63.4,2,0,0
9/20/2017 11:45,53,66,67,61.8,120,63.7,2,0,0
9/20/2017 11:50,58,66.3,72,62.1,130,64,2,0,0
9/20/2017 11:55,60,65.3,74,61.2,134,63,2,0,0
9/20/2017 12:00,62,67.2,76,63,138,64.9,2,0,0
9/20/2017 12:05,53,65.6,67,61.4,120,63.2,2,0,0
9/20/2017 12:10,60,66,74,61.8,134,63.7,2,0,0
9/20/2017 12:15,47,66.4,60,62.2,107,64.1,2,0,0
9/20/2017 12:20,63,68.7,57,62.9,120,65.9,2,0,0
9/20/2017 12:25,66,68.6,60,62.8,126,65.8,2,0,0
9/20/2017 12:30,67,68.5,60,62.7,127,65.8,2,0,0
9/20/2017 12:35,67,68.5,61,62.7,128,65.7,2,0,0
9/20/2017 12:40,70,68.6,62,62.8,132,65.9,2,0,0
9/20/2017 12:45,69,68.7,62,62.9,131,66,2,0,0
9/20/2017 12:50,64,68.7,57,62.9,121,66,2,0,0
9/20/2017 12:55,65,68.7,59,62.9,124,65.9,2,0,0
9/20/2017 13:00,64,68.6,58,62.8,122,65.8,2,0,0
9/20/2017 13:05,48,69.1,62,64.9,110,66.8,2,0,0
9/20/2017 13:10,55,69.6,69,65.4,124,67.3,2,0,0
9/20/2017 13:15,52,68.8,66,64.7,118,66.5,2,0,0
9/20/2017 13:20,63,68.1,77,63.9,140,65.8,2,0,0
9/20/2017 13:25,57,68.3,72,64,129,65.9,2,0,0
9/20/2017 13:30,65,66.9,78,62.5,143,64.5,2,0,0
9/20/2017 13:35,63,68.2,77,63.9,140,65.9,2,0,0
9/20/2017 13:40,50,67.8,65,63.7,115,65.5,2,0,0
9/20/2017 13:45,52,68.5,66,64.4,118,66.2,2,0,0
9/20/2017 13:50,54,68.8,69,64.6,123,66.4,2,0,0
9/20/2017 13:55,55,68.1,69,63.9,124,65.7,2,0,0
9/20/2017 14:00,53,68.9,67,64.8,120,66.6,2,0,0
9/20/2017 14:05,54,69.1,69,64.9,123,66.8,2,0,0
9/20/2017 14:10,52,67,67,62.8,119,64.7,2,0,0
9/20/2017 14:15,55,67.3,70,63,125,64.9,2,0,0
9/20/2017 14:20,49,67.9,62,63.7,111,65.6,2,0,0
9/20/2017 14:25,42,69.1,56,64.9,98,66.7,2,0,0
9/20/2017 14:30,53,67.9,67,63.7,120,65.5,2,0,0
9/20/2017 14:35,48,69.2,62,65.1,110,66.9,2,0,0
9/20/2017 14:40,55,70,68,65.8,123,67.7,2,0,0
9/20/2017 14:45,60,68.1,74,63.9,134,65.8,2,0,0
9/20/2017 14:50,54,67.5,69,63.3,123,65.2,2,0,0
9/20/2017 14:55,59,69.3,73,65.2,132,67,2,0,0
9/20/2017 15:00,46,69.4,61,65.2,107,67,2,0,0
9/20/2017 15:05,49,69,64,64.7,113,66.5,2,0,0
9/20/2017 15:10,53,68.4,67,64.2,120,66.1,2,0,0
9/20/2017 15:15,52,68.7,66,64.5,118,66.4,2,0,0
9/20/2017 15:20,52,68.4,66,64.2,118,66,2,0,0
9/20/2017 15:25,65,67.8,79,63.6,144,65.5,2,0,0
9/20/2017 15:30,62,68.2,77,64,139,65.9,2,0,0
9/20/2017 15:35,66,68.3,81,64.1,147,66,2,0,0
9/20/2017 15:40,54,69.1,69,64.9,123,66.7,2,0,0
9/20/2017 15:45,58,69.5,72,65.2,130,67.1,2,0,0
9/20/2017 15:50,61,69,75,64.7,136,66.6,2,0,0
9/20/2017 15:55,60,69.1,73,64.9,133,66.8,2,0,0
9/20/2017 16:00,60,68.5,74,64.3,134,66.2,2,0,0
9/20/2017 16:05,53,68.1,67,63.8,120,65.7,2,0,0
9/20/2017 16:10,54,67.8,68,63.5,122,65.4,2,0,0
9/20/2017 16:15,65,68.3,80,64.1,145,65.9,2,0,0
9/20/2017 16:20,57,68.5,71,64.3,128,66.2,2,0,0
9/20/2017 16:25,57,69.3,71,65.1,128,67,2,0,0
9/20/2017 16:30,60,68.9,75,64.8,135,66.6,2,0,0
9/20/2017 16:35,51,67.4,65,63.2,116,65.1,2,0,0
9/20/2017 16:40,64,68.3,79,64.1,143,66,2,0,0
9/20/2017 16:45,54,67.6,69,63.3,123,65.2,2,0,0
9/20/2017 16:50,56,68.1,70,63.9,126,65.8,2,0,0
9/20/2017 16:55,58,67.9,72,63.7,130,65.6,2,0,0
9/20/2017 17:00,53,69.3,67,65,120,66.9,2,0,0
9/20/2017 17:05,54,69.4,69,65.2,123,67.1,2,0,0
9/20/2017 17:10,63,69.3,77,65.1,140,67,2,0,0
9/20/2017 17:15,63,68.9,77,64.7,140,66.6,2,0,0
9/20/2017 17:20,69,68,84,63.7,153,65.6,2,0,0
9/20/2017 17:25,62,68.3,76,64.1,138,66,2,0,0
9/20/2017 17:30,58,68.4,71,64.1,129,66,2,0,0
9/20/2017 17:35,57,69.1,71,64.8,128,66.7,2,0,0
9/20/2017 17:40,54,69.1,68,64.8,122,66.7,2,0,0
9/20/2017 17:45,58,69.7,73,65.5,131,67.4,2,0,0
9/20/2017 17:50,48,70.2,62,65.9,110,67.8,2,0,0
9/20/2017 17:55,51,69.8,65,65.7,116,67.5,2,0,0
9/20/2017 18:00,65,68.4,80,64.2,145,66.1,2,0,0
9/20/2017 18:05,50,68.4,64,64.3,114,66.1,2,0,0
9/20/2017 18:10,50,69.5,64,65.3,114,67.1,2,0,0
9/20/2017 18:15,51,69.3,65,65.1,116,67,2,0,0
9/20/2017 18:20,50,69.3,63,65.1,113,67,2,0,0
9/20/2017 18:25,49,68.2,63,64,112,65.8,2,0,0
9/20/2017 18:30,49,68.9,63,64.6,112,66.5,2,0,0
9/20/2017 18:35,54,68.1,68,63.9,122,65.7,2,0,0
9/20/2017 18:40,51,69.2,64,65,115,66.8,2,0,0
9/20/2017 18:45,46,69.3,60,65.1,106,66.9,2,0,0
9/20/2017 18:50,50,68.5,65,64.3,115,66.1,2,0,0
9/20/2017 18:55,44,69.1,58,64.9,102,66.7,2,0,0
9/20/2017 19:00,40,69.7,54,65.5,94,67.3,2,0,0
9/20/2017 19:05,39,68.7,54,64.6,93,66.3,2,0,0
9/20/2017 19:10,40,68.7,54,64.5,94,66.3,2,0,0
9/20/2017 19:15,49,69.9,63,65.8,112,67.6,2,0,0
9/20/2017 19:20,45,68.1,59,63.9,104,65.7,2,0,0
9/20/2017 19:25,46,66.9,60,62.7,106,64.5,2,0,0
9/20/2017 19:30,47,67.8,61,63.6,108,65.4,2,0,0
9/20/2017 19:35,46,68.4,60,64.2,106,66,2,0,0
9/20/2017 19:40,39,68.3,53,64,92,65.8,2,0,0
9/20/2017 19:45,40,69.1,54,64.8,94,66.6,2,0,0
9/20/2017 19:50,41,69,55,64.8,96,66.6,2,0,0
9/20/2017 19:55,39,68.4,53,64.2,92,66,2,0,0
9/20/2017 20:00,36,67.8,51,63.6,87,65.3,2,0,0
9/20/2017 20:05,38,68.7,52,64.5,90,66.3,2,0,0
9/20/2017 20:10,40,67.5,54,63.3,94,65.1,2,0,0
9/20/2017 20:15,30,68.4,44,64.2,74,65.9,2,0,0
9/20/2017 20:20,29,68.3,44,64.1,73,65.8,2,0,0
9/20/2017 20:25,37,68.2,51,64,88,65.7,2,0,0
9/20/2017 20:30,34,68.2,49,64,83,65.7,2,0,0
9/20/2017 20:35,38,68.5,52,64.3,90,66.1,2,0,0
9/20/2017 20:40,31,68.8,45,64.6,76,66.3,2,0,0
9/20/2017 20:45,31,68.9,45,64.7,76,66.4,2,0,0
9/20/2017 20:50,31,67.7,44,63.5,75,65.2,2,0,0
9/20/2017 20:55,35,68.5,50,64.3,85,66,2,0,0
9/20/2017 21:00,31,68.5,46,64.3,77,66,2,0,0
9/20/2017 21:05,29,68.4,44,64.1,73,65.8,2,0,0
9/20/2017 21:10,28,68,42,63.8,70,65.5,2,0,0
9/20/2017 21:15,28,67.2,43,62.9,71,64.6,2,0,0
9/20/2017 21:20,27,67.1,41,62.8,68,64.5,2,0,0
9/20/2017 21:25,25,68.1,39,63.9,64,65.5,2,0,0
9/20/2017 21:30,29,68.5,43,64.3,72,66,2,0,0
9/20/2017 21:35,30,69,44,64.8,74,66.5,2,0,0
9/20/2017 21:40,30,69.2,44,65,74,66.7,2,0,0
9/20/2017 21:45,22,69.1,37,64.9,59,66.5,2,0,0
9/20/2017 21:50,34,68.8,49,64.5,83,66.3,2,0,0
9/20/2017 21:55,24,68.9,37,64.7,61,66.3,2,0,0
9/20/2017 22:00,26,68.4,40,64.2,66,65.8,2,0,0
9/20/2017 22:05,28,68.7,42,64.5,70,66.2,2,0,0
9/20/2017 22:10,25,69,39,64.8,64,66.5,2,0,0
9/20/2017 22:15,23,68.9,38,64.7,61,66.3,2,0,0
9/20/2017 22:20,21,69,36,64.8,57,66.3,2,0,0
9/20/2017 22:25,20,69,34,64.7,54,66.3,2,0,0
9/20/2017 22:30,20,69,35,64.8,55,66.3,2,0,0
9/20/2017 22:35,17,68.9,31,64.7,48,66.2,2,0,0
9/20/2017 22:40,22,68.8,37,64.6,59,66.2,2,0,0
9/20/2017 22:45,24,68.9,38,64.7,62,66.3,2,0,0
9/20/2017 22:50,17,68.9,32,64.7,49,66.2,2,0,0
9/20/2017 22:55,20,69,34,64.8,54,66.3,2,0,0
9/20/2017 23:00,16,68.9,31,64.7,47,66.2,2,0,0
9/20/2017 23:05,12,68.9,27,64.7,39,66,2,0,0
9/20/2017 23:10,21,69,35,64.8,56,66.4,2,0,0
9/20/2017 23:15,16,68.9,31,64.6,47,66.1,2,0,0
9/20/2017 23:20,18,68.7,33,64.5,51,66,2,0,0
9/20/2017 23:25,13,68.8,28,64.6,41,65.9,2,0,0
9/20/2017 23:30,19,68.4,33,64.2,52,65.7,2,0,0
9/20/2017 23:35,14,68.8,29,64.6,43,65.9,2,0,0
9/20/2017 23:40,15,68.8,30,64.6,45,66,2,0,0
9/20/2017 23:45,12,68.8,27,64.6,39,65.9,2,0,0
9/20/2017 23:50,15,68.9,30,64.7,45,66.1,2,0,0
9/20/2017 23:55,12,68.9,27,64.7,39,66,2,0,0
9/21/2017 0:00,13,68.9,28,64.7,41,66,2,0,0
9/21/2017 0:05,12,69,27,64.8,39,66.1,2,0,0
9/21/2017 0:10,10,68.9,25,64.7,35,65.9,2,0,0
9/21/2017 0:15,14,69,29,64.8,43,66.2,2,0,0
9/21/2017 0:20,9,68.9,24,64.7,33,65.8,2,0,0
9/21/2017 0:25,13,68.9,27,64.7,40,66.1,2,0,0
9/21/2017 0:30,12,68.9,27,64.7,39,66,2,0,0
9/21/2017 0:35,9,69,24,64.8,33,65.9,2,0,0
9/21/2017 0:40,9,68.9,24,64.7,33,65.9,2,0,0
9/21/2017 0:45,11,68.9,25,64.7,36,66,2,0,0
9/21/2017 0:50,8,68.9,23,64.7,31,65.8,2,0,0
9/21/2017 0:55,11,69,26,64.8,37,66,2,0,0
9/21/2017 1:00,9,68.9,24,64.7,33,65.9,2,0,0
9/21/2017 1:05,7,69,22,64.8,29,65.8,2,0,0
9/21/2017 1:10,10,69,25,64.8,35,66,2,0,0
9/21/2017 1:15,7,69,22,64.8,29,65.8,2,0,0
9/21/2017 1:20,7,69,22,64.8,29,65.8,2,0,0
9/21/2017 1:25,8,69,23,64.8,31,65.9,2,0,0
9/21/2017 1:30,9,69,24,64.8,33,66,2,0,0
9/21/2017 1:35,8,68.9,24,64.7,32,65.8,2,0,0
9/21/2017 1:40,8,68.9,23,64.7,31,65.8,2,0,0
9/21/2017 1:45,9,69,24,64.8,33,65.9,2,0,0
9/21/2017 1:50,10,69,25,64.8,35,66,2,0,0
9/21/2017 1:55,8,68.9,23,64.8,31,65.8,2,0,0
9/21/2017 2:00,7,69,22,64.8,29,65.8,2,0,0
9/21/2017 2:05,7,68.9,22,64.7,29,65.8,2,0,0
9/21/2017 2:10,8,69,23,64.8,31,65.9,2,0,0
9/21/2017 2:15,9,68.9,24,64.7,33,65.8,2,0,0
9/21/2017 2:20,8,68.7,23,64.5,31,65.6,2,0,0
9/21/2017 2:25,10,68.6,24,64.4,34,65.7,2,0,0
9/21/2017 2:30,8,68.8,23,64.6,31,65.7,2,0,0
9/21/2017 2:35,9,68.6,24,64.4,33,65.6,2,0,0
9/21/2017 2:40,10,68.5,25,64.3,35,65.5,2,0,0
9/21/2017 2:45,12,68.7,27,64.5,39,65.8,2,0,0
9/21/2017 2:50,12,68.9,26,64.7,38,66,2,0,0
9/21/2017 2:55,12,69,27,64.9,39,66.1,2,0,0
9/21/2017 3:00,11,69,26,64.8,37,66.1,2,0,0
9/21/2017 3:05,10,68.9,26,64.7,36,65.9,2,0,0
9/21/2017 3:10,9,69,24,64.8,33,66,2,0,0
9/21/2017 3:15,11,68.9,25,64.7,36,66,2,0,0
9/21/2017 3:20,12,68.6,27,64.4,39,65.7,2,0,0
9/21/2017 3:25,12,68.9,27,64.7,39,66,2,0,0
9/21/2017 3:30,12,68.6,26,64.4,38,65.7,2,0,0
9/21/2017 3:35,12,68.4,27,64.2,39,65.5,2,0,0
9/21/2017 3:40,15,68.2,30,64,45,65.4,2,0,0
9/21/2017 3:45,12,68.6,27,64.4,39,65.7,2,0,0
9/21/2017 3:50,13,68.8,28,64.6,41,65.9,2,0,0
9/21/2017 3:55,13,68.8,28,64.6,41,65.9,2,0,0
9/21/2017 4:00,12,68.8,27,64.6,39,65.9,2,0,0
9/21/2017 4:05,17,68.8,32,64.6,49,66,2,0,0
9/21/2017 4:10,24,68.9,39,64.7,63,66.3,2,0,0
9/21/2017 4:15,16,69,30,64.8,46,66.2,2,0,0
9/21/2017 4:20,26,68.8,41,64.6,67,66.2,2,0,0
9/21/2017 4:25,25,69.1,40,64.9,65,66.5,2,0,0
9/21/2017 4:30,25,69.2,39,65,64,66.6,2,0,0
9/21/2017 4:35,32,69.1,47,64.8,79,66.6,2,0,0
9/21/2017 4:40,35,69,50,64.8,85,66.5,2,0,0
9/21/2017 4:45,36,69.8,51,65.6,87,67.4,2,0,0
9/21/2017 4:50,44,69.6,59,65.3,103,67.2,2,0,0
9/21/2017 4:55,46,69.9,61,65.6,107,67.4,2,0,0
9/21/2017 5:00,36,70.4,51,66.2,87,67.9,2,0,0
9/21/2017 5:05,39,69.8,54,65.6,93,67.3,2,0,0
9/21/2017 5:10,46,69.3,61,65.1,107,66.9,2,0,0
9/21/2017 5:15,55,68,70,63.8,125,65.6,2,0,0
9/21/2017 5:20,54,68.5,69,64.3,123,66.2,2,0,0
9/21/2017 5:25,51,68,67,63.7,118,65.6,2,0,0
9/21/2017 5:30,62,68,78,63.7,140,65.6,2,0,0
9/21/2017 5:35,67,68.5,83,64.2,150,66.1,2,0,0
9/21/2017 5:40,67,67.4,83,63.1,150,65,2,0,0
9/21/2017 5:45,76,67.5,93,63.2,169,65.1,2,0,0
9/21/2017 5:50,69,67.4,85,63.2,154,65.1,2,0,0
9/21/2017 5:55,61,68.4,77,64.1,138,66,2,0,0
9/21/2017 6:00,59,68,75,63.7,134,65.6,2,0,0
9/21/2017 6:05,63,68.1,80,63.8,143,65.7,2,0,0
9/21/2017 6:10,51,69.2,45,63.2,96,66.4,2,0,0
9/21/2017 6:15,52,69.1,47,63.1,99,66.2,2,0,0
9/21/2017 6:20,76,65.9,94,61.6,170,63.5,2,0,0
9/21/2017 6:25,70,65.3,86,61,156,62.9,2,0,0
9/21/2017 6:30,62,66.9,78,62.6,140,64.5,2,0,0
9/21/2017 6:35,75,67.7,91,63.4,166,65.4,2,0,0
9/21/2017 6:40,70,67.5,86,63.2,156,65.2,2,0,0
9/21/2017 6:45,71,67.9,87,63.6,158,65.5,2,0,0
9/21/2017 6:50,67,68,83,63.7,150,65.6,2,0,0
9/21/2017 6:55,78,66.7,94,62.3,172,64.3,2,0,0
9/21/2017 7:00,66,66.3,82,62,148,64,2,0,0
9/21/2017 7:05,73,67.6,88,63.3,161,65.3,2,0,0
9/21/2017 7:10,87,67.1,103,62.8,190,64.8,2,0,0
9/21/2017 7:15,76,67,92,62.7,168,64.6,2,0,0
9/21/2017 7:20,87,67.1,104,62.8,191,64.8,2,0,0
9/21/2017 7:25,83,65.1,100,60.8,183,62.8,2,0,0
9/21/2017 7:30,89,66.2,105,61.8,194,63.8,2,0,0
9/21/2017 7:35,91,66.9,107,62.6,198,64.6,2,0,0
9/21/2017 7:40,89,66.9,105,62.6,194,64.6,2,0,0
9/21/2017 7:45,88,66.6,104,62.3,192,64.2,2,0,0
9/21/2017 7:50,90,66.8,105,62.4,195,64.4,2,0,0
9/21/2017 7:55,79,66.9,95,62.5,174,64.5,2,0,0
9/21/2017 8:00,76,66,91,61.6,167,63.6,2,0,0
9/21/2017 8:05,77,66.2,92,61.9,169,63.9,2,0,0
9/21/2017 8:10,74,67.2,90,62.9,164,64.9,2,0,0
9/21/2017 8:15,73,67.4,89,63.1,162,65,2,0,0
9/21/2017 8:20,77,66.1,93,61.9,170,63.8,2,0,0
9/21/2017 8:25,79,66.3,95,62,174,64,2,0,0
9/21/2017 8:30,62,66.2,77,61.9,139,63.8,2,0,0
9/21/2017 8:35,66,65.6,81,61.3,147,63.2,2,0,0
9/21/2017 8:40,80,66,96,61.7,176,63.6,2,0,0
9/21/2017 8:45,83,65.6,99,61.3,182,63.3,2,0,0
9/21/2017 8:50,84,64.3,101,60,185,62,2,0,0
9/21/2017 8:55,83,65.4,99,61.1,182,63.1,2,0,0
9/21/2017 9:00,93,64.3,110,59.9,203,61.9,2,0,0
9/21/2017 9:05,83,65.5,99,61.2,182,63.2,2,0,0
9/21/2017 9:10,90,65,106,60.6,196,62.6,2,0,0
9/21/2017 9:15,72,64.9,87,60.6,159,62.6,2,0,0
9/21/2017 9:20,71,65.8,86,61.5,157,63.5,2,0,0
9/21/2017 9:25,68,66.9,83,62.5,151,64.5,2,0,0
9/21/2017 9:30,66,65.1,82,60.8,148,62.7,2,0,0
9/21/2017 9:35,72,65.6,88,61.3,160,63.2,2,0,0
9/21/2017 9:40,78,64.3,93,59.9,171,61.9,2,0,0
9/21/2017 9:45,71,65.6,86,61.3,157,63.2,2,0,0
9/21/2017 9:50,81,66,96,61.8,177,63.7,2,0,0
9/21/2017 9:55,72,64.2,87,59.8,159,61.8,2,0,0
9/21/2017 10:00,60,64.4,75,60.1,135,62,2,0,0
9/21/2017 10:05,68,66.3,83,62.1,151,64,2,0,0
9/21/2017 10:10,71,67.1,87,62.9,158,64.8,2,0,0
9/21/2017 10:15,72,66.4,87,62.2,159,64.1,2,0,0
9/21/2017 10:20,64,66.8,78,62.7,142,64.6,2,0,0
9/21/2017 10:25,72,67.4,87,63.3,159,65.1,2,0,0
9/21/2017 10:30,79,68.2,93,64,172,65.9,2,0,0
9/21/2017 10:35,63,68.4,76,64.2,139,66.1,2,0,0
9/21/2017 10:40,73,65.6,88,61.4,161,63.3,2,0,0
9/21/2017 10:45,67,65.9,81,61.6,148,63.6,2,0,0
9/21/2017 10:50,75,64.6,90,60.3,165,62.3,2,0,0
9/21/2017 10:55,74,64.7,90,60.5,164,62.4,2,0,0
9/21/2017 11:00,67,65.4,82,61.1,149,63,2,0,0
9/21/2017 11:05,65,65,81,60.7,146,62.6,2,0,0
9/21/2017 11:10,65,65.5,79,61.3,144,63.2,2,0,0
9/21/2017 11:15,58,66.5,73,62.2,131,64.1,2,0,0
9/21/2017 11:20,60,66.1,74,61.8,134,63.7,2,0,0
9/21/2017 11:25,66,66.4,80,62.1,146,64.1,2,0,0
9/21/2017 11:30,59,68,74,63.7,133,65.6,2,0,0
9/21/2017 11:35,63,68.3,78,64.1,141,65.9,2,0,0
9/21/2017 11:40,62,67.8,77,63.6,139,65.5,2,0,0
9/21/2017 11:45,53,66.8,67,62.6,120,64.4,2,0,0
9/21/2017 11:50,58,67.8,73,63.6,131,65.5,2,0,0
9/21/2017 11:55,51,68.5,65,64.3,116,66.2,2,0,0
9/21/2017 12:00,62,69.4,76,65.1,138,67,2,0,0
9/21/2017 12:05,59,68.4,74,64.1,133,66,2,0,0
9/21/2017 12:10,56,68.2,70,63.9,126,65.8,2,0,0
9/21/2017 12:15,52,67.1,66,62.7,118,64.6,2,0,0
9/21/2017 12:20,58,66.9,73,62.6,131,64.5,2,0,0
9/21/2017 12:25,49,68.2,64,63.9,113,65.8,2,0,0
9/21/2017 12:30,60,66.3,75,62,135,63.9,2,0,0
9/21/2017 12:35,50,66.7,64,62.4,114,64.3,2,0,0
9/21/2017 12:40,52,67.3,65,62.9,117,64.9,2,0,0
9/21/2017 12:45,71,67.4,85,63.1,156,65,2,0,0
9/21/2017 12:50,56,66.7,70,62.4,126,64.3,2,0,0
9/21/2017 12:55,51,67,65,62.7,116,64.6,2,0,0
9/21/2017 13:00,48,68.1,62,63.9,110,65.8,2,0,0
9/21/2017 13:05,53,67,68,62.8,121,64.6,2,0,0
9/21/2017 13:10,55,68.8,70,64.6,125,66.5,2,0,0
9/21/2017 13:15,55,67.9,69,63.7,124,65.6,2,0,0
9/21/2017 13:20,54,67.8,68,63.6,122,65.5,2,0,0
9/21/2017 13:25,64,68.3,77,64.1,141,66,2,0,0
9/21/2017 13:30,47,68.2,61,64,108,65.8,2,0,0
9/21/2017 13:35,55,69.1,69,64.9,124,66.7,2,0,0
9/21/2017 13:40,46,68.3,60,64,106,65.9,2,0,0
9/21/2017 13:45,59,67.2,73,62.9,132,64.8,2,0,0
9/21/2017 13:50,53,67.5,66,63.2,119,65.1,2,0,0
9/21/2017 13:55,48,66.9,63,62.6,111,64.4,2,0,0
9/21/2017 14:00,48,66.1,62,61.8,110,63.7,2,0,0
9/21/2017 14:05,50,65.8,64,61.6,114,63.4,2,0,0
9/21/2017 14:10,50,64.9,64,60.5,114,62.4,2,0,0
9/21/2017 14:15,56,64.6,71,60.3,127,62.2,2,0,0
9/21/2017 14:20,48,66.3,62,62.1,110,63.9,2,0,0
9/21/2017 14:25,55,65.3,70,61,125,62.9,2,0,0
9/21/2017 14:30,60,64.1,75,59.9,135,61.8,2,0,0
9/21/2017 14:35,61,65.3,74,61,135,62.9,2,0,0
9/21/2017 14:40,49,66.2,63,62,112,63.8,2,0,0
9/21/2017 14:45,49,67.6,64,63.4,113,65.2,2,0,0
9/21/2017 14:50,69,66.7,83,62.5,152,64.4,2,0,0
9/21/2017 14:55,60,67.5,74,63.3,134,65.2,2,0,0
9/21/2017 15:00,57,68.4,72,64.2,129,66.1,2,0,0
9/21/2017 15:05,67,67.6,80,63.4,147,65.3,2,0,0
9/21/2017 15:10,63,67.8,76,63.6,139,65.5,2,0,0
9/21/2017 15:15,61,67.6,75,63.3,136,65.2,2,0,0
9/21/2017 15:20,81,67.8,95,63.6,176,65.5,2,0,0
9/21/2017 15:25,78,66.3,92,62.1,170,64,2,0,0
9/21/2017 15:30,73,66.7,87,62.5,160,64.4,2,0,0
9/21/2017 15:35,80,65.9,95,61.6,175,63.6,2,0,0
9/21/2017 15:40,76,56.2,91,51.5,167,53.7,2,0,0
9/21/2017 15:45,79,45.7,94,40.7,173,43,2,0,0
9/21/2017 15:50,60,48.5,74,43.6,134,45.8,2,0,0
9/21/2017 15:55,60,56.5,73,51.9,133,54,2,0,0
9/21/2017 16:00,55,62.1,69,57.7,124,59.7,2,0,0
9/21/2017 16:05,68,65.2,82,60.8,150,62.8,2,0,0
9/21/2017 16:10,62,66.1,76,61.7,138,63.7,2,0,0
9/21/2017 16:15,58,66.6,73,62.3,131,64.2,2,0,0
9/21/2017 16:20,65,66.3,79,62,144,63.9,2,0,0
9/21/2017 16:25,62,66.2,77,61.9,139,63.8,2,0,0
9/21/2017 16:30,56,67,70,62.7,126,64.6,2,0,0
9/21/2017 16:35,57,67.1,72,62.8,129,64.7,2,0,0
9/21/2017 16:40,59,66.5,74,62.2,133,64.1,2,0,0
9/21/2017 16:45,59,67.5,73,63.3,132,65.2,2,0,0
9/21/2017 16:50,52,67.4,66,63.2,118,65.1,2,0,0
9/21/2017 16:55,62,66.8,76,62.5,138,64.4,2,0,0
9/21/2017 17:00,54,67.1,69,62.9,123,64.7,2,0,0
9/21/2017 17:05,54,68,69,63.8,123,65.6,2,0,0
9/21/2017 17:10,62,67.9,77,63.7,139,65.6,2,0,0
9/21/2017 17:15,66,65.5,81,61.2,147,63.1,2,0,0
9/21/2017 17:20,56,56.6,71,51.9,127,54,2,0,0
9/21/2017 17:25,50,52.6,65,47.7,115,49.8,2,0,0
9/21/2017 17:30,56,58.3,71,53.6,127,55.7,2,0,0
9/21/2017 17:35,56,63,71,58.5,127,60.5,2,0,0
9/21/2017 17:40,54,66,68,61.7,122,63.6,2,0,0
9/21/2017 17:45,50,66,65,61.8,115,63.6,2,0,0
9/21/2017 17:50,61,66.8,75,62.5,136,64.4,2,0,0
9/21/2017 17:55,67,68.1,81,63.9,148,65.8,2,0,0
9/21/2017 18:00,58,67.4,72,63.1,130,65,2,0,0
9/21/2017 18:05,50,66.9,64,62.6,114,64.5,2,0,0
9/21/2017 18:10,59,68,74,63.7,133,65.6,2,0,0
9/21/2017 18:15,52,67.5,66,63.3,118,65.2,2,0,0
9/21/2017 18:20,59,67.8,72,63.6,131,65.5,2,0,0
9/21/2017 18:25,69,67.5,83,63.2,152,65.2,2,0,0
9/21/2017 18:30,51,68.2,66,64,117,65.8,2,0,0
9/21/2017 18:35,59,68.5,73,64.3,132,66.2,2,0,0
9/21/2017 18:40,57,68.4,71,64.2,128,66,2,0,0
9/21/2017 18:45,56,68.5,70,64.3,126,66.2,2,0,0
9/21/2017 18:50,59,67.8,74,63.5,133,65.4,2,0,0
9/21/2017 18:55,53,69.1,66,64.8,119,66.7,2,0,0
9/21/2017 19:00,59,69.3,73,65.1,132,67,2,0,0
9/21/2017 19:05,53,69.5,67,65.2,120,67.1,2,0,0
9/21/2017 19:10,49,69.7,63,65.5,112,67.3,2,0,0
9/21/2017 19:15,57,70.1,71,66,128,67.8,2,0,0
9/21/2017 19:20,50,70,63,65.8,113,67.7,2,0,0
9/21/2017 19:25,57,68.5,72,64.3,129,66.2,2,0,0
9/21/2017 19:30,55,67.7,70,63.5,125,65.4,2,0,0
9/21/2017 19:35,55,67.9,70,63.7,125,65.5,2,0,0
9/21/2017 19:40,53,67.3,68,63,121,64.9,2,0,0
9/21/2017 19:45,53,67.7,68,63.4,121,65.3,2,0,0
9/21/2017 19:50,47,67.8,62,63.6,109,65.4,2,0,0
9/21/2017 19:55,52,68,66,63.7,118,65.6,2,0,0
9/21/2017 20:00,42,69.1,56,64.8,98,66.7,2,0,0
9/21/2017 20:05,42,69.4,56,65.2,98,67,2,0,0
9/21/2017 20:10,42,69.6,56,65.4,98,67.2,2,0,0
9/21/2017 20:15,43,67.8,58,63.6,101,65.4,2,0,0
9/21/2017 20:20,48,67.9,62,63.8,110,65.6,2,0,0
9/21/2017 20:25,41,69,55,64.9,96,66.6,2,0,0
9/21/2017 20:30,47,69,61,64.8,108,66.6,2,0,0
9/21/2017 20:35,47,69.5,61,65.3,108,67.2,2,0,0
9/21/2017 20:40,41,69.3,55,65.1,96,66.9,2,0,0
9/21/2017 20:45,37,69.1,51,64.9,88,66.7,2,0,0
9/21/2017 20:50,38,68.8,51,64.6,89,66.4,2,0,0
9/21/2017 20:55,34,69.1,48,64.9,82,66.6,2,0,0
9/21/2017 21:00,31,68.7,46,64.4,77,66.1,2,0,0
9/21/2017 21:05,38,69.1,52,64.9,90,66.7,2,0,0
9/21/2017 21:10,36,69,50,64.7,86,66.5,2,0,0
9/21/2017 21:15,36,69,50,64.7,86,66.5,2,0,0
9/21/2017 21:20,34,69.5,48,65.3,82,67,2,0,0
9/21/2017 21:25,34,69.3,48,65.1,82,66.8,2,0,0
9/21/2017 21:30,36,69.8,50,65.6,86,67.3,2,0,0
9/21/2017 21:35,35,69.3,49,65.1,84,66.8,2,0,0
9/21/2017 21:40,36,69.6,51,65.4,87,67.1,2,0,0
9/21/2017 21:45,28,69.3,42,65.1,70,66.8,2,0,0
9/21/2017 21:50,30,69.5,45,65.3,75,67,2,0,0
9/21/2017 21:55,22,69.4,37,65.2,59,66.7,2,0,0
9/21/2017 22:00,20,69.3,34,65.1,54,66.6,2,0,0
9/21/2017 22:05,21,69,35,64.8,56,66.4,2,0,0
9/21/2017 22:10,18,68.6,33,64.4,51,65.9,2,0,0
9/21/2017 22:15,22,68.8,37,64.6,59,66.1,2,0,0
9/21/2017 22:20,22,69,36,64.8,58,66.4,2,0,0
9/21/2017 22:25,33,69,47,64.7,80,66.5,2,0,0
9/21/2017 22:30,28,69.1,42,64.9,70,66.6,2,0,0
9/21/2017 22:35,29,68.5,43,64.3,72,66,2,0,0
9/21/2017 22:40,25,68.8,39,64.5,64,66.2,2,0,0
9/21/2017 22:45,22,68.9,37,64.6,59,66.2,2,0,0
9/21/2017 22:50,24,69.2,39,65,63,66.6,2,0,0
9/21/2017 22:55,21,68.9,35,64.6,56,66.2,2,0,0
9/21/2017 23:00,18,69,33,64.7,51,66.2,2,0,0
9/21/2017 23:05,14,69,29,64.8,43,66.2,2,0,0
9/21/2017 23:10,15,68.9,30,64.7,45,66.1,2,0,0
9/21/2017 23:15,19,69.1,33,64.9,52,66.4,2,0,0
9/21/2017 23:20,15,69,30,64.8,45,66.2,2,0,0
9/21/2017 23:25,15,68.9,30,64.7,45,66.1,2,0,0
9/21/2017 23:30,15,69,30,64.8,45,66.2,2,0,0
9/21/2017 23:35,18,68.6,32,64.4,50,66,2,0,0
9/21/2017 23:40,11,68.7,26,64.5,37,65.8,2,0,0
9/21/2017 23:45,16,68.8,30,64.6,46,66.1,2,0,0
9/21/2017 23:50,14,69,29,64.7,43,66.1,2,0,0
9/21/2017 23:55,13,69,28,64.8,41,66.1,2,0,0
9/22/2017 0:00,9,68.9,24,64.7,33,65.8,2,0,0
9/22/2017 0:05,12,68.8,27,64.6,39,65.9,2,0,0
9/22/2017 0:10,15,68.9,30,64.7,45,66.1,2,0,0
9/22/2017 0:15,11,68.9,26,64.7,37,66,2,0,0
9/22/2017 0:20,10,68.8,25,64.6,35,65.8,2,0,0
9/22/2017 0:25,9,68.8,24,64.6,33,65.8,2,0,0
9/22/2017 0:30,11,68.9,26,64.7,37,66,2,0,0
9/22/2017 0:35,8,68.9,24,64.7,32,65.8,2,0,0
9/22/2017 0:40,8,68.8,23,64.6,31,65.7,2,0,0
9/22/2017 0:45,7,68.9,22,64.7,29,65.7,2,0,0
9/22/2017 0:50,8,68.9,23,64.8,31,65.8,2,0,0
9/22/2017 0:55,8,68.9,23,64.7,31,65.8,2,0,0
9/22/2017 1:00,10,68.7,25,64.5,35,65.7,2,0,0
9/22/2017 1:05,10,68.9,25,64.7,35,65.9,2,0,0
9/22/2017 1:10,9,68.9,24,64.7,33,65.8,2,0,0
9/22/2017 1:15,7,68.8,22,64.6,29,65.7,2,0,0
9/22/2017 1:20,6,68.9,21,64.7,27,65.6,2,0,0
9/22/2017 1:25,6,68.9,22,64.7,28,65.6,2,0,0
9/22/2017 1:30,9,68.7,24,64.5,33,65.6,2,0,0
9/22/2017 1:35,10,68.7,25,64.5,35,65.7,2,0,0
9/22/2017 1:40,8,68.7,23,64.5,31,65.6,2,0,0
9/22/2017 1:45,8,68.6,23,64.4,31,65.5,2,0,0
9/22/2017 1:50,11,68.6,26,64.4,37,65.6,2,0,0
9/22/2017 1:55,7,68.8,22,64.6,29,65.6,2,0,0
9/22/2017 2:00,8,68.9,23,64.7,31,65.8,2,0,0
9/22/2017 2:05,8,68.9,23,64.8,31,65.8,2,0,0
9/22/2017 2:10,12,68.6,26,64.4,38,65.8,2,0,0
9/22/2017 2:15,6,68.8,21,64.6,27,65.5,2,0,0
9/22/2017 2:20,11,68.7,26,64.5,37,65.8,2,0,0
9/22/2017 2:25,7,68.8,22,64.6,29,65.6,2,0,0
9/22/2017 2:30,10,68.5,26,64.3,36,65.5,2,0,0
9/22/2017 2:35,7,68.7,22,64.5,29,65.6,2,0,0
9/22/2017 2:40,7,68.8,22,64.6,29,65.7,2,0,0
9/22/2017 2:45,12,68.3,27,64.1,39,65.4,2,0,0
9/22/2017 2:50,13,68.6,28,64.4,41,65.7,2,0,0
9/22/2017 2:55,10,68.8,26,64.6,36,65.8,2,0,0
9/22/2017 3:00,11,68.9,26,64.7,37,65.9,2,0,0
9/22/2017 3:05,9,68.9,25,64.7,34,65.8,2,0,0
9/22/2017 3:10,8,68.9,24,64.7,32,65.7,2,0,0
9/22/2017 3:15,11,68.9,26,64.7,37,66,2,0,0
9/22/2017 3:20,7,68.9,22,64.7,29,65.7,2,0,0
9/22/2017 3:25,12,68.8,27,64.6,39,65.9,2,0,0
9/22/2017 3:30,12,68.5,27,64.3,39,65.6,2,0,0
9/22/2017 3:35,11,68.7,26,64.5,37,65.8,2,0,0
9/22/2017 3:40,11,68.7,26,64.5,37,65.8,2,0,0
9/22/2017 3:45,13,68.9,28,64.7,41,66,2,0,0
9/22/2017 3:50,18,68.6,32,64.4,50,65.9,2,0,0
9/22/2017 3:55,8,68.8,24,64.6,32,65.7,2,0,0
9/22/2017 4:00,16,69,30,64.8,46,66.2,2,0,0
9/22/2017 4:05,20,68.8,34,64.6,54,66.1,2,0,0
9/22/2017 4:10,20,68.8,35,64.6,55,66.2,2,0,0
9/22/2017 4:15,14,68.8,29,64.6,43,66,2,0,0
9/22/2017 4:20,20,68.8,34,64.6,54,66.2,2,0,0
9/22/2017 4:25,18,69,33,64.8,51,66.3,2,0,0
9/22/2017 4:30,20,69,36,64.8,56,66.3,2,0,0
9/22/2017 4:35,28,68.6,42,64.4,70,66.1,2,0,0
9/22/2017 4:40,24,69,39,64.7,63,66.3,2,0,0
9/22/2017 4:45,31,69.3,46,65.1,77,66.8,2,0,0
9/22/2017 4:50,41,69,56,64.8,97,66.6,2,0,0
9/22/2017 4:55,34,68.8,49,64.6,83,66.3,2,0,0
9/22/2017 5:00,41,68.7,56,64.4,97,66.2,2,0,0
9/22/2017 5:05,17,70.3,16,64.3,33,67.4,2,0,0
9/22/2017 5:10,19,70.3,18,64.3,37,67.4,2,0,0
9/22/2017 5:15,23,70.4,20,64.4,43,67.6,2,0,0
9/22/2017 5:20,26,70.4,23,64.4,49,67.6,2,0,0
9/22/2017 5:25,28,70.5,25,64.5,53,67.7,2,0,0
9/22/2017 5:30,32,70.5,29,64.5,61,67.6,2,0,0
9/22/2017 5:35,67,67.4,85,62.9,152,64.9,2,0,0
9/22/2017 5:40,67,68.3,83,63.9,150,65.9,2,0,0
9/22/2017 5:45,63,67.7,79,63.3,142,65.2,2,0,0
9/22/2017 5:50,65,67.7,80,63.4,145,65.3,2,0,0
9/22/2017 5:55,55,66.9,71,62.5,126,64.4,2,0,0
9/22/2017 6:00,44,66.4,59,62,103,63.9,2,0,0
9/22/2017 6:05,56,65.7,72,61.3,128,63.2,2,0,0
9/22/2017 6:10,67,65.8,84,61.4,151,63.4,2,0,0
9/22/2017 6:15,63,66.4,79,62,142,63.9,2,0,0
9/22/2017 6:20,64,65.9,80,61.6,144,63.5,2,0,0
9/22/2017 6:25,64,65.4,80,61,144,63,2,0,0
9/22/2017 6:30,63,66.2,78,61.8,141,63.8,2,0,0
9/22/2017 6:35,68,66,84,61.6,152,63.6,2,0,0
9/22/2017 6:40,70,64.9,86,60.5,156,62.5,2,0,0
9/22/2017 6:45,80,65.2,96,60.8,176,62.8,2,0,0
9/22/2017 6:50,61,65.9,78,61.5,139,63.4,2,0,0
9/22/2017 6:55,80,64.8,97,60.4,177,62.4,2,0,0
9/22/2017 7:00,66,65.4,82,61.1,148,63,2,0,0
9/22/2017 7:05,78,66.5,94,62.2,172,64.1,2,0,0
9/22/2017 7:10,80,66.4,95,62.1,175,64.1,2,0,0
9/22/2017 7:15,82,66,99,61.7,181,63.6,2,0,0
9/22/2017 7:20,84,66.3,100,62,184,63.9,2,0,0
9/22/2017 7:25,87,66.5,103,62.2,190,64.1,2,0,0
9/22/2017 7:30,76,66.6,92,62.2,168,64.2,2,0,0
9/22/2017 7:35,84,66.2,101,61.8,185,63.8,2,0,0
9/22/2017 7:40,84,66.4,100,62.1,184,64,2,0,0
9/22/2017 7:45,87,66.7,103,62.4,190,64.3,2,0,0
9/22/2017 7:50,79,67,96,62.7,175,64.6,2,0,0
9/22/2017 7:55,75,66.9,91,62.5,166,64.5,2,0,0
9/22/2017 8:00,87,65.7,102,61.4,189,63.4,2,0,0
9/22/2017 8:05,83,66.2,99,61.8,182,63.8,2,0,0
9/22/2017 8:10,88,65.8,104,61.5,192,63.5,2,0,0
9/22/2017 8:15,88,65.2,104,60.9,192,62.9,2,0,0
9/22/2017 8:20,83,65.2,99,60.9,182,62.8,2,0,0
9/22/2017 8:25,70,65.2,86,60.9,156,62.8,2,0,0
9/22/2017 8:30,79,66.9,94,62.6,173,64.6,2,0,0
9/22/2017 8:35,81,66.4,97,62.1,178,64.1,2,0,0
9/22/2017 8:40,81,65.9,97,61.6,178,63.5,2,0,0
9/22/2017 8:45,84,65.2,100,60.9,184,62.8,2,0,0
9/22/2017 8:50,73,64.6,89,60.3,162,62.2,2,0,0
9/22/2017 8:55,85,63.4,100,59.1,185,61.1,2,0,0
9/22/2017 9:00,76,63.8,90,59.5,166,61.5,2,0,0
9/22/2017 9:05,87,64.9,102,60.6,189,62.6,2,0,0
9/22/2017 9:10,84,64,100,59.7,184,61.7,2,0,0
9/22/2017 9:15,71,63.8,87,59.4,158,61.4,2,0,0
9/22/2017 9:20,79,64.9,94,60.4,173,62.5,2,0,0
9/22/2017 9:25,72,67.9,65,62.1,137,65.1,2,0,0
9/22/2017 9:30,82,67,97,62.7,179,64.7,2,0,0
9/22/2017 9:35,76,64.5,92,60.2,168,62.1,2,0,0
9/22/2017 9:40,79,65.2,94,61,173,62.9,2,0,0
9/22/2017 9:45,71,66.2,86,61.9,157,63.9,2,0,0
9/22/2017 9:50,68,65.8,83,61.6,151,63.5,2,0,0
9/22/2017 9:55,64,65.6,79,61.3,143,63.2,2,0,0
9/22/2017 10:00,65,66.8,78,62.6,143,64.5,2,0,0
9/22/2017 10:05,62,66.8,77,62.5,139,64.4,2,0,0
9/22/2017 10:10,71,65.7,85,61.4,156,63.4,2,0,0
9/22/2017 10:15,64,66.1,79,61.8,143,63.7,2,0,0
9/22/2017 10:20,74,66.7,89,62.5,163,64.4,2,0,0
9/22/2017 10:25,63,67.5,77,63.3,140,65.2,2,0,0
9/22/2017 10:30,65,66.7,79,62.4,144,64.4,2,0,0
9/22/2017 10:35,55,67.5,70,63.3,125,65.1,2,0,0
9/22/2017 10:40,66,67.3,80,63,146,65,2,0,0
9/22/2017 10:45,58,67.1,73,62.8,131,64.7,2,0,0
9/22/2017 10:50,52,67,66,62.7,118,64.6,2,0,0
9/22/2017 10:55,42,67,57,62.8,99,64.6,2,0,0
9/22/2017 11:00,57,66.2,71,61.9,128,63.8,2,0,0
9/22/2017 11:05,61,66.7,74,62.4,135,64.3,2,0,0
9/22/2017 11:10,60,66.7,74,62.5,134,64.4,2,0,0
9/22/2017 11:15,64,66.4,78,62.2,142,64.1,2,0,0
9/22/2017 11:20,58,67,73,62.7,131,64.6,2,0,0
9/22/2017 11:25,63,67.2,77,63,140,64.9,2,0,0
9/22/2017 11:30,68,65.6,83,61.5,151,63.3,2,0,0
9/22/2017 11:35,63,64.7,77,60.4,140,62.3,2,0,0
9/22/2017 11:40,57,64.7,71,60.5,128,62.4,2,0,0
9/22/2017 11:45,59,66.4,73,62.1,132,64,2,0,0
9/22/2017 11:50,56,67.3,69,63,125,64.9,2,0,0
9/22/2017 11:55,65,65.4,79,61.2,144,63.1,2,0,0
9/22/2017 12:00,56,66,70,61.7,126,63.6,2,0,0
9/22/2017 12:05,57,66.4,71,62.1,128,64.1,2,0,0
9/22/2017 12:10,62,65.9,77,61.5,139,63.5,2,0,0
9/22/2017 12:15,47,67.6,61,63.3,108,65.2,2,0,0
9/22/2017 12:20,60,67.2,74,62.9,134,64.8,2,0,0
9/22/2017 12:25,59,67.1,73,62.8,132,64.7,2,0,0
9/22/2017 12:30,47,68,62,63.7,109,65.5,2,0,0
9/22/2017 12:35,66,68.6,81,64.3,147,66.2,2,0,0
9/22/2017 12:40,54,69,68,64.7,122,66.6,2,0,0
9/22/2017 12:45,60,68.6,74,64.3,134,66.2,2,0,0
9/22/2017 12:50,63,67.7,77,63.4,140,65.3,2,0,0
9/22/2017 12:55,55,67.7,68,63.4,123,65.3,2,0,0
9/22/2017 13:00,53,67.7,67,63.4,120,65.3,2,0,0
9/22/2017 13:05,58,67.8,73,63.6,131,65.4,2,0,0
9/22/2017 13:10,58,68.1,73,63.8,131,65.7,2,0,0
9/22/2017 13:15,63,68.4,77,64.2,140,66.1,2,0,0
9/22/2017 13:20,64,67.1,78,62.9,142,64.8,2,0,0
9/22/2017 13:25,61,66.7,75,62.5,136,64.4,2,0,0
9/22/2017 13:30,57,66.8,71,62.6,128,64.5,2,0,0
9/22/2017 13:35,60,68.3,74,64.1,134,66,2,0,0
9/22/2017 13:40,56,66.9,71,62.7,127,64.5,2,0,0
9/22/2017 13:45,62,67.8,76,63.5,138,65.4,2,0,0
9/22/2017 13:50,54,67.3,68,63,122,64.9,2,0,0
9/22/2017 13:55,57,67.4,71,63.1,128,65,2,0,0
9/22/2017 14:00,58,66.9,72,62.6,130,64.5,2,0,0
9/22/2017 14:05,45,67.6,59,63.4,104,65.2,2,0,0
9/22/2017 14:10,47,67.5,62,63.3,109,65.1,2,0,0
9/22/2017 14:15,59,68.2,73,64,132,65.8,2,0,0
9/22/2017 14:20,53,67.8,66,63.6,119,65.5,2,0,0
9/22/2017 14:25,56,66.2,70,62,126,63.9,2,0,0
9/22/2017 14:30,59,66.8,74,62.5,133,64.4,2,0,0
9/22/2017 14:35,53,66.7,67,62.4,120,64.3,2,0,0
9/22/2017 14:40,65,67.9,78,63.7,143,65.6,2,0,0
9/22/2017 14:45,52,67,66,62.7,118,64.6,2,0,0
9/22/2017 14:50,63,65.4,77,61.1,140,63.1,2,0,0
9/22/2017 14:55,53,66.3,68,62.1,121,63.9,2,0,0
9/22/2017 15:00,69,66,83,61.8,152,63.7,2,0,0
9/22/2017 15:05,67,66.4,81,62.1,148,64,2,0,0
9/22/2017 15:10,64,66.1,78,61.9,142,63.8,2,0,0
9/22/2017 15:15,57,66.7,71,62.5,128,64.4,2,0,0
9/22/2017 15:20,63,67.3,77,63.1,140,65,2,0,0
9/22/2017 15:25,74,67.1,88,62.8,162,64.8,2,0,0
9/22/2017 15:30,63,66.6,77,62.4,140,64.3,2,0,0
9/22/2017 15:35,66,67.4,79,63.2,145,65.1,2,0,0
9/22/2017 15:40,75,67.4,90,63.2,165,65.1,2,0,0
9/22/2017 15:45,72,66.5,87,62.3,159,64.2,2,0,0
9/22/2017 15:50,71,60.3,86,55.9,157,57.9,2,0,0
9/22/2017 15:55,69,52.1,84,47.4,153,49.5,2,0,0
9/22/2017 16:00,63,54.7,78,50,141,52.1,2,0,0
9/22/2017 16:05,77,48.9,91,43.9,168,46.2,2,0,0
9/22/2017 16:10,71,45.5,86,40.5,157,42.7,2,0,0
9/22/2017 16:15,75,43.3,90,38.2,165,40.5,2,0,0
9/22/2017 16:20,51,47.8,66,42.9,117,45,2,0,0
9/22/2017 16:25,66,54.9,80,50.2,146,52.3,2,0,0
9/22/2017 16:30,55,61.9,70,57.4,125,59.4,2,0,0
9/22/2017 16:35,59,64.1,73,59.7,132,61.7,2,0,0
9/22/2017 16:40,57,66.6,71,62.3,128,64.2,2,0,0
9/22/2017 16:45,72,67.1,86,62.8,158,64.7,2,0,0
9/22/2017 16:50,65,67.5,79,63.2,144,65.1,2,0,0
9/22/2017 16:55,66,68.2,81,63.9,147,65.8,2,0,0
9/22/2017 17:00,72,64.6,86,60.2,158,62.2,2,0,0
9/22/2017 17:05,67,54,82,49.2,149,51.4,2,0,0
9/22/2017 17:10,63,49,78,44.1,141,46.3,2,0,0
9/22/2017 17:15,51,49.3,66,44.4,117,46.5,2,0,0
9/22/2017 17:20,60,49.7,74,44.7,134,47,2,0,0
9/22/2017 17:25,57,51.5,72,46.7,129,48.8,2,0,0
9/22/2017 17:30,70,47.5,85,42.5,155,44.8,2,0,0
9/22/2017 17:35,51,45.6,66,40.5,117,42.7,2,0,0
9/22/2017 17:40,57,43.5,72,38.3,129,40.6,2,0,0
9/22/2017 17:45,49,47.2,64,42.1,113,44.3,2,0,0
9/22/2017 17:50,57,54.8,71,50,128,52.2,2,0,0
9/22/2017 17:55,60,60.8,74,56.2,134,58.3,2,0,0
9/22/2017 18:00,54,63.2,69,58.8,123,60.7,2,0,0
9/22/2017 18:05,52,65.2,66,60.8,118,62.8,2,0,0
9/22/2017 18:10,62,66.2,77,61.9,139,63.8,2,0,0
9/22/2017 18:15,62,66,77,61.7,139,63.6,2,0,0
9/22/2017 18:20,56,66.6,71,62.3,127,64.2,2,0,0
9/22/2017 18:25,55,66.8,70,62.4,125,64.3,2,0,0
9/22/2017 18:30,58,65,72,60.6,130,62.6,2,0,0
9/22/2017 18:35,53,66.8,68,62.5,121,64.4,2,0,0
9/22/2017 18:40,46,67.5,60,63.2,106,65,2,0,0
9/22/2017 18:45,50,67.7,65,63.5,115,65.3,2,0,0
9/22/2017 18:50,57,68.7,70,64.5,127,66.4,2,0,0
9/22/2017 18:55,58,69.5,72,65.3,130,67.1,2,0,0
9/22/2017 19:00,46,69.4,61,65.2,107,67,2,0,0
9/22/2017 19:05,59,68.3,73,64.1,132,66,2,0,0
9/22/2017 19:10,51,68.5,65,64.3,116,66.1,2,0,0
9/22/2017 19:15,52,68.8,66,64.6,118,66.4,2,0,0
9/22/2017 19:20,51,68.2,66,64,117,65.8,2,0,0
9/22/2017 19:25,59,65.3,74,61,133,62.9,2,0,0
9/22/2017 19:30,52,65.8,66,61.5,118,63.4,2,0,0
9/22/2017 19:35,50,66.1,65,61.8,115,63.7,2,0,0
9/22/2017 19:40,53,67.2,67,63,120,64.9,2,0,0
9/22/2017 19:45,41,68.2,54,63.9,95,65.8,2,0,0
9/22/2017 19:50,46,68.4,59,64.2,105,66,2,0,0
9/22/2017 19:55,43,67.8,56,63.6,99,65.4,2,0,0
9/22/2017 20:00,44,68,59,63.8,103,65.6,2,0,0
9/22/2017 20:05,40,68,54,63.8,94,65.6,2,0,0
9/22/2017 20:10,48,68.7,62,64.5,110,66.3,2,0,0
9/22/2017 20:15,43,68.9,57,64.7,100,66.5,2,0,0
9/22/2017 20:20,45,68.7,59,64.5,104,66.3,2,0,0
9/22/2017 20:25,48,68.4,62,64.1,110,66,2,0,0
9/22/2017 20:30,45,68.1,59,63.8,104,65.7,2,0,0
9/22/2017 20:35,39,68.8,54,64.5,93,66.3,2,0,0
9/22/2017 20:40,40,68.9,54,64.7,94,66.5,2,0,0
9/22/2017 20:45,35,69.1,50,64.9,85,66.6,2,0,0
9/22/2017 20:50,35,69,49,64.7,84,66.5,2,0,0
9/22/2017 20:55,35,68.5,49,64.2,84,66,2,0,0
9/22/2017 21:00,36,68.7,50,64.4,86,66.2,2,0,0
9/22/2017 21:05,30,69,44,64.7,74,66.5,2,0,0
9/22/2017 21:10,38,68.1,53,63.9,91,65.6,2,0,0
9/22/2017 21:15,36,68,50,63.8,86,65.6,2,0,0
9/22/2017 21:20,40,68.2,54,64,94,65.8,2,0,0
9/22/2017 21:25,38,68.1,53,63.9,91,65.6,2,0,0
9/22/2017 21:30,35,69,50,64.8,85,66.5,2,0,0
9/22/2017 21:35,39,67.5,54,63.2,93,65,2,0,0
9/22/2017 21:40,39,67.3,53,62.9,92,64.8,2,0,0
9/22/2017 21:45,35,68.5,50,64.2,85,66,2,0,0
9/22/2017 21:50,38,68.5,53,64.2,91,66,2,0,0
9/22/2017 21:55,39,68.6,53,64.3,92,66.2,2,0,0
9/22/2017 22:00,31,67.8,46,63.5,77,65.2,2,0,0
9/22/2017 22:05,31,67.3,46,63,77,64.8,2,0,0
9/22/2017 22:10,36,68.2,51,63.9,87,65.7,2,0,0
9/22/2017 22:15,29,68,43,63.8,72,65.5,2,0,0
9/22/2017 22:20,31,68.6,46,64.4,77,66.1,2,0,0
9/22/2017 22:25,35,68.4,50,64.2,85,65.9,2,0,0
9/22/2017 22:30,33,68.6,48,64.4,81,66.1,2,0,0
9/22/2017 22:35,32,68.6,47,64.3,79,66,2,0,0
9/22/2017 22:40,27,68.5,41,64.3,68,65.9,2,0,0
9/22/2017 22:45,28,70.4,26,64.4,54,67.5,2,0,0
9/22/2017 22:50,34,67.6,47,63.4,81,65.1,2,0,0
9/22/2017 22:55,31,68.2,46,64,77,65.7,2,0,0
9/22/2017 23:00,26,67.9,41,63.7,67,65.3,2,0,0
9/22/2017 23:05,26,68.4,40,64.2,66,65.8,2,0,0
9/22/2017 23:10,36,68.5,50,64.3,86,66.1,2,0,0
9/22/2017 23:15,32,68.7,46,64.4,78,66.2,2,0,0
9/22/2017 23:20,38,68.4,52,64.1,90,65.9,2,0,0
9/22/2017 23:25,30,68.8,44,64.6,74,66.3,2,0,0
9/22/2017 23:30,36,68.6,51,64.4,87,66.1,2,0,0
9/22/2017 23:35,25,69,39,64.8,64,66.5,2,0,0
9/22/2017 23:40,32,68.7,46,64.5,78,66.2,2,0,0
9/22/2017 23:45,26,69,40,64.8,66,66.4,2,0,0
9/22/2017 23:50,26,69.2,40,64.9,66,66.6,2,0,0
9/22/2017 23:55,21,69.1,35,64.9,56,66.5,2,0,0
9/23/2017 0:00,21,68.9,36,64.7,57,66.2,2,0,0
9/23/2017 0:05,9,69,23,64.8,32,66,2,0,0
9/23/2017 0:10,17,68.9,32,64.7,49,66.2,2,0,0
9/23/2017 0:15,16,68.8,31,64.6,47,66,2,0,0
9/23/2017 0:20,13,68.9,27,64.7,40,66.1,2,0,0
9/23/2017 0:25,12,68.9,27,64.7,39,66,2,0,0
9/23/2017 0:30,18,69,32,64.8,50,66.3,2,0,0
9/23/2017 0:35,13,68.9,28,64.7,41,66,2,0,0
9/23/2017 0:40,19,69.1,32,64.9,51,66.5,2,0,0
9/23/2017 0:45,18,68.9,32,64.7,50,66.2,2,0,0
9/23/2017 0:50,14,68.6,29,64.4,43,65.8,2,0,0
9/23/2017 0:55,9,70.2,8,64.2,17,67.4,2,0,0
9/23/2017 1:00,14,68.9,29,64.7,43,66,2,0,0
9/23/2017 1:05,12,68.9,26,64.7,38,66,2,0,0
9/23/2017 1:10,14,68.9,28,64.7,42,66.1,2,0,0
9/23/2017 1:15,13,68.9,27,64.7,40,66,2,0,0
9/23/2017 1:20,12,68.7,27,64.5,39,65.8,2,0,0
9/23/2017 1:25,11,69,26,64.8,37,66,2,0,0
9/23/2017 1:30,12,68.9,27,64.7,39,66,2,0,0
9/23/2017 1:35,11,68.8,26,64.6,37,65.9,2,0,0
9/23/2017 1:40,9,68.9,24,64.7,33,65.8,2,0,0
9/23/2017 1:45,10,68.9,24,64.7,34,65.9,2,0,0
9/23/2017 1:50,7,68.9,22,64.7,29,65.7,2,0,0
9/23/2017 1:55,12,68.9,26,64.7,38,66,2,0,0
9/23/2017 2:00,12,68.9,27,64.7,39,66,2,0,0
9/23/2017 2:05,9,68.9,23,64.7,32,65.9,2,0,0
9/23/2017 2:10,12,69,27,64.8,39,66.1,2,0,0
9/23/2017 2:15,5,70.2,5,64.2,10,67.2,2,0,0
9/23/2017 2:20,12,68.9,27,64.7,39,66,2,0,0
9/23/2017 2:25,9,68.6,24,64.4,33,65.6,2,0,0
9/23/2017 2:30,12,68.8,27,64.6,39,65.9,2,0,0
9/23/2017 2:35,5,70.3,4,64.3,9,67.6,2,0,0
9/23/2017 2:40,10,68.9,25,64.7,35,65.9,2,0,0
9/23/2017 2:45,7,68.9,22,64.7,29,65.7,2,0,0
9/23/2017 2:50,9,68.9,24,64.7,33,65.9,2,0,0
9/23/2017 2:55,12,68.9,26,64.8,38,66.1,2,0,0
9/23/2017 3:00,13,69,27,64.8,40,66.1,2,0,0
9/23/2017 3:05,12,68.9,27,64.7,39,66,2,0,0
9/23/2017 3:10,8,68.8,23,64.6,31,65.7,2,0,0
9/23/2017 3:15,11,68.9,25,64.7,36,66,2,0,0
9/23/2017 3:20,10,68.9,24,64.8,34,66,2,0,0
9/23/2017 3:25,10,68.7,25,64.5,35,65.7,2,0,0
9/23/2017 3:30,11,68.9,26,64.7,37,66,2,0,0
9/23/2017 3:35,11,68.6,26,64.4,37,65.7,2,0,0
9/23/2017 3:40,9,68.8,24,64.6,33,65.7,2,0,0
9/23/2017 3:45,10,68.8,25,64.6,35,65.8,2,0,0
9/23/2017 3:50,9,68.8,24,64.6,33,65.8,2,0,0
9/23/2017 3:55,9,68.7,23,64.5,32,65.7,2,0,0
9/23/2017 4:00,9,68.8,24,64.6,33,65.7,2,0,0
9/23/2017 4:05,9,68.8,24,64.6,33,65.8,2,0,0
9/23/2017 4:10,5,70.1,4,64.1,9,67.4,2,0,0
9/23/2017 4:15,5,70.2,5,64.2,10,67.2,2,0,0
9/23/2017 4:20,13,68.9,27,64.7,40,66,2,0,0
9/23/2017 4:25,11,68.9,26,64.7,37,66,2,0,0
9/23/2017 4:30,14,69,29,64.8,43,66.2,2,0,0
9/23/2017 4:35,7,70.3,6,64.3,13,67.5,2,0,0
9/23/2017 4:40,8,70.4,7,64.4,15,67.6,2,0,0
9/23/2017 4:45,14,68.9,29,64.7,43,66,2,0,0
9/23/2017 4:50,16,68.9,31,64.7,47,66.1,2,0,0
9/23/2017 4:55,18,69.1,32,64.9,50,66.4,2,0,0
9/23/2017 5:00,15,69,29,64.8,44,66.2,2,0,0
9/23/2017 5:05,18,68.9,33,64.7,51,66.2,2,0,0
9/23/2017 5:10,21,69.1,36,64.9,57,66.5,2,0,0
9/23/2017 5:15,10,70.4,9,64.4,19,67.6,2,0,0
9/23/2017 5:20,12,70.4,10,64.4,22,67.7,2,0,0
9/23/2017 5:25,11,68.9,27,64.7,38,65.9,2,0,0
9/23/2017 5:30,34,68.8,49,64.5,83,66.3,2,0,0
9/23/2017 5:35,18,68.9,33,64.7,51,66.2,2,0,0
9/23/2017 5:40,15,70.6,14,64.6,29,67.7,2,0,0
9/23/2017 5:45,21,68.9,36,64.7,57,66.2,2,0,0
9/23/2017 5:50,23,69.1,37,64.9,60,66.5,2,0,0
9/23/2017 5:55,27,69.2,42,65,69,66.7,2,0,0
9/23/2017 6:00,23,68.9,38,64.7,61,66.3,2,0,0
9/23/2017 6:05,25,68.5,39,64.3,64,65.9,2,0,0
9/23/2017 6:10,28,68.6,42,64.4,70,66.1,2,0,0
9/23/2017 6:15,26,67.9,40,63.8,66,65.4,2,0,0
9/23/2017 6:20,30,67.9,44,63.7,74,65.4,2,0,0
9/23/2017 6:25,27,68.5,41,64.3,68,66,2,0,0
9/23/2017 6:30,31,68.3,46,64.1,77,65.8,2,0,0
9/23/2017 6:35,31,68.3,46,64.1,77,65.8,2,0,0
9/23/2017 6:40,32,68.3,47,64.1,79,65.8,2,0,0
9/23/2017 6:45,40,68.7,55,64.5,95,66.2,2,0,0
9/23/2017 6:50,28,70.6,25,64.6,53,67.8,2,0,0
9/23/2017 6:55,28,68.9,42,64.7,70,66.4,2,0,0
9/23/2017 7:00,31,68.8,45,64.6,76,66.3,2,0,0
9/23/2017 7:05,39,67.9,53,63.7,92,65.5,2,0,0
9/23/2017 7:10,39,66.8,53,62.7,92,64.4,2,0,0
9/23/2017 7:15,34,67.6,48,63.4,82,65.2,2,0,0
9/23/2017 7:20,45,67.7,59,63.5,104,65.3,2,0,0
9/23/2017 7:25,38,68.7,53,64.5,91,66.3,2,0,0
9/23/2017 7:30,48,68.7,63,64.5,111,66.3,2,0,0
9/23/2017 7:35,44,68.8,58,64.6,102,66.4,2,0,0
9/23/2017 7:40,48,69.3,63,65.1,111,66.9,2,0,0
9/23/2017 7:45,51,69.6,65,65.3,116,67.2,2,0,0
9/23/2017 7:50,52,69.3,67,65,119,66.9,2,0,0
9/23/2017 7:55,41,68.6,56,64.4,97,66.1,2,0,0
9/23/2017 8:00,40,68.8,54,64.5,94,66.3,2,0,0
9/23/2017 8:05,43,68.1,57,63.9,100,65.7,2,0,0
9/23/2017 8:10,43,69.1,55,64.9,98,66.7,2,0,0
9/23/2017 8:15,46,70.4,41,64.4,87,67.6,2,0,0
9/23/2017 8:20,43,68.9,58,64.7,101,66.5,2,0,0
9/23/2017 8:25,43,68.7,57,64.5,100,66.3,2,0,0
9/23/2017 8:30,43,68.1,58,63.9,101,65.7,2,0,0
9/23/2017 8:35,54,67.7,68,63.4,122,65.3,2,0,0
9/23/2017 8:40,59,68.5,73,64.3,132,66.1,2,0,0
9/23/2017 8:45,58,68.9,71,64.6,129,66.5,2,0,0
9/23/2017 8:50,56,69.8,71,65.6,127,67.4,2,0,0
9/23/2017 8:55,57,69.9,70,65.7,127,67.6,2,0,0
9/23/2017 9:00,49,69.6,63,65.4,112,67.2,2,0,0
9/23/2017 9:05,42,69.5,56,65.3,98,67.1,2,0,0
9/23/2017 9:10,43,68.6,57,64.4,100,66.2,2,0,0
9/23/2017 9:15,42,68.6,56,64.4,98,66.2,2,0,0
9/23/2017 9:20,50,67.7,65,63.5,115,65.3,2,0,0
9/23/2017 9:25,56,68.2,70,63.9,126,65.8,2,0,0
9/23/2017 9:30,55,68.3,69,64.1,124,66,2,0,0
9/23/2017 9:35,60,69,74,64.7,134,66.6,2,0,0
9/23/2017 9:40,62,69.4,76,65.2,138,67.1,2,0,0
9/23/2017 9:45,68,67.6,82,63.3,150,65.2,2,0,0
9/23/2017 9:50,61,68.1,75,63.8,136,65.7,2,0,0
9/23/2017 9:55,68,68.4,82,64.2,150,66.1,2,0,0
9/23/2017 10:00,58,67.7,71,63.5,129,65.4,2,0,0
9/23/2017 10:05,70,67,84,62.8,154,64.7,2,0,0
9/23/2017 10:10,62,67.6,76,63.4,138,65.3,2,0,0
9/23/2017 10:15,75,67.5,89,63.2,164,65.2,2,0,0
9/23/2017 10:20,62,66.9,77,62.7,139,64.6,2,0,0
9/23/2017 10:25,59,67.8,73,63.6,132,65.5,2,0,0
9/23/2017 10:30,73,67.8,87,63.5,160,65.5,2,0,0
9/23/2017 10:35,74,67.7,89,63.4,163,65.4,2,0,0
9/23/2017 10:40,63,67.8,77,63.6,140,65.5,2,0,0
9/23/2017 10:45,74,67.8,89,63.6,163,65.5,2,0,0
9/23/2017 10:50,62,67.7,76,63.5,138,65.4,2,0,0
9/23/2017 10:55,70,67.7,85,63.6,155,65.4,2,0,0
9/23/2017 11:00,58,67.9,72,63.8,130,65.7,2,0,0
9/23/2017 11:05,70,67.8,83,63.6,153,65.5,2,0,0
9/23/2017 11:10,85,67.7,99,63.5,184,65.4,2,0,0
9/23/2017 11:15,70,69.9,63,63.9,133,67.1,2,0,0
9/23/2017 11:20,68,68.4,81,64.3,149,66.1,2,0,0
9/23/2017 11:25,72,67.5,86,63.3,158,65.2,2,0,0
9/23/2017 11:30,60,68.8,74,64.7,134,66.5,2,0,0
9/23/2017 11:35,67,68.2,81,64,148,65.9,2,0,0
9/23/2017 11:40,76,68.8,90,64.7,166,66.6,2,0,0
9/23/2017 11:45,72,67.8,86,63.7,158,65.6,2,0,0
9/23/2017 11:50,80,67.9,94,63.6,174,65.6,2,0,0
9/23/2017 11:55,76,67.4,90,63.2,166,65.1,2,0,0
9/23/2017 12:00,71,68.2,85,64,156,65.9,2,0,0
9/23/2017 12:05,63,68.1,77,63.9,140,65.8,2,0,0
9/23/2017 12:10,72,68,86,63.8,158,65.7,2,0,0
9/23/2017 12:15,69,68.7,82,64.5,151,66.4,2,0,0
9/23/2017 12:20,69,68,82,63.9,151,65.8,2,0,0
9/23/2017 12:25,79,68.4,94,64.2,173,66.1,2,0,0
9/23/2017 12:30,67,69.3,80,65.1,147,67,2,0,0
9/23/2017 12:35,63,69,77,64.8,140,66.7,2,0,0
9/23/2017 12:40,65,69.2,79,65,144,66.9,2,0,0
9/23/2017 12:45,72,69.4,85,65.2,157,67.1,2,0,0
9/23/2017 12:50,72,69.7,85,65.6,157,67.5,2,0,0
9/23/2017 12:55,77,69.1,90,65,167,66.9,2,0,0
9/23/2017 13:00,75,68.1,90,63.9,165,65.8,2,0,0
9/23/2017 13:05,64,68,78,63.8,142,65.7,2,0,0
9/23/2017 13:10,68,68.2,81,63.9,149,65.9,2,0,0
9/23/2017 13:15,57,68.1,72,64,129,65.8,2,0,0
9/23/2017 13:20,76,68.1,90,63.9,166,65.8,2,0,0
9/23/2017 13:25,67,67.7,80,63.5,147,65.4,2,0,0
9/23/2017 13:30,68,67.7,83,63.4,151,65.3,2,0,0
9/23/2017 13:35,78,67.4,93,63.2,171,65.1,2,0,0
9/23/2017 13:40,68,67.3,82,63.1,150,65,2,0,0
9/23/2017 13:45,65,68.2,79,64.1,144,66,2,0,0
9/23/2017 13:50,66,68.5,80,64.3,146,66.2,2,0,0
9/23/2017 13:55,62,68.6,76,64.4,138,66.3,2,0,0
9/23/2017 14:00,71,69.1,86,65,157,66.9,2,0,0
9/23/2017 14:05,74,69,88,64.8,162,66.7,2,0,0
9/23/2017 14:10,70,68.9,83,64.6,153,66.6,2,0,0
9/23/2017 14:15,69,68.3,84,64.1,153,66,2,0,0
9/23/2017 14:20,66,68.6,79,64.4,145,66.3,2,0,0
9/23/2017 14:25,66,68.7,80,64.6,146,66.5,2,0,0
9/23/2017 14:30,69,67.9,83,63.6,152,65.6,2,0,0
9/23/2017 14:35,72,68.4,86,64.2,158,66.1,2,0,0
9/23/2017 14:40,68,68.3,82,64.1,150,66,2,0,0
9/23/2017 14:45,70,68,84,63.8,154,65.7,2,0,0
9/23/2017 14:50,68,68.1,82,63.9,150,65.8,2,0,0
9/23/2017 14:55,70,68.4,85,64.2,155,66.1,2,0,0
9/23/2017 15:00,67,68.3,80,64.1,147,66,2,0,0
9/23/2017 15:05,78,67.6,92,63.4,170,65.4,2,0,0
9/23/2017 15:10,75,67.5,88,63.2,163,65.2,2,0,0
9/23/2017 15:15,70,67.5,84,63.3,154,65.2,2,0,0
9/23/2017 15:20,81,67.2,96,63,177,64.9,2,0,0
9/23/2017 15:25,58,68.1,72,63.9,130,65.8,2,0,0
9/23/2017 15:30,67,67.9,81,63.8,148,65.7,2,0,0
9/23/2017 15:35,63,68.7,77,64.6,140,66.5,2,0,0
9/23/2017 15:40,78,69.1,92,64.9,170,66.8,2,0,0
9/23/2017 15:45,82,68.9,96,64.7,178,66.6,2,0,0
9/23/2017 15:50,68,68,83,63.7,151,65.6,2,0,0
9/23/2017 15:55,73,67.6,87,63.4,160,65.3,2,0,0
9/23/2017 16:00,60,67.8,74,63.5,134,65.4,2,0,0
9/23/2017 16:05,67,67.5,81,63.2,148,65.1,2,0,0
9/23/2017 16:10,75,68,89,63.7,164,65.7,2,0,0
9/23/2017 16:15,66,67.7,80,63.5,146,65.4,2,0,0
9/23/2017 16:20,77,68.2,91,64,168,66,2,0,0
9/23/2017 16:25,67,68.5,81,64.3,148,66.2,2,0,0
9/23/2017 16:30,74,67.9,89,63.7,163,65.6,2,0,0
9/23/2017 16:35,76,68.6,90,64.4,166,66.3,2,0,0
9/23/2017 16:40,60,68.7,74,64.5,134,66.4,2,0,0
9/23/2017 16:45,70,68.9,85,64.7,155,66.6,2,0,0
9/23/2017 16:50,62,68.6,77,64.4,139,66.3,2,0,0
9/23/2017 16:55,79,68.4,93,64.2,172,66.1,2,0,0
9/23/2017 17:00,79,67,94,62.7,173,64.6,2,0,0
9/23/2017 17:05,79,67.4,93,63.1,172,65,2,0,0
9/23/2017 17:10,85,67.7,100,63.4,185,65.4,2,0,0
9/23/2017 17:15,80,67.1,94,62.8,174,64.8,2,0,0
9/23/2017 17:20,77,67.5,93,63.2,170,65.2,2,0,0
9/23/2017 17:25,89,67.7,103,63.4,192,65.4,2,0,0
9/23/2017 17:30,86,67.2,100,62.9,186,64.9,2,0,0
9/23/2017 17:35,75,67.1,90,62.8,165,64.7,2,0,0
9/23/2017 17:40,82,66.1,97,61.8,179,63.8,2,0,0
9/23/2017 17:45,91,65.5,107,61.1,198,63.1,2,0,0
9/23/2017 17:50,74,65.6,88,61.2,162,63.2,2,0,0
9/23/2017 17:55,79,66.5,93,62.2,172,64.1,2,0,0
9/23/2017 18:00,69,66.9,83,62.6,152,64.5,2,0,0
9/23/2017 18:05,76,67.3,90,63.1,166,65,2,0,0
9/23/2017 18:10,66,68.1,81,63.9,147,65.8,2,0,0
9/23/2017 18:15,59,68.4,73,64.2,132,66,2,0,0
9/23/2017 18:20,60,68.3,74,64.1,134,66,2,0,0
9/23/2017 18:25,57,67.5,71,63.2,128,65.1,2,0,0
9/23/2017 18:30,54,68.2,68,64,122,65.9,2,0,0
9/23/2017 18:35,53,68.8,67,64.6,120,66.5,2,0,0
9/23/2017 18:40,50,68.4,64,64.2,114,66,2,0,0
9/23/2017 18:45,55,68.2,70,64,125,65.9,2,0,0
9/23/2017 18:50,53,68.9,67,64.7,120,66.6,2,0,0
9/23/2017 18:55,56,68.7,71,64.5,127,66.3,2,0,0
9/23/2017 19:00,69,69.1,84,64.9,153,66.8,2,0,0
9/23/2017 19:05,49,68.9,62,64.8,111,66.6,2,0,0
9/23/2017 19:10,55,69.1,69,64.9,124,66.7,2,0,0
9/23/2017 19:15,58,68.7,72,64.5,130,66.4,2,0,0
9/23/2017 19:20,45,68.4,59,64.2,104,66,2,0,0
9/23/2017 19:25,54,68.2,68,64,122,65.9,2,0,0
9/23/2017 19:30,53,67.6,67,63.3,120,65.2,2,0,0
9/23/2017 19:35,57,66.8,71,62.5,128,64.4,2,0,0
9/23/2017 19:40,53,67.6,67,63.3,120,65.2,2,0,0
9/23/2017 19:45,49,66.6,62,62.4,111,64.2,2,0,0
9/23/2017 19:50,42,67.3,56,63.1,98,64.9,2,0,0
9/23/2017 19:55,47,67.1,61,62.9,108,64.8,2,0,0
9/23/2017 20:00,41,67,55,62.8,96,64.6,2,0,0
9/23/2017 20:05,46,67.7,61,63.5,107,65.3,2,0,0
9/23/2017 20:10,47,67.4,61,63.2,108,65,2,0,0
9/23/2017 20:15,48,68,62,63.8,110,65.6,2,0,0
9/23/2017 20:20,44,68,58,63.8,102,65.6,2,0,0
9/23/2017 20:25,42,68,56,63.8,98,65.6,2,0,0
9/23/2017 20:30,36,67.8,50,63.6,86,65.4,2,0,0
9/23/2017 20:35,42,67.8,56,63.6,98,65.4,2,0,0
9/23/2017 20:40,48,67.1,62,62.8,110,64.7,2,0,0
9/23/2017 20:45,45,67.7,58,63.4,103,65.3,2,0,0
9/23/2017 20:50,39,67.9,53,63.7,92,65.5,2,0,0
9/23/2017 20:55,37,68.1,52,63.9,89,65.7,2,0,0
9/23/2017 21:00,40,68,54,63.8,94,65.6,2,0,0
9/23/2017 21:05,44,67.4,58,63.2,102,65,2,0,0
9/23/2017 21:10,39,68,52,63.9,91,65.7,2,0,0
9/23/2017 21:15,34,67.8,48,63.6,82,65.3,2,0,0
9/23/2017 21:20,44,67.5,57,63.3,101,65.1,2,0,0
9/23/2017 21:25,36,67.8,50,63.6,86,65.3,2,0,0
9/23/2017 21:30,37,68.1,50,64,87,65.7,2,0,0
9/23/2017 21:35,39,68.4,53,64.2,92,66,2,0,0
9/23/2017 21:40,39,68.2,54,64,93,65.7,2,0,0
9/23/2017 21:45,37,68.1,51,63.9,88,65.7,2,0,0
9/23/2017 21:50,34,68.4,48,64.2,82,65.9,2,0,0
9/23/2017 21:55,38,67.9,52,63.7,90,65.5,2,0,0
9/23/2017 22:00,32,68.5,46,64.3,78,66,2,0,0
9/23/2017 22:05,31,68.7,45,64.4,76,66.2,2,0,0
9/23/2017 22:10,39,68.8,52,64.6,91,66.4,2,0,0
9/23/2017 22:15,34,68.9,48,64.7,82,66.4,2,0,0
9/23/2017 22:20,33,68.6,47,64.4,80,66.1,2,0,0
9/23/2017 22:25,30,68.3,44,64.1,74,65.8,2,0,0
9/23/2017 22:30,34,69,49,64.8,83,66.5,2,0,0
9/23/2017 22:35,27,69,41,64.8,68,66.5,2,0,0
9/23/2017 22:40,28,69.1,42,64.9,70,66.6,2,0,0
9/23/2017 22:45,30,68.7,45,64.5,75,66.2,2,0,0
9/23/2017 22:50,29,68.8,43,64.6,72,66.3,2,0,0
9/23/2017 22:55,27,68.8,41,64.6,68,66.3,2,0,0
9/23/2017 23:00,25,69,39,64.9,64,66.5,2,0,0
9/23/2017 23:05,29,68.6,43,64.4,72,66.1,2,0,0
9/23/2017 23:10,24,69,38,64.9,62,66.5,2,0,0
9/23/2017 23:15,25,68.7,39,64.5,64,66.2,2,0,0
9/23/2017 23:20,18,68.8,32,64.6,50,66.2,2,0,0
9/23/2017 23:25,19,68.7,33,64.5,52,66.1,2,0,0
9/23/2017 23:30,21,68.8,35,64.6,56,66.2,2,0,0
9/23/2017 23:35,18,69,32,64.8,50,66.3,2,0,0
9/23/2017 23:40,17,69,31,64.9,48,66.3,2,0,0
9/23/2017 23:45,22,69.2,37,65,59,66.6,2,0,0
9/23/2017 23:50,16,68.9,30,64.7,46,66.2,2,0,0
9/23/2017 23:55,18,69,33,64.8,51,66.3,2,0,0
9/24/2017 0:00,20,68.9,34,64.7,54,66.2,2,0,0
9/24/2017 0:05,20,68.6,34,64.4,54,66,2,0,0
9/24/2017 0:10,21,68.7,35,64.5,56,66.1,2,0,0
9/24/2017 0:15,11,68.8,26,64.6,37,65.9,2,0,0
9/24/2017 0:20,13,68.8,28,64.6,41,65.9,2,0,0
9/24/2017 0:25,12,68.7,27,64.5,39,65.8,2,0,0
9/24/2017 0:30,15,69,29,64.8,44,66.2,2,0,0
9/24/2017 0:35,16,68.8,30,64.6,46,66.1,2,0,0
9/24/2017 0:40,12,68.9,26,64.7,38,66,2,0,0
9/24/2017 0:45,11,68.9,25,64.7,36,66,2,0,0
9/24/2017 0:50,12,68.9,26,64.8,38,66.1,2,0,0
9/24/2017 0:55,10,69,25,64.8,35,66,2,0,0
9/24/2017 1:00,10,69,25,64.8,35,66,2,0,0
9/24/2017 1:05,13,68.9,28,64.7,41,66.1,2,0,0
9/24/2017 1:10,12,68.7,27,64.5,39,65.8,2,0,0
9/24/2017 1:15,11,68.8,25,64.6,36,65.9,2,0,0
9/24/2017 1:20,10,68.9,24,64.7,34,65.9,2,0,0
9/24/2017 1:25,8,68.9,23,64.7,31,65.8,2,0,0
9/24/2017 1:30,10,68.9,24,64.7,34,65.9,2,0,0
9/24/2017 1:35,9,68.9,24,64.7,33,65.9,2,0,0
9/24/2017 1:40,10,68.6,24,64.4,34,65.7,2,0,0
9/24/2017 1:45,11,68.8,26,64.6,37,65.9,2,0,0
9/24/2017 1:50,9,68.9,24,64.7,33,65.9,2,0,0
9/24/2017 1:55,9,68.7,24,64.5,33,65.6,2,0,0
9/24/2017 2:00,8,68.8,23,64.6,31,65.7,2,0,0
9/24/2017 2:05,11,68.8,26,64.6,37,65.9,2,0,0
9/24/2017 2:10,8,68.9,23,64.7,31,65.8,2,0,0
9/24/2017 2:15,10,69,24,64.8,34,66,2,0,0
9/24/2017 2:20,10,68.9,25,64.7,35,65.9,2,0,0
9/24/2017 2:25,10,68.9,25,64.7,35,65.9,2,0,0
9/24/2017 2:30,11,69,25,64.7,36,66,2,0,0
9/24/2017 2:35,9,68.9,23,64.7,32,65.9,2,0,0
9/24/2017 2:40,9,68.9,24,64.8,33,65.9,2,0,0
9/24/2017 2:45,9,68.9,24,64.8,33,65.9,2,0,0
9/24/2017 2:50,7,68.9,22,64.8,29,65.8,2,0,0
9/24/2017 2:55,9,69,24,64.8,33,65.9,2,0,0
9/24/2017 3:00,7,69,22,64.8,29,65.8,2,0,0
9/24/2017 3:05,8,68.9,24,64.7,32,65.8,2,0,0
9/24/2017 3:10,7,69,22,64.8,29,65.8,2,0,0
9/24/2017 3:15,7,68.8,22,64.7,29,65.7,2,0,0
9/24/2017 3:20,6,68.9,21,64.7,27,65.6,2,0,0
9/24/2017 3:25,6,68.9,21,64.8,27,65.7,2,0,0
9/24/2017 3:30,9,68.9,24,64.7,33,65.9,2,0,0
9/24/2017 3:35,9,68.9,24,64.7,33,65.9,2,0,0
9/24/2017 3:40,7,68.8,22,64.6,29,65.7,2,0,0
9/24/2017 3:45,9,68.9,24,64.7,33,65.8,2,0,0
9/24/2017 3:50,7,68.9,22,64.7,29,65.7,2,0,0
9/24/2017 3:55,7,68.8,22,64.6,29,65.7,2,0,0
9/24/2017 4:00,7,68.9,22,64.7,29,65.7,2,0,0
9/24/2017 4:05,9,68.8,24,64.6,33,65.8,2,0,0
9/24/2017 4:10,7,68.8,22,64.6,29,65.7,2,0,0
9/24/2017 4:15,9,68.9,23,64.7,32,65.9,2,0,0
9/24/2017 4:20,9,68.9,24,64.7,33,65.8,2,0,0
9/24/2017 4:25,9,68.9,24,64.8,33,65.9,2,0,0
9/24/2017 4:30,12,68.9,26,64.7,38,66,2,0,0
9/24/2017 4:35,13,68.8,28,64.6,41,66,2,0,0
9/24/2017 4:40,10,68.8,25,64.6,35,65.8,2,0,0
9/24/2017 4:45,11,68.8,25,64.6,36,65.9,2,0,0
9/24/2017 4:50,10,68.9,25,64.7,35,65.9,2,0,0
9/24/2017 4:55,14,68.8,29,64.6,43,66,2,0,0
9/24/2017 5:00,10,68.8,25,64.6,35,65.8,2,0,0
9/24/2017 5:05,13,68.9,28,64.7,41,66,2,0,0
9/24/2017 5:10,11,68.8,25,64.6,36,65.9,2,0,0
9/24/2017 5:15,12,68.8,26,64.6,38,66,2,0,0
9/24/2017 5:20,14,68.8,28,64.6,42,66,2,0,0
9/24/2017 5:25,16,68.7,30,64.5,46,66,2,0,0
9/24/2017 5:30,14,68.9,29,64.7,43,66.1,2,0,0
9/24/2017 5:35,18,68.7,32,64.5,50,66.1,2,0,0
9/24/2017 5:40,14,68.8,29,64.6,43,65.9,2,0,0
9/24/2017 5:45,15,68.8,29,64.6,44,66,2,0,0
9/24/2017 5:50,15,68.8,30,64.6,45,66,2,0,0
9/24/2017 5:55,16,68.8,31,64.6,47,66,2,0,0
9/24/2017 6:00,15,68.8,30,64.6,45,66,2,0,0
9/24/2017 6:05,18,68.6,32,64.4,50,65.9,2,0,0
9/24/2017 6:10,19,68.3,34,64.1,53,65.6,2,0,0
9/24/2017 6:15,19,68.6,33,64.4,52,65.9,2,0,0
9/24/2017 6:20,20,68.6,35,64.4,55,65.9,2,0,0
9/24/2017 6:25,24,68.9,38,64.8,62,66.4,2,0,0
9/24/2017 6:30,24,68.8,39,64.6,63,66.2,2,0,0
9/24/2017 6:35,19,68.7,34,64.5,53,66,2,0,0
9/24/2017 6:40,27,68.8,41,64.6,68,66.3,2,0,0
9/24/2017 6:45,22,68.5,36,64.3,58,65.9,2,0,0
9/24/2017 6:50,26,68.3,41,64.1,67,65.8,2,0,0
9/24/2017 6:55,18,68.8,33,64.6,51,66.1,2,0,0
9/24/2017 7:00,20,69.1,34,64.9,54,66.5,2,0,0
9/24/2017 7:05,18,69,33,64.9,51,66.3,2,0,0
9/24/2017 7:10,25,69,39,64.8,64,66.4,2,0,0
9/24/2017 7:15,21,68.9,35,64.7,56,66.3,2,0,0
9/24/2017 7:20,25,68.8,39,64.6,64,66.3,2,0,0
9/24/2017 7:25,30,68.9,44,64.6,74,66.3,2,0,0
9/24/2017 7:30,32,68.9,47,64.7,79,66.4,2,0,0
9/24/2017 7:35,27,68.6,42,64.4,69,66,2,0,0
9/24/2017 7:40,34,68.9,48,64.7,82,66.5,2,0,0
9/24/2017 7:45,29,68.7,43,64.5,72,66.2,2,0,0
9/24/2017 7:50,29,68.8,44,64.7,73,66.3,2,0,0
9/24/2017 7:55,33,69,47,64.8,80,66.5,2,0,0
9/24/2017 8:00,31,68.8,45,64.6,76,66.3,2,0,0
9/24/2017 8:05,27,68.7,42,64.5,69,66.2,2,0,0
9/24/2017 8:10,34,67.8,48,63.6,82,65.4,2,0,0
9/24/2017 8:15,35,68.6,49,64.4,84,66.1,2,0,0
9/24/2017 8:20,32,68.7,47,64.5,79,66.2,2,0,0
9/24/2017 8:25,34,68.6,48,64.4,82,66.2,2,0,0
9/24/2017 8:30,44,69.2,59,65,103,66.8,2,0,0
9/24/2017 8:35,41,69.3,55,65.1,96,66.9,2,0,0
9/24/2017 8:40,40,69.4,54,65.2,94,67,2,0,0
9/24/2017 8:45,37,68.4,51,64.2,88,66,2,0,0
9/24/2017 8:50,34,68.7,48,64.4,82,66.2,2,0,0
9/24/2017 8:55,40,68.5,54,64.3,94,66.1,2,0,0
9/24/2017 9:00,39,69,54,64.8,93,66.6,2,0,0
9/24/2017 9:05,44,68.3,58,64.1,102,65.9,2,0,0
9/24/2017 9:10,43,69.1,57,64.9,100,66.7,2,0,0
9/24/2017 9:15,53,69.3,67,65.1,120,66.9,2,0,0
9/24/2017 9:20,49,70,63,65.8,112,67.6,2,0,0
9/24/2017 9:25,47,69.5,61,65.3,108,67.1,2,0,0
9/24/2017 9:30,41,68.8,56,64.6,97,66.4,2,0,0
9/24/2017 9:35,50,69.1,64,64.8,114,66.7,2,0,0
9/24/2017 9:40,57,68.4,71,64.1,128,66,2,0,0
9/24/2017 9:45,56,67.8,71,63.6,127,65.4,2,0,0
9/24/2017 9:50,51,69.1,65,64.8,116,66.7,2,0,0
9/24/2017 9:55,59,68.9,74,64.7,133,66.5,2,0,0
9/24/2017 10:00,60,68.7,74,64.5,134,66.4,2,0,0
9/24/2017 10:05,52,67.9,66,63.6,118,65.5,2,0,0
9/24/2017 10:10,68,68.3,83,64,151,65.9,2,0,0
9/24/2017 10:15,57,68.5,71,64.3,128,66.1,2,0,0
9/24/2017 10:20,64,68.9,78,64.8,142,66.6,2,0,0
9/24/2017 10:25,68,68.7,83,64.5,151,66.4,2,0,0
9/24/2017 10:30,60,68.4,74,64.2,134,66.1,2,0,0
9/24/2017 10:35,58,69,72,64.7,130,66.6,2,0,0
9/24/2017 10:40,61,67.9,75,63.7,136,65.6,2,0,0
9/24/2017 10:45,68,67.9,82,63.7,150,65.6,2,0,0
9/24/2017 10:50,73,67.5,87,63.2,160,65.2,2,0,0
9/24/2017 10:55,70,68.1,83,63.9,153,65.8,2,0,0
9/24/2017 11:00,66,68.1,80,63.9,146,65.8,2,0,0
9/24/2017 11:05,58,69.2,52,63.2,110,66.4,2,0,0
9/24/2017 11:10,65,69.8,59,63.8,124,66.9,2,0,0
9/24/2017 11:15,62,70.1,55,64.1,117,67.3,2,0,0
9/24/2017 11:20,75,65.8,88,61.6,163,63.5,2,0,0
9/24/2017 11:25,83,66.3,96,62,179,64,2,0,0
9/24/2017 11:30,61,70,54,64,115,67.2,2,0,0
9/24/2017 11:35,62,70,55,64,117,67.2,2,0,0
9/24/2017 11:40,64,69.8,57,63.8,121,67,2,0,0
9/24/2017 11:45,64,69.7,57,63.7,121,66.9,2,0,0
9/24/2017 11:50,63,69.7,56,63.7,119,66.9,2,0,0
9/24/2017 11:55,65,69.7,58,63.7,123,66.9,2,0,0
9/24/2017 12:00,64,69.6,57,63.6,121,66.8,2,0,0
9/24/2017 12:05,63,69.6,57,63.6,120,66.7,2,0,0
9/24/2017 12:10,64,69.6,57,63.6,121,66.8,2,0,0
9/24/2017 12:15,71,69.3,86,65.1,157,67,2,0,0
9/24/2017 12:20,83,68.6,96,64.4,179,66.4,2,0,0
9/24/2017 12:25,67,68.3,82,64.1,149,66,2,0,0
9/24/2017 12:30,74,68.4,88,64.2,162,66.1,2,0,0
9/24/2017 12:35,79,68.1,93,63.8,172,65.8,2,0,0
9/24/2017 12:40,69,68,84,63.8,153,65.7,2,0,0
9/24/2017 12:45,69,68.5,83,64.3,152,66.2,2,0,0
9/24/2017 12:50,66,68.6,80,64.4,146,66.3,2,0,0
9/24/2017 12:55,64,68.7,78,64.5,142,66.4,2,0,0
9/24/2017 13:00,64,68.8,78,64.6,142,66.5,2,0,0
9/24/2017 13:05,67,68.5,81,64.3,148,66.2,2,0,0
9/24/2017 13:10,59,68.5,73,64.3,132,66.1,2,0,0
9/24/2017 13:15,68,68.3,82,64.1,150,66,2,0,0
9/24/2017 13:20,65,68.4,79,64.2,144,66.1,2,0,0
9/24/2017 13:25,60,68.7,74,64.5,134,66.4,2,0,0
9/24/2017 13:30,61,68.5,74,64.3,135,66.2,2,0,0
9/24/2017 13:35,65,69,79,64.8,144,66.7,2,0,0
9/24/2017 13:40,61,68.9,75,64.7,136,66.6,2,0,0
9/24/2017 13:45,70,68.6,84,64.4,154,66.3,2,0,0
9/24/2017 13:50,58,68.4,72,64.2,130,66.1,2,0,0
9/24/2017 13:55,59,67.9,73,63.8,132,65.6,2,0,0
9/24/2017 14:00,61,68.7,75,64.6,136,66.4,2,0,0
9/24/2017 14:05,58,68.2,72,64,130,65.8,2,0,0
9/24/2017 14:10,52,68.2,66,64,118,65.9,2,0,0
9/24/2017 14:15,54,68.2,68,64,122,65.9,2,0,0
9/24/2017 14:20,52,68.1,65,64,117,65.8,2,0,0
9/24/2017 14:25,55,68.6,68,64.4,123,66.3,2,0,0
9/24/2017 14:30,64,68.6,78,64.5,142,66.3,2,0,0
9/24/2017 14:35,64,67.4,79,63.2,143,65.1,2,0,0
9/24/2017 14:40,54,67.3,68,63.1,122,65,2,0,0
9/24/2017 14:45,55,67.4,69,63.2,124,65.1,2,0,0
9/24/2017 14:50,74,67.2,87,63,161,64.9,2,0,0
9/24/2017 14:55,59,67.7,73,63.4,132,65.3,2,0,0
9/24/2017 15:00,62,67.4,75,63.2,137,65.1,2,0,0
9/24/2017 15:05,77,67.4,90,63.2,167,65.1,2,0,0
9/24/2017 15:10,64,67.6,78,63.4,142,65.3,2,0,0
9/24/2017 15:15,72,67.1,87,62.9,159,64.8,2,0,0
9/24/2017 15:20,67,67.1,81,62.9,148,64.8,2,0,0
9/24/2017 15:25,63,67.2,77,62.9,140,64.8,2,0,0
9/24/2017 15:30,66,67.5,80,63.3,146,65.2,2,0,0
9/24/2017 15:35,59,67.1,74,62.9,133,64.8,2,0,0
9/24/2017 15:40,73,66.6,87,62.4,160,64.3,2,0,0
9/24/2017 15:45,58,66.8,72,62.6,130,64.5,2,0,0
9/24/2017 15:50,57,67.4,75,62.5,132,64.6,2,0,0
9/24/2017 15:55,53,67.6,70,62.8,123,64.9,2,0,0
9/24/2017 16:00,50,68,68,63.2,118,65.2,2,0,0
9/24/2017 16:05,50,68.5,68,63.8,118,65.8,2,0,0
9/24/2017 16:10,50,68.2,68,63.4,118,65.4,2,0,0
9/24/2017 16:15,47,69,65,64.3,112,66.2,2,0,0
9/24/2017 16:20,55,68.8,72,64.1,127,66.2,2,0,0
9/24/2017 16:25,55,68.2,71,63.5,126,65.5,2,0,0
9/24/2017 16:30,50,68.2,68,63.4,118,65.4,2,0,0
9/24/2017 16:35,48,68.2,66,63.5,114,65.5,2,0,0
9/24/2017 16:40,56,68.4,75,63.7,131,65.7,2,0,0
9/24/2017 16:45,48,68.2,65,63.5,113,65.5,2,0,0
9/24/2017 16:50,54,69.1,71,64.5,125,66.5,2,0,0
9/24/2017 16:55,47,68.8,64,64.1,111,66.1,2,0,0
9/24/2017 17:00,56,68.9,75,64.2,131,66.2,2,0,0
9/24/2017 17:05,46,66.8,64,62,110,64,2,0,0
9/24/2017 17:10,51,67,69,62.1,120,64.2,2,0,0
9/24/2017 17:15,57,67.7,74,62.9,131,65,2,0,0
9/24/2017 17:20,57,67.1,73,62.3,130,64.4,2,0,0
9/24/2017 17:25,54,66.2,70,61.2,124,63.4,2,0,0
9/24/2017 17:30,48,68,66,63.2,114,65.2,2,0,0
9/24/2017 17:35,67,68.5,86,63.8,153,65.9,2,0,0
9/24/2017 17:40,46,68.5,64,63.8,110,65.8,2,0,0
9/24/2017 17:45,44,68.3,62,63.6,106,65.5,2,0,0
9/24/2017 17:50,64,67.6,83,62.8,147,64.9,2,0,0
9/24/2017 17:55,58,68.5,77,63.9,135,65.9,2,0,0
9/24/2017 18:00,58,68.1,76,63.4,134,65.5,2,0,0
9/24/2017 18:05,45,68.5,62,63.8,107,65.8,2,0,0
9/24/2017 18:10,49,69.2,67,64.6,116,66.5,2,0,0
9/24/2017 18:15,46,68.7,64,64.1,110,66,2,0,0
9/24/2017 18:20,59,69,78,64.3,137,66.3,2,0,0
9/24/2017 18:25,48,69.1,66,64.4,114,66.3,2,0,0
9/24/2017 18:30,49,69.1,67,64.5,116,66.5,2,0,0
9/24/2017 18:35,60,68.4,78,63.6,138,65.7,2,0,0
9/24/2017 18:40,49,67.8,67,63.1,116,65.1,2,0,0
9/24/2017 18:45,55,68,74,63.3,129,65.3,2,0,0
9/24/2017 18:50,46,67.5,63,62.8,109,64.8,2,0,0
9/24/2017 18:55,46,68.2,64,63.4,110,65.4,2,0,0
9/24/2017 19:00,48,68.6,65,64,113,65.9,2,0,0
9/24/2017 19:05,46,68.9,63,64.3,109,66.3,2,0,0
9/24/2017 19:10,56,69,75,64.3,131,66.3,2,0,0
9/24/2017 19:15,44,69.1,61,64.4,105,66.4,2,0,0
9/24/2017 19:20,51,69.5,68,64.8,119,66.8,2,0,0
9/24/2017 19:25,49,68.8,68,64.1,117,66.1,2,0,0
9/24/2017 19:30,44,68.8,61,64.2,105,66.1,2,0,0
9/24/2017 19:35,45,68.7,63,63.9,108,65.9,2,0,0
9/24/2017 19:40,48,67.7,66,62.9,114,64.9,2,0,0
9/24/2017 19:45,43,67.8,59,63,102,65,2,0,0
9/24/2017 19:50,44,67.4,61,62.6,105,64.6,2,0,0
9/24/2017 19:55,35,68.4,51,63.6,86,65.6,2,0,0
9/24/2017 20:00,35,68.3,52,63.6,87,65.5,2,0,0
9/24/2017 20:05,33,69,49,64.4,82,66.2,2,0,0
9/24/2017 20:10,35,68.1,51,63.4,86,65.4,2,0,0
9/24/2017 20:15,36,68.1,52,63.4,88,65.4,2,0,0
9/24/2017 20:20,28,68.5,44,63.9,72,65.7,2,0,0
9/24/2017 20:25,30,68.6,46,63.9,76,65.8,2,0,0
9/24/2017 20:30,38,69,55,64.4,93,66.3,2,0,0
9/24/2017 20:35,30,68.8,47,64.1,77,66,2,0,0
9/24/2017 20:40,31,69,48,64.3,79,66.2,2,0,0
9/24/2017 20:45,29,68.8,46,64.1,75,65.9,2,0,0
9/24/2017 20:50,29,67.9,45,63.2,74,65,2,0,0
9/24/2017 20:55,27,68.1,44,63.4,71,65.2,2,0,0
9/24/2017 21:00,27,69.1,42,64.5,69,66.3,2,0,0
9/24/2017 21:05,31,69.2,48,64.6,79,66.4,2,0,0
9/24/2017 21:10,25,68.9,41,64.2,66,66,2,0,0
9/24/2017 21:15,26,69.4,42,64.7,68,66.5,2,0,0
9/24/2017 21:20,24,69.7,39,65.1,63,66.8,2,0,0
9/24/2017 21:25,22,69.1,38,64.5,60,66.2,2,0,0
9/24/2017 21:30,31,69.3,48,64.7,79,66.5,2,0,0
9/24/2017 21:35,22,69.3,38,64.7,60,66.4,2,0,0
9/24/2017 21:40,24,69.2,40,64.6,64,66.3,2,0,0
9/24/2017 21:45,23,69.1,39,64.5,62,66.2,2,0,0
9/24/2017 21:50,23,69.2,39,64.5,62,66.3,2,0,0
9/24/2017 21:55,26,69.1,42,64.5,68,66.3,2,0,0
9/24/2017 22:00,18,69.1,34,64.5,52,66.1,2,0,0
9/24/2017 22:05,24,68.9,40,64.3,64,66,2,0,0
9/24/2017 22:10,21,69.1,37,64.4,58,66.1,2,0,0
9/24/2017 22:15,22,69.1,38,64.5,60,66.2,2,0,0
9/24/2017 22:20,21,68.9,37,64.2,58,65.9,2,0,0
9/24/2017 22:25,15,69.2,31,64.5,46,66.1,2,0,0
9/24/2017 22:30,15,69.3,31,64.7,46,66.2,2,0,0
9/24/2017 22:35,18,69.3,33,64.7,51,66.3,2,0,0
9/24/2017 22:40,19,69.4,34,64.8,53,66.5,2,0,0
9/24/2017 22:45,19,69.2,34,64.6,53,66.3,2,0,0
9/24/2017 22:50,21,69.2,36,64.6,57,66.3,2,0,0
9/24/2017 22:55,21,69.3,36,64.7,57,66.4,2,0,0
9/24/2017 23:00,20,69.1,35,64.5,55,66.1,2,0,0
9/24/2017 23:05,20,69.1,36,64.5,56,66.2,2,0,0
9/24/2017 23:10,16,69.2,31,64.6,47,66.2,2,0,0
9/24/2017 23:15,15,69.2,30,64.6,45,66.2,2,0,0
9/24/2017 23:20,19,69.1,34,64.4,53,66.1,2,0,0
9/24/2017 23:25,15,69.2,30,64.5,45,66.1,2,0,0
9/24/2017 23:30,13,69.3,28,64.7,41,66.1,2,0,0
9/24/2017 23:35,15,69.3,30,64.7,45,66.2,2,0,0
9/24/2017 23:40,16,69.4,32,64.8,48,66.3,2,0,0
9/24/2017 23:45,12,69.4,27,64.8,39,66.3,2,0,0
9/24/2017 23:50,11,69.3,27,64.7,38,66,2,0,0
9/24/2017 23:55,9,69.3,24,64.7,33,66,2,0,0
