5 Minutes,Lane 1 Flow (Veh/5 Minutes),Lane 1 Speed (mph),Lane 2 Flow (Veh/5 Minutes),Lane 2 Speed (mph),Flow (Veh/5 Minutes),Speed (mph),# Lane Points,% Observed,Holiday
11/20/2017 0:00,13,69.3,28,64.7,41,66.2,2,0,0
11/20/2017 0:05,12,69.5,27,64.9,39,66.3,2,0,0
11/20/2017 0:10,13,69.3,29,64.7,42,66.2,2,0,0
11/20/2017 0:15,11,69.2,26,64.6,37,66,2,0,0
11/20/2017 0:20,9,69.3,24,64.7,33,66,2,0,0
11/20/2017 0:25,12,69.4,27,64.8,39,66.2,2,0,0
11/20/2017 0:30,9,69.4,24,64.8,33,66,2,0,0
11/20/2017 0:35,7,69.3,22,64.7,29,65.8,2,0,0
11/20/2017 0:40,8,69.4,23,64.8,31,66,2,0,0
11/20/2017 0:45,8,69.3,23,64.7,31,65.9,2,0,0
11/20/2017 0:50,7,69.3,23,64.7,30,65.8,2,0,0
11/20/2017 0:55,9,69.3,24,64.7,33,66,2,0,0
11/20/2017 1:00,12,69.5,21,64.9,33,66.5,2,0,0
11/20/2017 1:05,8,69,23,64.4,31,65.5,2,0,0
11/20/2017 1:10,6,69.2,21,64.6,27,65.6,2,0,0
11/20/2017 1:15,9,69.3,24,64.7,33,66,2,0,0
11/20/2017 1:20,6,69.4,21,64.8,27,65.8,2,0,0
11/20/2017 1:25,6,69.4,21,64.8,27,65.8,2,0,0
11/20/2017 1:30,5,69.3,20,64.7,25,65.6,2,0,0
11/20/2017 1:35,5,69.3,20,64.7,25,65.6,2,0,0
11/20/2017 1:40,6,69.1,21,64.5,27,65.5,2,0,0
11/20/2017 1:45,8,68.9,23,64.3,31,65.5,2,0,0
11/20/2017 1:50,7,69.2,22,64.5,29,65.7,2,0,0
11/20/2017 1:55,7,69.2,22,64.6,29,65.7,2,0,0
11/20/2017 2:00,5,69.3,21,64.7,26,65.6,2,0,0
11/20/2017 2:05,6,69.3,21,64.7,27,65.7,2,0,0
11/20/2017 2:10,5,69.3,21,64.7,26,65.6,2,0,0
11/20/2017 2:15,8,69.2,24,64.6,32,65.7,2,0,0
11/20/2017 2:20,8,69.3,23,64.7,31,65.9,2,0,0
11/20/2017 2:25,5,69.4,20,64.8,25,65.7,2,0,0
11/20/2017 2:30,7,69.3,22,64.7,29,65.8,2,0,0
11/20/2017 2:35,8,69.3,23,64.7,31,65.9,2,0,0
11/20/2017 2:40,9,69.1,24,64.5,33,65.8,2,0,0
11/20/2017 2:45,7,69.2,22,64.6,29,65.7,2,0,0
11/20/2017 2:50,12,69.2,27,64.6,39,66,2,0,0
11/20/2017 2:55,11,69.3,27,64.7,38,66,2,0,0
11/20/2017 3:00,8,69.3,24,64.7,32,65.9,2,0,0
11/20/2017 3:05,11,69.2,27,64.5,38,65.9,2,0,0
11/20/2017 3:10,10,69.2,25,64.6,35,65.9,2,0,0
11/20/2017 3:15,11,69.3,26,64.7,37,66.1,2,0,0
11/20/2017 3:20,13,69.5,29,64.9,42,66.3,2,0,0
11/20/2017 3:25,10,69.4,26,64.8,36,66.1,2,0,0
11/20/2017 3:30,12,69.5,28,64.9,40,66.3,2,0,0
11/20/2017 3:35,12,69.3,28,64.7,40,66.1,2,0,0
11/20/2017 3:40,15,69.1,30,64.5,45,66.1,2,0,0
11/20/2017 3:45,10,69.3,25,64.7,35,66,2,0,0
11/20/2017 3:50,15,69.4,30,64.8,45,66.4,2,0,0
11/20/2017 3:55,16,69.4,32,64.8,48,66.3,2,0,0
11/20/2017 4:00,18,69.3,34,64.7,52,66.3,2,0,0
11/20/2017 4:05,27,69.7,43,65.1,70,66.8,2,0,0
11/20/2017 4:10,23,69.6,39,65,62,66.7,2,0,0
11/20/2017 4:15,22,69.7,39,65.1,61,66.8,2,0,0
11/20/2017 4:20,23,69,40,64.3,63,66,2,0,0
11/20/2017 4:25,24,69.3,41,64.7,65,66.4,2,0,0
11/20/2017 4:30,25,69.1,41,64.5,66,66.2,2,0,0
11/20/2017 4:35,30,70.1,47,65.5,77,67.3,2,0,0
11/20/2017 4:40,34,69.6,52,65,86,66.8,2,0,0
11/20/2017 4:45,35,68.8,53,64.2,88,66,2,0,0
11/20/2017 4:50,36,69.7,53,65.1,89,67,2,0,0
11/20/2017 4:55,43,69.6,62,65.1,105,66.9,2,0,0
11/20/2017 5:00,43,70.4,61,65.9,104,67.7,2,0,0
11/20/2017 5:05,42,70,60,65.5,102,67.4,2,0,0
11/20/2017 5:10,53,68.8,74,64.1,127,66.1,2,0,0
11/20/2017 5:15,49,66.9,69,62,118,64,2,0,0
11/20/2017 5:20,69,68.7,91,64,160,66,2,0,0
11/20/2017 5:25,59,69.8,80,65.2,139,67.1,2,0,0
11/20/2017 5:30,57,68.9,78,64.3,135,66.2,2,0,0
11/20/2017 5:35,59,68.1,81,63.4,140,65.3,2,0,0
11/20/2017 5:40,69,68.9,92,64.3,161,66.2,2,0,0
11/20/2017 5:45,65,68.9,86,64.4,151,66.3,2,0,0
11/20/2017 5:50,72,67.4,95,62.6,167,64.7,2,0,0
11/20/2017 5:55,59,68,79,63.3,138,65.3,2,0,0
11/20/2017 6:00,59,66.9,80,62,139,64.1,2,0,0
11/20/2017 6:05,62,67.8,83,62.9,145,65,2,0,0
11/20/2017 6:10,68,67.6,90,62.8,158,64.8,2,0,0
11/20/2017 6:15,68,66.4,90,61.5,158,63.6,2,0,0
11/20/2017 6:20,55,67.2,76,62.3,131,64.4,2,0,0
11/20/2017 6:25,71,67.6,93,62.8,164,64.9,2,0,0
11/20/2017 6:30,70,67.4,93,62.6,163,64.7,2,0,0
11/20/2017 6:35,78,66.8,101,61.9,179,64,2,0,0
11/20/2017 6:40,68,66.4,90,61.5,158,63.6,2,0,0
11/20/2017 6:45,72,65.8,94,60.9,166,63,2,0,0
11/20/2017 6:50,74,66.7,97,61.9,171,64,2,0,0
11/20/2017 6:55,68,67.6,89,62.8,157,64.9,2,0,0
11/20/2017 7:00,58,68.1,78,63.3,136,65.3,2,0,0
11/20/2017 7:05,67,67.8,88,63.1,155,65.1,2,0,0
11/20/2017 7:10,77,68.1,100,63.4,177,65.5,2,0,0
11/20/2017 7:15,76,68.4,99,63.6,175,65.7,2,0,0
11/20/2017 7:20,79,69.1,101,64.5,180,66.5,2,0,0
11/20/2017 7:25,77,68.1,99,63.4,176,65.4,2,0,0
11/20/2017 7:30,81,69,104,64.4,185,66.4,2,0,0
11/20/2017 7:35,74,68,97,63.3,171,65.3,2,0,0
11/20/2017 7:40,74,68,95,63.3,169,65.3,2,0,0
11/20/2017 7:45,72,69,94,64.3,166,66.3,2,0,0
11/20/2017 7:50,91,68.9,115,64.2,206,66.3,2,0,0
11/20/2017 7:55,77,69.2,100,64.6,177,66.6,2,0,0
11/20/2017 8:00,66,68.2,87,63.5,153,65.5,2,0,0
11/20/2017 8:05,71,68.3,92,63.6,163,65.6,2,0,0
11/20/2017 8:10,76,68.2,98,63.5,174,65.6,2,0,0
11/20/2017 8:15,77,67.8,100,63.1,177,65.1,2,0,0
11/20/2017 8:20,70,66.6,90,61.8,160,63.9,2,0,0
11/20/2017 8:25,82,66.1,104,61.2,186,63.4,2,0,0
11/20/2017 8:30,73,65,96,59.9,169,62.1,2,0,0
11/20/2017 8:35,69,65.9,90,61,159,63.1,2,0,0
11/20/2017 8:40,79,66.6,101,61.7,180,63.8,2,0,0
11/20/2017 8:45,67,67.1,88,62.2,155,64.3,2,0,0
11/20/2017 8:50,74,66.7,95,61.9,169,64,2,0,0
11/20/2017 8:55,63,66.2,84,61.3,147,63.4,2,0,0
11/20/2017 9:00,70,67.1,91,62.3,161,64.4,2,0,0
11/20/2017 9:05,65,67.8,84,63.1,149,65.2,2,0,0
11/20/2017 9:10,70,67.8,90,63.1,160,65.2,2,0,0
11/20/2017 9:15,61,67.2,80,62.5,141,64.6,2,0,0
11/20/2017 9:20,60,67.8,80,63.1,140,65.1,2,0,0
11/20/2017 9:25,53,67.5,73,62.9,126,64.8,2,0,0
11/20/2017 9:30,67,68.8,86,64.2,153,66.2,2,0,0
11/20/2017 9:35,74,69.3,95,64.7,169,66.7,2,0,0
11/20/2017 9:40,57,69.1,75,64.6,132,66.5,2,0,0
11/20/2017 9:45,61,67.3,81,62.6,142,64.6,2,0,0
11/20/2017 9:50,68,67.4,88,62.6,156,64.7,2,0,0
11/20/2017 9:55,62,67.5,82,62.8,144,64.8,2,0,0
11/20/2017 10:00,62,65.8,81,61,143,63.1,2,0,0
11/20/2017 10:05,64,67.9,83,63.1,147,65.2,2,0,0
11/20/2017 10:10,56,67.4,75,62.6,131,64.7,2,0,0
11/20/2017 10:15,54,66.9,72,62.1,126,64.2,2,0,0
11/20/2017 10:20,62,67.3,81,62.5,143,64.6,2,0,0
11/20/2017 10:25,60,66.6,79,61.8,139,63.9,2,0,0
11/20/2017 10:30,61,67.6,80,62.8,141,64.9,2,0,0
11/20/2017 10:35,61,68.9,79,64.2,140,66.2,2,0,0
11/20/2017 10:40,53,68.3,71,63.7,124,65.7,2,0,0
11/20/2017 10:45,62,67.3,82,62.5,144,64.6,2,0,0
11/20/2017 10:50,60,67.5,80,62.7,140,64.8,2,0,0
11/20/2017 10:55,61,67.6,80,62.9,141,65,2,0,0
11/20/2017 11:00,53,68.2,72,63.5,125,65.5,2,0,0
11/20/2017 11:05,68,69,89,64.5,157,66.5,2,0,0
11/20/2017 11:10,55,69.3,73,64.8,128,66.8,2,0,0
11/20/2017 11:15,54,69.7,72,65.1,126,67.1,2,0,0
11/20/2017 11:20,49,68.9,67,64.3,116,66.2,2,0,0
11/20/2017 11:25,62,67.5,81,62.8,143,64.8,2,0,0
11/20/2017 11:30,61,66.1,81,61.3,142,63.3,2,0,0
11/20/2017 11:35,58,66.8,78,62,136,64,2,0,0
11/20/2017 11:40,50,67.9,67,63.2,117,65.2,2,0,0
11/20/2017 11:45,52,65.7,71,60.8,123,62.8,2,0,0
11/20/2017 11:50,48,66.3,66,61.5,114,63.5,2,0,0
11/20/2017 11:55,53,66.5,71,61.7,124,63.7,2,0,0
11/20/2017 12:00,50,68.3,68,63.7,118,65.6,2,0,0
11/20/2017 12:05,52,67.9,70,63.2,122,65.2,2,0,0
11/20/2017 12:10,57,67.9,76,63.1,133,65.2,2,0,0
11/20/2017 12:15,49,69.5,67,64.8,116,66.8,2,0,0
11/20/2017 12:20,52,69.7,70,65,122,67,2,0,0
11/20/2017 12:25,61,68.3,80,63.6,141,65.6,2,0,0
11/20/2017 12:30,58,69.1,75,64.4,133,66.4,2,0,0
11/20/2017 12:35,63,69.5,82,64.9,145,66.9,2,0,0
11/20/2017 12:40,49,70.5,66,66,115,67.9,2,0,0
11/20/2017 12:45,56,69.7,74,65.1,130,67.1,2,0,0
11/20/2017 12:50,47,69.8,66,65.2,113,67.1,2,0,0
11/20/2017 12:55,49,70.6,67,66,116,68,2,0,0
11/20/2017 13:00,56,69.9,73,65.3,129,67.3,2,0,0
11/20/2017 13:05,55,69.6,73,65,128,67,2,0,0
11/20/2017 13:10,51,69.4,70,64.8,121,66.8,2,0,0
11/20/2017 13:15,54,69.8,72,65.2,126,67.2,2,0,0
11/20/2017 13:20,60,69.8,78,65.2,138,67.2,2,0,0
11/20/2017 13:25,57,70,75,65.5,132,67.4,2,0,0
11/20/2017 13:30,51,70.2,69,65.7,120,67.6,2,0,0
11/20/2017 13:35,50,69.2,68,64.6,118,66.6,2,0,0
11/20/2017 13:40,44,70.4,61,65.9,105,67.8,2,0,0
11/20/2017 13:45,48,69.8,65,65.3,113,67.2,2,0,0
11/20/2017 13:50,49,70.4,66,65.9,115,67.8,2,0,0
11/20/2017 13:55,42,70.3,60,65.7,102,67.6,2,0,0
11/20/2017 14:00,51,70.4,69,65.8,120,67.8,2,0,0
11/20/2017 14:05,43,69.7,61,65.1,104,67,2,0,0
11/20/2017 14:10,56,69.3,74,64.8,130,66.7,2,0,0
11/20/2017 14:15,47,69.8,64,65.2,111,67.2,2,0,0
11/20/2017 14:20,54,69.3,72,64.7,126,66.7,2,0,0
11/20/2017 14:25,55,69.6,72,64.9,127,66.9,2,0,0
11/20/2017 14:30,54,70.8,73,66.4,127,68.2,2,0,0
11/20/2017 14:35,50,69.6,68,65.1,118,67,2,0,0
11/20/2017 14:40,54,68.2,72,63.6,126,65.6,2,0,0
11/20/2017 14:45,54,68.4,72,63.8,126,65.8,2,0,0
11/20/2017 14:50,50,68.6,68,63.9,118,65.9,2,0,0
11/20/2017 14:55,38,70.1,55,65.5,93,67.4,2,0,0
11/20/2017 15:00,52,68.7,70,64.1,122,66,2,0,0
11/20/2017 15:05,52,68.6,70,63.9,122,65.9,2,0,0
11/20/2017 15:10,53,67.6,72,62.9,125,64.9,2,0,0
11/20/2017 15:15,51,69.1,68,64.5,119,66.5,2,0,0
11/20/2017 15:20,54,67.8,72,63.2,126,65.2,2,0,0
11/20/2017 15:25,61,67.2,80,62.4,141,64.5,2,0,0
11/20/2017 15:30,55,68.3,74,63.7,129,65.6,2,0,0
11/20/2017 15:35,50,68.3,68,63.6,118,65.6,2,0,0
11/20/2017 15:40,53,67.9,72,63.2,125,65.2,2,0,0
11/20/2017 15:45,60,68.1,80,63.4,140,65.4,2,0,0
11/20/2017 15:50,61,67.5,80,62.8,141,64.8,2,0,0
11/20/2017 15:55,54,67.7,72,63,126,65,2,0,0
11/20/2017 16:00,42,68.3,60,63.6,102,65.5,2,0,0
11/20/2017 16:05,51,68.1,69,63.5,120,65.4,2,0,0
11/20/2017 16:10,52,68.5,70,63.9,122,65.8,2,0,0
11/20/2017 16:15,62,68.6,81,63.9,143,65.9,2,0,0
11/20/2017 16:20,66,69.3,85,64.7,151,66.7,2,0,0
11/20/2017 16:25,51,68.1,69,63.5,120,65.5,2,0,0
11/20/2017 16:30,61,67.6,80,62.9,141,64.9,2,0,0
11/20/2017 16:35,57,68.4,75,63.7,132,65.7,2,0,0
11/20/2017 16:40,53,68.3,71,63.6,124,65.6,2,0,0
11/20/2017 16:45,58,69.1,77,64.4,135,66.4,2,0,0
11/20/2017 16:50,55,68.7,73,64,128,66,2,0,0
11/20/2017 16:55,61,67.8,81,63.1,142,65.1,2,0,0
11/20/2017 17:00,50,68.8,68,64.1,118,66.1,2,0,0
11/20/2017 17:05,55,68.5,73,63.8,128,65.8,2,0,0
11/20/2017 17:10,51,68.7,69,64,120,66,2,0,0
11/20/2017 17:15,62,67.9,82,63.1,144,65.2,2,0,0
11/20/2017 17:20,61,67.9,80,63.1,141,65.2,2,0,0
11/20/2017 17:25,58,68.4,76,63.7,134,65.8,2,0,0
11/20/2017 17:30,55,68.5,73,63.8,128,65.8,2,0,0
11/20/2017 17:35,46,68.5,63,63.8,109,65.8,2,0,0
11/20/2017 17:40,46,68.9,63,64.3,109,66.2,2,0,0
11/20/2017 17:45,49,69.1,67,64.4,116,66.4,2,0,0
11/20/2017 17:50,50,68.4,68,63.6,118,65.6,2,0,0
11/20/2017 17:55,48,68.6,65,63.8,113,65.8,2,0,0
11/20/2017 18:00,48,68.7,66,64,114,66,2,0,0
11/20/2017 18:05,45,68.4,62,63.7,107,65.7,2,0,0
11/20/2017 18:10,54,68.9,71,64.3,125,66.3,2,0,0
11/20/2017 18:15,47,69.3,64,64.7,111,66.6,2,0,0
11/20/2017 18:20,47,69,64,64.4,111,66.4,2,0,0
11/20/2017 18:25,50,68.5,68,63.8,118,65.8,2,0,0
11/20/2017 18:30,46,69.4,64,64.7,110,66.7,2,0,0
11/20/2017 18:35,44,69.7,60,65.1,104,67,2,0,0
11/20/2017 18:40,41,70.3,57,65.8,98,67.6,2,0,0
11/20/2017 18:45,42,69.6,60,65,102,66.9,2,0,0
11/20/2017 18:50,43,69.5,59,64.9,102,66.8,2,0,0
11/20/2017 18:55,41,69.8,58,65.2,99,67.1,2,0,0
11/20/2017 19:00,42,70.1,59,65.6,101,67.4,2,0,0
11/20/2017 19:05,50,69.9,67,65.4,117,67.3,2,0,0
11/20/2017 19:10,47,70.1,65,65.6,112,67.5,2,0,0
11/20/2017 19:15,45,68.9,62,64.2,107,66.2,2,0,0
11/20/2017 19:20,48,69.2,66,64.6,114,66.5,2,0,0
11/20/2017 19:25,43,68.9,61,64.3,104,66.2,2,0,0
11/20/2017 19:30,38,69.6,54,65,92,66.9,2,0,0
11/20/2017 19:35,36,69.9,53,65.4,89,67.2,2,0,0
11/20/2017 19:40,41,70.9,58,66.4,99,68.2,2,0,0
11/20/2017 19:45,32,70.2,48,65.7,80,67.5,2,0,0
11/20/2017 19:50,32,70,48,65.4,80,67.2,2,0,0
11/20/2017 19:55,30,70.7,46,66.2,76,67.9,2,0,0
11/20/2017 20:00,27,69.4,44,64.8,71,66.5,2,0,0
11/20/2017 20:05,34,68.7,50,64.1,84,66,2,0,0
11/20/2017 20:10,32,69.2,49,64.6,81,66.4,2,0,0
11/20/2017 20:15,37,69.2,54,64.6,91,66.5,2,0,0
11/20/2017 20:20,36,69,53,64.3,89,66.2,2,0,0
11/20/2017 20:25,27,69.5,44,65,71,66.7,2,0,0
11/20/2017 20:30,33,69.9,49,65.4,82,67.2,2,0,0
11/20/2017 20:35,29,69.6,44,65,73,66.8,2,0,0
11/20/2017 20:40,35,69.8,51,65.3,86,67.1,2,0,0
11/20/2017 20:45,32,69.5,48,64.9,80,66.8,2,0,0
11/20/2017 20:50,34,69.6,50,65,84,66.9,2,0,0
11/20/2017 20:55,29,69.4,45,64.8,74,66.6,2,0,0
11/20/2017 21:00,35,68.9,51,64.3,86,66.2,2,0,0
11/20/2017 21:05,33,68.2,49,63.5,82,65.4,2,0,0
11/20/2017 21:10,31,68.4,48,63.7,79,65.5,2,0,0
11/20/2017 21:15,22,68.6,38,64,60,65.7,2,0,0
11/20/2017 21:20,20,68.9,37,64.3,57,65.9,2,0,0
11/20/2017 21:25,23,69.4,40,64.8,63,66.4,2,0,0
11/20/2017 21:30,29,69.6,46,65,75,66.8,2,0,0
11/20/2017 21:35,23,69.6,40,65,63,66.7,2,0,0
11/20/2017 21:40,17,69.6,33,65,50,66.6,2,0,0
11/20/2017 21:45,17,69.5,33,64.9,50,66.5,2,0,0
11/20/2017 21:50,20,69.5,36,64.9,56,66.5,2,0,0
11/20/2017 21:55,20,69.6,35,65,55,66.7,2,0,0
11/20/2017 22:00,22,68.4,37,63.8,59,65.5,2,0,0
11/20/2017 22:05,23,69,39,64.4,62,66.1,2,0,0
11/20/2017 22:10,22,69,38,64.4,60,66.1,2,0,0
11/20/2017 22:15,21,69,36,64.4,57,66.1,2,0,0
11/20/2017 22:20,21,69.2,36,64.6,57,66.3,2,0,0
11/20/2017 22:25,16,69.1,32,64.5,48,66,2,0,0
11/20/2017 22:30,22,68.3,37,63.7,59,65.4,2,0,0
11/20/2017 22:35,20,68.9,36,64.3,56,65.9,2,0,0
11/20/2017 22:40,22,69.1,38,64.5,60,66.2,2,0,0
11/20/2017 22:45,21,69.5,36,64.9,57,66.6,2,0,0
11/20/2017 22:50,20,69.3,37,64.7,57,66.3,2,0,0
11/20/2017 22:55,19,69.4,35,64.8,54,66.4,2,0,0
11/20/2017 23:00,22,69.4,37,64.7,59,66.5,2,0,0
11/20/2017 23:05,19,69.2,35,64.6,54,66.2,2,0,0
11/20/2017 23:10,16,69.3,31,64.7,47,66.3,2,0,0
11/20/2017 23:15,16,69.3,32,64.7,48,66.3,2,0,0
11/20/2017 23:20,17,69.4,32,64.8,49,66.4,2,0,0
11/20/2017 23:25,13,69.4,28,64.8,41,66.3,2,0,0
11/20/2017 23:30,16,69.4,31,64.8,47,66.3,2,0,0
11/20/2017 23:35,14,69.3,29,64.7,43,66.2,2,0,0
11/20/2017 23:40,19,68.6,34,63.9,53,65.6,2,0,0
11/20/2017 23:45,13,68.4,29,63.8,42,65.2,2,0,0
11/20/2017 23:50,17,69.1,32,64.4,49,66,2,0,0
11/20/2017 23:55,11,69.2,26,64.6,37,66,2,0,0
11/21/2017 0:00,16,69.3,31,64.7,47,66.3,2,0,0
11/21/2017 0:05,17,69.2,33,64.6,50,66.2,2,0,0
11/21/2017 0:10,12,69.3,27,64.7,39,66.1,2,0,0
11/21/2017 0:15,9,69.3,24,64.7,33,66,2,0,0
11/21/2017 0:20,11,69.1,26,64.5,37,65.8,2,0,0
11/21/2017 0:25,10,69.2,25,64.6,35,65.9,2,0,0
11/21/2017 0:30,10,69.1,25,64.5,35,65.8,2,0,0
11/21/2017 0:35,9,69.2,24,64.5,33,65.8,2,0,0
11/21/2017 0:40,9,69.2,24,64.5,33,65.8,2,0,0
11/21/2017 0:45,7,69.3,22,64.7,29,65.8,2,0,0
11/21/2017 0:50,6,69.3,22,64.7,28,65.6,2,0,0
11/21/2017 0:55,7,69.3,22,64.7,29,65.8,2,0,0
11/21/2017 1:00,7,69.3,22,64.7,29,65.8,2,0,0
11/21/2017 1:05,9,69.3,24,64.7,33,66,2,0,0
11/21/2017 1:10,8,69.3,23,64.7,31,65.9,2,0,0
11/21/2017 1:15,8,69.3,23,64.7,31,65.9,2,0,0
11/21/2017 1:20,6,69.2,21,64.5,27,65.6,2,0,0
11/21/2017 1:25,6,69.3,21,64.7,27,65.8,2,0,0
11/21/2017 1:30,7,69.2,22,64.6,29,65.7,2,0,0
11/21/2017 1:35,9,69.1,25,64.5,34,65.7,2,0,0
11/21/2017 1:40,6,69.2,21,64.6,27,65.6,2,0,0
11/21/2017 1:45,5,69.2,20,64.5,25,65.5,2,0,0
11/21/2017 1:50,12,69.3,21,64.7,33,66.3,2,0,0
11/21/2017 1:55,7,69.3,22,64.7,29,65.8,2,0,0
11/21/2017 2:00,7,69.4,22,64.8,29,65.9,2,0,0
11/21/2017 2:05,6,69.4,21,64.7,27,65.8,2,0,0
11/21/2017 2:10,5,69.3,21,64.7,26,65.6,2,0,0
11/21/2017 2:15,6,69.3,21,64.7,27,65.8,2,0,0
11/21/2017 2:20,8,69.3,23,64.7,31,65.9,2,0,0
11/21/2017 2:25,7,69.2,22,64.5,29,65.7,2,0,0
11/21/2017 2:30,9,69.1,24,64.5,33,65.7,2,0,0
11/21/2017 2:35,7,69.1,23,64.5,30,65.5,2,0,0
11/21/2017 2:40,10,69.2,25,64.6,35,65.9,2,0,0
11/21/2017 2:45,10,69.3,26,64.7,36,66,2,0,0
11/21/2017 2:50,8,69.5,24,64.9,32,66,2,0,0
11/21/2017 2:55,11,69.3,26,64.7,37,66,2,0,0
11/21/2017 3:00,10,69.4,26,64.8,36,66.1,2,0,0
11/21/2017 3:05,4,70.1,3,64.1,7,67.5,2,0,0
11/21/2017 3:10,4,70,3,64,7,67.4,2,0,0
11/21/2017 3:15,4,70.1,3,64.1,7,67.5,2,0,0
11/21/2017 3:20,4,70.2,3,64.2,7,67.6,2,0,0
11/21/2017 3:25,4,69.9,4,63.9,8,66.9,2,0,0
11/21/2017 3:30,4,69.7,4,63.7,8,66.7,2,0,0
11/21/2017 3:35,5,69.9,4,63.9,9,67.2,2,0,0
11/21/2017 3:40,5,70.2,5,64.2,10,67.2,2,0,0
11/21/2017 3:45,5,70,5,64,10,67,2,0,0
11/21/2017 3:50,6,69.8,5,63.8,11,67.1,2,0,0
11/21/2017 3:55,5,70,5,64,10,67,2,0,0
11/21/2017 4:00,5,69.8,5,63.8,10,66.8,2,0,0
11/21/2017 4:05,6,69.8,5,63.8,11,67.1,2,0,0
11/21/2017 4:10,6,70,6,64,12,67,2,0,0
11/21/2017 4:15,6,69.8,6,63.8,12,66.8,2,0,0
11/21/2017 4:20,8,70.1,8,64.1,16,67.1,2,0,0
11/21/2017 4:25,8,70,8,64,16,67,2,0,0
11/21/2017 4:30,9,70.1,9,64.1,18,67.1,2,0,0
11/21/2017 4:35,11,70.2,10,64.2,21,67.3,2,0,0
11/21/2017 4:40,13,70.2,11,64.2,24,67.5,2,0,0
11/21/2017 4:45,14,70.3,12,64.3,26,67.5,2,0,0
11/21/2017 4:50,15,70.4,13,64.4,28,67.6,2,0,0
11/21/2017 4:55,15,70.2,13,64.2,28,67.4,2,0,0
11/21/2017 5:00,16,70.2,15,64.2,31,67.3,2,0,0
11/21/2017 5:05,18,70.3,16,64.3,34,67.5,2,0,0
11/21/2017 5:10,21,70.3,19,64.3,40,67.5,2,0,0
11/21/2017 5:15,24,70.4,21,64.4,45,67.6,2,0,0
11/21/2017 5:20,26,70.5,23,64.5,49,67.7,2,0,0
11/21/2017 5:25,27,70.4,25,64.4,52,67.5,2,0,0
11/21/2017 5:30,31,70.6,27,64.6,58,67.8,2,0,0
11/21/2017 5:35,33,70.8,30,64.8,63,67.9,2,0,0
11/21/2017 5:40,36,70.8,32,64.8,68,68,2,0,0
11/21/2017 5:45,40,70.9,36,64.9,76,68.1,2,0,0
11/21/2017 5:50,42,70.8,37,64.8,79,68,2,0,0
11/21/2017 5:55,41,70.7,36,64.7,77,67.9,2,0,0
11/21/2017 6:00,40,70.3,35,64.3,75,67.5,2,0,0
11/21/2017 6:05,42,70,37,64,79,67.2,2,0,0
11/21/2017 6:10,45,69.8,40,63.8,85,67,2,0,0
11/21/2017 6:15,47,69.7,43,63.7,90,66.8,2,0,0
11/21/2017 6:20,48,69.5,44,63.5,92,66.6,2,0,0
11/21/2017 6:25,53,69.4,47,63.4,100,66.6,2,0,0
11/21/2017 6:30,54,69.4,48,63.4,102,66.6,2,0,0
11/21/2017 6:35,58,69.3,52,63.3,110,66.5,2,0,0
11/21/2017 6:40,63,69.2,56,63.2,119,66.4,2,0,0
11/21/2017 6:45,65,69.1,58,63.1,123,66.3,2,0,0
11/21/2017 6:50,65,69.2,59,63.2,124,66.3,2,0,0
11/21/2017 6:55,64,69.3,58,63.3,122,66.4,2,0,0
11/21/2017 7:00,65,69,58,63,123,66.2,2,0,0
11/21/2017 7:05,67,68.9,61,62.9,128,66,2,0,0
11/21/2017 7:10,72,68.9,64,62.9,136,66.1,2,0,0
11/21/2017 7:15,79,69.1,70,63.1,149,66.3,2,0,0
11/21/2017 7:20,81,69.1,72,63.1,153,66.3,2,0,0
11/21/2017 7:25,87,68.9,78,62.9,165,66.1,2,0,0
11/21/2017 7:30,87,68.9,78,62.9,165,66.1,2,0,0
11/21/2017 7:35,90,69,80,63,170,66.2,2,0,0
11/21/2017 7:40,94,69,84,63,178,66.2,2,0,0
11/21/2017 7:45,92,68.9,83,62.9,175,66.1,2,0,0
11/21/2017 7:50,90,69,81,63,171,66.2,2,0,0
11/21/2017 7:55,91,68.9,81,62.9,172,66.1,2,0,0
11/21/2017 8:00,89,69,79,63,168,66.2,2,0,0
11/21/2017 8:05,89,68.6,79,62.8,168,65.9,2,0,0
11/21/2017 8:10,79,66.9,103,61.9,182,64.1,2,0,0
11/21/2017 8:15,78,66.4,101,61.4,179,63.5,2,0,0
11/21/2017 8:20,79,67.2,100,62.3,179,64.4,2,0,0
11/21/2017 8:25,79,66,101,61,180,63.2,2,0,0
11/21/2017 8:30,83,66.1,106,61.1,189,63.3,2,0,0
11/21/2017 8:35,75,66.4,96,61.4,171,63.6,2,0,0
11/21/2017 8:40,81,65.1,103,60.1,184,62.3,2,0,0
11/21/2017 8:45,82,65.5,105,60.5,187,62.7,2,0,0
11/21/2017 8:50,79,65.5,99,60.5,178,62.7,2,0,0
11/21/2017 8:55,74,65.3,96,60.3,170,62.5,2,0,0
11/21/2017 9:00,81,66.2,103,61.2,184,63.4,2,0,0
11/21/2017 9:05,67,66.6,87,61.7,154,63.9,2,0,0
11/21/2017 9:10,78,65.7,101,60.8,179,62.9,2,0,0
11/21/2017 9:15,76,64.4,98,59.3,174,61.5,2,0,0
11/21/2017 9:20,70,63.6,90,58.5,160,60.7,2,0,0
11/21/2017 9:25,59,65.6,78,60.7,137,62.8,2,0,0
11/21/2017 9:30,69,66.4,88,61.5,157,63.6,2,0,0
11/21/2017 9:35,66,66.1,86,61.1,152,63.3,2,0,0
11/21/2017 9:40,70,64.8,90,59.7,160,61.9,2,0,0
11/21/2017 9:45,70,65.6,91,60.5,161,62.7,2,0,0
11/21/2017 9:50,69,66,89,61,158,63.2,2,0,0
11/21/2017 9:55,68,66.2,87,61.2,155,63.4,2,0,0
11/21/2017 10:00,66,66.9,86,62,152,64.1,2,0,0
11/21/2017 10:05,70,66.8,91,61.9,161,64,2,0,0
11/21/2017 10:10,72,66.8,93,61.9,165,64,2,0,0
11/21/2017 10:15,67,66,87,61.1,154,63.2,2,0,0
11/21/2017 10:20,71,67.4,91,62.7,162,64.7,2,0,0
11/21/2017 10:25,81,67.2,103,62.4,184,64.5,2,0,0
11/21/2017 10:30,64,67.2,83,62.4,147,64.5,2,0,0
11/21/2017 10:35,70,67.1,91,62.4,161,64.5,2,0,0
11/21/2017 10:40,58,68.6,77,64,135,66,2,0,0
11/21/2017 10:45,70,67.8,90,63.1,160,65.2,2,0,0
11/21/2017 10:50,67,67.2,87,62.5,154,64.6,2,0,0
11/21/2017 10:55,57,68.6,75,64,132,66,2,0,0
11/21/2017 11:00,59,67.7,77,63,136,65,2,0,0
11/21/2017 11:05,55,67.1,74,62.2,129,64.3,2,0,0
11/21/2017 11:10,62,66.7,81,61.8,143,63.9,2,0,0
11/21/2017 11:15,65,66.7,84,61.8,149,63.9,2,0,0
11/21/2017 11:20,66,66.8,86,61.9,152,64,2,0,0
11/21/2017 11:25,61,65.9,81,60.9,142,63.1,2,0,0
11/21/2017 11:30,69,67.5,89,62.7,158,64.8,2,0,0
11/21/2017 11:35,63,67.9,83,63.1,146,65.2,2,0,0
11/21/2017 11:40,73,67.7,92,63,165,65.1,2,0,0
11/21/2017 11:45,68,67.1,88,62.3,156,64.4,2,0,0
11/21/2017 11:50,55,66.9,73,62.1,128,64.1,2,0,0
11/21/2017 11:55,55,68.7,73,64,128,66,2,0,0
11/21/2017 12:00,58,68.7,77,64.1,135,66.1,2,0,0
11/21/2017 12:05,55,68.9,74,64.3,129,66.3,2,0,0
11/21/2017 12:10,65,69.5,85,64.9,150,66.9,2,0,0
11/21/2017 12:15,54,69.3,73,64.7,127,66.7,2,0,0
11/21/2017 12:20,64,68.2,83,63.5,147,65.6,2,0,0
11/21/2017 12:25,61,68.8,81,64.2,142,66.2,2,0,0
11/21/2017 12:30,56,69.4,74,64.8,130,66.8,2,0,0
11/21/2017 12:35,67,70.4,86,65.9,153,67.9,2,0,0
11/21/2017 12:40,64,69.9,84,65.3,148,67.3,2,0,0
11/21/2017 12:45,59,70.3,78,65.7,137,67.7,2,0,0
11/21/2017 12:50,54,70.2,72,65.6,126,67.5,2,0,0
11/21/2017 12:55,60,69.3,79,64.7,139,66.7,2,0,0
11/21/2017 13:00,59,68.8,77,64.1,136,66.2,2,0,0
11/21/2017 13:05,57,69.7,76,65.1,133,67,2,0,0
11/21/2017 13:10,68,69.2,89,64.6,157,66.6,2,0,0
11/21/2017 13:15,61,68.8,81,64.1,142,66.1,2,0,0
11/21/2017 13:20,60,68.1,79,63.3,139,65.4,2,0,0
11/21/2017 13:25,55,67.4,73,62.5,128,64.6,2,0,0
11/21/2017 13:30,65,67.2,84,62.4,149,64.5,2,0,0
11/21/2017 13:35,63,67.5,82,62.7,145,64.8,2,0,0
11/21/2017 13:40,58,67.3,78,62.5,136,64.5,2,0,0
11/21/2017 13:45,52,68.7,71,64,123,66,2,0,0
11/21/2017 13:50,49,69,67,64.3,116,66.3,2,0,0
11/21/2017 13:55,54,67.7,73,62.9,127,64.9,2,0,0
11/21/2017 14:00,51,68.8,69,64.2,120,66.2,2,0,0
11/21/2017 14:05,47,68.8,64,64.1,111,66.1,2,0,0
11/21/2017 14:10,52,69.1,70,64.4,122,66.4,2,0,0
11/21/2017 14:15,61,68.1,79,63.4,140,65.4,2,0,0
11/21/2017 14:20,56,68.5,74,63.9,130,65.9,2,0,0
11/21/2017 14:25,62,68.9,82,64.3,144,66.3,2,0,0
11/21/2017 14:30,64,68.3,82,63.7,146,65.7,2,0,0
11/21/2017 14:35,59,69,77,64.5,136,66.4,2,0,0
11/21/2017 14:40,62,68.2,81,63.6,143,65.6,2,0,0
11/21/2017 14:45,62,69.6,81,65.1,143,67,2,0,0
11/21/2017 14:50,57,69.6,76,65,133,66.9,2,0,0
11/21/2017 14:55,62,69.1,80,64.4,142,66.5,2,0,0
11/21/2017 15:00,59,69.6,78,65,137,67,2,0,0
11/21/2017 15:05,56,69.5,75,64.9,131,66.9,2,0,0
11/21/2017 15:10,51,68.2,70,63.5,121,65.5,2,0,0
11/21/2017 15:15,63,68.9,82,64.3,145,66.3,2,0,0
11/21/2017 15:20,63,69.1,83,64.5,146,66.5,2,0,0
11/21/2017 15:25,67,69.3,86,64.6,153,66.7,2,0,0
11/21/2017 15:30,74,67.6,96,62.8,170,64.9,2,0,0
11/21/2017 15:35,69,68.6,88,63.9,157,66,2,0,0
11/21/2017 15:40,58,69,77,64.3,135,66.3,2,0,0
11/21/2017 15:45,70,69.2,90,64.6,160,66.6,2,0,0
11/21/2017 15:50,70,65.3,90,60.3,160,62.5,2,0,0
11/21/2017 15:55,69,64.6,88,59.5,157,61.7,2,0,0
11/21/2017 16:00,54,58,73,52.1,127,54.6,2,0,0
11/21/2017 16:05,53,61.3,71,55.8,124,58.2,2,0,0
11/21/2017 16:10,56,65,74,59.9,130,62.1,2,0,0
11/21/2017 16:15,56,67.6,75,62.8,131,64.8,2,0,0
11/21/2017 16:20,57,68.6,76,63.8,133,65.9,2,0,0
11/21/2017 16:25,56,68.9,74,64.2,130,66.2,2,0,0
11/21/2017 16:30,63,67.8,82,63.1,145,65.1,2,0,0
11/21/2017 16:35,60,67.3,79,62.4,139,64.5,2,0,0
11/21/2017 16:40,60,66.1,80,61.2,140,63.3,2,0,0
11/21/2017 16:45,58,64.9,77,59.8,135,62,2,0,0
11/21/2017 16:50,49,64.2,67,59,116,61.2,2,0,0
11/21/2017 16:55,67,66,86,61,153,63.2,2,0,0
11/21/2017 17:00,53,66.2,71,61.2,124,63.4,2,0,0
11/21/2017 17:05,50,65.8,68,60.8,118,62.9,2,0,0
11/21/2017 17:10,53,65.6,72,60.5,125,62.6,2,0,0
11/21/2017 17:15,51,60,70,54.2,121,56.6,2,0,0
11/21/2017 17:20,42,58,60,52.1,102,54.5,2,0,0
11/21/2017 17:25,51,53.4,71,47,122,49.7,2,0,0
11/21/2017 17:30,52,51.2,70,44.5,122,47.4,2,0,0
11/21/2017 17:35,49,48.7,68,41.7,117,44.6,2,0,0
11/21/2017 17:40,45,48.6,63,41.6,108,44.5,2,0,0
11/21/2017 17:45,44,49.8,62,42.9,106,45.8,2,0,0
11/21/2017 17:50,44,52.9,63,46.5,107,49.1,2,0,0
11/21/2017 17:55,51,57.1,69,51.1,120,53.6,2,0,0
11/21/2017 18:00,54,58.1,72,52.2,126,54.7,2,0,0
11/21/2017 18:05,51,58,69,52.1,120,54.6,2,0,0
11/21/2017 18:10,50,60.6,69,55.1,119,57.4,2,0,0
11/21/2017 18:15,49,59.3,68,53.5,117,55.9,2,0,0
11/21/2017 18:20,47,59.4,65,53.7,112,56.1,2,0,0
11/21/2017 18:25,53,63.2,70,57.9,123,60.2,2,0,0
11/21/2017 18:30,49,64.2,67,59,116,61.2,2,0,0
11/21/2017 18:35,50,64.7,68,59.6,118,61.8,2,0,0
11/21/2017 18:40,51,64.6,69,59.5,120,61.7,2,0,0
11/21/2017 18:45,48,66,66,61,114,63.1,2,0,0
11/21/2017 18:50,51,67.4,69,62.5,120,64.6,2,0,0
11/21/2017 18:55,50,68.3,68,63.6,118,65.6,2,0,0
11/21/2017 19:00,54,69.6,72,65,126,66.9,2,0,0
11/21/2017 19:05,51,69.8,69,65.2,120,67.1,2,0,0
11/21/2017 19:10,48,68.4,67,63.6,115,65.6,2,0,0
11/21/2017 19:15,60,69.1,78,64.4,138,66.5,2,0,0
11/21/2017 19:20,46,69.3,64,64.7,110,66.6,2,0,0
11/21/2017 19:25,46,69.3,64,64.6,110,66.6,2,0,0
11/21/2017 19:30,42,69,59,64.4,101,66.3,2,0,0
11/21/2017 19:35,41,69.2,59,64.6,100,66.5,2,0,0
11/21/2017 19:40,44,69.3,61,64.7,105,66.6,2,0,0
11/21/2017 19:45,41,70.3,58,65.7,99,67.6,2,0,0
11/21/2017 19:50,42,70.3,59,65.8,101,67.7,2,0,0
11/21/2017 19:55,40,69.9,57,65.4,97,67.2,2,0,0
11/21/2017 20:00,43,69.3,61,64.7,104,66.6,2,0,0
11/21/2017 20:05,41,69.4,58,64.8,99,66.7,2,0,0
11/21/2017 20:10,36,69.3,54,64.7,90,66.5,2,0,0
11/21/2017 20:15,39,69.2,56,64.6,95,66.5,2,0,0
11/21/2017 20:20,44,69.2,62,64.5,106,66.4,2,0,0
11/21/2017 20:25,36,69.2,53,64.6,89,66.4,2,0,0
11/21/2017 20:30,42,68.5,59,63.9,101,65.8,2,0,0
11/21/2017 20:35,34,69.2,51,64.6,85,66.4,2,0,0
11/21/2017 20:40,38,69.1,55,64.5,93,66.4,2,0,0
11/21/2017 20:45,41,69.3,58,64.7,99,66.6,2,0,0
11/21/2017 20:50,43,69.5,59,64.9,102,66.8,2,0,0
11/21/2017 20:55,41,68.9,58,64.2,99,66.2,2,0,0
11/21/2017 21:00,32,68.2,49,63.5,81,65.3,2,0,0
11/21/2017 21:05,33,68.4,49,63.7,82,65.6,2,0,0
11/21/2017 21:10,29,68.6,45,63.9,74,65.8,2,0,0
11/21/2017 21:15,32,67.3,48,62.5,80,64.4,2,0,0
11/21/2017 21:20,33,68,49,63.3,82,65.2,2,0,0
11/21/2017 21:25,37,67.6,55,62.9,92,64.8,2,0,0
11/21/2017 21:30,33,68.1,50,63.4,83,65.3,2,0,0
11/21/2017 21:35,30,68.7,47,64.1,77,65.9,2,0,0
11/21/2017 21:40,30,68.9,47,64.2,77,66,2,0,0
11/21/2017 21:45,24,69.3,41,64.6,65,66.3,2,0,0
11/21/2017 21:50,29,68.6,45,64,74,65.8,2,0,0
11/21/2017 21:55,24,68.5,41,63.8,65,65.5,2,0,0
11/21/2017 22:00,15,68.7,31,64.1,46,65.6,2,0,0
11/21/2017 22:05,22,69,38,64.4,60,66.1,2,0,0
11/21/2017 22:10,24,69,40,64.4,64,66.1,2,0,0
11/21/2017 22:15,24,69.2,39,64.6,63,66.4,2,0,0
11/21/2017 22:20,29,69,45,64.4,74,66.2,2,0,0
11/21/2017 22:25,28,69.5,44,64.9,72,66.6,2,0,0
11/21/2017 22:30,28,68.7,44,64.1,72,65.9,2,0,0
11/21/2017 22:35,23,68.8,40,64.2,63,65.9,2,0,0
11/21/2017 22:40,19,68.9,34,64.2,53,65.9,2,0,0
11/21/2017 22:45,22,69,38,64.4,60,66,2,0,0
11/21/2017 22:50,22,69.3,38,64.7,60,66.4,2,0,0
11/21/2017 22:55,18,69.3,34,64.7,52,66.3,2,0,0
11/21/2017 23:00,22,69,37,64.4,59,66.1,2,0,0
11/21/2017 23:05,24,69.4,39,64.8,63,66.5,2,0,0
11/21/2017 23:10,23,68.7,39,64,62,65.7,2,0,0
11/21/2017 23:15,17,69.2,32,64.5,49,66.1,2,0,0
11/21/2017 23:20,14,69.2,29,64.6,43,66.1,2,0,0
11/21/2017 23:25,13,69.2,29,64.6,42,66,2,0,0
11/21/2017 23:30,17,69.2,33,64.6,50,66.2,2,0,0
11/21/2017 23:35,17,69.2,34,64.6,51,66.1,2,0,0
11/21/2017 23:40,21,69.4,37,64.8,58,66.4,2,0,0
11/21/2017 23:45,14,69.4,30,64.8,44,66.3,2,0,0
11/21/2017 23:50,17,69.4,33,64.8,50,66.4,2,0,0
11/21/2017 23:55,15,69.4,30,64.8,45,66.3,2,0,0
11/22/2017 0:00,14,69.3,29,64.7,43,66.2,2,0,0
11/22/2017 0:05,18,69.4,34,64.8,52,66.4,2,0,0
11/22/2017 0:10,12,69.3,28,64.7,40,66.1,2,0,0
11/22/2017 0:15,16,69.2,32,64.6,48,66.2,2,0,0
11/22/2017 0:20,12,69.3,27,64.7,39,66.2,2,0,0
11/22/2017 0:25,9,69.4,24,64.8,33,66.1,2,0,0
11/22/2017 0:30,12,69.4,27,64.8,39,66.2,2,0,0
11/22/2017 0:35,9,69.1,24,64.5,33,65.7,2,0,0
11/22/2017 0:40,6,69.2,21,64.6,27,65.6,2,0,0
11/22/2017 0:45,8,69.3,23,64.7,31,65.9,2,0,0
11/22/2017 0:50,9,69.4,24,64.8,33,66,2,0,0
11/22/2017 0:55,8,69.1,24,64.5,32,65.7,2,0,0
11/22/2017 1:00,6,69,22,64.4,28,65.3,2,0,0
11/22/2017 1:05,5,69.2,21,64.6,26,65.5,2,0,0
11/22/2017 1:10,7,69.3,23,64.7,30,65.8,2,0,0
11/22/2017 1:15,7,69.3,22,64.7,29,65.8,2,0,0
11/22/2017 1:20,6,69.3,22,64.7,28,65.7,2,0,0
11/22/2017 1:25,6,69.3,21,64.7,27,65.7,2,0,0
11/22/2017 1:30,6,69.4,22,64.8,28,65.8,2,0,0
11/22/2017 1:35,8,69.3,24,64.7,32,65.9,2,0,0
11/22/2017 1:40,9,69.4,25,64.8,34,66,2,0,0
11/22/2017 1:45,5,69.4,20,64.8,25,65.7,2,0,0
11/22/2017 1:50,7,69.5,22,64.9,29,66,2,0,0
11/22/2017 1:55,9,69.4,19,64.8,28,66.3,2,0,0
11/22/2017 2:00,5,69.3,21,64.7,26,65.5,2,0,0
11/22/2017 2:05,8,69.4,23,64.8,31,66,2,0,0
11/22/2017 2:10,9,69.4,24,64.8,33,66,2,0,0
11/22/2017 2:15,6,69.4,21,64.8,27,65.8,2,0,0
11/22/2017 2:20,6,69.2,21,64.6,27,65.6,2,0,0
11/22/2017 2:25,5,69.4,21,64.8,26,65.7,2,0,0
11/22/2017 2:30,12,69.5,28,64.9,40,66.2,2,0,0
11/22/2017 2:35,8,69.4,23,64.8,31,66,2,0,0
11/22/2017 2:40,7,69.5,22,64.9,29,66,2,0,0
11/22/2017 2:45,10,69.3,26,64.7,36,66,2,0,0
11/22/2017 2:50,8,69.3,24,64.7,32,65.9,2,0,0
11/22/2017 2:55,10,69.2,25,64.6,35,65.9,2,0,0
11/22/2017 3:00,9,69.2,25,64.6,34,65.8,2,0,0
11/22/2017 3:05,13,69.4,29,64.8,42,66.2,2,0,0
11/22/2017 3:10,10,69.4,25,64.8,35,66.2,2,0,0
11/22/2017 3:15,14,69.2,30,64.5,44,66,2,0,0
11/22/2017 3:20,9,69,25,64.4,34,65.6,2,0,0
11/22/2017 3:25,18,67.6,34,62.9,52,64.5,2,0,0
11/22/2017 3:30,15,68.5,31,63.8,46,65.3,2,0,0
11/22/2017 3:35,11,69,27,64.3,38,65.7,2,0,0
11/22/2017 3:40,14,69,30,64.4,44,65.8,2,0,0
11/22/2017 3:45,19,68.8,35,64.2,54,65.8,2,0,0
11/22/2017 3:50,16,68.6,33,63.9,49,65.4,2,0,0
11/22/2017 3:55,15,68.9,30,64.3,45,65.9,2,0,0
11/22/2017 4:00,20,69.3,36,64.7,56,66.3,2,0,0
11/22/2017 4:05,23,69.6,39,65,62,66.7,2,0,0
11/22/2017 4:10,23,69.5,39,64.9,62,66.6,2,0,0
11/22/2017 4:15,24,69.2,40,64.5,64,66.3,2,0,0
11/22/2017 4:20,23,69.5,40,64.9,63,66.6,2,0,0
11/22/2017 4:25,26,69.4,43,64.8,69,66.5,2,0,0
11/22/2017 4:30,27,69.9,43,65.4,70,67.1,2,0,0
11/22/2017 4:35,38,70.4,56,65.9,94,67.7,2,0,0
11/22/2017 4:40,32,70.5,49,66,81,67.8,2,0,0
11/22/2017 4:45,41,70.2,59,65.7,100,67.6,2,0,0
11/22/2017 4:50,36,68.9,54,64.3,90,66.1,2,0,0
11/22/2017 4:55,39,68.2,57,63.5,96,65.4,2,0,0
11/22/2017 5:00,36,69.2,53,64.6,89,66.5,2,0,0
11/22/2017 5:05,46,69.4,64,64.8,110,66.7,2,0,0
11/22/2017 5:10,42,69.3,60,64.7,102,66.6,2,0,0
11/22/2017 5:15,51,68.1,71,63.4,122,65.4,2,0,0
11/22/2017 5:20,49,67.7,69,62.9,118,64.9,2,0,0
11/22/2017 5:25,51,67.4,72,62.5,123,64.5,2,0,0
11/22/2017 5:30,55,66.6,75,61.8,130,63.8,2,0,0
11/22/2017 5:35,51,67.7,71,62.9,122,64.9,2,0,0
11/22/2017 5:40,63,68.5,83,63.7,146,65.8,2,0,0
11/22/2017 5:45,57,68.5,77,63.8,134,65.8,2,0,0
11/22/2017 5:50,66,67.2,87,62.3,153,64.4,2,0,0
11/22/2017 5:55,53,65.9,73,61,126,63.1,2,0,0
11/22/2017 6:00,52,66.3,72,61.3,124,63.4,2,0,0
11/22/2017 6:05,56,67.4,76,62.6,132,64.7,2,0,0
11/22/2017 6:10,56,67.6,76,62.8,132,64.8,2,0,0
11/22/2017 6:15,67,66.9,87,62.1,154,64.2,2,0,0
11/22/2017 6:20,67,66.7,90,61.9,157,63.9,2,0,0
11/22/2017 6:25,56,67.2,76,62.4,132,64.5,2,0,0
11/22/2017 6:30,68,67.2,89,62.4,157,64.5,2,0,0
11/22/2017 6:35,65,67.6,87,62.8,152,64.9,2,0,0
11/22/2017 6:40,73,69,95,64.3,168,66.4,2,0,0
11/22/2017 6:45,63,69.9,84,65.3,147,67.3,2,0,0
11/22/2017 6:50,57,68.9,78,64.3,135,66.2,2,0,0
11/22/2017 6:55,58,68.7,78,64,136,66,2,0,0
11/22/2017 7:00,63,69.2,85,64.6,148,66.6,2,0,0
11/22/2017 7:05,67,69.5,89,64.9,156,66.9,2,0,0
11/22/2017 7:10,61,69.5,81,64.9,142,66.9,2,0,0
11/22/2017 7:15,60,69.9,81,65.3,141,67.3,2,0,0
11/22/2017 7:20,72,69.4,94,64.7,166,66.8,2,0,0
11/22/2017 7:25,76,69.7,98,65.1,174,67.1,2,0,0
11/22/2017 7:30,64,69.6,84,65,148,67,2,0,0
11/22/2017 7:35,78,68.2,100,63.5,178,65.5,2,0,0
11/22/2017 7:40,71,67.6,93,63,164,65,2,0,0
11/22/2017 7:45,74,67.6,95,62.8,169,64.9,2,0,0
11/22/2017 7:50,76,68.4,97,63.7,173,65.8,2,0,0
11/22/2017 7:55,73,68.5,93,63.9,166,65.9,2,0,0
11/22/2017 8:00,60,69.4,80,64.8,140,66.8,2,0,0
11/22/2017 8:05,62,68.4,82,63.7,144,65.7,2,0,0
11/22/2017 8:10,77,67.9,99,63.2,176,65.2,2,0,0
11/22/2017 8:15,56,68.5,75,63.8,131,65.8,2,0,0
11/22/2017 8:20,74,68.5,95,63.9,169,65.9,2,0,0
11/22/2017 8:25,65,69.3,84,64.7,149,66.7,2,0,0
11/22/2017 8:30,51,69.9,69,65.2,120,67.2,2,0,0
11/22/2017 8:35,71,69.4,90,64.8,161,66.8,2,0,0
11/22/2017 8:40,76,67.1,98,62.3,174,64.4,2,0,0
11/22/2017 8:45,62,65.6,82,60.6,144,62.8,2,0,0
11/22/2017 8:50,64,66.3,84,61.4,148,63.5,2,0,0
11/22/2017 8:55,64,67.4,83,62.6,147,64.7,2,0,0
11/22/2017 9:00,57,68.1,76,63.4,133,65.4,2,0,0
11/22/2017 9:05,64,67,84,62.2,148,64.3,2,0,0
11/22/2017 9:10,65,65.9,85,61,150,63.1,2,0,0
11/22/2017 9:15,66,66.8,86,62,152,64.1,2,0,0
11/22/2017 9:20,62,67.8,81,63.1,143,65.1,2,0,0
11/22/2017 9:25,58,68.7,76,64,134,66.1,2,0,0
11/22/2017 9:30,63,67.8,81,63.1,144,65.2,2,0,0
11/22/2017 9:35,66,66.3,86,61.4,152,63.5,2,0,0
11/22/2017 9:40,62,66.9,81,62,143,64.1,2,0,0
11/22/2017 9:45,54,65.7,72,60.9,126,62.9,2,0,0
11/22/2017 9:50,63,67.1,83,62.3,146,64.4,2,0,0
11/22/2017 9:55,61,67.2,80,62.4,141,64.5,2,0,0
11/22/2017 10:00,63,66.5,83,61.7,146,63.8,2,0,0
11/22/2017 10:05,62,66,81,61.2,143,63.3,2,0,0
11/22/2017 10:10,63,65.9,83,61.1,146,63.2,2,0,0
11/22/2017 10:15,58,68.2,77,63.5,135,65.5,2,0,0
11/22/2017 10:20,65,67.1,85,62.4,150,64.4,2,0,0
11/22/2017 10:25,62,66,82,61.2,144,63.3,2,0,0
11/22/2017 10:30,72,66.2,93,61.4,165,63.5,2,0,0
11/22/2017 10:35,62,67.2,80,62.4,142,64.5,2,0,0
11/22/2017 10:40,64,67.2,83,62.5,147,64.5,2,0,0
11/22/2017 10:45,64,67.6,83,62.8,147,64.9,2,0,0
11/22/2017 10:50,64,67.7,83,62.9,147,65,2,0,0
11/22/2017 10:55,69,67.1,88,62.2,157,64.4,2,0,0
11/22/2017 11:00,59,68.5,79,63.8,138,65.8,2,0,0
11/22/2017 11:05,68,67.6,88,62.9,156,65,2,0,0
11/22/2017 11:10,59,67.6,79,62.9,138,64.9,2,0,0
11/22/2017 11:15,70,67.5,91,62.8,161,64.9,2,0,0
11/22/2017 11:20,61,67,80,62.3,141,64.4,2,0,0
11/22/2017 11:25,64,67.3,84,62.6,148,64.7,2,0,0
11/22/2017 11:30,67,66.3,85,61.5,152,63.6,2,0,0
11/22/2017 11:35,58,68.1,77,63.4,135,65.4,2,0,0
11/22/2017 11:40,66,67.6,86,62.9,152,64.9,2,0,0
11/22/2017 11:45,59,67.2,78,62.4,137,64.5,2,0,0
11/22/2017 11:50,53,68.4,71,63.7,124,65.7,2,0,0
11/22/2017 11:55,63,68.4,81,63.7,144,65.8,2,0,0
11/22/2017 12:00,62,67.7,82,62.9,144,65,2,0,0
11/22/2017 12:05,64,66.8,84,62,148,64.1,2,0,0
11/22/2017 12:10,64,67.8,83,63.1,147,65.2,2,0,0
11/22/2017 12:15,48,69,66,64.3,114,66.3,2,0,0
11/22/2017 12:20,60,68.9,78,64.2,138,66.2,2,0,0
11/22/2017 12:25,63,69.4,83,64.8,146,66.8,2,0,0
11/22/2017 12:30,58,69.6,77,65.1,135,67,2,0,0
11/22/2017 12:35,57,69.9,77,65.4,134,67.3,2,0,0
11/22/2017 12:40,69,70,88,65.5,157,67.5,2,0,0
11/22/2017 12:45,55,69.9,73,65.4,128,67.4,2,0,0
11/22/2017 12:50,50,69.4,68,64.8,118,66.7,2,0,0
11/22/2017 12:55,57,70.4,76,65.9,133,67.8,2,0,0
11/22/2017 13:00,43,68.4,61,63.8,104,65.7,2,0,0
11/22/2017 13:05,55,69.6,72,65,127,67,2,0,0
11/22/2017 13:10,56,70.5,74,66,130,67.9,2,0,0
11/22/2017 13:15,57,71.3,76,66.8,133,68.7,2,0,0
11/22/2017 13:20,56,70.7,76,66.2,132,68.1,2,0,0
11/22/2017 13:25,54,70.7,72,66.2,126,68.1,2,0,0
11/22/2017 13:30,55,71.7,74,67.3,129,69.2,2,0,0
11/22/2017 13:35,55,70.9,72,66.5,127,68.4,2,0,0
11/22/2017 13:40,59,70,78,65.5,137,67.4,2,0,0
11/22/2017 13:45,56,70.6,75,66.1,131,68.1,2,0,0
11/22/2017 13:50,61,69.9,80,65.4,141,67.4,2,0,0
11/22/2017 13:55,54,70.6,72,66.1,126,68,2,0,0
11/22/2017 14:00,53,69.3,70,64.8,123,66.8,2,0,0
11/22/2017 14:05,53,69.5,71,65,124,66.9,2,0,0
11/22/2017 14:10,50,68.9,67,64.2,117,66.2,2,0,0
11/22/2017 14:15,51,68.9,69,64.3,120,66.3,2,0,0
11/22/2017 14:20,58,70.6,77,66.1,135,68.1,2,0,0
11/22/2017 14:25,60,70,77,65.4,137,67.4,2,0,0
11/22/2017 14:30,52,70.6,69,66.1,121,68,2,0,0
11/22/2017 14:35,55,69.5,73,65,128,66.9,2,0,0
11/22/2017 14:40,48,70.8,65,66.3,113,68.2,2,0,0
11/22/2017 14:45,53,70.1,71,65.5,124,67.5,2,0,0
11/22/2017 14:50,49,70.3,67,65.8,116,67.7,2,0,0
11/22/2017 14:55,51,69.8,70,65.2,121,67.2,2,0,0
11/22/2017 15:00,52,70.4,70,65.8,122,67.7,2,0,0
11/22/2017 15:05,50,70.2,69,65.6,119,67.5,2,0,0
11/22/2017 15:10,53,69.7,71,65.1,124,67.1,2,0,0
11/22/2017 15:15,48,69,66,64.4,114,66.3,2,0,0
11/22/2017 15:20,60,69.9,79,65.4,139,67.4,2,0,0
11/22/2017 15:25,48,68.8,65,64.1,113,66.1,2,0,0
11/22/2017 15:30,60,68.9,79,64.2,139,66.2,2,0,0
11/22/2017 15:35,54,69,72,64.4,126,66.4,2,0,0
11/22/2017 15:40,46,69.7,64,65.2,110,67.1,2,0,0
11/22/2017 15:45,62,69.2,81,64.7,143,66.6,2,0,0
11/22/2017 15:50,56,69.2,75,64.6,131,66.6,2,0,0
11/22/2017 15:55,50,69.1,68,64.4,118,66.4,2,0,0
11/22/2017 16:00,52,69,70,64.4,122,66.3,2,0,0
11/22/2017 16:05,48,68.6,65,63.9,113,65.9,2,0,0
11/22/2017 16:10,58,69.5,77,64.9,135,66.9,2,0,0
11/22/2017 16:15,56,68.5,76,63.9,132,65.8,2,0,0
11/22/2017 16:20,58,69.1,76,64.5,134,66.5,2,0,0
11/22/2017 16:25,57,70.2,75,65.8,132,67.7,2,0,0
11/22/2017 16:30,54,69.6,73,65,127,66.9,2,0,0
11/22/2017 16:35,49,70.1,68,65.5,117,67.4,2,0,0
11/22/2017 16:40,56,69.3,73,64.6,129,66.7,2,0,0
11/22/2017 16:45,50,69.4,68,64.8,118,66.7,2,0,0
11/22/2017 16:50,47,69.2,66,64.6,113,66.5,2,0,0
11/22/2017 16:55,51,69.6,69,65.1,120,67,2,0,0
11/22/2017 17:00,51,68.5,69,63.9,120,65.8,2,0,0
11/22/2017 17:05,58,67.7,77,62.9,135,65,2,0,0
11/22/2017 17:10,56,68.3,74,63.6,130,65.6,2,0,0
11/22/2017 17:15,55,67.6,74,62.8,129,64.9,2,0,0
11/22/2017 17:20,50,68.3,69,63.6,119,65.5,2,0,0
11/22/2017 17:25,50,68.3,68,63.5,118,65.5,2,0,0
11/22/2017 17:30,47,67.4,66,62.6,113,64.6,2,0,0
11/22/2017 17:35,49,67.4,67,62.7,116,64.7,2,0,0
11/22/2017 17:40,55,68.4,74,63.7,129,65.7,2,0,0
11/22/2017 17:45,45,67.6,62,62.9,107,64.9,2,0,0
11/22/2017 17:50,41,68.7,59,64.1,100,66,2,0,0
11/22/2017 17:55,43,68.3,60,63.6,103,65.6,2,0,0
11/22/2017 18:00,46,68.2,63,63.5,109,65.5,2,0,0
11/22/2017 18:05,46,67.3,62,62.5,108,64.6,2,0,0
11/22/2017 18:10,41,68.1,58,63.4,99,65.3,2,0,0
11/22/2017 18:15,43,68.9,61,64.3,104,66.2,2,0,0
11/22/2017 18:20,54,68.9,74,64.2,128,66.2,2,0,0
11/22/2017 18:25,46,68.5,64,63.8,110,65.7,2,0,0
11/22/2017 18:30,50,68.6,68,63.9,118,65.9,2,0,0
11/22/2017 18:35,49,68.8,67,64.1,116,66.1,2,0,0
11/22/2017 18:40,50,69,67,64.4,117,66.4,2,0,0
11/22/2017 18:45,43,68.6,61,63.9,104,65.8,2,0,0
11/22/2017 18:50,44,69.7,60,65.1,104,67,2,0,0
11/22/2017 18:55,41,70.3,59,65.7,100,67.6,2,0,0
11/22/2017 19:00,44,69.2,62,64.6,106,66.5,2,0,0
11/22/2017 19:05,44,69.6,62,64.9,106,66.9,2,0,0
11/22/2017 19:10,39,69.3,56,64.6,95,66.5,2,0,0
11/22/2017 19:15,39,69.4,56,64.7,95,66.7,2,0,0
11/22/2017 19:20,35,69.3,51,64.6,86,66.5,2,0,0
11/22/2017 19:25,47,68.8,64,64.1,111,66.1,2,0,0
11/22/2017 19:30,45,68.7,62,64,107,65.9,2,0,0
11/22/2017 19:35,42,68.5,59,63.8,101,65.8,2,0,0
11/22/2017 19:40,28,69.5,45,64.9,73,66.7,2,0,0
11/22/2017 19:45,36,69.7,53,65.1,89,66.9,2,0,0
11/22/2017 19:50,41,70.3,57,65.7,98,67.6,2,0,0
11/22/2017 19:55,40,69.2,58,64.6,98,66.5,2,0,0
11/22/2017 20:00,33,69.5,50,64.9,83,66.7,2,0,0
11/22/2017 20:05,40,69.8,57,65.3,97,67.1,2,0,0
11/22/2017 20:10,42,68.9,59,64.2,101,66.1,2,0,0
11/22/2017 20:15,33,69.6,49,65,82,66.9,2,0,0
11/22/2017 20:20,28,69.8,44,65.2,72,67,2,0,0
11/22/2017 20:25,33,69.7,49,65.1,82,67,2,0,0
11/22/2017 20:30,33,70.1,49,65.5,82,67.4,2,0,0
11/22/2017 20:35,35,70,51,65.4,86,67.3,2,0,0
11/22/2017 20:40,31,69.7,47,65.2,78,67,2,0,0
11/22/2017 20:45,43,69.7,60,65.1,103,67,2,0,0
11/22/2017 20:50,41,70.3,58,65.8,99,67.7,2,0,0
11/22/2017 20:55,35,70.2,52,65.7,87,67.5,2,0,0
11/22/2017 21:00,36,69.6,53,65,89,66.9,2,0,0
11/22/2017 21:05,38,70.1,54,65.5,92,67.4,2,0,0
11/22/2017 21:10,32,69.4,49,64.8,81,66.7,2,0,0
11/22/2017 21:15,32,69.2,49,64.6,81,66.4,2,0,0
11/22/2017 21:20,30,69.4,46,64.8,76,66.7,2,0,0
11/22/2017 21:25,34,69.9,50,65.3,84,67.2,2,0,0
11/22/2017 21:30,31,69.8,47,65.3,78,67.1,2,0,0
11/22/2017 21:35,25,70,41,65.4,66,67.1,2,0,0
11/22/2017 21:40,27,69.6,42,65,69,66.8,2,0,0
11/22/2017 21:45,29,69.6,45,65.1,74,66.9,2,0,0
11/22/2017 21:50,25,69.7,41,65.2,66,66.9,2,0,0
11/22/2017 21:55,20,69.6,36,65,56,66.7,2,0,0
11/22/2017 22:00,23,69.6,39,65,62,66.7,2,0,0
11/22/2017 22:05,31,68.2,48,63.5,79,65.3,2,0,0
11/22/2017 22:10,30,68.9,47,64.2,77,66,2,0,0
11/22/2017 22:15,29,68.8,44,64.2,73,66,2,0,0
11/22/2017 22:20,21,68.4,37,63.8,58,65.5,2,0,0
11/22/2017 22:25,24,68.8,40,64.2,64,65.9,2,0,0
11/22/2017 22:30,24,69.2,39,64.6,63,66.3,2,0,0
11/22/2017 22:35,24,69.6,40,65,64,66.8,2,0,0
11/22/2017 22:40,22,69.4,37,64.8,59,66.5,2,0,0
11/22/2017 22:45,20,69.4,35,64.8,55,66.5,2,0,0
11/22/2017 22:50,24,69.5,40,65,64,66.7,2,0,0
11/22/2017 22:55,21,68.9,37,64.2,58,65.9,2,0,0
11/22/2017 23:00,22,69.1,37,64.5,59,66.2,2,0,0
11/22/2017 23:05,26,69.6,41,65,67,66.7,2,0,0
11/22/2017 23:10,27,69.8,43,65.3,70,67,2,0,0
11/22/2017 23:15,26,69.8,42,65.2,68,67,2,0,0
11/22/2017 23:20,26,69.9,42,65.3,68,67.1,2,0,0
11/22/2017 23:25,27,70.3,43,65.7,70,67.5,2,0,0
11/22/2017 23:30,25,69.7,41,65.1,66,66.9,2,0,0
11/22/2017 23:35,31,69.9,47,65.3,78,67.1,2,0,0
11/22/2017 23:40,22,70,37,65.5,59,67.2,2,0,0
11/22/2017 23:45,18,69.8,33,65.2,51,66.8,2,0,0
11/22/2017 23:50,20,69.8,36,65.2,56,66.8,2,0,0
11/22/2017 23:55,15,69.7,30,65.1,45,66.6,2,0,0
11/23/2017 0:00,17,69.3,33,64.7,50,66.3,2,0,1
11/23/2017 0:05,13,69.4,28,64.8,41,66.2,2,0,1
11/23/2017 0:10,17,69.5,33,65,50,66.5,2,0,1
11/23/2017 0:15,14,69.1,30,64.5,44,66,2,0,1
11/23/2017 0:20,14,69,30,64.3,44,65.8,2,0,1
11/23/2017 0:25,12,68.9,27,64.3,39,65.7,2,0,1
11/23/2017 0:30,11,69.2,27,64.6,38,65.9,2,0,1
11/23/2017 0:35,10,69.4,25,64.8,35,66.1,2,0,1
11/23/2017 0:40,13,69.5,29,65,42,66.4,2,0,1
11/23/2017 0:45,9,69.5,24,65,33,66.2,2,0,1
11/23/2017 0:50,10,69.4,26,64.8,36,66,2,0,1
11/23/2017 0:55,9,69.4,24,64.8,33,66.1,2,0,1
11/23/2017 1:00,10,69.5,25,64.9,35,66.2,2,0,1
11/23/2017 1:05,10,69.4,25,64.8,35,66.2,2,0,1
11/23/2017 1:10,8,69.5,24,64.9,32,66,2,0,1
11/23/2017 1:15,10,69.5,25,64.9,35,66.2,2,0,1
11/23/2017 1:20,9,69,24,64.4,33,65.7,2,0,1
11/23/2017 1:25,10,69,20,64.4,30,65.9,2,0,1
11/23/2017 1:30,8,69.1,23,64.5,31,65.7,2,0,1
11/23/2017 1:35,7,69.2,22,64.5,29,65.7,2,0,1
11/23/2017 1:40,9,69.2,24,64.6,33,65.9,2,0,1
11/23/2017 1:45,7,69.2,23,64.5,30,65.6,2,0,1
11/23/2017 1:50,14,69.3,22,64.7,36,66.5,2,0,1
11/23/2017 1:55,7,69.3,22,64.7,29,65.8,2,0,1
11/23/2017 2:00,7,69.5,22,64.9,29,66,2,0,1
11/23/2017 2:05,6,69.5,21,64.9,27,65.9,2,0,1
11/23/2017 2:10,7,69.4,22,64.8,29,65.9,2,0,1
11/23/2017 2:15,7,69.4,23,64.7,30,65.8,2,0,1
11/23/2017 2:20,7,69.4,22,64.8,29,65.9,2,0,1
11/23/2017 2:25,6,69.4,21,64.8,27,65.8,2,0,1
11/23/2017 2:30,7,69.4,22,64.8,29,65.9,2,0,1
11/23/2017 2:35,15,69.4,22,64.8,37,66.7,2,0,1
11/23/2017 2:40,11,69.5,26,64.9,37,66.3,2,0,1
11/23/2017 2:45,7,69.5,22,64.9,29,66,2,0,1
11/23/2017 2:50,14,69.2,22,64.6,36,66.4,2,0,1
11/23/2017 2:55,7,69.3,22,64.7,29,65.8,2,0,1
11/23/2017 3:00,9,69.4,24,64.8,33,66.1,2,0,1
11/23/2017 3:05,8,69.4,24,64.8,32,66,2,0,1
11/23/2017 3:10,6,69.3,22,64.7,28,65.7,2,0,1
11/23/2017 3:15,7,69.4,23,64.8,30,65.8,2,0,1
11/23/2017 3:20,9,69.3,24,64.7,33,66,2,0,1
11/23/2017 3:25,9,69.3,25,64.7,34,66,2,0,1
11/23/2017 3:30,8,69.4,24,64.8,32,65.9,2,0,1
11/23/2017 3:35,11,69.4,26,64.8,37,66.1,2,0,1
11/23/2017 3:40,9,69.4,24,64.8,33,66.1,2,0,1
11/23/2017 3:45,10,69.4,25,64.8,35,66.1,2,0,1
11/23/2017 3:50,10,69.3,25,64.7,35,66.1,2,0,1
11/23/2017 3:55,12,69.2,27,64.6,39,66,2,0,1
11/23/2017 4:00,10,69.3,26,64.7,36,65.9,2,0,1
11/23/2017 4:05,12,69.3,28,64.7,40,66.1,2,0,1
11/23/2017 4:10,7,69.1,22,64.5,29,65.6,2,0,1
11/23/2017 4:15,13,69.1,29,64.4,42,65.9,2,0,1
11/23/2017 4:20,15,69.2,30,64.6,45,66.1,2,0,1
11/23/2017 4:25,15,68.8,30,64.2,45,65.7,2,0,1
11/23/2017 4:30,13,69.1,28,64.5,41,66,2,0,1
11/23/2017 4:35,14,69.1,29,64.4,43,65.9,2,0,1
11/23/2017 4:40,15,69.2,30,64.5,45,66.1,2,0,1
11/23/2017 4:45,15,69.3,30,64.7,45,66.2,2,0,1
11/23/2017 4:50,17,69.3,33,64.7,50,66.3,2,0,1
11/23/2017 4:55,14,69.3,29,64.7,43,66.2,2,0,1
11/23/2017 5:00,13,69.4,28,64.8,41,66.3,2,0,1
11/23/2017 5:05,18,69.8,33,65.2,51,66.8,2,0,1
11/23/2017 5:10,11,69.6,27,65,38,66.3,2,0,1
11/23/2017 5:15,15,69.5,30,64.9,45,66.5,2,0,1
11/23/2017 5:20,15,69.5,30,64.9,45,66.4,2,0,1
11/23/2017 5:25,14,69.5,29,64.9,43,66.4,2,0,1
11/23/2017 5:30,13,69.5,29,64.9,42,66.3,2,0,1
11/23/2017 5:35,16,69.5,31,64.9,47,66.5,2,0,1
11/23/2017 5:40,12,69.5,28,64.9,40,66.3,2,0,1
11/23/2017 5:45,17,69.6,33,65,50,66.6,2,0,1
11/23/2017 5:50,12,69.5,28,64.9,40,66.3,2,0,1
11/23/2017 5:55,12,69.5,28,65,40,66.3,2,0,1
11/23/2017 6:00,14,69.6,30,65,44,66.5,2,0,1
11/23/2017 6:05,13,69.5,28,64.9,41,66.3,2,0,1
11/23/2017 6:10,12,69.5,27,64.9,39,66.3,2,0,1
11/23/2017 6:15,14,69.2,30,64.5,44,66,2,0,1
11/23/2017 6:20,12,69.2,28,64.6,40,66,2,0,1
11/23/2017 6:25,16,69.3,32,64.7,48,66.2,2,0,1
11/23/2017 6:30,15,69.4,31,64.8,46,66.3,2,0,1
11/23/2017 6:35,20,69.4,36,64.8,56,66.5,2,0,1
11/23/2017 6:40,19,69.3,35,64.7,54,66.3,2,0,1
11/23/2017 6:45,21,69.5,37,65,58,66.6,2,0,1
11/23/2017 6:50,21,69.7,37,65.1,58,66.8,2,0,1
11/23/2017 6:55,22,69.6,38,65,60,66.7,2,0,1
11/23/2017 7:00,18,69.7,34,65.1,52,66.7,2,0,1
11/23/2017 7:05,21,69.6,37,65,58,66.7,2,0,1
11/23/2017 7:10,27,69.5,43,64.9,70,66.6,2,0,1
11/23/2017 7:15,31,69.8,47,65.3,78,67.1,2,0,1
11/23/2017 7:20,19,69.7,34,65.1,53,66.7,2,0,1
11/23/2017 7:25,20,69.5,36,64.9,56,66.5,2,0,1
11/23/2017 7:30,26,69.7,42,65.1,68,66.8,2,0,1
11/23/2017 7:35,26,69.3,42,64.7,68,66.4,2,0,1
11/23/2017 7:40,27,69.8,43,65.3,70,67,2,0,1
11/23/2017 7:45,27,68.9,42,64.2,69,66,2,0,1
11/23/2017 7:50,25,69.1,41,64.5,66,66.3,2,0,1
11/23/2017 7:55,22,69.6,38,65,60,66.7,2,0,1
11/23/2017 8:00,26,69.4,42,64.7,68,66.5,2,0,1
11/23/2017 8:05,27,69.2,43,64.6,70,66.4,2,0,1
11/23/2017 8:10,20,69.2,35,64.6,55,66.3,2,0,1
11/23/2017 8:15,27,69.4,43,64.8,70,66.6,2,0,1
11/23/2017 8:20,23,69.5,39,64.9,62,66.6,2,0,1
11/23/2017 8:25,22,69.4,38,64.8,60,66.5,2,0,1
11/23/2017 8:30,25,69.4,41,64.8,66,66.5,2,0,1
11/23/2017 8:35,20,69.4,37,64.8,57,66.5,2,0,1
11/23/2017 8:40,18,69.5,34,64.9,52,66.5,2,0,1
11/23/2017 8:45,25,69.5,41,65,66,66.7,2,0,1
11/23/2017 8:50,20,69.5,35,64.9,55,66.6,2,0,1
11/23/2017 8:55,22,69.4,38,64.8,60,66.5,2,0,1
11/23/2017 9:00,24,69.5,39,64.9,63,66.7,2,0,1
11/23/2017 9:05,26,69.8,41,65.2,67,66.9,2,0,1
11/23/2017 9:10,23,69.6,39,65,62,66.7,2,0,1
11/23/2017 9:15,25,69.8,41,65.2,66,67,2,0,1
11/23/2017 9:20,24,69.4,39,64.8,63,66.5,2,0,1
11/23/2017 9:25,31,69.7,47,65.1,78,66.9,2,0,1
11/23/2017 9:30,37,70,53,65.4,90,67.3,2,0,1
11/23/2017 9:35,33,70.1,49,65.5,82,67.3,2,0,1
11/23/2017 9:40,25,69.9,41,65.3,66,67,2,0,1
11/23/2017 9:45,29,70.1,45,65.5,74,67.3,2,0,1
11/23/2017 9:50,32,70.1,48,65.5,80,67.4,2,0,1
11/23/2017 9:55,27,69.9,43,65.3,70,67.1,2,0,1
11/23/2017 10:00,29,69.5,45,64.9,74,66.7,2,0,1
11/23/2017 10:05,40,69.1,56,64.5,96,66.5,2,0,1
11/23/2017 10:10,31,69.3,47,64.7,78,66.5,2,0,1
11/23/2017 10:15,41,69.1,58,64.5,99,66.4,2,0,1
11/23/2017 10:20,36,69.4,53,64.9,89,66.7,2,0,1
11/23/2017 10:25,37,69.3,54,64.7,91,66.6,2,0,1
11/23/2017 10:30,39,69.3,56,64.8,95,66.7,2,0,1
11/23/2017 10:35,43,69.4,59,64.8,102,66.7,2,0,1
11/23/2017 10:40,37,69.1,54,64.6,91,66.4,2,0,1
11/23/2017 10:45,39,69.1,56,64.5,95,66.3,2,0,1
11/23/2017 10:50,38,69.4,54,64.8,92,66.7,2,0,1
11/23/2017 10:55,42,69.5,59,64.9,101,66.8,2,0,1
11/23/2017 11:00,37,69.8,53,65.3,90,67.1,2,0,1
11/23/2017 11:05,45,68.9,63,64.3,108,66.2,2,0,1
11/23/2017 11:10,44,67.3,62,62.6,106,64.5,2,0,1
11/23/2017 11:15,38,68.4,55,63.8,93,65.7,2,0,1
11/23/2017 11:20,40,68.9,57,64.3,97,66.2,2,0,1
11/23/2017 11:25,44,69.7,61,65.2,105,67.1,2,0,1
11/23/2017 11:30,46,69.9,63,65.4,109,67.3,2,0,1
11/23/2017 11:35,51,70,68,65.5,119,67.4,2,0,1
11/23/2017 11:40,39,70.1,55,65.6,94,67.5,2,0,1
11/23/2017 11:45,46,69.9,64,65.5,110,67.4,2,0,1
11/23/2017 11:50,46,69.7,63,65.3,109,67.2,2,0,1
11/23/2017 11:55,45,68.8,62,64.3,107,66.2,2,0,1
11/23/2017 12:00,36,69.9,52,65.4,88,67.2,2,0,1
11/23/2017 12:05,47,71.8,65,67.4,112,69.3,2,0,1
11/23/2017 12:10,44,72.6,61,68.3,105,70.1,2,0,1
11/23/2017 12:15,38,72.7,54,68.4,92,70.2,2,0,1
11/23/2017 12:20,47,72.7,65,68.3,112,70.2,2,0,1
11/23/2017 12:25,44,73.4,60,69.1,104,70.9,2,0,1
11/23/2017 12:30,44,73.3,62,69.1,106,70.8,2,0,1
11/23/2017 12:35,46,73.8,64,69.5,110,71.3,2,0,1
11/23/2017 12:40,41,72.8,58,68.5,99,70.3,2,0,1
11/23/2017 12:45,50,73,68,68.7,118,70.5,2,0,1
11/23/2017 12:50,46,73.3,63,69.1,109,70.9,2,0,1
11/23/2017 12:55,45,73.1,63,68.8,108,70.6,2,0,1
11/23/2017 13:00,51,72.9,69,68.6,120,70.4,2,0,1
11/23/2017 13:05,44,72.9,61,68.6,105,70.4,2,0,1
11/23/2017 13:10,50,72.6,67,68.2,117,70.1,2,0,1
11/23/2017 13:15,49,73,67,68.8,116,70.6,2,0,1
11/23/2017 13:20,40,72.1,57,67.8,97,69.6,2,0,1
11/23/2017 13:25,53,72.1,71,67.7,124,69.6,2,0,1
11/23/2017 13:30,55,71.7,72,67.2,127,69.2,2,0,1
11/23/2017 13:35,47,72.3,65,68,112,69.8,2,0,1
11/23/2017 13:40,45,71.9,61,67.5,106,69.4,2,0,1
11/23/2017 13:45,50,71.8,68,67.5,118,69.3,2,0,1
11/23/2017 13:50,52,72,70,67.6,122,69.5,2,0,1
11/23/2017 13:55,49,71.6,67,67.1,116,69,2,0,1
11/23/2017 14:00,44,70,61,65.4,105,67.3,2,0,1
11/23/2017 14:05,49,69.8,67,65.2,116,67.1,2,0,1
11/23/2017 14:10,50,69,68,64.4,118,66.3,2,0,1
11/23/2017 14:15,52,68.7,70,64.1,122,66.1,2,0,1
11/23/2017 14:20,55,69.1,74,64.5,129,66.5,2,0,1
11/23/2017 14:25,57,69.1,77,64.6,134,66.5,2,0,1
11/23/2017 14:30,49,68.9,67,64.3,116,66.3,2,0,1
11/23/2017 14:35,51,68.9,69,64.4,120,66.3,2,0,1
11/23/2017 14:40,53,69.3,71,64.8,124,66.7,2,0,1
11/23/2017 14:45,46,69.1,63,64.6,109,66.5,2,0,1
11/23/2017 14:50,50,68.9,67,64.3,117,66.2,2,0,1
11/23/2017 14:55,43,68.8,60,64.2,103,66.1,2,0,1
11/23/2017 15:00,48,70.9,65,66.5,113,68.3,2,0,1
11/23/2017 15:05,44,71,62,66.4,106,68.3,2,0,1
11/23/2017 15:10,50,71,67,66.5,117,68.4,2,0,1
11/23/2017 15:15,40,71,58,66.5,98,68.3,2,0,1
11/23/2017 15:20,45,71,63,66.5,108,68.4,2,0,1
11/23/2017 15:25,43,71.1,60,66.6,103,68.5,2,0,1
11/23/2017 15:30,50,72.2,67,67.8,117,69.7,2,0,1
11/23/2017 15:35,55,71.8,74,67.4,129,69.3,2,0,1
11/23/2017 15:40,44,71.9,62,67.6,106,69.4,2,0,1
11/23/2017 15:45,42,71.9,59,67.5,101,69.4,2,0,1
11/23/2017 15:50,42,71.9,59,67.6,101,69.4,2,0,1
11/23/2017 15:55,38,72.1,55,67.7,93,69.5,2,0,1
11/23/2017 16:00,44,72.2,61,67.8,105,69.6,2,0,1
11/23/2017 16:05,42,71.5,58,67.1,100,68.9,2,0,1
11/23/2017 16:10,41,71,57,66.6,98,68.4,2,0,1
11/23/2017 16:15,35,71.2,52,66.8,87,68.6,2,0,1
11/23/2017 16:20,49,72.4,66,68.2,115,70,2,0,1
11/23/2017 16:25,35,72,52,67.6,87,69.4,2,0,1
11/23/2017 16:30,37,71.9,53,67.5,90,69.3,2,0,1
11/23/2017 16:35,36,71.2,53,66.8,89,68.6,2,0,1
11/23/2017 16:40,31,71,48,66.6,79,68.3,2,0,1
11/23/2017 16:45,36,71.5,53,67,89,68.8,2,0,1
11/23/2017 16:50,38,70.9,55,66.4,93,68.2,2,0,1
11/23/2017 16:55,27,70.4,43,65.9,70,67.6,2,0,1
11/23/2017 17:00,32,70.2,48,65.7,80,67.5,2,0,1
11/23/2017 17:05,29,70.5,45,66,74,67.8,2,0,1
11/23/2017 17:10,29,70.8,44,66.3,73,68,2,0,1
11/23/2017 17:15,31,70.5,48,66,79,67.8,2,0,1
11/23/2017 17:20,38,70.4,55,65.8,93,67.7,2,0,1
11/23/2017 17:25,32,70.3,49,65.8,81,67.6,2,0,1
11/23/2017 17:30,32,70.3,49,65.7,81,67.5,2,0,1
11/23/2017 17:35,35,70.4,52,65.8,87,67.6,2,0,1
11/23/2017 17:40,31,70.3,48,65.7,79,67.5,2,0,1
11/23/2017 17:45,28,70,44,65.4,72,67.2,2,0,1
11/23/2017 17:50,25,70.1,40,65.5,65,67.3,2,0,1
11/23/2017 17:55,26,69.8,42,65.2,68,67,2,0,1
11/23/2017 18:00,30,70.3,46,65.7,76,67.5,2,0,1
11/23/2017 18:05,35,70.7,50,66.2,85,68.1,2,0,1
11/23/2017 18:10,27,70.7,42,66.2,69,68,2,0,1
11/23/2017 18:15,25,70.5,42,65.9,67,67.6,2,0,1
11/23/2017 18:20,28,70.1,44,65.5,72,67.3,2,0,1
11/23/2017 18:25,27,69.3,43,64.7,70,66.5,2,0,1
11/23/2017 18:30,33,69.8,49,65.2,82,67,2,0,1
11/23/2017 18:35,25,70.2,40,65.7,65,67.4,2,0,1
11/23/2017 18:40,29,70.1,46,65.5,75,67.3,2,0,1
11/23/2017 18:45,33,70.1,49,65.5,82,67.4,2,0,1
11/23/2017 18:50,28,69.6,45,64.9,73,66.7,2,0,1
11/23/2017 18:55,32,70,48,65.4,80,67.3,2,0,1
11/23/2017 19:00,32,70.1,47,65.6,79,67.4,2,0,1
11/23/2017 19:05,32,70.3,49,65.7,81,67.5,2,0,1
11/23/2017 19:10,33,69.8,48,65.3,81,67.1,2,0,1
11/23/2017 19:15,32,69.8,48,65.2,80,67,2,0,1
11/23/2017 19:20,29,70,45,65.5,74,67.2,2,0,1
11/23/2017 19:25,30,69.6,46,65,76,66.8,2,0,1
11/23/2017 19:30,35,69.7,51,65.2,86,67,2,0,1
11/23/2017 19:35,36,70.3,53,65.8,89,67.6,2,0,1
11/23/2017 19:40,36,70.3,52,65.8,88,67.6,2,0,1
11/23/2017 19:45,35,70.1,52,65.5,87,67.4,2,0,1
11/23/2017 19:50,34,69.8,50,65.2,84,67.1,2,0,1
11/23/2017 19:55,32,69.8,48,65.2,80,67.1,2,0,1
11/23/2017 20:00,36,69.9,53,65.3,89,67.2,2,0,1
11/23/2017 20:05,30,69.6,47,65,77,66.8,2,0,1
11/23/2017 20:10,36,69.3,52,64.7,88,66.6,2,0,1
11/23/2017 20:15,34,69.3,51,64.7,85,66.6,2,0,1
11/23/2017 20:20,44,70,61,65.5,105,67.4,2,0,1
11/23/2017 20:25,35,69.8,51,65.2,86,67.1,2,0,1
11/23/2017 20:30,37,69.4,54,64.8,91,66.7,2,0,1
11/23/2017 20:35,39,70,55,65.4,94,67.3,2,0,1
11/23/2017 20:40,34,69.9,51,65.3,85,67.1,2,0,1
11/23/2017 20:45,38,69.7,56,65.1,94,67,2,0,1
11/23/2017 20:50,35,69.7,52,65.2,87,67,2,0,1
11/23/2017 20:55,39,69.4,56,64.7,95,66.6,2,0,1
11/23/2017 21:00,39,69.6,57,65,96,66.8,2,0,1
11/23/2017 21:05,40,69.3,57,64.7,97,66.6,2,0,1
11/23/2017 21:10,41,68.6,57,63.9,98,65.9,2,0,1
11/23/2017 21:15,35,68.7,52,64,87,65.9,2,0,1
11/23/2017 21:20,39,68.1,56,63.4,95,65.3,2,0,1
11/23/2017 21:25,39,67.8,56,62.9,95,64.9,2,0,1
11/23/2017 21:30,36,68.3,53,63.6,89,65.5,2,0,1
11/23/2017 21:35,41,68.5,59,63.7,100,65.7,2,0,1
11/23/2017 21:40,36,68.6,53,63.9,89,65.8,2,0,1
11/23/2017 21:45,48,68.9,67,64.2,115,66.2,2,0,1
11/23/2017 21:50,31,69.2,49,64.6,80,66.3,2,0,1
11/23/2017 21:55,45,69.5,62,64.9,107,66.8,2,0,1
11/23/2017 22:00,31,68.9,47,64.3,78,66.1,2,0,1
11/23/2017 22:05,33,69,49,64.4,82,66.2,2,0,1
11/23/2017 22:10,35,69.2,51,64.6,86,66.5,2,0,1
11/23/2017 22:15,26,69.5,42,64.9,68,66.7,2,0,1
11/23/2017 22:20,30,68.9,46,64.3,76,66.1,2,0,1
11/23/2017 22:25,34,69.5,50,64.9,84,66.8,2,0,1
11/23/2017 22:30,32,69.4,48,64.8,80,66.6,2,0,1
11/23/2017 22:35,30,69.6,46,65,76,66.8,2,0,1
11/23/2017 22:40,27,69.4,43,64.8,70,66.6,2,0,1
11/23/2017 22:45,24,69.5,40,64.9,64,66.6,2,0,1
11/23/2017 22:50,26,69.6,42,65,68,66.8,2,0,1
11/23/2017 22:55,25,69.5,41,64.9,66,66.6,2,0,1
11/23/2017 23:00,22,69.4,38,64.8,60,66.5,2,0,1
11/23/2017 23:05,23,69.4,39,64.8,62,66.5,2,0,1
11/23/2017 23:10,21,69.5,37,64.9,58,66.6,2,0,1
11/23/2017 23:15,21,69.6,36,65,57,66.7,2,0,1
11/23/2017 23:20,20,69.6,36,65,56,66.6,2,0,1
11/23/2017 23:25,19,69.5,34,64.9,53,66.5,2,0,1
11/23/2017 23:30,20,69.3,36,64.6,56,66.3,2,0,1
11/23/2017 23:35,22,69.6,38,64.9,60,66.6,2,0,1
11/23/2017 23:40,16,69.6,31,65,47,66.5,2,0,1
11/23/2017 23:45,19,69.5,35,64.9,54,66.5,2,0,1
11/23/2017 23:50,15,69.5,31,64.9,46,66.4,2,0,1
11/23/2017 23:55,17,69.4,33,64.7,50,66.3,2,0,1
11/24/2017 0:00,14,69.3,29,64.7,43,66.2,2,0,1
11/24/2017 0:05,15,69.3,31,64.7,46,66.2,2,0,1
11/24/2017 0:10,12,69.4,27,64.8,39,66.2,2,0,1
11/24/2017 0:15,11,69.4,26,64.8,37,66.2,2,0,1
11/24/2017 0:20,11,69.3,27,64.7,38,66.1,2,0,1
11/24/2017 0:25,11,69.2,26,64.6,37,66,2,0,1
11/24/2017 0:30,9,69.3,25,64.7,34,65.9,2,0,1
11/24/2017 0:35,10,69.2,25,64.6,35,65.9,2,0,1
11/24/2017 0:40,12,69.3,28,64.7,40,66.1,2,0,1
11/24/2017 0:45,9,69.3,24,64.7,33,66,2,0,1
11/24/2017 0:50,8,69.4,24,64.8,32,66,2,0,1
11/24/2017 0:55,8,69.3,23,64.7,31,65.9,2,0,1
11/24/2017 1:00,8,69.3,23,64.7,31,65.9,2,0,1
11/24/2017 1:05,6,69.3,21,64.7,27,65.7,2,0,1
11/24/2017 1:10,8,69.3,24,64.7,32,65.9,2,0,1
11/24/2017 1:15,9,69.2,24,64.6,33,65.9,2,0,1
11/24/2017 1:20,6,69.3,21,64.7,27,65.7,2,0,1
11/24/2017 1:25,6,69.3,21,64.7,27,65.7,2,0,1
11/24/2017 1:30,6,69.3,21,64.7,27,65.7,2,0,1
11/24/2017 1:35,10,69,25,64.4,35,65.7,2,0,1
11/24/2017 1:40,6,69.3,21,64.7,27,65.7,2,0,1
11/24/2017 1:45,7,69.3,22,64.7,29,65.8,2,0,1
11/24/2017 1:50,5,69.3,20,64.7,25,65.6,2,0,1
11/24/2017 1:55,6,69.4,21,64.8,27,65.8,2,0,1
11/24/2017 2:00,5,69.4,20,64.8,25,65.7,2,0,1
11/24/2017 2:05,13,69.4,21,64.8,34,66.5,2,0,1
11/24/2017 2:10,6,69.3,22,64.7,28,65.6,2,0,1
11/24/2017 2:15,6,69.3,21,64.7,27,65.7,2,0,1
11/24/2017 2:20,5,69.3,20,64.7,25,65.6,2,0,1
11/24/2017 2:25,8,69.4,23,64.8,31,66,2,0,1
11/24/2017 2:30,7,69.4,22,64.8,29,65.9,2,0,1
11/24/2017 2:35,6,69.2,21,64.5,27,65.6,2,0,1
11/24/2017 2:40,9,69.2,26,64.5,35,65.7,2,0,1
11/24/2017 2:45,9,69.2,24,64.6,33,65.8,2,0,1
11/24/2017 2:50,11,69.3,21,64.7,32,66.3,2,0,1
11/24/2017 2:55,7,69,23,64.4,30,65.5,2,0,1
11/24/2017 3:00,8,69.3,23,64.7,31,65.8,2,0,1
11/24/2017 3:05,8,69.3,24,64.7,32,65.9,2,0,1
11/24/2017 3:10,9,69.4,25,64.8,34,66,2,0,1
11/24/2017 3:15,10,69.5,25,64.9,35,66.2,2,0,1
11/24/2017 3:20,8,69.5,23,64.9,31,66.1,2,0,1
11/24/2017 3:25,7,69.5,23,64.9,30,66,2,0,1
11/24/2017 3:30,7,69.3,22,64.7,29,65.8,2,0,1
11/24/2017 3:35,13,69.5,29,64.9,42,66.3,2,0,1
11/24/2017 3:40,9,69.5,25,64.9,34,66.1,2,0,1
11/24/2017 3:45,9,69.5,25,64.9,34,66.1,2,0,1
11/24/2017 3:50,8,69.4,23,64.8,31,66,2,0,1
11/24/2017 3:55,10,69.4,26,64.8,36,66.1,2,0,1
11/24/2017 4:00,10,69.3,25,64.7,35,66,2,0,1
11/24/2017 4:05,9,69.3,24,64.7,33,66,2,0,1
11/24/2017 4:10,10,69.3,25,64.7,35,66,2,0,1
11/24/2017 4:15,12,69.4,27,64.8,39,66.2,2,0,1
11/24/2017 4:20,10,69.4,26,64.8,36,66.1,2,0,1
11/24/2017 4:25,13,69.5,29,64.9,42,66.3,2,0,1
11/24/2017 4:30,12,69.3,28,64.7,40,66.1,2,0,1
11/24/2017 4:35,15,69.4,31,64.8,46,66.3,2,0,1
11/24/2017 4:40,13,69.5,29,64.9,42,66.3,2,0,1
11/24/2017 4:45,11,69.6,27,65,38,66.3,2,0,1
11/24/2017 4:50,16,69.5,31,64.9,47,66.5,2,0,1
11/24/2017 4:55,13,69.5,28,64.9,41,66.4,2,0,1
11/24/2017 5:00,19,69.2,35,64.6,54,66.2,2,0,1
11/24/2017 5:05,12,69.2,28,64.6,40,66,2,0,1
11/24/2017 5:10,13,69.2,28,64.6,41,66.1,2,0,1
11/24/2017 5:15,12,69.4,27,64.8,39,66.2,2,0,1
11/24/2017 5:20,15,69.5,31,65,46,66.5,2,0,1
11/24/2017 5:25,17,69.4,33,64.8,50,66.3,2,0,1
11/24/2017 5:30,14,69.1,30,64.5,44,65.9,2,0,1
11/24/2017 5:35,20,69.2,37,64.5,57,66.2,2,0,1
11/24/2017 5:40,21,69.6,38,65.1,59,66.7,2,0,1
11/24/2017 5:45,21,69.6,38,65,59,66.7,2,0,1
11/24/2017 5:50,21,69.4,38,64.8,59,66.5,2,0,1
11/24/2017 5:55,23,69.7,39,65.1,62,66.8,2,0,1
11/24/2017 6:00,19,69.5,36,64.9,55,66.5,2,0,1
11/24/2017 6:05,15,69.3,31,64.7,46,66.2,2,0,1
11/24/2017 6:10,22,69.5,38,64.9,60,66.6,2,0,1
11/24/2017 6:15,22,69.5,38,64.9,60,66.6,2,0,1
11/24/2017 6:20,25,69.8,42,65.2,67,66.9,2,0,1
11/24/2017 6:25,22,69.8,38,65.2,60,66.9,2,0,1
11/24/2017 6:30,20,69.7,36,65.1,56,66.8,2,0,1
11/24/2017 6:35,20,69.7,37,65.1,57,66.7,2,0,1
11/24/2017 6:40,22,69.6,38,65,60,66.7,2,0,1
11/24/2017 6:45,22,69.4,38,64.7,60,66.4,2,0,1
11/24/2017 6:50,22,69.6,37,65,59,66.7,2,0,1
11/24/2017 6:55,27,69.2,43,64.6,70,66.4,2,0,1
11/24/2017 7:00,25,68.4,42,63.8,67,65.5,2,0,1
11/24/2017 7:05,31,69.1,47,64.5,78,66.3,2,0,1
11/24/2017 7:10,26,69.6,42,65,68,66.7,2,0,1
11/24/2017 7:15,28,69.5,44,64.9,72,66.7,2,0,1
11/24/2017 7:20,27,69.6,43,65,70,66.7,2,0,1
11/24/2017 7:25,37,69.9,54,65.3,91,67.2,2,0,1
11/24/2017 7:30,27,69.6,44,65,71,66.7,2,0,1
11/24/2017 7:35,36,70,53,65.4,89,67.2,2,0,1
11/24/2017 7:40,33,68.8,50,64.1,83,66,2,0,1
11/24/2017 7:45,41,68.4,59,63.7,100,65.7,2,0,1
11/24/2017 7:50,32,68.5,49,63.8,81,65.6,2,0,1
11/24/2017 7:55,26,69.3,42,64.6,68,66.4,2,0,1
11/24/2017 8:00,33,69.6,50,65,83,66.8,2,0,1
11/24/2017 8:05,31,70.1,47,65.5,78,67.3,2,0,1
11/24/2017 8:10,35,69.9,51,65.4,86,67.2,2,0,1
11/24/2017 8:15,31,69.6,48,65,79,66.8,2,0,1
11/24/2017 8:20,26,69.8,42,65.2,68,67,2,0,1
11/24/2017 8:25,27,69.2,44,64.6,71,66.4,2,0,1
11/24/2017 8:30,29,68.9,46,64.3,75,66.1,2,0,1
11/24/2017 8:35,27,69.2,43,64.5,70,66.3,2,0,1
11/24/2017 8:40,26,69.1,43,64.5,69,66.2,2,0,1
11/24/2017 8:45,34,68.9,50,64.3,84,66.1,2,0,1
11/24/2017 8:50,32,68.8,48,64.1,80,66,2,0,1
11/24/2017 8:55,32,69.5,49,65,81,66.8,2,0,1
11/24/2017 9:00,27,69.1,43,64.5,70,66.3,2,0,1
11/24/2017 9:05,31,69.5,48,64.9,79,66.7,2,0,1
11/24/2017 9:10,35,69.8,52,65.2,87,67.1,2,0,1
11/24/2017 9:15,39,68.8,56,64.1,95,66,2,0,1
11/24/2017 9:20,33,69,50,64.3,83,66.2,2,0,1
11/24/2017 9:25,30,68.9,46,64.2,76,66.1,2,0,1
11/24/2017 9:30,34,69.2,51,64.6,85,66.5,2,0,1
11/24/2017 9:35,35,69.3,52,64.7,87,66.6,2,0,1
11/24/2017 9:40,44,68.8,62,64.1,106,66.1,2,0,1
11/24/2017 9:45,37,70.1,54,65.6,91,67.4,2,0,1
11/24/2017 9:50,48,70.3,66,65.9,114,67.7,2,0,1
11/24/2017 9:55,42,69.7,59,65.1,101,67,2,0,1
11/24/2017 10:00,46,69.8,64,65.3,110,67.2,2,0,1
11/24/2017 10:05,40,69.9,57,65.3,97,67.2,2,0,1
11/24/2017 10:10,47,70,64,65.5,111,67.4,2,0,1
11/24/2017 10:15,46,70.9,64,66.5,110,68.3,2,0,1
11/24/2017 10:20,48,68.7,66,64.1,114,66,2,0,1
11/24/2017 10:25,46,68.6,64,64.1,110,66,2,0,1
11/24/2017 10:30,49,68.1,67,63.4,116,65.4,2,0,1
11/24/2017 10:35,58,68.9,76,64.3,134,66.3,2,0,1
11/24/2017 10:40,56,69.6,74,65.1,130,67,2,0,1
11/24/2017 10:45,53,69.9,70,65.4,123,67.4,2,0,1
11/24/2017 10:50,53,70.1,71,65.6,124,67.5,2,0,1
11/24/2017 10:55,51,69.6,69,65,120,67,2,0,1
11/24/2017 11:00,52,69.4,70,64.8,122,66.7,2,0,1
11/24/2017 11:05,48,69.1,66,64.5,114,66.5,2,0,1
11/24/2017 11:10,52,68.7,71,64,123,66,2,0,1
11/24/2017 11:15,56,68,76,63.4,132,65.3,2,0,1
11/24/2017 11:20,55,69,73,64.4,128,66.4,2,0,1
11/24/2017 11:25,55,68.7,73,64,128,66,2,0,1
11/24/2017 11:30,60,69.4,79,64.8,139,66.8,2,0,1
11/24/2017 11:35,53,70.4,71,65.9,124,67.9,2,0,1
11/24/2017 11:40,45,70.7,63,66.2,108,68.1,2,0,1
11/24/2017 11:45,54,70.4,72,65.9,126,67.8,2,0,1
11/24/2017 11:50,54,69.5,73,64.9,127,66.9,2,0,1
11/24/2017 11:55,53,70.3,72,65.8,125,67.7,2,0,1
11/24/2017 12:00,45,70.3,63,65.7,108,67.6,2,0,1
11/24/2017 12:05,60,68.9,79,64.3,139,66.3,2,0,1
11/24/2017 12:10,56,68.6,75,63.9,131,65.9,2,0,1
11/24/2017 12:15,65,70.3,84,65.7,149,67.7,2,0,1
11/24/2017 12:20,57,70.5,77,66,134,67.9,2,0,1
11/24/2017 12:25,53,70.8,70,66.3,123,68.2,2,0,1
11/24/2017 12:30,65,70.8,83,66.3,148,68.3,2,0,1
11/24/2017 12:35,49,70.2,68,65.7,117,67.6,2,0,1
11/24/2017 12:40,56,70.8,74,66.3,130,68.2,2,0,1
11/24/2017 12:45,55,71.5,73,67.1,128,69,2,0,1
11/24/2017 12:50,61,70.2,81,65.6,142,67.6,2,0,1
11/24/2017 12:55,52,71.1,70,66.6,122,68.5,2,0,1
11/24/2017 13:00,54,70.3,72,65.8,126,67.7,2,0,1
11/24/2017 13:05,54,70.9,72,66.4,126,68.3,2,0,1
11/24/2017 13:10,49,71.1,66,66.7,115,68.6,2,0,1
11/24/2017 13:15,46,71.3,64,66.9,110,68.7,2,0,1
11/24/2017 13:20,49,71,67,66.5,116,68.4,2,0,1
11/24/2017 13:25,47,71.8,64,67.4,111,69.3,2,0,1
11/24/2017 13:30,44,72,61,67.6,105,69.4,2,0,1
11/24/2017 13:35,43,71.6,59,67.2,102,69.1,2,0,1
11/24/2017 13:40,39,71.2,56,66.7,95,68.5,2,0,1
11/24/2017 13:45,42,71.3,59,66.8,101,68.7,2,0,1
11/24/2017 13:50,50,70.8,68,66.3,118,68.2,2,0,1
11/24/2017 13:55,45,70.8,62,66.3,107,68.2,2,0,1
11/24/2017 14:00,41,70.8,58,66.2,99,68.1,2,0,1
11/24/2017 14:05,44,71.7,61,67.3,105,69.1,2,0,1
11/24/2017 14:10,43,71.6,61,67.1,104,69,2,0,1
11/24/2017 14:15,54,69.1,72,64.5,126,66.5,2,0,1
11/24/2017 14:20,52,70.9,70,66.5,122,68.4,2,0,1
11/24/2017 14:25,43,70.4,60,65.9,103,67.8,2,0,1
11/24/2017 14:30,48,71.1,65,66.6,113,68.5,2,0,1
11/24/2017 14:35,51,70.7,68,66.2,119,68.2,2,0,1
11/24/2017 14:40,48,72,65,67.6,113,69.4,2,0,1
11/24/2017 14:45,42,71.1,59,66.6,101,68.5,2,0,1
11/24/2017 14:50,50,71.5,67,67,117,68.9,2,0,1
11/24/2017 14:55,43,70.4,61,65.9,104,67.8,2,0,1
11/24/2017 15:00,42,71.7,59,67.2,101,69.1,2,0,1
11/24/2017 15:05,40,71.2,57,66.7,97,68.6,2,0,1
11/24/2017 15:10,46,70.7,64,66.2,110,68.1,2,0,1
11/24/2017 15:15,45,71.5,62,67.1,107,68.9,2,0,1
11/24/2017 15:20,46,71.6,64,67.2,110,69.1,2,0,1
11/24/2017 15:25,46,71.1,63,66.7,109,68.6,2,0,1
11/24/2017 15:30,42,70.8,60,66.3,102,68.2,2,0,1
11/24/2017 15:35,49,70.8,66,66.4,115,68.3,2,0,1
11/24/2017 15:40,50,70.9,67,66.4,117,68.3,2,0,1
11/24/2017 15:45,58,69.9,77,65.3,135,67.2,2,0,1
11/24/2017 15:50,55,70.7,73,66.2,128,68.1,2,0,1
11/24/2017 15:55,49,72,66,67.6,115,69.5,2,0,1
11/24/2017 16:00,53,72.4,71,68.2,124,70,2,0,1
11/24/2017 16:05,56,71.7,74,67.4,130,69.2,2,0,1
11/24/2017 16:10,52,72.3,69,67.9,121,69.8,2,0,1
11/24/2017 16:15,53,72.3,70,67.9,123,69.8,2,0,1
11/24/2017 16:20,44,72,61,67.6,105,69.4,2,0,1
11/24/2017 16:25,52,71.9,70,67.6,122,69.4,2,0,1
11/24/2017 16:30,49,71.6,66,67.2,115,69,2,0,1
11/24/2017 16:35,50,71.7,68,67.3,118,69.2,2,0,1
11/24/2017 16:40,54,72.3,73,68.1,127,69.9,2,0,1
11/24/2017 16:45,48,72.6,66,68.3,114,70.1,2,0,1
11/24/2017 16:50,51,71.6,68,67.2,119,69.1,2,0,1
11/24/2017 16:55,46,71.6,64,67.2,110,69,2,0,1
11/24/2017 17:00,57,71.4,75,67.1,132,69,2,0,1
11/24/2017 17:05,48,70.1,65,65.7,113,67.6,2,0,1
11/24/2017 17:10,53,71,71,66.6,124,68.5,2,0,1
11/24/2017 17:15,54,71.1,73,66.7,127,68.5,2,0,1
11/24/2017 17:20,58,70.8,78,66.3,136,68.2,2,0,1
11/24/2017 17:25,49,70.7,66,66.3,115,68.2,2,0,1
11/24/2017 17:30,51,71.1,69,66.7,120,68.5,2,0,1
11/24/2017 17:35,57,70.8,76,66.4,133,68.3,2,0,1
11/24/2017 17:40,59,70.6,77,66.2,136,68.1,2,0,1
11/24/2017 17:45,57,70.9,75,66.4,132,68.4,2,0,1
11/24/2017 17:50,53,69.9,71,65.4,124,67.3,2,0,1
11/24/2017 17:55,52,70.5,69,66,121,67.9,2,0,1
11/24/2017 18:00,53,70,71,65.4,124,67.3,2,0,1
11/24/2017 18:05,56,70,73,65.5,129,67.4,2,0,1
11/24/2017 18:10,67,70.5,84,65.9,151,67.9,2,0,1
11/24/2017 18:15,61,70.3,79,65.8,140,67.8,2,0,1
11/24/2017 18:20,56,70.3,74,65.7,130,67.7,2,0,1
11/24/2017 18:25,65,70.1,83,65.5,148,67.5,2,0,1
11/24/2017 18:30,60,70.9,79,66.4,139,68.4,2,0,1
11/24/2017 18:35,58,70.9,77,66.5,135,68.4,2,0,1
11/24/2017 18:40,53,70.2,72,65.7,125,67.6,2,0,1
11/24/2017 18:45,49,70.4,67,65.9,116,67.8,2,0,1
11/24/2017 18:50,49,70.9,67,66.4,116,68.3,2,0,1
11/24/2017 18:55,54,71.4,72,66.9,126,68.8,2,0,1
11/24/2017 19:00,45,70.7,63,66.2,108,68.1,2,0,1
11/24/2017 19:05,44,70.1,61,65.5,105,67.5,2,0,1
11/24/2017 19:10,45,69.6,63,65,108,66.9,2,0,1
11/24/2017 19:15,39,70.4,56,65.9,95,67.8,2,0,1
11/24/2017 19:20,42,70.3,59,65.8,101,67.7,2,0,1
11/24/2017 19:25,32,70.1,48,65.6,80,67.4,2,0,1
11/24/2017 19:30,38,70,55,65.5,93,67.4,2,0,1
11/24/2017 19:35,32,70,48,65.5,80,67.3,2,0,1
11/24/2017 19:40,34,70.1,51,65.6,85,67.4,2,0,1
11/24/2017 19:45,34,70.2,50,65.6,84,67.5,2,0,1
11/24/2017 19:50,30,70.5,46,66,76,67.7,2,0,1
11/24/2017 19:55,31,69.8,47,65.2,78,67,2,0,1
11/24/2017 20:00,29,68.9,45,64.2,74,66.1,2,0,1
11/24/2017 20:05,28,68.8,44,64.1,72,65.9,2,0,1
11/24/2017 20:10,30,68.7,46,64.1,76,65.9,2,0,1
11/24/2017 20:15,31,68.6,49,63.9,80,65.7,2,0,1
11/24/2017 20:20,27,69.1,43,64.5,70,66.3,2,0,1
11/24/2017 20:25,30,69.3,46,64.7,76,66.5,2,0,1
11/24/2017 20:30,33,69,49,64.4,82,66.2,2,0,1
11/24/2017 20:35,27,69.7,43,65.2,70,66.9,2,0,1
11/24/2017 20:40,29,69.5,44,64.9,73,66.8,2,0,1
11/24/2017 20:45,29,69.1,44,64.5,73,66.3,2,0,1
11/24/2017 20:50,27,69.3,43,64.7,70,66.5,2,0,1
11/24/2017 20:55,32,69.3,48,64.7,80,66.5,2,0,1
11/24/2017 21:00,25,69.8,40,65.2,65,67,2,0,1
11/24/2017 21:05,21,69.7,37,65.1,58,66.7,2,0,1
11/24/2017 21:10,25,69.4,40,64.8,65,66.5,2,0,1
11/24/2017 21:15,30,69.2,45,64.6,75,66.5,2,0,1
11/24/2017 21:20,29,69.4,45,64.8,74,66.6,2,0,1
11/24/2017 21:25,26,69.5,42,64.9,68,66.6,2,0,1
11/24/2017 21:30,29,69.6,45,65,74,66.8,2,0,1
11/24/2017 21:35,27,69.4,43,64.8,70,66.6,2,0,1
11/24/2017 21:40,20,69.3,36,64.7,56,66.4,2,0,1
11/24/2017 21:45,26,69.4,43,64.8,69,66.6,2,0,1
11/24/2017 21:50,21,69.4,36,64.8,57,66.5,2,0,1
11/24/2017 21:55,28,69.6,44,65,72,66.8,2,0,1
11/24/2017 22:00,33,69.4,48,64.8,81,66.7,2,0,1
11/24/2017 22:05,28,69.4,43,64.8,71,66.6,2,0,1
11/24/2017 22:10,30,69.3,46,64.7,76,66.5,2,0,1
11/24/2017 22:15,28,69.1,44,64.5,72,66.3,2,0,1
11/24/2017 22:20,23,69.4,39,64.8,62,66.5,2,0,1
11/24/2017 22:25,19,69.5,35,64.9,54,66.5,2,0,1
11/24/2017 22:30,24,69.3,40,64.7,64,66.4,2,0,1
11/24/2017 22:35,17,69.3,32,64.7,49,66.3,2,0,1
11/24/2017 22:40,27,69.4,44,64.8,71,66.6,2,0,1
11/24/2017 22:45,20,69.1,36,64.5,56,66.2,2,0,1
11/24/2017 22:50,18,69.4,33,64.8,51,66.4,2,0,1
11/24/2017 22:55,24,69.6,40,65,64,66.7,2,0,1
11/24/2017 23:00,23,69.6,40,65,63,66.6,2,0,1
11/24/2017 23:05,17,69.3,33,64.7,50,66.3,2,0,1
11/24/2017 23:10,15,69.3,31,64.7,46,66.2,2,0,1
11/24/2017 23:15,20,69.7,36,65.1,56,66.7,2,0,1
11/24/2017 23:20,16,69.2,31,64.6,47,66.2,2,0,1
11/24/2017 23:25,19,69.3,35,64.7,54,66.4,2,0,1
11/24/2017 23:30,18,69.4,34,64.8,52,66.4,2,0,1
11/24/2017 23:35,17,69.5,33,64.9,50,66.5,2,0,1
11/24/2017 23:40,16,69,31,64.4,47,65.9,2,0,1
11/24/2017 23:45,16,69.2,31,64.6,47,66.1,2,0,1
11/24/2017 23:50,16,69.3,31,64.7,47,66.3,2,0,1
11/24/2017 23:55,17,69.2,32,64.6,49,66.2,2,0,1
11/25/2017 0:00,13,69.3,28,64.7,41,66.2,2,0,0
11/25/2017 0:05,13,69.5,28,64.9,41,66.4,2,0,0
11/25/2017 0:10,14,69.6,30,65,44,66.5,2,0,0
11/25/2017 0:15,13,69.5,28,64.9,41,66.3,2,0,0
11/25/2017 0:20,15,69.5,30,64.9,45,66.4,2,0,0
11/25/2017 0:25,12,69.4,27,64.8,39,66.3,2,0,0
11/25/2017 0:30,10,69,26,64.4,36,65.7,2,0,0
11/25/2017 0:35,11,69.3,26,64.7,37,66.1,2,0,0
11/25/2017 0:40,9,68.9,24,64.3,33,65.5,2,0,0
11/25/2017 0:45,8,69.1,23,64.5,31,65.7,2,0,0
11/25/2017 0:50,7,69.2,23,64.6,30,65.7,2,0,0
11/25/2017 0:55,9,69.2,24,64.6,33,65.9,2,0,0
11/25/2017 1:00,9,69.3,24,64.7,33,65.9,2,0,0
11/25/2017 1:05,10,69.4,25,64.8,35,66.1,2,0,0
11/25/2017 1:10,7,69.4,23,64.8,30,65.8,2,0,0
11/25/2017 1:15,9,69.4,24,64.8,33,66.1,2,0,0
11/25/2017 1:20,8,69.4,23,64.8,31,66,2,0,0
11/25/2017 1:25,9,68.9,24,64.3,33,65.6,2,0,0
11/25/2017 1:30,10,69.2,25,64.5,35,65.9,2,0,0
11/25/2017 1:35,8,68.9,24,64.3,32,65.5,2,0,0
11/25/2017 1:40,9,69.2,25,64.6,34,65.8,2,0,0
11/25/2017 1:45,9,69.3,25,64.7,34,65.9,2,0,0
11/25/2017 1:50,7,69.2,22,64.6,29,65.7,2,0,0
11/25/2017 1:55,8,69.3,23,64.7,31,65.9,2,0,0
11/25/2017 2:00,6,69.3,21,64.7,27,65.7,2,0,0
11/25/2017 2:05,7,69.4,22,64.8,29,65.9,2,0,0
11/25/2017 2:10,8,69.3,23,64.7,31,65.9,2,0,0
11/25/2017 2:15,9,69.4,24,64.8,33,66.1,2,0,0
11/25/2017 2:20,7,69.4,23,64.7,30,65.8,2,0,0
11/25/2017 2:25,8,69.4,24,64.8,32,65.9,2,0,0
11/25/2017 2:30,9,69.4,24,64.8,33,66,2,0,0
11/25/2017 2:35,8,69.4,24,64.8,32,65.9,2,0,0
11/25/2017 2:40,10,69.3,25,64.7,35,66.1,2,0,0
11/25/2017 2:45,10,69.3,20,64.7,30,66.2,2,0,0
11/25/2017 2:50,8,69.3,24,64.7,32,65.9,2,0,0
11/25/2017 2:55,7,69.3,22,64.7,29,65.8,2,0,0
11/25/2017 3:00,7,69.3,23,64.7,30,65.7,2,0,0
11/25/2017 3:05,7,69.3,22,64.7,29,65.8,2,0,0
11/25/2017 3:10,6,69.2,21,64.6,27,65.6,2,0,0
11/25/2017 3:15,11,69.3,26,64.7,37,66.1,2,0,0
11/25/2017 3:20,7,69.3,22,64.7,29,65.8,2,0,0
11/25/2017 3:25,10,69.3,25,64.7,35,66.1,2,0,0
11/25/2017 3:30,9,69.3,24,64.7,33,66,2,0,0
11/25/2017 3:35,11,68.8,27,64.1,38,65.5,2,0,0
11/25/2017 3:40,6,69,22,64.4,28,65.4,2,0,0
11/25/2017 3:45,7,69.2,23,64.5,30,65.6,2,0,0
11/25/2017 3:50,10,69.2,25,64.6,35,65.9,2,0,0
11/25/2017 3:55,13,69.3,28,64.7,41,66.1,2,0,0
11/25/2017 4:00,8,69.2,24,64.6,32,65.8,2,0,0
11/25/2017 4:05,14,69.1,29,64.5,43,66,2,0,0
11/25/2017 4:10,12,69.3,28,64.7,40,66,2,0,0
11/25/2017 4:15,14,69.2,30,64.6,44,66.1,2,0,0
11/25/2017 4:20,15,69.1,31,64.5,46,66,2,0,0
11/25/2017 4:25,16,69.2,31,64.6,47,66.2,2,0,0
11/25/2017 4:30,18,69.1,33,64.4,51,66.1,2,0,0
11/25/2017 4:35,15,69,30,64.4,45,65.9,2,0,0
11/25/2017 4:40,19,69.2,35,64.6,54,66.2,2,0,0
11/25/2017 4:45,21,69.3,37,64.7,58,66.3,2,0,0
11/25/2017 4:50,14,69.1,30,64.4,44,65.9,2,0,0
11/25/2017 4:55,20,68.9,36,64.2,56,65.9,2,0,0
11/25/2017 5:00,18,69.3,34,64.7,52,66.3,2,0,0
11/25/2017 5:05,11,69.3,27,64.7,38,66,2,0,0
11/25/2017 5:10,18,69.1,34,64.4,52,66,2,0,0
11/25/2017 5:15,15,69.2,30,64.6,45,66.2,2,0,0
11/25/2017 5:20,16,69.3,31,64.7,47,66.3,2,0,0
11/25/2017 5:25,17,69.2,33,64.6,50,66.2,2,0,0
11/25/2017 5:30,13,69.4,29,64.8,42,66.2,2,0,0
11/25/2017 5:35,18,69.2,34,64.5,52,66.1,2,0,0
11/25/2017 5:40,20,69.4,37,64.8,57,66.4,2,0,0
11/25/2017 5:45,14,69.4,30,64.8,44,66.3,2,0,0
11/25/2017 5:50,14,69.2,29,64.6,43,66.1,2,0,0
11/25/2017 5:55,12,69.3,27,64.7,39,66.1,2,0,0
11/25/2017 6:00,15,69.3,31,64.6,46,66.1,2,0,0
11/25/2017 6:05,15,69.3,30,64.7,45,66.3,2,0,0
11/25/2017 6:10,19,69.1,34,64.5,53,66.1,2,0,0
11/25/2017 6:15,14,68.9,29,64.2,43,65.8,2,0,0
11/25/2017 6:20,18,69.1,33,64.5,51,66.1,2,0,0
11/25/2017 6:25,19,68.7,35,64,54,65.7,2,0,0
11/25/2017 6:30,17,69,33,64.4,50,65.9,2,0,0
11/25/2017 6:35,22,69,38,64.4,60,66.1,2,0,0
11/25/2017 6:40,20,69.1,36,64.5,56,66.1,2,0,0
11/25/2017 6:45,24,69.4,40,64.8,64,66.5,2,0,0
11/25/2017 6:50,23,69.2,39,64.6,62,66.3,2,0,0
11/25/2017 6:55,27,69.3,43,64.7,70,66.5,2,0,0
11/25/2017 7:00,22,69.4,38,64.8,60,66.5,2,0,0
11/25/2017 7:05,26,69.4,43,64.8,69,66.6,2,0,0
11/25/2017 7:10,31,68.7,47,64,78,65.9,2,0,0
11/25/2017 7:15,23,69,40,64.4,63,66,2,0,0
11/25/2017 7:20,28,69.2,45,64.6,73,66.4,2,0,0
11/25/2017 7:25,24,69.4,41,64.8,65,66.5,2,0,0
11/25/2017 7:30,23,69.5,39,64.9,62,66.6,2,0,0
11/25/2017 7:35,26,69,43,64.3,69,66.1,2,0,0
11/25/2017 7:40,30,69.4,46,64.8,76,66.6,2,0,0
11/25/2017 7:45,32,69.1,49,64.5,81,66.3,2,0,0
11/25/2017 7:50,30,69.1,46,64.5,76,66.3,2,0,0
11/25/2017 7:55,31,69.3,47,64.7,78,66.5,2,0,0
11/25/2017 8:00,29,69.8,46,65.2,75,66.9,2,0,0
11/25/2017 8:05,31,69.5,48,64.9,79,66.7,2,0,0
11/25/2017 8:10,32,69.5,49,64.9,81,66.7,2,0,0
11/25/2017 8:15,28,69.6,44,65.1,72,66.9,2,0,0
11/25/2017 8:20,25,69.8,41,65.2,66,66.9,2,0,0
11/25/2017 8:25,29,69.7,46,65.2,75,66.9,2,0,0
11/25/2017 8:30,28,69.7,45,65.1,73,66.8,2,0,0
11/25/2017 8:35,36,69.6,52,65,88,66.8,2,0,0
11/25/2017 8:40,36,69.7,53,65.1,89,67,2,0,0
11/25/2017 8:45,41,68.9,57,64.2,98,66.2,2,0,0
11/25/2017 8:50,36,69.7,53,65.2,89,67,2,0,0
11/25/2017 8:55,39,69.3,56,64.7,95,66.6,2,0,0
11/25/2017 9:00,34,69.6,51,65,85,66.8,2,0,0
11/25/2017 9:05,39,69.3,56,64.6,95,66.5,2,0,0
11/25/2017 9:10,34,68.9,50,64.2,84,66.1,2,0,0
11/25/2017 9:15,40,68.4,57,63.7,97,65.6,2,0,0
11/25/2017 9:20,39,69,55,64.3,94,66.3,2,0,0
11/25/2017 9:25,46,69.1,64,64.4,110,66.4,2,0,0
11/25/2017 9:30,53,69.8,71,65.3,124,67.2,2,0,0
11/25/2017 9:35,43,69.2,62,64.6,105,66.5,2,0,0
11/25/2017 9:40,45,69.4,62,64.8,107,66.8,2,0,0
11/25/2017 9:45,50,70.2,68,65.7,118,67.6,2,0,0
11/25/2017 9:50,49,70.1,66,65.6,115,67.5,2,0,0
11/25/2017 9:55,47,69.4,64,64.7,111,66.7,2,0,0
11/25/2017 10:00,42,69.6,59,65,101,67,2,0,0
11/25/2017 10:05,46,69.9,64,65.3,110,67.2,2,0,0
11/25/2017 10:10,48,69.8,65,65.2,113,67.2,2,0,0
11/25/2017 10:15,46,69.7,64,65.1,110,67,2,0,0
11/25/2017 10:20,52,69.7,69,65.1,121,67,2,0,0
11/25/2017 10:25,50,69.6,68,65,118,66.9,2,0,0
11/25/2017 10:30,44,69.9,61,65.3,105,67.2,2,0,0
11/25/2017 10:35,49,69.7,67,65.1,116,67,2,0,0
11/25/2017 10:40,55,67.8,73,62.9,128,65,2,0,0
11/25/2017 10:45,47,67,65,62.1,112,64.2,2,0,0
11/25/2017 10:50,59,67.5,78,62.6,137,64.7,2,0,0
11/25/2017 10:55,61,68.8,80,64.1,141,66.1,2,0,0
11/25/2017 11:00,51,69.5,69,64.9,120,66.9,2,0,0
11/25/2017 11:05,64,68.6,83,63.9,147,65.9,2,0,0
11/25/2017 11:10,63,67.8,82,63.1,145,65.1,2,0,0
11/25/2017 11:15,61,68.7,80,64.1,141,66.1,2,0,0
11/25/2017 11:20,63,68.8,82,64.1,145,66.1,2,0,0
11/25/2017 11:25,60,68.1,80,63.3,140,65.3,2,0,0
11/25/2017 11:30,62,69.2,81,64.6,143,66.6,2,0,0
11/25/2017 11:35,57,69.2,76,64.6,133,66.6,2,0,0
11/25/2017 11:40,56,68.7,75,64.1,131,66.1,2,0,0
11/25/2017 11:45,58,68.4,76,63.8,134,65.8,2,0,0
11/25/2017 11:50,53,69.2,72,64.6,125,66.6,2,0,0
11/25/2017 11:55,54,69,71,64.4,125,66.4,2,0,0
11/25/2017 12:00,59,68.9,77,64.2,136,66.3,2,0,0
11/25/2017 12:05,55,68.7,73,64,128,66.1,2,0,0
11/25/2017 12:10,59,68.9,78,64.2,137,66.2,2,0,0
11/25/2017 12:15,61,69.2,80,64.6,141,66.6,2,0,0
11/25/2017 12:20,50,69.1,68,64.5,118,66.4,2,0,0
11/25/2017 12:25,63,69.1,81,64.5,144,66.5,2,0,0
11/25/2017 12:30,65,68.7,84,64,149,66,2,0,0
11/25/2017 12:35,55,68.6,74,63.9,129,65.9,2,0,0
11/25/2017 12:40,67,69.8,86,65.3,153,67.2,2,0,0
11/25/2017 12:45,59,69.9,77,65.4,136,67.4,2,0,0
11/25/2017 12:50,73,69.4,94,64.8,167,66.8,2,0,0
11/25/2017 12:55,68,68.3,88,63.6,156,65.6,2,0,0
11/25/2017 13:00,59,68.4,77,63.6,136,65.7,2,0,0
11/25/2017 13:05,60,68.8,79,64.1,139,66.1,2,0,0
11/25/2017 13:10,61,68.8,79,64.2,140,66.2,2,0,0
11/25/2017 13:15,53,69.4,71,64.9,124,66.8,2,0,0
11/25/2017 13:20,63,69.2,81,64.6,144,66.6,2,0,0
11/25/2017 13:25,51,68.3,69,63.6,120,65.6,2,0,0
11/25/2017 13:30,68,69.2,87,64.6,155,66.6,2,0,0
11/25/2017 13:35,58,69.3,78,64.8,136,66.7,2,0,0
11/25/2017 13:40,58,68.7,76,64.1,134,66.1,2,0,0
11/25/2017 13:45,55,69.5,73,65,128,67,2,0,0
11/25/2017 13:50,58,68.8,76,64.3,134,66.2,2,0,0
11/25/2017 13:55,59,68.9,77,64.4,136,66.3,2,0,0
11/25/2017 14:00,62,69.5,81,65,143,66.9,2,0,0
11/25/2017 14:05,56,69.7,74,65.2,130,67.1,2,0,0
11/25/2017 14:10,61,68.9,79,64.3,140,66.3,2,0,0
11/25/2017 14:15,57,68.7,76,64.1,133,66.1,2,0,0
11/25/2017 14:20,62,68.7,81,64.1,143,66.1,2,0,0
11/25/2017 14:25,61,69.4,79,64.8,140,66.8,2,0,0
11/25/2017 14:30,66,70.3,85,65.8,151,67.8,2,0,0
11/25/2017 14:35,62,70.2,81,65.7,143,67.7,2,0,0
11/25/2017 14:40,60,70.3,78,65.8,138,67.8,2,0,0
11/25/2017 14:45,50,70.7,68,66.2,118,68.1,2,0,0
11/25/2017 14:50,56,69.7,74,65.1,130,67.1,2,0,0
11/25/2017 14:55,59,69.4,77,64.8,136,66.8,2,0,0
11/25/2017 15:00,60,70.2,79,65.8,139,67.7,2,0,0
11/25/2017 15:05,66,70.5,84,66,150,68,2,0,0
11/25/2017 15:10,65,70.1,84,65.6,149,67.6,2,0,0
11/25/2017 15:15,58,69.4,76,64.8,134,66.8,2,0,0
11/25/2017 15:20,61,69.6,79,65,140,67,2,0,0
11/25/2017 15:25,61,70.3,79,65.8,140,67.7,2,0,0
11/25/2017 15:30,62,69.6,82,65.1,144,67,2,0,0
11/25/2017 15:35,67,69.9,86,65.3,153,67.3,2,0,0
11/25/2017 15:40,66,69.5,85,64.9,151,66.9,2,0,0
11/25/2017 15:45,73,69.2,92,64.6,165,66.7,2,0,0
11/25/2017 15:50,66,69.1,85,64.5,151,66.5,2,0,0
11/25/2017 15:55,66,68.6,85,63.9,151,65.9,2,0,0
11/25/2017 16:00,68,69.6,87,65,155,67,2,0,0
11/25/2017 16:05,60,69.5,79,64.9,139,66.9,2,0,0
11/25/2017 16:10,56,69.1,74,64.5,130,66.5,2,0,0
11/25/2017 16:15,66,69.3,85,64.7,151,66.7,2,0,0
11/25/2017 16:20,66,69.3,85,64.7,151,66.7,2,0,0
11/25/2017 16:25,65,69.9,83,65.4,148,67.4,2,0,0
11/25/2017 16:30,71,69.8,90,65.2,161,67.2,2,0,0
11/25/2017 16:35,69,68.9,89,64.2,158,66.3,2,0,0
11/25/2017 16:40,71,69.7,91,65.2,162,67.2,2,0,0
11/25/2017 16:45,72,69.3,92,64.8,164,66.8,2,0,0
11/25/2017 16:50,71,69.5,91,65,162,67,2,0,0
11/25/2017 16:55,64,69.5,83,64.9,147,66.9,2,0,0
11/25/2017 17:00,55,68.5,74,63.8,129,65.8,2,0,0
11/25/2017 17:05,55,68.5,73,63.8,128,65.8,2,0,0
11/25/2017 17:10,62,68.6,79,64,141,66,2,0,0
11/25/2017 17:15,73,68.2,93,63.5,166,65.6,2,0,0
11/25/2017 17:20,61,68.2,79,63.5,140,65.6,2,0,0
11/25/2017 17:25,67,67.6,86,62.8,153,64.9,2,0,0
11/25/2017 17:30,60,67.8,79,63,139,65.1,2,0,0
11/25/2017 17:35,51,67.3,69,62.5,120,64.5,2,0,0
11/25/2017 17:40,59,67.1,77,62.3,136,64.4,2,0,0
11/25/2017 17:45,60,67.9,78,63.2,138,65.3,2,0,0
11/25/2017 17:50,51,67.9,70,63.2,121,65.2,2,0,0
11/25/2017 17:55,59,68.1,77,63.4,136,65.4,2,0,0
11/25/2017 18:00,48,68.6,66,63.9,114,65.9,2,0,0
11/25/2017 18:05,59,69.1,77,64.5,136,66.5,2,0,0
11/25/2017 18:10,56,68.4,74,63.8,130,65.8,2,0,0
11/25/2017 18:15,51,69.1,68,64.5,119,66.4,2,0,0
11/25/2017 18:20,54,69.2,73,64.6,127,66.5,2,0,0
11/25/2017 18:25,53,69.3,70,64.7,123,66.7,2,0,0
11/25/2017 18:30,52,69.1,70,64.5,122,66.4,2,0,0
11/25/2017 18:35,45,68.7,62,64.1,107,66,2,0,0
11/25/2017 18:40,42,68.7,59,64.1,101,66,2,0,0
11/25/2017 18:45,39,68.7,55,64.1,94,66,2,0,0
11/25/2017 18:50,57,67.9,76,63.2,133,65.2,2,0,0
11/25/2017 18:55,54,68.2,71,63.6,125,65.6,2,0,0
11/25/2017 19:00,44,68.5,61,63.8,105,65.8,2,0,0
11/25/2017 19:05,35,68.9,51,64.2,86,66.1,2,0,0
11/25/2017 19:10,38,69.7,54,65.1,92,67,2,0,0
11/25/2017 19:15,42,69.5,59,64.9,101,66.8,2,0,0
11/25/2017 19:20,48,70.6,66,66.1,114,68,2,0,0
11/25/2017 19:25,33,69.8,49,65.2,82,67,2,0,0
11/25/2017 19:30,35,69.5,52,64.9,87,66.8,2,0,0
11/25/2017 19:35,40,69.5,56,64.8,96,66.8,2,0,0
11/25/2017 19:40,41,69,58,64.4,99,66.3,2,0,0
11/25/2017 19:45,39,69.1,56,64.5,95,66.4,2,0,0
11/25/2017 19:50,38,69.1,53,64.5,91,66.4,2,0,0
11/25/2017 19:55,28,69.2,44,64.6,72,66.4,2,0,0
11/25/2017 20:00,41,68.9,58,64.3,99,66.2,2,0,0
11/25/2017 20:05,37,69.2,54,64.5,91,66.4,2,0,0
11/25/2017 20:10,43,69.2,60,64.6,103,66.5,2,0,0
11/25/2017 20:15,42,69,59,64.3,101,66.2,2,0,0
11/25/2017 20:20,39,68.9,55,64.3,94,66.2,2,0,0
11/25/2017 20:25,38,69.5,55,64.9,93,66.8,2,0,0
11/25/2017 20:30,29,69.1,46,64.5,75,66.3,2,0,0
11/25/2017 20:35,41,69.2,58,64.5,99,66.4,2,0,0
11/25/2017 20:40,36,69.2,52,64.5,88,66.4,2,0,0
11/25/2017 20:45,30,69.4,46,64.8,76,66.6,2,0,0
11/25/2017 20:50,26,69.5,42,64.9,68,66.7,2,0,0
11/25/2017 20:55,34,69.6,50,65,84,66.8,2,0,0
11/25/2017 21:00,31,69.3,47,64.7,78,66.5,2,0,0
11/25/2017 21:05,28,69.2,44,64.6,72,66.4,2,0,0
11/25/2017 21:10,40,68.7,56,64.1,96,66,2,0,0
11/25/2017 21:15,26,69.1,42,64.5,68,66.3,2,0,0
11/25/2017 21:20,38,69.5,55,64.9,93,66.8,2,0,0
11/25/2017 21:25,32,69.3,49,64.7,81,66.5,2,0,0
11/25/2017 21:30,36,69.3,53,64.7,89,66.5,2,0,0
11/25/2017 21:35,35,69.3,52,64.6,87,66.5,2,0,0
11/25/2017 21:40,42,69,59,64.3,101,66.3,2,0,0
11/25/2017 21:45,35,68.8,52,64.1,87,66,2,0,0
11/25/2017 21:50,32,69.1,49,64.4,81,66.3,2,0,0
11/25/2017 21:55,31,69,47,64.3,78,66.2,2,0,0
11/25/2017 22:00,28,69.2,45,64.6,73,66.3,2,0,0
11/25/2017 22:05,30,69.3,46,64.7,76,66.5,2,0,0
11/25/2017 22:10,24,68.9,39,64.2,63,66,2,0,0
11/25/2017 22:15,25,69,41,64.4,66,66.2,2,0,0
11/25/2017 22:20,33,69.1,49,64.5,82,66.4,2,0,0
11/25/2017 22:25,31,69.3,48,64.7,79,66.5,2,0,0
11/25/2017 22:30,30,69.8,46,65.2,76,67,2,0,0
11/25/2017 22:35,30,69.6,46,65,76,66.8,2,0,0
11/25/2017 22:40,27,69.8,43,65.2,70,67,2,0,0
11/25/2017 22:45,25,69.5,40,64.9,65,66.7,2,0,0
11/25/2017 22:50,27,69.6,43,65,70,66.8,2,0,0
11/25/2017 22:55,24,69.7,40,65.1,64,66.8,2,0,0
11/25/2017 23:00,25,69.4,41,64.8,66,66.5,2,0,0
11/25/2017 23:05,26,69.4,42,64.7,68,66.5,2,0,0
11/25/2017 23:10,24,69.5,40,64.9,64,66.6,2,0,0
11/25/2017 23:15,26,69.5,42,64.9,68,66.6,2,0,0
11/25/2017 23:20,20,69.4,35,64.8,55,66.5,2,0,0
11/25/2017 23:25,25,69.5,41,64.9,66,66.6,2,0,0
11/25/2017 23:30,26,69.6,42,65,68,66.8,2,0,0
11/25/2017 23:35,19,69.4,35,64.7,54,66.4,2,0,0
11/25/2017 23:40,17,69.4,32,64.8,49,66.4,2,0,0
11/25/2017 23:45,24,69.6,39,65,63,66.8,2,0,0
11/25/2017 23:50,17,69.6,32,65,49,66.6,2,0,0
11/25/2017 23:55,16,69.4,32,64.8,48,66.3,2,0,0
11/26/2017 0:00,20,69.3,36,64.7,56,66.4,2,0,0
11/26/2017 0:05,18,69.2,33,64.6,51,66.2,2,0,0
11/26/2017 0:10,12,69.2,28,64.6,40,66,2,0,0
11/26/2017 0:15,11,69.4,26,64.8,37,66.1,2,0,0
11/26/2017 0:20,10,69.4,26,64.8,36,66,2,0,0
11/26/2017 0:25,16,69.2,32,64.5,48,66.1,2,0,0
11/26/2017 0:30,13,69.3,28,64.7,41,66.1,2,0,0
11/26/2017 0:35,13,69.1,29,64.5,42,65.9,2,0,0
11/26/2017 0:40,13,69.3,29,64.7,42,66.1,2,0,0
11/26/2017 0:45,14,69.3,29,64.7,43,66.2,2,0,0
11/26/2017 0:50,13,69.2,28,64.6,41,66.1,2,0,0
11/26/2017 0:55,12,69.1,28,64.5,40,65.9,2,0,0
11/26/2017 1:00,10,69.2,25,64.6,35,65.9,2,0,0
11/26/2017 1:05,11,69.3,27,64.7,38,66,2,0,0
11/26/2017 1:10,10,69.3,25,64.7,35,66,2,0,0
11/26/2017 1:15,9,69.2,24,64.6,33,65.9,2,0,0
11/26/2017 1:20,9,69.3,24,64.7,33,66,2,0,0
11/26/2017 1:25,8,69.3,23,64.7,31,65.9,2,0,0
11/26/2017 1:30,8,69.1,23,64.5,31,65.7,2,0,0
11/26/2017 1:35,9,69.3,24,64.7,33,65.9,2,0,0
11/26/2017 1:40,9,68.9,24,64.2,33,65.5,2,0,0
11/26/2017 1:45,8,69.1,24,64.5,32,65.6,2,0,0
11/26/2017 1:50,8,69.3,24,64.7,32,65.8,2,0,0
11/26/2017 1:55,7,69.3,23,64.7,30,65.8,2,0,0
11/26/2017 2:00,14,69.4,22,64.8,36,66.6,2,0,0
11/26/2017 2:05,10,69.4,25,64.8,35,66.2,2,0,0
11/26/2017 2:10,10,69.4,25,64.8,35,66.1,2,0,0
11/26/2017 2:15,4,69.4,19,64.8,23,65.6,2,0,0
11/26/2017 2:20,8,69.1,23,64.5,31,65.7,2,0,0
11/26/2017 2:25,8,69.2,23,64.6,31,65.8,2,0,0
11/26/2017 2:30,6,69.3,21,64.7,27,65.7,2,0,0
11/26/2017 2:35,9,69.3,24,64.7,33,66,2,0,0
11/26/2017 2:40,8,69.4,24,64.8,32,66,2,0,0
11/26/2017 2:45,6,69.4,21,64.8,27,65.9,2,0,0
11/26/2017 2:50,8,69.4,23,64.8,31,66,2,0,0
11/26/2017 2:55,9,69.5,24,64.9,33,66.1,2,0,0
11/26/2017 3:00,7,69.5,23,64.9,30,66,2,0,0
11/26/2017 3:05,8,69.4,23,64.8,31,66,2,0,0
11/26/2017 3:10,8,69.4,24,64.8,32,66,2,0,0
11/26/2017 3:15,7,69.3,22,64.7,29,65.8,2,0,0
11/26/2017 3:20,10,69.4,25,64.8,35,66.1,2,0,0
11/26/2017 3:25,7,69.4,22,64.8,29,65.9,2,0,0
11/26/2017 3:30,8,69.4,23,64.8,31,66,2,0,0
11/26/2017 3:35,10,69.1,25,64.5,35,65.8,2,0,0
11/26/2017 3:40,7,69.2,23,64.6,30,65.7,2,0,0
11/26/2017 3:45,10,69.2,26,64.6,36,65.9,2,0,0
11/26/2017 3:50,15,69.3,30,64.7,45,66.2,2,0,0
11/26/2017 3:55,9,69.3,24,64.7,33,65.9,2,0,0
11/26/2017 4:00,9,69.3,24,64.7,33,66,2,0,0
11/26/2017 4:05,14,69.3,29,64.7,43,66.2,2,0,0
11/26/2017 4:10,13,69.4,29,64.8,42,66.2,2,0,0
11/26/2017 4:15,15,69.4,30,64.8,45,66.3,2,0,0
11/26/2017 4:20,14,69.3,29,64.7,43,66.2,2,0,0
11/26/2017 4:25,16,69.3,31,64.7,47,66.3,2,0,0
11/26/2017 4:30,14,69.3,30,64.7,44,66.2,2,0,0
11/26/2017 4:35,17,69.4,33,64.8,50,66.4,2,0,0
11/26/2017 4:40,27,69.4,42,64.8,69,66.6,2,0,0
11/26/2017 4:45,25,69.4,40,64.8,65,66.6,2,0,0
11/26/2017 4:50,25,69.2,41,64.6,66,66.4,2,0,0
11/26/2017 4:55,19,69.2,36,64.6,55,66.2,2,0,0
11/26/2017 5:00,19,69.2,35,64.6,54,66.2,2,0,0
11/26/2017 5:05,16,69.3,32,64.6,48,66.2,2,0,0
11/26/2017 5:10,18,68.9,34,64.2,52,65.9,2,0,0
11/26/2017 5:15,19,69.2,34,64.6,53,66.2,2,0,0
11/26/2017 5:20,20,69.3,37,64.7,57,66.3,2,0,0
11/26/2017 5:25,20,69,36,64.4,56,66,2,0,0
11/26/2017 5:30,17,69.1,33,64.5,50,66.1,2,0,0
11/26/2017 5:35,20,69.3,37,64.7,57,66.3,2,0,0
11/26/2017 5:40,23,69.2,39,64.6,62,66.3,2,0,0
11/26/2017 5:45,18,69.3,34,64.7,52,66.3,2,0,0
11/26/2017 5:50,17,69,33,64.4,50,66,2,0,0
11/26/2017 5:55,19,69.2,35,64.6,54,66.2,2,0,0
11/26/2017 6:00,16,69.3,32,64.7,48,66.3,2,0,0
11/26/2017 6:05,21,69.2,37,64.6,58,66.3,2,0,0
11/26/2017 6:10,18,69.2,33,64.6,51,66.2,2,0,0
11/26/2017 6:15,19,69.3,35,64.7,54,66.4,2,0,0
11/26/2017 6:20,18,69.1,33,64.5,51,66.1,2,0,0
11/26/2017 6:25,17,69.2,33,64.5,50,66.1,2,0,0
11/26/2017 6:30,23,69,39,64.4,62,66.1,2,0,0
11/26/2017 6:35,26,68.8,42,64.2,68,65.9,2,0,0
11/26/2017 6:40,21,69.1,37,64.5,58,66.2,2,0,0
11/26/2017 6:45,31,68.8,47,64.2,78,66,2,0,0
11/26/2017 6:50,22,68.9,38,64.2,60,65.9,2,0,0
11/26/2017 6:55,22,68.9,38,64.3,60,66,2,0,0
11/26/2017 7:00,27,68.9,43,64.3,70,66.1,2,0,0
11/26/2017 7:05,28,69,44,64.4,72,66.2,2,0,0
11/26/2017 7:10,21,68.7,37,64.1,58,65.7,2,0,0
11/26/2017 7:15,27,68.7,43,64,70,65.8,2,0,0
11/26/2017 7:20,24,68.9,40,64.3,64,66,2,0,0
11/26/2017 7:25,24,69.1,40,64.4,64,66.2,2,0,0
11/26/2017 7:30,23,69.1,39,64.5,62,66.2,2,0,0
11/26/2017 7:35,32,69.2,50,64.5,82,66.3,2,0,0
11/26/2017 7:40,42,69.8,59,65.2,101,67.1,2,0,0
11/26/2017 7:45,45,69.3,62,64.7,107,66.6,2,0,0
11/26/2017 7:50,37,68.9,54,64.3,91,66.2,2,0,0
11/26/2017 7:55,34,68.9,51,64.3,85,66.2,2,0,0
11/26/2017 8:00,38,69.3,55,64.7,93,66.6,2,0,0
11/26/2017 8:05,32,68.8,49,64.1,81,66,2,0,0
11/26/2017 8:10,34,68.4,51,63.8,85,65.6,2,0,0
11/26/2017 8:15,40,68.5,57,63.8,97,65.7,2,0,0
11/26/2017 8:20,33,68.1,50,63.4,83,65.2,2,0,0
11/26/2017 8:25,35,68.6,51,63.9,86,65.8,2,0,0
11/26/2017 8:30,47,68.1,65,63.4,112,65.3,2,0,0
11/26/2017 8:35,31,68.4,47,63.7,78,65.6,2,0,0
11/26/2017 8:40,38,68.4,55,63.7,93,65.6,2,0,0
11/26/2017 8:45,35,69.1,52,64.4,87,66.3,2,0,0
11/26/2017 8:50,35,69.2,52,64.6,87,66.4,2,0,0
11/26/2017 8:55,35,69.1,53,64.5,88,66.3,2,0,0
11/26/2017 9:00,36,69.4,53,64.8,89,66.7,2,0,0
11/26/2017 9:05,37,69.6,54,65,91,66.9,2,0,0
11/26/2017 9:10,32,69.7,49,65.1,81,66.9,2,0,0
11/26/2017 9:15,43,69.8,61,65.3,104,67.1,2,0,0
11/26/2017 9:20,40,70.4,57,65.9,97,67.7,2,0,0
11/26/2017 9:25,35,69.6,53,65,88,66.8,2,0,0
11/26/2017 9:30,49,69,67,64.4,116,66.4,2,0,0
11/26/2017 9:35,49,68.2,67,63.5,116,65.5,2,0,0
11/26/2017 9:40,43,68.2,60,63.4,103,65.4,2,0,0
11/26/2017 9:45,52,67.4,70,62.6,122,64.7,2,0,0
11/26/2017 9:50,46,67.7,64,62.9,110,64.9,2,0,0
11/26/2017 9:55,50,67.2,68,62.4,118,64.4,2,0,0
11/26/2017 10:00,49,66.5,67,61.6,116,63.7,2,0,0
11/26/2017 10:05,49,67,68,62.1,117,64.2,2,0,0
11/26/2017 10:10,41,67.1,60,62.3,101,64.2,2,0,0
11/26/2017 10:15,59,66.5,78,61.5,137,63.7,2,0,0
11/26/2017 10:20,55,66.8,72,61.9,127,64,2,0,0
11/26/2017 10:25,64,66.4,82,61.4,146,63.6,2,0,0
11/26/2017 10:30,50,66,68,61,118,63.1,2,0,0
11/26/2017 10:35,57,65.7,76,60.6,133,62.8,2,0,0
11/26/2017 10:40,54,66.9,72,62,126,64.1,2,0,0
11/26/2017 10:45,62,66.8,80,61.9,142,64,2,0,0
11/26/2017 10:50,51,66.7,69,61.9,120,63.9,2,0,0
11/26/2017 10:55,71,66.8,90,61.9,161,64.1,2,0,0
11/26/2017 11:00,53,66,70,61,123,63.1,2,0,0
11/26/2017 11:05,62,65.8,81,60.8,143,63,2,0,0
11/26/2017 11:10,55,66.2,74,61.3,129,63.4,2,0,0
11/26/2017 11:15,59,65,77,59.9,136,62.1,2,0,0
11/26/2017 11:20,43,65.4,60,60.4,103,62.5,2,0,0
11/26/2017 11:25,55,65,74,59.9,129,62.1,2,0,0
11/26/2017 11:30,58,63.9,77,58.7,135,60.9,2,0,0
11/26/2017 11:35,52,64.8,70,59.7,122,61.8,2,0,0
11/26/2017 11:40,61,65.9,79,60.9,140,63.1,2,0,0
11/26/2017 11:45,56,65.3,75,60.3,131,62.4,2,0,0
11/26/2017 11:50,72,65.2,93,60.1,165,62.3,2,0,0
11/26/2017 11:55,60,65.2,79,60.1,139,62.3,2,0,0
11/26/2017 12:00,59,65.9,78,60.9,137,63,2,0,0
11/26/2017 12:05,51,65.9,70,60.8,121,63,2,0,0
11/26/2017 12:10,45,66.6,62,61.6,107,63.7,2,0,0
11/26/2017 12:15,50,65.7,68,60.7,118,62.8,2,0,0
11/26/2017 12:20,62,65.3,80,60.3,142,62.5,2,0,0
11/26/2017 12:25,51,66.1,69,61.1,120,63.2,2,0,0
11/26/2017 12:30,61,66.5,79,61.7,140,63.8,2,0,0
11/26/2017 12:35,48,64.8,65,59.7,113,61.8,2,0,0
11/26/2017 12:40,54,64.7,72,59.6,126,61.8,2,0,0
11/26/2017 12:45,50,64.8,67,59.7,117,61.8,2,0,0
11/26/2017 12:50,58,64.5,77,59.4,135,61.6,2,0,0
11/26/2017 12:55,49,65.1,67,60.1,116,62.2,2,0,0
11/26/2017 13:00,58,65.3,76,60.3,134,62.5,2,0,0
11/26/2017 13:05,47,65.9,66,61,113,63,2,0,0
11/26/2017 13:10,46,65.6,63,60.6,109,62.7,2,0,0
11/26/2017 13:15,41,64.8,58,59.7,99,61.8,2,0,0
11/26/2017 13:20,52,65,70,60,122,62.2,2,0,0
11/26/2017 13:25,49,65.7,66,60.7,115,62.8,2,0,0
11/26/2017 13:30,49,66.1,67,61.2,116,63.2,2,0,0
11/26/2017 13:35,44,67.1,61,62.3,105,64.3,2,0,0
11/26/2017 13:40,50,67,68,62.1,118,64.2,2,0,0
11/26/2017 13:45,53,65.9,70,60.9,123,63.1,2,0,0
11/26/2017 13:50,51,66.2,68,61.3,119,63.4,2,0,0
11/26/2017 13:55,47,65.8,65,60.8,112,62.9,2,0,0
11/26/2017 14:00,50,66,67,61,117,63.1,2,0,0
11/26/2017 14:05,46,65.9,64,61,110,63.1,2,0,0
11/26/2017 14:10,55,65.3,72,60.2,127,62.4,2,0,0
11/26/2017 14:15,49,65,67,59.9,116,62,2,0,0
11/26/2017 14:20,51,65,68,59.8,119,62,2,0,0
11/26/2017 14:25,57,65.2,74,60,131,62.3,2,0,0
11/26/2017 14:30,54,65.8,72,60.8,126,62.9,2,0,0
11/26/2017 14:35,45,66.2,62,61.2,107,63.3,2,0,0
11/26/2017 14:40,53,66.2,70,61.2,123,63.4,2,0,0
11/26/2017 14:45,53,65.9,70,61,123,63.1,2,0,0
11/26/2017 14:50,51,65.9,69,60.9,120,63,2,0,0
11/26/2017 14:55,46,66.7,63,61.8,109,63.8,2,0,0
11/26/2017 15:00,50,67.3,67,62.4,117,64.5,2,0,0
11/26/2017 15:05,48,67.1,65,62.3,113,64.3,2,0,0
11/26/2017 15:10,45,67.5,62,62.7,107,64.7,2,0,0
11/26/2017 15:15,59,66.9,77,62.1,136,64.2,2,0,0
11/26/2017 15:20,60,66.3,78,61.4,138,63.5,2,0,0
11/26/2017 15:25,55,66.7,74,61.8,129,63.9,2,0,0
11/26/2017 15:30,54,67.6,72,62.7,126,64.8,2,0,0
11/26/2017 15:35,60,67,79,62.1,139,64.2,2,0,0
11/26/2017 15:40,53,67.5,72,62.7,125,64.7,2,0,0
11/26/2017 15:45,52,67.4,71,62.5,123,64.6,2,0,0
11/26/2017 15:50,54,66.7,73,61.8,127,63.9,2,0,0
11/26/2017 15:55,54,66.6,72,61.7,126,63.8,2,0,0
11/26/2017 16:00,43,67.4,60,62.6,103,64.6,2,0,0
11/26/2017 16:05,48,67.7,66,63,114,65,2,0,0
11/26/2017 16:10,49,67.9,66,63.1,115,65.2,2,0,0
11/26/2017 16:15,49,67.5,67,62.7,116,64.7,2,0,0
11/26/2017 16:20,56,66.9,73,62,129,64.1,2,0,0
11/26/2017 16:25,42,67.5,58,62.8,100,64.8,2,0,0
11/26/2017 16:30,50,67.4,69,62.7,119,64.7,2,0,0
11/26/2017 16:35,52,67.7,70,63,122,65,2,0,0
11/26/2017 16:40,47,68.1,64,63.4,111,65.4,2,0,0
11/26/2017 16:45,51,68.7,69,64,120,66,2,0,0
11/26/2017 16:50,40,68.6,56,63.9,96,65.8,2,0,0
11/26/2017 16:55,48,68.1,65,63.3,113,65.3,2,0,0
11/26/2017 17:00,48,67.9,66,63.2,114,65.2,2,0,0
11/26/2017 17:05,39,68.9,56,64.3,95,66.2,2,0,0
11/26/2017 17:10,46,69,63,64.4,109,66.3,2,0,0
11/26/2017 17:15,46,69.1,62,64.5,108,66.5,2,0,0
11/26/2017 17:20,50,68.8,66,64.1,116,66.1,2,0,0
11/26/2017 17:25,53,68.7,71,64.1,124,66.1,2,0,0
11/26/2017 17:30,42,68.6,59,64,101,65.9,2,0,0
11/26/2017 17:35,58,68.4,77,63.7,135,65.7,2,0,0
11/26/2017 17:40,56,68.3,74,63.6,130,65.7,2,0,0
11/26/2017 17:45,42,68.5,59,63.8,101,65.7,2,0,0
11/26/2017 17:50,50,68.5,68,63.8,118,65.8,2,0,0
11/26/2017 17:55,42,68.6,59,63.9,101,65.9,2,0,0
11/26/2017 18:00,46,67.8,63,63,109,65,2,0,0
11/26/2017 18:05,50,67.5,67,62.7,117,64.7,2,0,0
11/26/2017 18:10,43,67.7,61,62.9,104,64.9,2,0,0
11/26/2017 18:15,46,68.4,63,63.7,109,65.7,2,0,0
11/26/2017 18:20,50,68.8,68,64.2,118,66.1,2,0,0
11/26/2017 18:25,43,69.2,60,64.6,103,66.6,2,0,0
11/26/2017 18:30,50,68.4,68,63.8,118,65.8,2,0,0
11/26/2017 18:35,40,68.6,57,63.9,97,65.8,2,0,0
11/26/2017 18:40,41,69.3,58,64.7,99,66.6,2,0,0
11/26/2017 18:45,46,68.6,64,64,110,65.9,2,0,0
11/26/2017 18:50,44,68.8,62,64.2,106,66.1,2,0,0
11/26/2017 18:55,41,69.4,57,64.8,98,66.7,2,0,0
11/26/2017 19:00,37,69.9,54,65.3,91,67.1,2,0,0
11/26/2017 19:05,45,68.8,63,64.1,108,66,2,0,0
11/26/2017 19:10,37,68.9,53,64.2,90,66.1,2,0,0
11/26/2017 19:15,45,69,61,64.3,106,66.3,2,0,0
11/26/2017 19:20,40,69.1,56,64.5,96,66.4,2,0,0
11/26/2017 19:25,37,68.1,54,63.4,91,65.3,2,0,0
11/26/2017 19:30,27,68.9,42,64.2,69,66,2,0,0
11/26/2017 19:35,38,69,55,64.4,93,66.3,2,0,0
11/26/2017 19:40,33,69.1,49,64.4,82,66.3,2,0,0
11/26/2017 19:45,31,69,46,64.4,77,66.3,2,0,0
11/26/2017 19:50,35,68.5,51,63.9,86,65.8,2,0,0
11/26/2017 19:55,41,68.6,58,63.9,99,65.8,2,0,0
11/26/2017 20:00,31,68.5,47,63.8,78,65.7,2,0,0
11/26/2017 20:05,30,68.9,47,64.2,77,66.1,2,0,0
11/26/2017 20:10,28,67.8,44,63.1,72,65,2,0,0
11/26/2017 20:15,31,68.3,47,63.6,78,65.5,2,0,0
11/26/2017 20:20,32,68.3,48,63.6,80,65.5,2,0,0
11/26/2017 20:25,35,68.4,51,63.7,86,65.6,2,0,0
11/26/2017 20:30,41,68.5,57,63.8,98,65.8,2,0,0
11/26/2017 20:35,34,69.2,51,64.6,85,66.4,2,0,0
11/26/2017 20:40,39,69,56,64.4,95,66.3,2,0,0
11/26/2017 20:45,31,68.8,48,64.2,79,66,2,0,0
11/26/2017 20:50,32,68.1,48,63.4,80,65.3,2,0,0
11/26/2017 20:55,35,68.1,52,63.4,87,65.3,2,0,0
11/26/2017 21:00,35,68.6,52,63.9,87,65.8,2,0,0
11/26/2017 21:05,37,68.5,54,63.8,91,65.7,2,0,0
11/26/2017 21:10,32,68.9,48,64.2,80,66.1,2,0,0
11/26/2017 21:15,32,68.5,47,63.8,79,65.7,2,0,0
11/26/2017 21:20,31,69.1,48,64.5,79,66.3,2,0,0
11/26/2017 21:25,34,69.1,50,64.5,84,66.4,2,0,0
11/26/2017 21:30,28,68.9,44,64.2,72,66.1,2,0,0
11/26/2017 21:35,32,69.2,48,64.5,80,66.4,2,0,0
11/26/2017 21:40,28,69.4,44,64.8,72,66.6,2,0,0
11/26/2017 21:45,22,69.3,38,64.7,60,66.4,2,0,0
11/26/2017 21:50,25,69.3,41,64.7,66,66.4,2,0,0
11/26/2017 21:55,27,69.3,43,64.7,70,66.4,2,0,0
11/26/2017 22:00,25,68.7,41,64.1,66,65.8,2,0,0
11/26/2017 22:05,18,68.8,34,64.1,52,65.7,2,0,0
11/26/2017 22:10,24,68.8,40,64.2,64,65.9,2,0,0
11/26/2017 22:15,24,69,40,64.4,64,66.1,2,0,0
11/26/2017 22:20,26,69,42,64.4,68,66.1,2,0,0
11/26/2017 22:25,25,69.3,42,64.7,67,66.4,2,0,0
11/26/2017 22:30,25,69.2,41,64.5,66,66.3,2,0,0
11/26/2017 22:35,19,69.3,35,64.7,54,66.3,2,0,0
11/26/2017 22:40,21,69.4,37,64.8,58,66.5,2,0,0
11/26/2017 22:45,26,69.4,41,64.8,67,66.6,2,0,0
11/26/2017 22:50,23,69.4,38,64.8,61,66.6,2,0,0
11/26/2017 22:55,16,69.3,31,64.7,47,66.3,2,0,0
11/26/2017 23:00,18,69.3,33,64.7,51,66.4,2,0,0
11/26/2017 23:05,18,69.2,34,64.6,52,66.2,2,0,0
11/26/2017 23:10,19,69.2,34,64.6,53,66.3,2,0,0
11/26/2017 23:15,15,68.9,30,64.2,45,65.8,2,0,0
11/26/2017 23:20,18,69,33,64.4,51,66,2,0,0
11/26/2017 23:25,20,69,35,64.4,55,66.1,2,0,0
11/26/2017 23:30,22,68.5,37,63.8,59,65.5,2,0,0
11/26/2017 23:35,23,68.7,39,64,62,65.8,2,0,0
11/26/2017 23:40,24,68.9,39,64.3,63,66,2,0,0
11/26/2017 23:45,18,69.1,33,64.5,51,66.1,2,0,0
11/26/2017 23:50,17,69.3,33,64.7,50,66.2,2,0,0
11/26/2017 23:55,16,68.3,31,63.7,47,65.3,2,0,0
