5 Minutes,Lane 1 Flow (Veh/5 Minutes),Lane 1 Speed (mph),Lane 2 Flow (Veh/5 Minutes),Lane 2 Speed (mph),Flow (Veh/5 Minutes),Speed (mph),# Lane Points,% Observed,Holiday
11/27/2017 0:00,8,69.3,23,64.7,31,65.9,2,0,0
11/27/2017 0:05,12,69.1,27,64.4,39,65.9,2,0,0
11/27/2017 0:10,11,68.8,26,64.2,37,65.6,2,0,0
11/27/2017 0:15,15,68,30,63.2,45,64.8,2,0,0
11/27/2017 0:20,15,67.8,30,63.1,45,64.6,2,0,0
11/27/2017 0:25,15,67,29,62.3,44,63.9,2,0,0
11/27/2017 0:30,13,67.8,28,63.1,41,64.6,2,0,0
11/27/2017 0:35,11,68.2,26,63.5,37,64.9,2,0,0
11/27/2017 0:40,13,68.3,29,63.6,42,65,2,0,0
11/27/2017 0:45,12,67.9,27,63.2,39,64.7,2,0,0
11/27/2017 0:50,11,68.2,27,63.6,38,64.9,2,0,0
11/27/2017 0:55,13,68.4,28,63.7,41,65.2,2,0,0
11/27/2017 1:00,9,68.7,24,64,33,65.3,2,0,0
11/27/2017 1:05,11,68.7,26,64.1,37,65.5,2,0,0
11/27/2017 1:10,11,68.7,26,64,37,65.4,2,0,0
11/27/2017 1:15,9,68.5,24,63.8,33,65.1,2,0,0
11/27/2017 1:20,11,68.4,26,63.7,37,65.1,2,0,0
11/27/2017 1:25,14,68.4,29,63.8,43,65.3,2,0,0
11/27/2017 1:30,10,67.9,25,63.2,35,64.6,2,0,0
11/27/2017 1:35,14,68.3,29,63.6,43,65.1,2,0,0
11/27/2017 1:40,10,68.7,25,64,35,65.3,2,0,0
11/27/2017 1:45,8,68.9,24,64.2,32,65.4,2,0,0
11/27/2017 1:50,11,68.8,26,64.1,37,65.5,2,0,0
11/27/2017 1:55,15,69,22,64.4,37,66.3,2,0,0
11/27/2017 2:00,10,69.2,26,64.5,36,65.8,2,0,0
11/27/2017 2:05,6,69.1,21,64.5,27,65.5,2,0,0
11/27/2017 2:10,7,69.2,23,64.5,30,65.6,2,0,0
11/27/2017 2:15,13,69.2,21,64.6,34,66.4,2,0,0
11/27/2017 2:20,10,68.9,25,64.2,35,65.5,2,0,0
11/27/2017 2:25,10,68.6,25,64,35,65.3,2,0,0
11/27/2017 2:30,8,69,24,64.4,32,65.5,2,0,0
11/27/2017 2:35,10,69,25,64.3,35,65.6,2,0,0
11/27/2017 2:40,10,69.1,25,64.5,35,65.8,2,0,0
11/27/2017 2:45,12,69.2,28,64.6,40,66,2,0,0
11/27/2017 2:50,9,69.2,24,64.6,33,65.9,2,0,0
11/27/2017 2:55,10,69.1,25,64.5,35,65.8,2,0,0
11/27/2017 3:00,8,69.2,24,64.5,32,65.7,2,0,0
11/27/2017 3:05,12,69.2,28,64.5,40,65.9,2,0,0
11/27/2017 3:10,11,68.9,27,64.2,38,65.6,2,0,0
11/27/2017 3:15,10,68.8,25,64.2,35,65.5,2,0,0
11/27/2017 3:20,12,68.8,27,64.2,39,65.6,2,0,0
11/27/2017 3:25,13,68.9,28,64.2,41,65.7,2,0,0
11/27/2017 3:30,11,68.6,26,64,37,65.4,2,0,0
11/27/2017 3:35,14,68.5,30,63.8,44,65.3,2,0,0
11/27/2017 3:40,15,68.5,30,63.8,45,65.4,2,0,0
11/27/2017 3:45,17,67.8,32,63.1,49,64.7,2,0,0
11/27/2017 3:50,17,68.5,32,63.8,49,65.4,2,0,0
11/27/2017 3:55,21,68.4,38,63.7,59,65.3,2,0,0
11/27/2017 4:00,15,68.7,30,64.1,45,65.6,2,0,0
11/27/2017 4:05,21,68.7,37,64,58,65.7,2,0,0
11/27/2017 4:10,19,68.9,35,64.2,54,65.9,2,0,0
11/27/2017 4:15,19,68.6,34,63.9,53,65.6,2,0,0
11/27/2017 4:20,31,68.8,48,64.1,79,66,2,0,0
11/27/2017 4:25,27,68.5,43,63.8,70,65.6,2,0,0
11/27/2017 4:30,31,68.5,48,63.8,79,65.7,2,0,0
11/27/2017 4:35,36,68.7,54,63.9,90,65.8,2,0,0
11/27/2017 4:40,34,68.6,50,63.8,84,65.7,2,0,0
11/27/2017 4:45,53,68.8,72,64,125,66.1,2,0,0
11/27/2017 4:50,44,68.5,61,63.7,105,65.7,2,0,0
11/27/2017 4:55,48,67.3,67,62.4,115,64.5,2,0,0
11/27/2017 5:00,46,68.5,65,63.7,111,65.7,2,0,0
11/27/2017 5:05,48,68.1,66,63.3,114,65.3,2,0,0
11/27/2017 5:10,44,66.7,64,61.8,108,63.8,2,0,0
11/27/2017 5:15,54,68.5,74,63.8,128,65.8,2,0,0
11/27/2017 5:20,53,68.7,73,64,126,66,2,0,0
11/27/2017 5:25,54,67.1,74,62.2,128,64.3,2,0,0
11/27/2017 5:30,62,68,82,63.2,144,65.3,2,0,0
11/27/2017 5:35,70,68.4,92,63.6,162,65.7,2,0,0
11/27/2017 5:40,64,68.6,85,63.9,149,65.9,2,0,0
11/27/2017 5:45,58,68.2,79,63.5,137,65.5,2,0,0
11/27/2017 5:50,64,68.5,86,63.8,150,65.8,2,0,0
11/27/2017 5:55,65,68.8,86,64.1,151,66.2,2,0,0
11/27/2017 6:00,57,68.3,77,63.6,134,65.6,2,0,0
11/27/2017 6:05,63,67.8,85,63,148,65.1,2,0,0
11/27/2017 6:10,64,66,85,61.1,149,63.2,2,0,0
11/27/2017 6:15,67,66.1,88,61.1,155,63.3,2,0,0
11/27/2017 6:20,72,66.1,95,61.1,167,63.2,2,0,0
11/27/2017 6:25,62,66.9,83,62,145,64.1,2,0,0
11/27/2017 6:30,69,66.4,91,61.5,160,63.6,2,0,0
11/27/2017 6:35,75,66.6,98,61.6,173,63.8,2,0,0
11/27/2017 6:40,68,66.9,89,62,157,64.1,2,0,0
11/27/2017 6:45,74,67,97,62.1,171,64.2,2,0,0
11/27/2017 6:50,72,67.8,95,62.9,167,65,2,0,0
11/27/2017 6:55,59,67.4,81,62.6,140,64.6,2,0,0
11/27/2017 7:00,60,67.4,81,62.6,141,64.7,2,0,0
11/27/2017 7:05,74,68.6,96,63.9,170,66,2,0,0
11/27/2017 7:10,64,68.5,85,63.8,149,65.8,2,0,0
11/27/2017 7:15,68,68.7,88,64,156,66.1,2,0,0
11/27/2017 7:20,74,68.4,97,63.7,171,65.7,2,0,0
11/27/2017 7:25,81,66,105,61.1,186,63.2,2,0,0
11/27/2017 7:30,83,67.4,105,62.6,188,64.7,2,0,0
11/27/2017 7:35,82,67.4,106,62.5,188,64.6,2,0,0
11/27/2017 7:40,92,66.8,116,61.9,208,64,2,0,0
11/27/2017 7:45,87,66.4,110,61.4,197,63.6,2,0,0
11/27/2017 7:50,81,67.6,104,62.9,185,65,2,0,0
11/27/2017 7:55,90,67.2,113,62.3,203,64.5,2,0,0
11/27/2017 8:00,75,67.1,98,62.3,173,64.4,2,0,0
11/27/2017 8:05,87,66.4,110,61.6,197,63.7,2,0,0
11/27/2017 8:10,93,65.6,117,60.7,210,62.8,2,0,0
11/27/2017 8:15,82,66.7,106,61.8,188,63.9,2,0,0
11/27/2017 8:20,83,66,106,61.1,189,63.2,2,0,0
11/27/2017 8:25,88,65.6,112,60.6,200,62.8,2,0,0
11/27/2017 8:30,87,65.4,110,60.4,197,62.6,2,0,0
11/27/2017 8:35,81,66.7,103,61.8,184,64,2,0,0
11/27/2017 8:40,77,66.2,98,61.3,175,63.4,2,0,0
11/27/2017 8:45,77,66.6,98,61.8,175,63.9,2,0,0
11/27/2017 8:50,77,65.5,100,60.5,177,62.7,2,0,0
11/27/2017 8:55,74,65.8,94,60.8,168,63,2,0,0
11/27/2017 9:00,70,66.3,90,61.4,160,63.5,2,0,0
11/27/2017 9:05,65,66.2,86,61.3,151,63.4,2,0,0
11/27/2017 9:10,73,65.5,93,60.6,166,62.7,2,0,0
11/27/2017 9:15,61,66.2,81,61.3,142,63.4,2,0,0
11/27/2017 9:20,66,66.3,87,61.3,153,63.5,2,0,0
11/27/2017 9:25,67,67,89,62.2,156,64.3,2,0,0
11/27/2017 9:30,62,65.8,83,60.9,145,63,2,0,0
11/27/2017 9:35,75,66.9,95,62,170,64.2,2,0,0
11/27/2017 9:40,78,65,100,60,178,62.2,2,0,0
11/27/2017 9:45,68,66.3,86,61.3,154,63.5,2,0,0
11/27/2017 9:50,71,66.6,92,61.7,163,63.9,2,0,0
11/27/2017 9:55,70,66.8,90,62,160,64.1,2,0,0
11/27/2017 10:00,64,67.6,84,62.8,148,64.9,2,0,0
11/27/2017 10:05,67,68.7,87,64,154,66.1,2,0,0
11/27/2017 10:10,58,69,77,64.3,135,66.3,2,0,0
11/27/2017 10:15,60,68.7,78,64,138,66.1,2,0,0
11/27/2017 10:20,66,68.7,85,64,151,66.1,2,0,0
11/27/2017 10:25,54,68.2,72,63.4,126,65.5,2,0,0
11/27/2017 10:30,55,66.5,74,61.6,129,63.7,2,0,0
11/27/2017 10:35,66,66.5,84,61.7,150,63.8,2,0,0
11/27/2017 10:40,56,66.6,75,61.7,131,63.8,2,0,0
11/27/2017 10:45,54,66.8,72,62,126,64,2,0,0
11/27/2017 10:50,55,67.3,73,62.5,128,64.6,2,0,0
11/27/2017 10:55,66,67.7,85,62.9,151,65,2,0,0
11/27/2017 11:00,50,68.3,68,63.5,118,65.5,2,0,0
11/27/2017 11:05,66,67.4,85,62.7,151,64.8,2,0,0
11/27/2017 11:10,59,67.9,78,63.2,137,65.2,2,0,0
11/27/2017 11:15,62,67.5,80,62.7,142,64.8,2,0,0
11/27/2017 11:20,62,69.2,80,64.5,142,66.5,2,0,0
11/27/2017 11:25,55,68.6,74,64.1,129,66,2,0,0
11/27/2017 11:30,59,68.7,78,64.1,137,66.1,2,0,0
11/27/2017 11:35,65,67.7,85,63,150,65.1,2,0,0
11/27/2017 11:40,63,66.9,82,62,145,64.1,2,0,0
11/27/2017 11:45,60,67.4,79,62.7,139,64.7,2,0,0
11/27/2017 11:50,54,67.7,72,63,126,65,2,0,0
11/27/2017 11:55,51,68.5,68,63.9,119,65.9,2,0,0
11/27/2017 12:00,49,69.5,66,65,115,66.9,2,0,0
11/27/2017 12:05,52,69.1,70,64.5,122,66.5,2,0,0
11/27/2017 12:10,51,69.2,69,64.6,120,66.5,2,0,0
11/27/2017 12:15,52,68.5,71,63.8,123,65.8,2,0,0
11/27/2017 12:20,52,69.6,70,65.1,122,67,2,0,0
11/27/2017 12:25,51,70.2,69,65.8,120,67.7,2,0,0
11/27/2017 12:30,47,70.2,65,65.7,112,67.6,2,0,0
11/27/2017 12:35,50,69.5,68,64.9,118,66.8,2,0,0
11/27/2017 12:40,60,69,79,64.3,139,66.3,2,0,0
11/27/2017 12:45,42,68.6,59,63.9,101,65.8,2,0,0
11/27/2017 12:50,46,68.3,63,63.5,109,65.5,2,0,0
11/27/2017 12:55,42,68.5,59,63.8,101,65.8,2,0,0
11/27/2017 13:00,47,67.4,64,62.5,111,64.6,2,0,0
11/27/2017 13:05,46,68.6,64,64,110,65.9,2,0,0
11/27/2017 13:10,50,69.6,68,65.1,118,67,2,0,0
11/27/2017 13:15,45,69.1,62,64.5,107,66.4,2,0,0
11/27/2017 13:20,47,68.6,64,63.9,111,65.9,2,0,0
11/27/2017 13:25,45,69.1,63,64.5,108,66.4,2,0,0
11/27/2017 13:30,55,69.3,73,64.7,128,66.7,2,0,0
11/27/2017 13:35,58,69.1,77,64.5,135,66.4,2,0,0
11/27/2017 13:40,55,69.7,73,65.2,128,67.1,2,0,0
11/27/2017 13:45,45,70.5,63,65.9,108,67.8,2,0,0
11/27/2017 13:50,48,69.8,66,65.2,114,67.1,2,0,0
11/27/2017 13:55,50,69.8,68,65.3,118,67.2,2,0,0
11/27/2017 14:00,44,70,62,65.4,106,67.3,2,0,0
11/27/2017 14:05,46,70.2,63,65.7,109,67.6,2,0,0
11/27/2017 14:10,48,69.6,66,65.1,114,67,2,0,0
11/27/2017 14:15,49,68.9,66,64.3,115,66.2,2,0,0
11/27/2017 14:20,54,69.2,72,64.6,126,66.5,2,0,0
11/27/2017 14:25,49,68.9,68,64.3,117,66.2,2,0,0
11/27/2017 14:30,42,67.9,60,63.2,102,65.2,2,0,0
11/27/2017 14:35,42,68.7,60,64.1,102,66,2,0,0
11/27/2017 14:40,39,69.2,56,64.6,95,66.5,2,0,0
11/27/2017 14:45,47,67.8,66,63.1,113,65,2,0,0
11/27/2017 14:50,32,67.4,48,62.6,80,64.5,2,0,0
11/27/2017 14:55,42,68.3,60,63.6,102,65.6,2,0,0
11/27/2017 15:00,43,68.6,60,63.9,103,65.8,2,0,0
11/27/2017 15:05,42,69.1,60,64.5,102,66.4,2,0,0
11/27/2017 15:10,45,69.1,64,64.6,109,66.4,2,0,0
11/27/2017 15:15,50,69.9,68,65.3,118,67.2,2,0,0
11/27/2017 15:20,45,68.8,62,64.2,107,66.1,2,0,0
11/27/2017 15:25,55,67.9,74,63.2,129,65.2,2,0,0
11/27/2017 15:30,53,68.5,71,63.8,124,65.8,2,0,0
11/27/2017 15:35,48,68,66,63.3,114,65.3,2,0,0
11/27/2017 15:40,50,69,68,64.4,118,66.3,2,0,0
11/27/2017 15:45,67,68.7,87,64.1,154,66.1,2,0,0
11/27/2017 15:50,64,67.5,83,62.8,147,64.8,2,0,0
11/27/2017 15:55,57,66.9,75,62.1,132,64.2,2,0,0
11/27/2017 16:00,54,68.6,72,63.9,126,65.9,2,0,0
11/27/2017 16:05,64,68.3,83,63.6,147,65.7,2,0,0
11/27/2017 16:10,58,68,77,63.3,135,65.3,2,0,0
11/27/2017 16:15,65,67,85,62.1,150,64.2,2,0,0
11/27/2017 16:20,59,63.8,78,58.6,137,60.9,2,0,0
11/27/2017 16:25,58,58.9,77,53.1,135,55.6,2,0,0
11/27/2017 16:30,54,58.8,72,53.1,126,55.5,2,0,0
11/27/2017 16:35,49,58.2,68,52.4,117,54.8,2,0,0
11/27/2017 16:40,49,62.2,68,56.9,117,59.1,2,0,0
11/27/2017 16:45,47,65,64,60,111,62.1,2,0,0
11/27/2017 16:50,44,66.5,63,61.5,107,63.6,2,0,0
11/27/2017 16:55,57,66.3,76,61.4,133,63.5,2,0,0
11/27/2017 17:00,48,68,67,63.3,115,65.3,2,0,0
11/27/2017 17:05,45,67.2,62,62.5,107,64.5,2,0,0
11/27/2017 17:10,50,63.1,69,57.9,119,60.1,2,0,0
11/27/2017 17:15,44,60.9,63,55.3,107,57.6,2,0,0
11/27/2017 17:20,54,56.1,72,50,126,52.6,2,0,0
11/27/2017 17:25,44,51.4,63,44.7,107,47.5,2,0,0
11/27/2017 17:30,57,47.4,76,40.3,133,43.3,2,0,0
11/27/2017 17:35,44,47.3,62,40.2,106,43.2,2,0,0
11/27/2017 17:40,55,41.5,74,33.8,129,37.1,2,0,0
11/27/2017 17:45,56,39.6,76,31.7,132,35.1,2,0,0
11/27/2017 17:50,48,43.9,67,36.5,115,39.6,2,0,0
11/27/2017 17:55,49,42.2,67,34.7,116,37.9,2,0,0
11/27/2017 18:00,46,40.7,64,32.9,110,36.2,2,0,0
11/27/2017 18:05,46,50.5,64,43.8,110,46.6,2,0,0
11/27/2017 18:10,59,58.6,77,52.7,136,55.3,2,0,0
11/27/2017 18:15,58,56.9,77,50.9,135,53.5,2,0,0
11/27/2017 18:20,43,54.6,61,48.2,104,50.9,2,0,0
11/27/2017 18:25,38,54.7,55,48.5,93,51.1,2,0,0
11/27/2017 18:30,46,58.2,63,52.4,109,54.8,2,0,0
11/27/2017 18:35,44,58,60,52.2,104,54.7,2,0,0
11/27/2017 18:40,40,59.5,55,53.9,95,56.3,2,0,0
11/27/2017 18:45,38,63.2,54,58,92,60.1,2,0,0
11/27/2017 18:50,41,64,56,58.9,97,61,2,0,0
11/27/2017 18:55,46,65.9,62,61,108,63.1,2,0,0
11/27/2017 19:00,48,68.5,65,63.9,113,65.9,2,0,0
11/27/2017 19:05,38,69.1,55,64.5,93,66.4,2,0,0
11/27/2017 19:10,48,68.6,66,63.9,114,65.9,2,0,0
11/27/2017 19:15,35,67.6,53,62.9,88,64.8,2,0,0
11/27/2017 19:20,42,69.5,58,64.8,100,66.8,2,0,0
11/27/2017 19:25,41,67.8,59,63,100,65,2,0,0
11/27/2017 19:30,35,69.2,52,64.5,87,66.4,2,0,0
11/27/2017 19:35,36,69.8,53,65.3,89,67.1,2,0,0
11/27/2017 19:40,34,68.8,51,64.1,85,66,2,0,0
11/27/2017 19:45,31,69.2,48,64.5,79,66.3,2,0,0
11/27/2017 19:50,27,69.9,43,65.4,70,67.1,2,0,0
11/27/2017 19:55,26,69.1,42,64.4,68,66.2,2,0,0
11/27/2017 20:00,33,67.8,51,63,84,64.9,2,0,0
11/27/2017 20:05,25,68.6,41,63.9,66,65.7,2,0,0
11/27/2017 20:10,29,69,45,64.4,74,66.2,2,0,0
11/27/2017 20:15,33,68.7,49,64,82,65.9,2,0,0
11/27/2017 20:20,33,68.2,50,63.5,83,65.4,2,0,0
11/27/2017 20:25,32,68.7,48,64.1,80,65.9,2,0,0
11/27/2017 20:30,30,69.4,47,64.8,77,66.6,2,0,0
11/27/2017 20:35,29,69.5,45,64.9,74,66.7,2,0,0
11/27/2017 20:40,31,68.9,47,64.2,78,66.1,2,0,0
11/27/2017 20:45,29,69,46,64.4,75,66.2,2,0,0
11/27/2017 20:50,28,68.9,44,64.3,72,66.1,2,0,0
11/27/2017 20:55,27,69.1,43,64.5,70,66.3,2,0,0
11/27/2017 21:00,26,69.6,42,65,68,66.8,2,0,0
11/27/2017 21:05,29,69.9,45,65.4,74,67.2,2,0,0
11/27/2017 21:10,30,68.8,46,64.2,76,66,2,0,0
11/27/2017 21:15,26,69.3,42,64.7,68,66.4,2,0,0
11/27/2017 21:20,31,69.5,47,64.9,78,66.7,2,0,0
11/27/2017 21:25,26,70,41,65.4,67,67.2,2,0,0
11/27/2017 21:30,21,69.6,37,65,58,66.7,2,0,0
11/27/2017 21:35,24,68.7,40,64.1,64,65.8,2,0,0
11/27/2017 21:40,19,69.3,35,64.7,54,66.3,2,0,0
11/27/2017 21:45,23,69.3,39,64.7,62,66.4,2,0,0
11/27/2017 21:50,14,69.3,30,64.7,44,66.2,2,0,0
11/27/2017 21:55,22,69.3,38,64.7,60,66.3,2,0,0
11/27/2017 22:00,20,69.4,36,64.8,56,66.5,2,0,0
11/27/2017 22:05,24,69.5,40,64.9,64,66.7,2,0,0
11/27/2017 22:10,18,69.4,34,64.8,52,66.4,2,0,0
11/27/2017 22:15,22,69.4,37,64.8,59,66.5,2,0,0
11/27/2017 22:20,22,68.9,38,64.3,60,66,2,0,0
11/27/2017 22:25,22,69,38,64.4,60,66.1,2,0,0
11/27/2017 22:30,17,68.7,33,64.1,50,65.7,2,0,0
11/27/2017 22:35,19,68.9,35,64.2,54,65.9,2,0,0
11/27/2017 22:40,18,69.4,33,64.8,51,66.5,2,0,0
11/27/2017 22:45,18,69.5,34,64.9,52,66.5,2,0,0
11/27/2017 22:50,17,69.4,33,64.8,50,66.4,2,0,0
11/27/2017 22:55,17,69.4,33,64.8,50,66.4,2,0,0
11/27/2017 23:00,17,69,32,64.4,49,66,2,0,0
11/27/2017 23:05,18,69.3,33,64.7,51,66.3,2,0,0
11/27/2017 23:10,15,69.3,30,64.7,45,66.2,2,0,0
11/27/2017 23:15,15,69.3,31,64.7,46,66.2,2,0,0
11/27/2017 23:20,14,69.4,30,64.8,44,66.2,2,0,0
11/27/2017 23:25,15,69.4,30,64.8,45,66.3,2,0,0
11/27/2017 23:30,12,69.4,28,64.8,40,66.2,2,0,0
11/27/2017 23:35,17,69.4,32,64.8,49,66.4,2,0,0
11/27/2017 23:40,12,69.5,27,64.9,39,66.3,2,0,0
11/27/2017 23:45,13,69.5,29,64.9,42,66.3,2,0,0
11/27/2017 23:50,16,69.5,32,64.9,48,66.4,2,0,0
11/27/2017 23:55,12,69.5,28,64.9,40,66.3,2,0,0
11/28/2017 0:00,11,69.3,27,64.7,38,66.1,2,0,0
11/28/2017 0:05,12,68.9,27,64.3,39,65.7,2,0,0
11/28/2017 0:10,10,69.2,25,64.5,35,65.9,2,0,0
11/28/2017 0:15,14,69.2,30,64.6,44,66.1,2,0,0
11/28/2017 0:20,13,69.3,28,64.7,41,66.2,2,0,0
11/28/2017 0:25,11,69.3,26,64.7,37,66,2,0,0
11/28/2017 0:30,10,69.3,25,64.7,35,66,2,0,0
11/28/2017 0:35,10,69.3,25,64.7,35,66,2,0,0
11/28/2017 0:40,12,69.2,28,64.6,40,66,2,0,0
11/28/2017 0:45,10,68.7,25,64,35,65.4,2,0,0
11/28/2017 0:50,10,69,26,64.4,36,65.7,2,0,0
11/28/2017 0:55,9,69.2,24,64.5,33,65.8,2,0,0
11/28/2017 1:00,12,69.3,27,64.7,39,66.1,2,0,0
11/28/2017 1:05,8,69.3,24,64.7,32,65.8,2,0,0
11/28/2017 1:10,5,69.4,20,64.8,25,65.7,2,0,0
11/28/2017 1:15,8,69.3,23,64.7,31,65.9,2,0,0
11/28/2017 1:20,8,69.4,23,64.8,31,66,2,0,0
11/28/2017 1:25,8,69.4,23,64.8,31,66,2,0,0
11/28/2017 1:30,10,69.3,25,64.7,35,66,2,0,0
11/28/2017 1:35,7,69.2,23,64.6,30,65.7,2,0,0
11/28/2017 1:40,7,69.3,23,64.7,30,65.7,2,0,0
11/28/2017 1:45,8,69.3,23,64.7,31,65.9,2,0,0
11/28/2017 1:50,7,69.3,22,64.7,29,65.8,2,0,0
11/28/2017 1:55,6,69.3,21,64.7,27,65.8,2,0,0
11/28/2017 2:00,7,69.3,22,64.7,29,65.8,2,0,0
11/28/2017 2:05,7,69,22,64.4,29,65.5,2,0,0
11/28/2017 2:10,7,68.9,22,64.2,29,65.4,2,0,0
11/28/2017 2:15,7,68.6,22,64,29,65.1,2,0,0
11/28/2017 2:20,9,68.9,24,64.2,33,65.5,2,0,0
11/28/2017 2:25,7,69.2,22,64.5,29,65.7,2,0,0
11/28/2017 2:30,8,69.2,24,64.6,32,65.7,2,0,0
11/28/2017 2:35,9,69.2,25,64.6,34,65.8,2,0,0
11/28/2017 2:40,7,69.3,23,64.7,30,65.7,2,0,0
11/28/2017 2:45,9,69,24,64.4,33,65.7,2,0,0
11/28/2017 2:50,10,69.2,25,64.6,35,65.9,2,0,0
11/28/2017 2:55,10,69.3,25,64.7,35,66,2,0,0
11/28/2017 3:00,11,69,27,64.4,38,65.7,2,0,0
11/28/2017 3:05,9,69.2,24,64.6,33,65.9,2,0,0
11/28/2017 3:10,12,69.3,28,64.7,40,66,2,0,0
11/28/2017 3:15,9,69.1,24,64.5,33,65.8,2,0,0
11/28/2017 3:20,9,69.3,24,64.7,33,66,2,0,0
11/28/2017 3:25,11,69.3,27,64.7,38,66.1,2,0,0
11/28/2017 3:30,11,69.2,27,64.6,38,66,2,0,0
11/28/2017 3:35,13,69.3,28,64.7,41,66.2,2,0,0
11/28/2017 3:40,12,69.4,27,64.8,39,66.2,2,0,0
11/28/2017 3:45,13,69.4,29,64.8,42,66.2,2,0,0
11/28/2017 3:50,16,69.4,32,64.8,48,66.3,2,0,0
11/28/2017 3:55,13,69.4,29,64.8,42,66.2,2,0,0
11/28/2017 4:00,19,69.2,36,64.5,55,66.1,2,0,0
11/28/2017 4:05,16,69,31,64.4,47,65.9,2,0,0
11/28/2017 4:10,19,69.1,35,64.5,54,66.1,2,0,0
11/28/2017 4:15,21,69.4,37,64.8,58,66.4,2,0,0
11/28/2017 4:20,23,69.4,39,64.8,62,66.5,2,0,0
11/28/2017 4:25,25,69.7,42,65.1,67,66.8,2,0,0
11/28/2017 4:30,28,69.8,44,65.2,72,67,2,0,0
11/28/2017 4:35,32,70.3,49,65.8,81,67.5,2,0,0
11/28/2017 4:40,34,70.6,51,66.1,85,67.9,2,0,0
11/28/2017 4:45,35,70.4,53,65.9,88,67.7,2,0,0
11/28/2017 4:50,38,70.9,56,66.5,94,68.3,2,0,0
11/28/2017 4:55,41,68.7,60,64.1,101,66,2,0,0
11/28/2017 5:00,41,68.4,59,63.9,100,65.7,2,0,0
11/28/2017 5:05,47,68.4,66,63.7,113,65.7,2,0,0
11/28/2017 5:10,43,68.6,61,63.9,104,65.9,2,0,0
11/28/2017 5:15,51,68.1,71,63.4,122,65.4,2,0,0
11/28/2017 5:20,53,67.6,74,62.7,127,64.7,2,0,0
11/28/2017 5:25,64,68.5,86,63.7,150,65.8,2,0,0
11/28/2017 5:30,52,68.3,72,63.5,124,65.5,2,0,0
11/28/2017 5:35,58,68.1,78,63.3,136,65.4,2,0,0
11/28/2017 5:40,62,67,83,62.1,145,64.2,2,0,0
11/28/2017 5:45,64,67.4,86,62.6,150,64.6,2,0,0
11/28/2017 5:50,56,68.6,77,63.8,133,65.8,2,0,0
11/28/2017 5:55,61,66.8,81,62,142,64.1,2,0,0
11/28/2017 6:00,56,66.9,77,61.9,133,64,2,0,0
11/28/2017 6:05,60,66.8,81,61.8,141,64,2,0,0
11/28/2017 6:10,62,67.1,83,62.1,145,64.2,2,0,0
11/28/2017 6:15,59,68.1,80,63.2,139,65.3,2,0,0
11/28/2017 6:20,60,66.7,81,61.7,141,63.8,2,0,0
11/28/2017 6:25,61,67.2,82,62.3,143,64.4,2,0,0
11/28/2017 6:30,66,67.1,88,62.2,154,64.3,2,0,0
11/28/2017 6:35,70,66.6,92,61.5,162,63.7,2,0,0
11/28/2017 6:40,66,66.6,87,61.6,153,63.7,2,0,0
11/28/2017 6:45,80,66.8,104,61.8,184,64,2,0,0
11/28/2017 6:50,84,68.1,107,63.2,191,65.4,2,0,0
11/28/2017 6:55,77,69,99,64.3,176,66.4,2,0,0
11/28/2017 7:00,66,69.4,87,64.6,153,66.7,2,0,0
11/28/2017 7:05,86,69,111,64.2,197,66.3,2,0,0
11/28/2017 7:10,71,68.8,93,64,164,66.1,2,0,0
11/28/2017 7:15,81,68,104,63.2,185,65.3,2,0,0
11/28/2017 7:20,76,68.6,98,63.8,174,65.9,2,0,0
11/28/2017 7:25,80,67.8,103,62.9,183,65,2,0,0
11/28/2017 7:30,99,66.7,124,61.7,223,63.9,2,0,0
11/28/2017 7:35,85,66.8,110,61.8,195,64,2,0,0
11/28/2017 7:40,93,67.1,117,62.2,210,64.4,2,0,0
11/28/2017 7:45,87,65.9,111,60.9,198,63.1,2,0,0
11/28/2017 7:50,92,63.7,115,58.4,207,60.8,2,0,0
11/28/2017 7:55,71,56.5,92,50.4,163,53.1,2,0,0
11/28/2017 8:00,72,59.3,93,53.5,165,56,2,0,0
11/28/2017 8:05,81,60.9,104,55.4,185,57.8,2,0,0
11/28/2017 8:10,85,62.4,108,57.1,193,59.4,2,0,0
11/28/2017 8:15,70,64.9,91,59.8,161,62.1,2,0,0
11/28/2017 8:20,57,67.8,76,63,133,65.1,2,0,0
11/28/2017 8:25,62,68.1,82,63.3,144,65.4,2,0,0
11/28/2017 8:30,57,68.2,76,63.4,133,65.4,2,0,0
11/28/2017 8:35,65,67.8,85,63,150,65.1,2,0,0
11/28/2017 8:40,60,68.1,80,63.3,140,65.3,2,0,0
11/28/2017 8:45,66,68.1,86,63.4,152,65.4,2,0,0
11/28/2017 8:50,69,68.8,89,64.1,158,66.1,2,0,0
11/28/2017 8:55,72,68.8,93,64,165,66.1,2,0,0
11/28/2017 9:00,69,67.8,89,63,158,65.1,2,0,0
11/28/2017 9:05,68,66.3,88,61.3,156,63.4,2,0,0
11/28/2017 9:10,70,67,90,62.1,160,64.2,2,0,0
11/28/2017 9:15,63,66.4,83,61.5,146,63.6,2,0,0
11/28/2017 9:20,72,65.7,92,60.7,164,62.9,2,0,0
11/28/2017 9:25,71,64.5,92,59.4,163,61.6,2,0,0
11/28/2017 9:30,63,65.7,83,60.8,146,62.9,2,0,0
11/28/2017 9:35,69,64.6,90,59.6,159,61.8,2,0,0
11/28/2017 9:40,77,63.4,99,58.2,176,60.5,2,0,0
11/28/2017 9:45,71,64.8,93,59.7,164,61.9,2,0,0
11/28/2017 9:50,72,65.1,93,60,165,62.2,2,0,0
11/28/2017 9:55,64,65.2,84,60.2,148,62.4,2,0,0
11/28/2017 10:00,75,63.9,96,58.8,171,61,2,0,0
11/28/2017 10:05,71,65.2,91,60.2,162,62.4,2,0,0
11/28/2017 10:10,71,66.3,92,61.4,163,63.5,2,0,0
11/28/2017 10:15,75,66.2,96,61.4,171,63.5,2,0,0
11/28/2017 10:20,60,66.3,81,61.5,141,63.5,2,0,0
11/28/2017 10:25,76,67.8,97,63.1,173,65.2,2,0,0
11/28/2017 10:30,64,68.1,84,63.5,148,65.5,2,0,0
11/28/2017 10:35,62,66.8,81,62,143,64.1,2,0,0
11/28/2017 10:40,63,66.5,82,61.7,145,63.8,2,0,0
11/28/2017 10:45,55,67.7,75,63,130,65,2,0,0
11/28/2017 10:50,53,66.6,72,61.8,125,63.8,2,0,0
11/28/2017 10:55,51,67.1,69,62.4,120,64.4,2,0,0
11/28/2017 11:00,49,67.8,67,63.1,116,65.1,2,0,0
11/28/2017 11:05,46,66.8,64,62,110,64,2,0,0
11/28/2017 11:10,48,66.6,65,61.9,113,63.9,2,0,0
11/28/2017 11:15,43,65.3,61,60.5,104,62.5,2,0,0
11/28/2017 11:20,51,65.9,68,61,119,63.1,2,0,0
11/28/2017 11:25,41,65.6,58,60.7,99,62.7,2,0,0
11/28/2017 11:30,44,67.6,62,62.9,106,64.8,2,0,0
11/28/2017 11:35,50,67.3,67,62.6,117,64.6,2,0,0
11/28/2017 11:40,51,67.1,70,62.4,121,64.4,2,0,0
11/28/2017 11:45,58,67.6,77,62.9,135,64.9,2,0,0
11/28/2017 11:50,61,68.1,78,63.5,139,65.5,2,0,0
11/28/2017 11:55,58,67,77,62.3,135,64.3,2,0,0
11/28/2017 12:00,47,68.1,64,63.4,111,65.4,2,0,0
11/28/2017 12:05,52,68.8,68,64.2,120,66.2,2,0,0
11/28/2017 12:10,53,69.3,71,64.7,124,66.7,2,0,0
11/28/2017 12:15,57,68.3,75,63.6,132,65.7,2,0,0
11/28/2017 12:20,47,67.1,65,62.3,112,64.3,2,0,0
11/28/2017 12:25,51,67.9,69,63.2,120,65.2,2,0,0
11/28/2017 12:30,49,67.2,67,62.4,116,64.4,2,0,0
11/28/2017 12:35,53,67.9,71,63.3,124,65.3,2,0,0
11/28/2017 12:40,49,68.5,67,63.9,116,65.8,2,0,0
11/28/2017 12:45,50,69.2,67,64.6,117,66.6,2,0,0
11/28/2017 12:50,56,68.4,74,63.8,130,65.8,2,0,0
11/28/2017 12:55,45,69.5,63,64.9,108,66.8,2,0,0
11/28/2017 13:00,51,68.8,69,64.2,120,66.2,2,0,0
11/28/2017 13:05,43,68.8,61,64.1,104,66.1,2,0,0
11/28/2017 13:10,45,68.9,63,64.3,108,66.2,2,0,0
11/28/2017 13:15,46,69.7,64,65.1,110,67,2,0,0
11/28/2017 13:20,54,69.7,72,65.1,126,67.1,2,0,0
11/28/2017 13:25,48,68.6,66,63.9,114,65.9,2,0,0
11/28/2017 13:30,50,67.6,69,62.8,119,64.8,2,0,0
11/28/2017 13:35,46,68.7,63,64,109,66,2,0,0
11/28/2017 13:40,52,68.4,70,63.7,122,65.7,2,0,0
11/28/2017 13:45,45,67.9,63,63.2,108,65.2,2,0,0
11/28/2017 13:50,49,68.4,66,63.7,115,65.7,2,0,0
11/28/2017 13:55,44,69.3,61,64.7,105,66.6,2,0,0
11/28/2017 14:00,46,70.2,63,65.6,109,67.5,2,0,0
11/28/2017 14:05,48,68.6,65,63.9,113,65.9,2,0,0
11/28/2017 14:10,45,68.3,63,63.6,108,65.6,2,0,0
11/28/2017 14:15,52,69.2,71,64.6,123,66.5,2,0,0
11/28/2017 14:20,55,68.7,74,64.1,129,66.1,2,0,0
11/28/2017 14:25,43,69.7,61,65.1,104,67,2,0,0
11/28/2017 14:30,57,67.1,78,62.4,135,64.4,2,0,0
11/28/2017 14:35,44,67.9,62,63.2,106,65.2,2,0,0
11/28/2017 14:40,60,67.2,79,62.5,139,64.6,2,0,0
11/28/2017 14:45,48,69.6,65,65.1,113,67,2,0,0
11/28/2017 14:50,47,69.9,63,65.4,110,67.3,2,0,0
11/28/2017 14:55,44,70.6,61,66.1,105,68,2,0,0
11/28/2017 15:00,47,70.7,65,66.2,112,68.1,2,0,0
11/28/2017 15:05,51,66.9,69,62.1,120,64.2,2,0,0
11/28/2017 15:10,49,67.4,67,62.6,116,64.6,2,0,0
11/28/2017 15:15,57,66.9,75,62.1,132,64.2,2,0,0
11/28/2017 15:20,47,67.3,65,62.6,112,64.6,2,0,0
11/28/2017 15:25,54,67.7,73,63,127,65,2,0,0
11/28/2017 15:30,61,67.6,80,62.9,141,64.9,2,0,0
11/28/2017 15:35,56,68.9,74,64.3,130,66.3,2,0,0
11/28/2017 15:40,73,68.7,92,64,165,66.1,2,0,0
11/28/2017 15:45,61,69.3,80,64.8,141,66.7,2,0,0
11/28/2017 15:50,59,68.6,78,64,137,66,2,0,0
11/28/2017 15:55,49,68.9,67,64.3,116,66.3,2,0,0
11/28/2017 16:00,58,68.6,76,64,134,66,2,0,0
11/28/2017 16:05,66,69.6,86,65.3,152,67.2,2,0,0
11/28/2017 16:10,50,69.4,68,65.1,118,66.9,2,0,0
11/28/2017 16:15,64,70.7,83,66.5,147,68.3,2,0,0
11/28/2017 16:20,55,70.5,74,66.2,129,68.1,2,0,0
11/28/2017 16:25,50,70.4,67,66,117,67.9,2,0,0
11/28/2017 16:30,50,69.4,68,65.1,118,66.9,2,0,0
11/28/2017 16:35,57,68.6,75,64.2,132,66.1,2,0,0
11/28/2017 16:40,54,68.8,72,64.3,126,66.2,2,0,0
11/28/2017 16:45,45,69.1,63,64.6,108,66.4,2,0,0
11/28/2017 16:50,51,68.9,69,64.4,120,66.3,2,0,0
11/28/2017 16:55,47,68.2,65,63.7,112,65.6,2,0,0
11/28/2017 17:00,47,67.5,64,62.8,111,64.8,2,0,0
11/28/2017 17:05,48,68.8,66,64.2,114,66.1,2,0,0
11/28/2017 17:10,59,67.6,79,62.8,138,64.8,2,0,0
11/28/2017 17:15,54,66.6,72,61.7,126,63.8,2,0,0
11/28/2017 17:20,56,66.2,75,61.3,131,63.4,2,0,0
11/28/2017 17:25,51,65.9,68,61,119,63.1,2,0,0
11/28/2017 17:30,55,64.6,74,59.6,129,61.7,2,0,0
11/28/2017 17:35,50,63.5,69,58.4,119,60.6,2,0,0
11/28/2017 17:40,52,63.6,71,58.4,123,60.6,2,0,0
11/28/2017 17:45,43,64.6,60,59.5,103,61.6,2,0,0
11/28/2017 17:50,47,65.1,66,60.1,113,62.2,2,0,0
11/28/2017 17:55,44,65.8,63,60.8,107,62.9,2,0,0
11/28/2017 18:00,44,67.5,60,62.7,104,64.7,2,0,0
11/28/2017 18:05,40,67,57,62.1,97,64.1,2,0,0
11/28/2017 18:10,46,67.3,64,62.5,110,64.5,2,0,0
11/28/2017 18:15,52,66,71,61.2,123,63.2,2,0,0
11/28/2017 18:20,48,66.8,67,62,115,64,2,0,0
11/28/2017 18:25,41,68.8,58,64.2,99,66.1,2,0,0
11/28/2017 18:30,41,69.4,57,64.8,98,66.7,2,0,0
11/28/2017 18:35,41,69.9,59,65.3,100,67.2,2,0,0
11/28/2017 18:40,50,69.7,67,65.1,117,67.1,2,0,0
11/28/2017 18:45,43,69.9,60,65.3,103,67.2,2,0,0
11/28/2017 18:50,48,69.9,66,65.3,114,67.3,2,0,0
11/28/2017 18:55,46,69.8,64,65.2,110,67.1,2,0,0
11/28/2017 19:00,48,67.9,66,63.2,114,65.2,2,0,0
11/28/2017 19:05,37,68.1,54,63.4,91,65.3,2,0,0
11/28/2017 19:10,35,68,52,63.3,87,65.2,2,0,0
11/28/2017 19:15,37,67.2,53,62.4,90,64.4,2,0,0
11/28/2017 19:20,43,67.3,60,62.5,103,64.5,2,0,0
11/28/2017 19:25,32,67.7,49,62.9,81,64.8,2,0,0
11/28/2017 19:30,40,68.5,56,63.7,96,65.7,2,0,0
11/28/2017 19:35,36,69.2,52,64.5,88,66.4,2,0,0
11/28/2017 19:40,35,69.3,52,64.7,87,66.5,2,0,0
11/28/2017 19:45,22,69.5,38,64.9,60,66.6,2,0,0
11/28/2017 19:50,32,70.1,48,65.6,80,67.4,2,0,0
11/28/2017 19:55,30,69.5,47,64.9,77,66.7,2,0,0
11/28/2017 20:00,32,68.9,49,64.3,81,66.1,2,0,0
11/28/2017 20:05,31,69.1,48,64.4,79,66.3,2,0,0
11/28/2017 20:10,33,68.7,50,64,83,65.9,2,0,0
11/28/2017 20:15,30,68.8,46,64.2,76,66,2,0,0
11/28/2017 20:20,31,68.9,48,64.3,79,66.1,2,0,0
11/28/2017 20:25,31,68.7,48,64,79,65.8,2,0,0
11/28/2017 20:30,30,68.5,47,63.8,77,65.6,2,0,0
11/28/2017 20:35,25,69.3,41,64.7,66,66.4,2,0,0
11/28/2017 20:40,27,69.4,43,64.8,70,66.6,2,0,0
11/28/2017 20:45,34,69.1,51,64.4,85,66.3,2,0,0
11/28/2017 20:50,32,68.8,49,64.1,81,66,2,0,0
11/28/2017 20:55,29,68.7,45,64.1,74,65.9,2,0,0
11/28/2017 21:00,26,69.2,43,64.6,69,66.3,2,0,0
11/28/2017 21:05,22,69.2,38,64.5,60,66.2,2,0,0
11/28/2017 21:10,26,69.3,42,64.7,68,66.4,2,0,0
11/28/2017 21:15,17,69.1,33,64.5,50,66.1,2,0,0
11/28/2017 21:20,24,69,39,64.3,63,66.1,2,0,0
11/28/2017 21:25,28,69.3,44,64.7,72,66.5,2,0,0
11/28/2017 21:30,21,69.3,37,64.7,58,66.3,2,0,0
11/28/2017 21:35,22,69.6,38,65,60,66.6,2,0,0
11/28/2017 21:40,22,69.6,39,65,61,66.7,2,0,0
11/28/2017 21:45,21,69.6,37,65,58,66.6,2,0,0
11/28/2017 21:50,22,69.6,38,65,60,66.7,2,0,0
11/28/2017 21:55,16,69.1,31,64.5,47,66.1,2,0,0
11/28/2017 22:00,17,69.3,33,64.7,50,66.2,2,0,0
11/28/2017 22:05,15,69.3,31,64.7,46,66.2,2,0,0
11/28/2017 22:10,21,69.3,37,64.7,58,66.4,2,0,0
11/28/2017 22:15,23,69.2,39,64.6,62,66.3,2,0,0
11/28/2017 22:20,23,69.1,39,64.5,62,66.2,2,0,0
11/28/2017 22:25,25,68.4,40,63.7,65,65.5,2,0,0
11/28/2017 22:30,20,68.7,36,64.1,56,65.7,2,0,0
11/28/2017 22:35,22,69.1,39,64.5,61,66.1,2,0,0
11/28/2017 22:40,21,69.4,36,64.8,57,66.5,2,0,0
11/28/2017 22:45,20,69.1,36,64.4,56,66.1,2,0,0
11/28/2017 22:50,18,69.5,34,64.9,52,66.5,2,0,0
11/28/2017 22:55,19,69.4,35,64.8,54,66.5,2,0,0
11/28/2017 23:00,15,69.4,30,64.8,45,66.3,2,0,0
11/28/2017 23:05,15,69.1,30,64.5,45,66,2,0,0
11/28/2017 23:10,15,69.1,30,64.5,45,66.1,2,0,0
11/28/2017 23:15,16,69.2,32,64.6,48,66.2,2,0,0
11/28/2017 23:20,13,69.3,29,64.7,42,66.2,2,0,0
11/28/2017 23:25,14,69.4,29,64.8,43,66.3,2,0,0
11/28/2017 23:30,15,69.4,30,64.7,45,66.3,2,0,0
11/28/2017 23:35,14,69.3,30,64.7,44,66.2,2,0,0
11/28/2017 23:40,14,69.3,29,64.7,43,66.2,2,0,0
11/28/2017 23:45,9,69.3,25,64.7,34,65.9,2,0,0
11/28/2017 23:50,13,69.4,29,64.8,42,66.2,2,0,0
11/28/2017 23:55,13,69.2,29,64.6,42,66,2,0,0
11/29/2017 0:00,14,69.3,30,64.7,44,66.2,2,0,0
11/29/2017 0:05,11,69.4,26,64.8,37,66.1,2,0,0
11/29/2017 0:10,11,69.2,26,64.6,37,66,2,0,0
11/29/2017 0:15,8,69,24,64.4,32,65.5,2,0,0
11/29/2017 0:20,7,69.2,22,64.5,29,65.7,2,0,0
11/29/2017 0:25,10,69.2,25,64.5,35,65.9,2,0,0
11/29/2017 0:30,8,69.3,23,64.7,31,65.9,2,0,0
11/29/2017 0:35,8,69.3,24,64.7,32,65.8,2,0,0
11/29/2017 0:40,8,69.2,24,64.5,32,65.7,2,0,0
11/29/2017 0:45,8,69,23,64.4,31,65.5,2,0,0
11/29/2017 0:50,13,69.1,21,64.5,34,66.2,2,0,0
11/29/2017 0:55,8,69.2,23,64.6,31,65.8,2,0,0
11/29/2017 1:00,7,69.4,23,64.8,30,65.9,2,0,0
11/29/2017 1:05,6,69.4,21,64.8,27,65.8,2,0,0
11/29/2017 1:10,6,69.3,21,64.7,27,65.8,2,0,0
11/29/2017 1:15,8,69.4,24,64.8,32,66,2,0,0
11/29/2017 1:20,7,69.4,22,64.8,29,65.9,2,0,0
11/29/2017 1:25,6,69.5,21,64.9,27,65.9,2,0,0
11/29/2017 1:30,7,69.4,22,64.8,29,65.9,2,0,0
11/29/2017 1:35,10,69.4,25,64.7,35,66.1,2,0,0
11/29/2017 1:40,13,69.4,21,64.7,34,66.5,2,0,0
11/29/2017 1:45,5,69.3,20,64.7,25,65.6,2,0,0
11/29/2017 1:50,7,69.3,22,64.7,29,65.8,2,0,0
11/29/2017 1:55,7,69.3,23,64.7,30,65.7,2,0,0
11/29/2017 2:00,7,69.3,22,64.7,29,65.8,2,0,0
11/29/2017 2:05,7,69.3,22,64.7,29,65.8,2,0,0
11/29/2017 2:10,5,69.4,20,64.7,25,65.7,2,0,0
11/29/2017 2:15,9,69.4,24,64.7,33,66,2,0,0
11/29/2017 2:20,5,69.4,21,64.8,26,65.7,2,0,0
11/29/2017 2:25,9,69.4,24,64.8,33,66.1,2,0,0
11/29/2017 2:30,8,69.4,24,64.8,32,66,2,0,0
11/29/2017 2:35,7,69.2,22,64.6,29,65.7,2,0,0
11/29/2017 2:40,7,69.2,22,64.6,29,65.7,2,0,0
11/29/2017 2:45,9,69.4,25,64.8,34,66,2,0,0
11/29/2017 2:50,10,69.3,25,64.7,35,66,2,0,0
11/29/2017 2:55,9,69.4,25,64.8,34,66,2,0,0
11/29/2017 3:00,10,68.9,26,64.3,36,65.6,2,0,0
11/29/2017 3:05,11,69.2,27,64.6,38,65.9,2,0,0
11/29/2017 3:10,10,69.3,25,64.7,35,66,2,0,0
11/29/2017 3:15,5,69.1,21,64.5,26,65.4,2,0,0
11/29/2017 3:20,10,69.3,26,64.7,36,65.9,2,0,0
11/29/2017 3:25,9,69.2,24,64.5,33,65.8,2,0,0
11/29/2017 3:30,13,68.8,28,64.1,41,65.6,2,0,0
11/29/2017 3:35,12,69,28,64.4,40,65.8,2,0,0
11/29/2017 3:40,12,69,27,64.4,39,65.8,2,0,0
11/29/2017 3:45,15,69.3,31,64.7,46,66.2,2,0,0
11/29/2017 3:50,12,69.3,27,64.7,39,66.1,2,0,0
11/29/2017 3:55,10,69.3,25,64.7,35,66,2,0,0
11/29/2017 4:00,20,69.1,36,64.5,56,66.1,2,0,0
11/29/2017 4:05,17,69.1,33,64.5,50,66,2,0,0
11/29/2017 4:10,19,69.1,35,64.5,54,66.1,2,0,0
11/29/2017 4:15,19,68.8,35,64.2,54,65.8,2,0,0
11/29/2017 4:20,16,68.7,32,64.1,48,65.6,2,0,0
11/29/2017 4:25,20,69.2,37,64.6,57,66.2,2,0,0
11/29/2017 4:30,25,69.6,41,65,66,66.7,2,0,0
11/29/2017 4:35,29,69.9,46,65.3,75,67.1,2,0,0
11/29/2017 4:40,34,68.9,52,64.2,86,66.1,2,0,0
11/29/2017 4:45,44,67.7,63,63,107,65,2,0,0
11/29/2017 4:50,36,67.7,54,63,90,64.9,2,0,0
11/29/2017 4:55,36,68.9,54,64.3,90,66.1,2,0,0
11/29/2017 5:00,44,69.8,64,65.2,108,67,2,0,0
11/29/2017 5:05,43,69.2,61,64.5,104,66.4,2,0,0
11/29/2017 5:10,42,65.7,61,60.3,103,62.5,2,0,0
11/29/2017 5:15,55,67.8,75,62.8,130,64.9,2,0,0
11/29/2017 5:20,52,68.9,71,64,123,66.1,2,0,0
11/29/2017 5:25,61,69.4,82,64.7,143,66.7,2,0,0
11/29/2017 5:30,65,69.8,86,65.2,151,67.2,2,0,0
11/29/2017 5:35,61,68.9,83,64.3,144,66.2,2,0,0
11/29/2017 5:40,64,68.8,86,64.2,150,66.2,2,0,0
11/29/2017 5:45,60,68,80,63.3,140,65.3,2,0,0
11/29/2017 5:50,55,67.6,76,62.9,131,64.8,2,0,0
11/29/2017 5:55,68,67.8,89,63.1,157,65.2,2,0,0
11/29/2017 6:00,57,68.3,77,63.6,134,65.6,2,0,0
11/29/2017 6:05,56,66.7,76,61.8,132,63.9,2,0,0
11/29/2017 6:10,62,66.9,84,62,146,64.1,2,0,0
11/29/2017 6:15,57,67.3,78,62.4,135,64.5,2,0,0
11/29/2017 6:20,63,67.7,85,62.8,148,64.9,2,0,0
11/29/2017 6:25,62,67.8,84,62.9,146,65,2,0,0
11/29/2017 6:30,67,68.2,90,63.4,157,65.5,2,0,0
11/29/2017 6:35,61,68.7,81,63.9,142,65.9,2,0,0
11/29/2017 6:40,72,68.2,94,63.3,166,65.4,2,0,0
11/29/2017 6:45,68,67.8,90,62.9,158,65,2,0,0
11/29/2017 6:50,79,68,102,63.1,181,65.2,2,0,0
11/29/2017 6:55,74,67.9,96,63,170,65.1,2,0,0
11/29/2017 7:00,70,67.2,92,62.3,162,64.4,2,0,0
11/29/2017 7:05,71,67.6,94,62.8,165,64.8,2,0,0
11/29/2017 7:10,77,67.4,100,62.5,177,64.6,2,0,0
11/29/2017 7:15,79,68.2,102,63.4,181,65.5,2,0,0
11/29/2017 7:20,79,68,102,63.1,181,65.3,2,0,0
11/29/2017 7:25,89,67.1,112,62.2,201,64.4,2,0,0
11/29/2017 7:30,86,67.5,109,62.6,195,64.7,2,0,0
11/29/2017 7:35,85,67.7,108,62.9,193,65,2,0,0
11/29/2017 7:40,87,67.4,111,62.5,198,64.7,2,0,0
11/29/2017 7:45,87,66.3,110,61.3,197,63.5,2,0,0
11/29/2017 7:50,83,60.2,104,54.5,187,57,2,0,0
11/29/2017 7:55,80,55.3,101,49,181,51.8,2,0,0
11/29/2017 8:00,66,57.3,88,51.3,154,53.9,2,0,0
11/29/2017 8:05,77,60.6,100,55.1,177,57.5,2,0,0
11/29/2017 8:10,87,62.7,111,57.4,198,59.8,2,0,0
11/29/2017 8:15,82,63.7,105,58.5,187,60.8,2,0,0
11/29/2017 8:20,84,65.6,106,60.6,190,62.8,2,0,0
11/29/2017 8:25,81,65.5,104,60.4,185,62.6,2,0,0
11/29/2017 8:30,75,65.1,97,60.1,172,62.3,2,0,0
11/29/2017 8:35,68,65.5,89,60.5,157,62.7,2,0,0
11/29/2017 8:40,80,65.7,102,60.6,182,62.9,2,0,0
11/29/2017 8:45,86,65.3,110,60.3,196,62.5,2,0,0
11/29/2017 8:50,82,65.8,104,60.8,186,63,2,0,0
11/29/2017 8:55,78,66.1,100,61,178,63.2,2,0,0
11/29/2017 9:00,75,65.8,97,60.8,172,63,2,0,0
11/29/2017 9:05,62,65.7,83,60.7,145,62.9,2,0,0
11/29/2017 9:10,79,66.2,101,61.3,180,63.5,2,0,0
11/29/2017 9:15,83,66,105,61,188,63.2,2,0,0
11/29/2017 9:20,82,65.6,104,60.6,186,62.8,2,0,0
11/29/2017 9:25,65,66,85,61,150,63.1,2,0,0
11/29/2017 9:30,79,66.3,101,61.3,180,63.5,2,0,0
11/29/2017 9:35,73,65.6,94,60.6,167,62.8,2,0,0
11/29/2017 9:40,71,64.5,92,59.3,163,61.6,2,0,0
11/29/2017 9:45,72,65.3,93,60.3,165,62.5,2,0,0
11/29/2017 9:50,73,64.9,94,59.9,167,62.1,2,0,0
11/29/2017 9:55,56,64.5,74,59.4,130,61.6,2,0,0
11/29/2017 10:00,61,64.9,80,59.9,141,62.1,2,0,0
11/29/2017 10:05,62,66.2,81,61.3,143,63.4,2,0,0
11/29/2017 10:10,61,66.7,80,61.9,141,64,2,0,0
11/29/2017 10:15,58,67.9,76,63.2,134,65.2,2,0,0
11/29/2017 10:20,57,67.5,76,62.7,133,64.7,2,0,0
11/29/2017 10:25,66,67.3,84,62.5,150,64.6,2,0,0
11/29/2017 10:30,57,67.8,75,63.1,132,65.2,2,0,0
11/29/2017 10:35,67,68.6,87,63.9,154,66,2,0,0
11/29/2017 10:40,52,67.5,71,62.7,123,64.8,2,0,0
11/29/2017 10:45,59,67.8,78,63,137,65,2,0,0
11/29/2017 10:50,57,66.6,76,61.8,133,63.8,2,0,0
11/29/2017 10:55,50,67.4,68,62.6,118,64.7,2,0,0
11/29/2017 11:00,52,68.2,70,63.5,122,65.5,2,0,0
11/29/2017 11:05,48,68.6,66,64,114,66,2,0,0
11/29/2017 11:10,29,69.2,46,64.6,75,66.4,2,0,0
11/29/2017 11:15,51,66.8,70,62,121,64,2,0,0
11/29/2017 11:20,58,67.3,78,62.6,136,64.6,2,0,0
11/29/2017 11:25,50,65.2,68,60.3,118,62.4,2,0,0
11/29/2017 11:30,55,66.8,72,62.1,127,64.1,2,0,0
11/29/2017 11:35,54,68.6,73,64,127,65.9,2,0,0
11/29/2017 11:40,53,67.5,72,62.8,125,64.8,2,0,0
11/29/2017 11:45,56,66.6,75,61.9,131,63.9,2,0,0
11/29/2017 11:50,55,67.3,73,62.6,128,64.6,2,0,0
11/29/2017 11:55,44,68.1,61,63.4,105,65.4,2,0,0
11/29/2017 12:00,53,69.2,71,64.6,124,66.6,2,0,0
11/29/2017 12:05,44,69.7,61,65.1,105,67,2,0,0
11/29/2017 12:10,53,69.7,71,65,124,67,2,0,0
11/29/2017 12:15,51,69,69,64.2,120,66.3,2,0,0
11/29/2017 12:20,53,69.6,72,65,125,67,2,0,0
11/29/2017 12:25,48,68.2,66,63.4,114,65.5,2,0,0
11/29/2017 12:30,53,68,71,63.3,124,65.3,2,0,0
11/29/2017 12:35,47,68.9,64,64.3,111,66.2,2,0,0
11/29/2017 12:40,55,68.6,73,63.9,128,65.9,2,0,0
11/29/2017 12:45,59,68.9,77,64.3,136,66.3,2,0,0
11/29/2017 12:50,53,68.8,71,64.1,124,66.1,2,0,0
11/29/2017 12:55,48,69.2,66,64.5,114,66.5,2,0,0
11/29/2017 13:00,56,69.4,74,64.8,130,66.8,2,0,0
11/29/2017 13:05,56,68.8,75,64.1,131,66.1,2,0,0
11/29/2017 13:10,53,69,70,64.4,123,66.4,2,0,0
11/29/2017 13:15,57,68.1,76,63.4,133,65.4,2,0,0
11/29/2017 13:20,47,69.5,65,64.9,112,66.8,2,0,0
11/29/2017 13:25,42,69.2,60,64.5,102,66.5,2,0,0
11/29/2017 13:30,56,67.4,76,62.6,132,64.6,2,0,0
11/29/2017 13:35,45,66.4,62,61.4,107,63.5,2,0,0
11/29/2017 13:40,52,67.1,71,62.3,123,64.3,2,0,0
11/29/2017 13:45,53,68,71,63.2,124,65.2,2,0,0
11/29/2017 13:50,52,69.5,71,64.8,123,66.8,2,0,0
11/29/2017 13:55,44,69.5,61,64.9,105,66.8,2,0,0
11/29/2017 14:00,40,69.9,57,65.3,97,67.2,2,0,0
11/29/2017 14:05,47,70.1,65,65.5,112,67.4,2,0,0
11/29/2017 14:10,43,69.7,60,65.1,103,67,2,0,0
11/29/2017 14:15,48,70,66,65.4,114,67.3,2,0,0
11/29/2017 14:20,59,67.8,78,62.9,137,65,2,0,0
11/29/2017 14:25,43,68.4,59,63.7,102,65.7,2,0,0
11/29/2017 14:30,55,68.4,73,63.6,128,65.7,2,0,0
11/29/2017 14:35,45,67.5,63,62.7,108,64.7,2,0,0
11/29/2017 14:40,42,68.2,60,63.4,102,65.4,2,0,0
11/29/2017 14:45,48,68.5,66,63.7,114,65.7,2,0,0
11/29/2017 14:50,47,68,64,63.3,111,65.3,2,0,0
11/29/2017 14:55,43,68,61,63.2,104,65.2,2,0,0
11/29/2017 15:00,42,68.7,59,64.1,101,66,2,0,0
11/29/2017 15:05,52,67.6,71,62.9,123,64.9,2,0,0
11/29/2017 15:10,49,67.1,67,62.3,116,64.3,2,0,0
11/29/2017 15:15,53,68.6,71,63.9,124,65.9,2,0,0
11/29/2017 15:20,48,68.7,65,64.1,113,66.1,2,0,0
11/29/2017 15:25,51,67.9,69,63.2,120,65.2,2,0,0
11/29/2017 15:30,48,68.2,65,63.4,113,65.5,2,0,0
11/29/2017 15:35,64,68.3,83,63.6,147,65.6,2,0,0
11/29/2017 15:40,51,69.2,69,64.6,120,66.5,2,0,0
11/29/2017 15:45,54,69.8,70,65.2,124,67.2,2,0,0
11/29/2017 15:50,60,69.3,78,64.7,138,66.7,2,0,0
11/29/2017 15:55,59,68.7,76,64.1,135,66.1,2,0,0
11/29/2017 16:00,61,68.7,80,64.1,141,66.1,2,0,0
11/29/2017 16:05,53,69,72,64.4,125,66.4,2,0,0
11/29/2017 16:10,58,68.7,77,64.1,135,66.1,2,0,0
11/29/2017 16:15,60,69.8,78,65.3,138,67.3,2,0,0
11/29/2017 16:20,47,69.3,65,64.7,112,66.6,2,0,0
11/29/2017 16:25,53,69.2,71,64.6,124,66.6,2,0,0
11/29/2017 16:30,52,68.2,70,63.5,122,65.5,2,0,0
11/29/2017 16:35,57,68.1,75,63.4,132,65.5,2,0,0
11/29/2017 16:40,60,69,79,64.3,139,66.3,2,0,0
11/29/2017 16:45,45,68.9,63,64.3,108,66.2,2,0,0
11/29/2017 16:50,46,67.5,65,62.7,111,64.7,2,0,0
11/29/2017 16:55,48,68.7,66,64,114,66,2,0,0
11/29/2017 17:00,52,68.3,71,63.7,123,65.6,2,0,0
11/29/2017 17:05,53,68.7,71,64.1,124,66,2,0,0
11/29/2017 17:10,46,68.3,65,63.5,111,65.5,2,0,0
11/29/2017 17:15,51,68.4,70,63.6,121,65.6,2,0,0
11/29/2017 17:20,61,67.4,80,62.6,141,64.7,2,0,0
11/29/2017 17:25,57,66.5,77,61.6,134,63.7,2,0,0
11/29/2017 17:30,57,64.3,75,59.1,132,61.3,2,0,0
11/29/2017 17:35,52,59.4,71,53.6,123,56.1,2,0,0
11/29/2017 17:40,50,55.8,68,49.7,118,52.3,2,0,0
11/29/2017 17:45,48,60.1,65,54.5,113,56.9,2,0,0
11/29/2017 17:50,53,64,71,58.7,124,61,2,0,0
11/29/2017 17:55,55,66.5,74,61.5,129,63.6,2,0,0
11/29/2017 18:00,51,67.4,70,62.6,121,64.6,2,0,0
11/29/2017 18:05,46,67.1,64,62.2,110,64.3,2,0,0
11/29/2017 18:10,44,68.2,61,63.4,105,65.4,2,0,0
11/29/2017 18:15,47,67.7,65,62.9,112,64.9,2,0,0
11/29/2017 18:20,46,67.7,64,63,110,65,2,0,0
11/29/2017 18:25,43,68.4,60,63.7,103,65.7,2,0,0
11/29/2017 18:30,47,69.7,65,65.1,112,67,2,0,0
11/29/2017 18:35,45,69.6,63,65,108,66.9,2,0,0
11/29/2017 18:40,40,69.5,57,65,97,66.9,2,0,0
11/29/2017 18:45,45,69.4,63,64.9,108,66.8,2,0,0
11/29/2017 18:50,39,69.3,56,64.7,95,66.5,2,0,0
11/29/2017 18:55,43,69.6,59,64.9,102,66.9,2,0,0
11/29/2017 19:00,42,68.1,60,63.4,102,65.3,2,0,0
11/29/2017 19:05,38,68.1,56,63.4,94,65.3,2,0,0
11/29/2017 19:10,37,68.2,54,63.6,91,65.5,2,0,0
11/29/2017 19:15,43,68.6,61,63.9,104,65.8,2,0,0
11/29/2017 19:20,31,69.5,47,65,78,66.8,2,0,0
11/29/2017 19:25,39,69.5,57,64.9,96,66.8,2,0,0
11/29/2017 19:30,35,69.9,52,65.3,87,67.2,2,0,0
11/29/2017 19:35,33,70,50,65.5,83,67.3,2,0,0
11/29/2017 19:40,33,69.7,50,65.1,83,66.9,2,0,0
11/29/2017 19:45,31,69.8,48,65.2,79,67,2,0,0
11/29/2017 19:50,29,69.6,45,65,74,66.8,2,0,0
11/29/2017 19:55,28,69.7,44,65.1,72,66.9,2,0,0
11/29/2017 20:00,34,69.9,50,65.3,84,67.2,2,0,0
11/29/2017 20:05,30,69.3,46,64.7,76,66.5,2,0,0
11/29/2017 20:10,30,69.6,46,65,76,66.8,2,0,0
11/29/2017 20:15,32,69.5,48,64.9,80,66.7,2,0,0
11/29/2017 20:20,30,69.5,46,65,76,66.8,2,0,0
11/29/2017 20:25,34,68.1,50,63.5,84,65.4,2,0,0
11/29/2017 20:30,27,68.7,44,64.1,71,65.8,2,0,0
11/29/2017 20:35,26,69.2,42,64.6,68,66.4,2,0,0
11/29/2017 20:40,28,69.4,44,64.8,72,66.6,2,0,0
11/29/2017 20:45,27,69.8,43,65.2,70,67,2,0,0
11/29/2017 20:50,24,69.9,40,65.3,64,67.1,2,0,0
11/29/2017 20:55,25,69,42,64.4,67,66.1,2,0,0
11/29/2017 21:00,22,69.1,38,64.5,60,66.2,2,0,0
11/29/2017 21:05,28,69,44,64.4,72,66.2,2,0,0
11/29/2017 21:10,28,69.4,45,64.8,73,66.6,2,0,0
11/29/2017 21:15,21,69,37,64.4,58,66.1,2,0,0
11/29/2017 21:20,23,69,39,64.3,62,66,2,0,0
11/29/2017 21:25,23,68.7,39,64,62,65.7,2,0,0
11/29/2017 21:30,18,69.1,33,64.5,51,66.1,2,0,0
11/29/2017 21:35,24,69.3,40,64.7,64,66.4,2,0,0
11/29/2017 21:40,21,69.1,37,64.5,58,66.1,2,0,0
11/29/2017 21:45,24,68.3,39,63.6,63,65.4,2,0,0
11/29/2017 21:50,23,68.8,39,64.2,62,65.9,2,0,0
11/29/2017 21:55,23,69.1,39,64.5,62,66.2,2,0,0
11/29/2017 22:00,19,69.1,35,64.5,54,66.1,2,0,0
11/29/2017 22:05,21,69.3,37,64.7,58,66.3,2,0,0
11/29/2017 22:10,22,69.4,39,64.8,61,66.5,2,0,0
11/29/2017 22:15,19,69.4,35,64.8,54,66.4,2,0,0
11/29/2017 22:20,19,69.3,35,64.7,54,66.3,2,0,0
11/29/2017 22:25,23,69.3,38,64.7,61,66.4,2,0,0
11/29/2017 22:30,21,69.4,37,64.7,58,66.4,2,0,0
11/29/2017 22:35,21,69.1,37,64.5,58,66.2,2,0,0
11/29/2017 22:40,17,69.2,33,64.6,50,66.2,2,0,0
11/29/2017 22:45,16,69,32,64.3,48,65.9,2,0,0
11/29/2017 22:50,20,69.3,36,64.7,56,66.4,2,0,0
11/29/2017 22:55,18,69.3,34,64.7,52,66.3,2,0,0
11/29/2017 23:00,15,69.3,31,64.7,46,66.2,2,0,0
11/29/2017 23:05,18,68.4,34,63.6,52,65.3,2,0,0
11/29/2017 23:10,18,68.9,34,64.2,52,65.8,2,0,0
11/29/2017 23:15,16,69.2,31,64.6,47,66.2,2,0,0
11/29/2017 23:20,14,69.4,29,64.8,43,66.3,2,0,0
11/29/2017 23:25,10,69.4,26,64.8,36,66.1,2,0,0
11/29/2017 23:30,15,69.3,30,64.7,45,66.2,2,0,0
11/29/2017 23:35,18,69.4,33,64.8,51,66.4,2,0,0
11/29/2017 23:40,16,69.3,32,64.7,48,66.2,2,0,0
11/29/2017 23:45,12,69.3,28,64.7,40,66.1,2,0,0
11/29/2017 23:50,12,69.2,27,64.6,39,66,2,0,0
11/29/2017 23:55,15,69.1,30,64.5,45,66,2,0,0
11/30/2017 0:00,10,69.3,25,64.7,35,66.1,2,0,0
11/30/2017 0:05,12,69.3,28,64.7,40,66.1,2,0,0
11/30/2017 0:10,11,69.2,27,64.5,38,65.9,2,0,0
11/30/2017 0:15,8,69,24,64.4,32,65.5,2,0,0
11/30/2017 0:20,9,69,24,64.4,33,65.7,2,0,0
11/30/2017 0:25,9,69,24,64.4,33,65.6,2,0,0
11/30/2017 0:30,8,69.3,24,64.7,32,65.9,2,0,0
11/30/2017 0:35,8,69.3,23,64.7,31,65.9,2,0,0
11/30/2017 0:40,8,69.4,24,64.7,32,65.9,2,0,0
11/30/2017 0:45,8,69.4,23,64.8,31,66,2,0,0
11/30/2017 0:50,6,69.4,22,64.7,28,65.7,2,0,0
11/30/2017 0:55,6,69.4,21,64.7,27,65.8,2,0,0
11/30/2017 1:00,7,69.3,22,64.7,29,65.8,2,0,0
11/30/2017 1:05,7,69.3,22,64.7,29,65.8,2,0,0
11/30/2017 1:10,6,69,21,64.3,27,65.3,2,0,0
11/30/2017 1:15,7,69.2,22,64.6,29,65.7,2,0,0
11/30/2017 1:20,8,69.3,24,64.7,32,65.8,2,0,0
11/30/2017 1:25,8,69.3,23,64.7,31,65.9,2,0,0
11/30/2017 1:30,7,69.1,23,64.5,30,65.6,2,0,0
11/30/2017 1:35,11,69.2,27,64.6,38,65.9,2,0,0
11/30/2017 1:40,6,69.2,21,64.6,27,65.7,2,0,0
11/30/2017 1:45,7,69.3,22,64.7,29,65.8,2,0,0
11/30/2017 1:50,7,69.4,22,64.8,29,65.9,2,0,0
11/30/2017 1:55,5,69.4,21,64.8,26,65.7,2,0,0
11/30/2017 2:00,7,69.3,22,64.7,29,65.8,2,0,0
11/30/2017 2:05,5,69.3,21,64.7,26,65.6,2,0,0
11/30/2017 2:10,6,69.3,22,64.7,28,65.6,2,0,0
11/30/2017 2:15,7,69.3,22,64.7,29,65.8,2,0,0
11/30/2017 2:20,6,69.4,21,64.8,27,65.8,2,0,0
11/30/2017 2:25,8,69.2,23,64.6,31,65.8,2,0,0
11/30/2017 2:30,9,69.2,24,64.6,33,65.9,2,0,0
11/30/2017 2:35,11,69.2,27,64.6,38,66,2,0,0
11/30/2017 2:40,7,69.3,22,64.7,29,65.8,2,0,0
11/30/2017 2:45,11,68.8,27,64.1,38,65.5,2,0,0
11/30/2017 2:50,8,69,23,64.4,31,65.6,2,0,0
11/30/2017 2:55,9,69.2,24,64.6,33,65.8,2,0,0
11/30/2017 3:00,10,69,25,64.3,35,65.6,2,0,0
11/30/2017 3:05,7,69.2,22,64.6,29,65.7,2,0,0
11/30/2017 3:10,12,69,27,64.4,39,65.8,2,0,0
11/30/2017 3:15,11,69.2,26,64.6,37,66,2,0,0
11/30/2017 3:20,5,69.3,21,64.7,26,65.6,2,0,0
11/30/2017 3:25,10,69.2,26,64.6,36,65.9,2,0,0
11/30/2017 3:30,13,69.3,28,64.7,41,66.2,2,0,0
11/30/2017 3:35,12,69.2,28,64.6,40,66,2,0,0
11/30/2017 3:40,11,69.1,27,64.5,38,65.8,2,0,0
11/30/2017 3:45,13,69.1,29,64.5,42,65.9,2,0,0
11/30/2017 3:50,14,69.1,31,64.5,45,65.9,2,0,0
11/30/2017 3:55,13,69.3,29,64.7,42,66.1,2,0,0
11/30/2017 4:00,16,69.2,32,64.6,48,66.1,2,0,0
11/30/2017 4:05,14,69.2,30,64.6,44,66,2,0,0
11/30/2017 4:10,17,69.1,33,64.5,50,66.1,2,0,0
11/30/2017 4:15,17,68.4,33,63.8,50,65.4,2,0,0
11/30/2017 4:20,24,68.5,41,63.8,65,65.5,2,0,0
11/30/2017 4:25,30,68.3,48,63.7,78,65.5,2,0,0
11/30/2017 4:30,25,68.5,42,63.9,67,65.6,2,0,0
11/30/2017 4:35,25,68.8,41,64.2,66,66,2,0,0
11/30/2017 4:40,32,69.2,50,64.5,82,66.3,2,0,0
11/30/2017 4:45,37,69.2,55,64.6,92,66.5,2,0,0
11/30/2017 4:50,35,68.9,53,64.2,88,66.1,2,0,0
11/30/2017 4:55,42,68.6,60,63.9,102,65.8,2,0,0
11/30/2017 5:00,42,69.7,60,65.1,102,67,2,0,0
11/30/2017 5:05,42,68.5,62,63.9,104,65.7,2,0,0
11/30/2017 5:10,48,69,68,64.4,116,66.3,2,0,0
11/30/2017 5:15,48,68.5,67,63.8,115,65.8,2,0,0
11/30/2017 5:20,53,67.9,74,63.1,127,65.1,2,0,0
11/30/2017 5:25,42,68.5,62,63.8,104,65.7,2,0,0
11/30/2017 5:30,62,67.4,84,62.7,146,64.7,2,0,0
11/30/2017 5:35,57,68,78,63.3,135,65.3,2,0,0
11/30/2017 5:40,56,68.9,77,64.2,133,66.2,2,0,0
11/30/2017 5:45,65,68.7,86,64,151,66,2,0,0
11/30/2017 5:50,65,67.9,86,63.1,151,65.2,2,0,0
11/30/2017 5:55,57,67.5,77,62.7,134,64.8,2,0,0
11/30/2017 6:00,51,67,71,62.2,122,64.2,2,0,0
11/30/2017 6:05,55,66.8,75,62,130,64,2,0,0
11/30/2017 6:10,51,65.3,71,60.2,122,62.3,2,0,0
11/30/2017 6:15,59,66.7,80,61.8,139,63.9,2,0,0
11/30/2017 6:20,56,66.7,77,61.7,133,63.8,2,0,0
11/30/2017 6:25,60,66.5,81,61.5,141,63.6,2,0,0
11/30/2017 6:30,64,67.1,86,62.3,150,64.3,2,0,0
11/30/2017 6:35,66,67.2,89,62.3,155,64.4,2,0,0
11/30/2017 6:40,80,66.3,102,61.4,182,63.6,2,0,0
11/30/2017 6:45,70,66.8,92,61.9,162,64,2,0,0
11/30/2017 6:50,80,67.9,103,63.1,183,65.2,2,0,0
11/30/2017 6:55,75,67.5,97,62.7,172,64.8,2,0,0
11/30/2017 7:00,74,67.3,95,62.5,169,64.6,2,0,0
11/30/2017 7:05,76,67.8,98,63,174,65.1,2,0,0
11/30/2017 7:10,74,67.5,97,62.7,171,64.8,2,0,0
11/30/2017 7:15,75,67.7,97,63,172,65,2,0,0
11/30/2017 7:20,83,66.8,106,61.9,189,64.1,2,0,0
11/30/2017 7:25,72,66.3,95,61.5,167,63.6,2,0,0
11/30/2017 7:30,94,65.6,119,60.6,213,62.8,2,0,0
11/30/2017 7:35,92,66.1,118,61.2,210,63.4,2,0,0
11/30/2017 7:40,83,65.9,107,60.9,190,63.1,2,0,0
11/30/2017 7:45,82,66.8,106,61.9,188,64.1,2,0,0
11/30/2017 7:50,79,66.5,103,61.6,182,63.7,2,0,0
11/30/2017 7:55,90,66.5,114,61.5,204,63.7,2,0,0
11/30/2017 8:00,77,66.3,99,61.3,176,63.5,2,0,0
11/30/2017 8:05,69,66,89,61,158,63.2,2,0,0
11/30/2017 8:10,83,65.2,106,60.2,189,62.4,2,0,0
11/30/2017 8:15,76,65.3,98,60.3,174,62.5,2,0,0
11/30/2017 8:20,75,64.1,97,59.1,172,61.3,2,0,0
11/30/2017 8:25,75,63.8,97,58.7,172,60.9,2,0,0
11/30/2017 8:30,69,64.2,90,59,159,61.2,2,0,0
11/30/2017 8:35,72,64.2,93,59.1,165,61.3,2,0,0
11/30/2017 8:40,90,63.9,112,58.8,202,61.1,2,0,0
11/30/2017 8:45,79,64.4,102,59.2,181,61.5,2,0,0
11/30/2017 8:50,83,64.9,106,59.8,189,62,2,0,0
11/30/2017 8:55,79,65,101,59.9,180,62.1,2,0,0
11/30/2017 9:00,76,64.4,96,59.3,172,61.5,2,0,0
11/30/2017 9:05,80,62.8,102,57.5,182,59.9,2,0,0
11/30/2017 9:10,73,63.7,94,58.5,167,60.7,2,0,0
11/30/2017 9:15,66,64.2,86,59.1,152,61.3,2,0,0
11/30/2017 9:20,69,64.6,89,59.6,158,61.8,2,0,0
11/30/2017 9:25,75,64.5,96,59.4,171,61.6,2,0,0
11/30/2017 9:30,74,62.8,96,57.6,170,59.8,2,0,0
11/30/2017 9:35,70,63.9,91,58.7,161,61,2,0,0
11/30/2017 9:40,69,64.4,90,59.2,159,61.5,2,0,0
11/30/2017 9:45,67,64.3,87,59.2,154,61.4,2,0,0
11/30/2017 9:50,74,65.6,95,60.6,169,62.8,2,0,0
11/30/2017 9:55,58,65,78,60,136,62.2,2,0,0
11/30/2017 10:00,60,65.2,79,60.2,139,62.3,2,0,0
11/30/2017 10:05,60,65.3,79,60.4,139,62.5,2,0,0
11/30/2017 10:10,62,65,82,60,144,62.1,2,0,0
11/30/2017 10:15,51,65.8,70,61,121,63,2,0,0
11/30/2017 10:20,50,63.4,67,58.3,117,60.5,2,0,0
11/30/2017 10:25,57,63,75,57.8,132,60,2,0,0
11/30/2017 10:30,47,59.3,66,53.8,113,56.1,2,0,0
11/30/2017 10:35,45,62.2,63,57,108,59.2,2,0,0
11/30/2017 10:40,46,64.2,63,59.1,109,61.2,2,0,0
11/30/2017 10:45,43,65.2,61,60.3,104,62.3,2,0,0
11/30/2017 10:50,40,65.3,58,60.3,98,62.4,2,0,0
11/30/2017 10:55,50,65.3,67,60.4,117,62.5,2,0,0
11/30/2017 11:00,41,64.9,58,60,99,62,2,0,0
11/30/2017 11:05,44,67,61,62.2,105,64.2,2,0,0
11/30/2017 11:10,40,65.7,57,60.9,97,62.9,2,0,0
11/30/2017 11:15,44,64.3,62,59.3,106,61.4,2,0,0
11/30/2017 11:20,48,64.1,66,59,114,61.2,2,0,0
11/30/2017 11:25,49,64.1,68,59,117,61.1,2,0,0
11/30/2017 11:30,48,65.2,66,60.2,114,62.3,2,0,0
11/30/2017 11:35,48,65,66,60.1,114,62.2,2,0,0
11/30/2017 11:40,49,65.6,67,60.7,116,62.8,2,0,0
11/30/2017 11:45,46,65.3,63,60.3,109,62.4,2,0,0
11/30/2017 11:50,42,65.9,59,61,101,63,2,0,0
11/30/2017 11:55,53,65.3,71,60.2,124,62.4,2,0,0
11/30/2017 12:00,57,64.6,75,59.5,132,61.7,2,0,0
11/30/2017 12:05,57,64.8,76,59.8,133,62,2,0,0
11/30/2017 12:10,50,64.7,68,59.6,118,61.8,2,0,0
11/30/2017 12:15,56,64.4,74,59.2,130,61.4,2,0,0
11/30/2017 12:20,50,65.7,69,60.7,119,62.8,2,0,0
11/30/2017 12:25,57,66.7,75,61.8,132,63.9,2,0,0
11/30/2017 12:30,60,65.5,79,60.5,139,62.7,2,0,0
11/30/2017 12:35,60,64.6,79,59.6,139,61.8,2,0,0
11/30/2017 12:40,57,65.1,76,60.1,133,62.3,2,0,0
11/30/2017 12:45,54,64.7,72,59.6,126,61.8,2,0,0
11/30/2017 12:50,54,66,71,61.1,125,63.2,2,0,0
11/30/2017 12:55,55,66.1,73,61.2,128,63.3,2,0,0
11/30/2017 13:00,46,66.6,64,61.7,110,63.8,2,0,0
11/30/2017 13:05,54,66.1,72,61.1,126,63.2,2,0,0
11/30/2017 13:10,51,65.5,68,60.5,119,62.7,2,0,0
11/30/2017 13:15,53,66.2,72,61.3,125,63.4,2,0,0
11/30/2017 13:20,49,65.6,67,60.7,116,62.8,2,0,0
11/30/2017 13:25,52,67.5,69,62.8,121,64.8,2,0,0
11/30/2017 13:30,53,67,71,62.2,124,64.2,2,0,0
11/30/2017 13:35,43,66.9,61,62.1,104,64.1,2,0,0
11/30/2017 13:40,52,65.9,70,61,122,63.1,2,0,0
11/30/2017 13:45,50,64.9,69,59.9,119,62,2,0,0
11/30/2017 13:50,45,66.7,62,61.7,107,63.8,2,0,0
11/30/2017 13:55,49,66.1,67,61.2,116,63.3,2,0,0
11/30/2017 14:00,51,66.1,69,61.3,120,63.3,2,0,0
11/30/2017 14:05,59,66.2,77,61.3,136,63.4,2,0,0
11/30/2017 14:10,48,66.2,66,61.2,114,63.3,2,0,0
11/30/2017 14:15,55,65.6,74,60.6,129,62.8,2,0,0
11/30/2017 14:20,52,65.2,70,60.2,122,62.3,2,0,0
11/30/2017 14:25,52,65.3,70,60.2,122,62.4,2,0,0
11/30/2017 14:30,51,66.2,69,61.3,120,63.4,2,0,0
11/30/2017 14:35,49,66.7,67,61.9,116,63.9,2,0,0
11/30/2017 14:40,52,67.2,70,62.5,122,64.5,2,0,0
11/30/2017 14:45,53,66.1,71,61.3,124,63.4,2,0,0
11/30/2017 14:50,47,66.2,65,61.4,112,63.4,2,0,0
11/30/2017 14:55,44,65.8,61,60.9,105,62.9,2,0,0
11/30/2017 15:00,54,66.6,72,61.7,126,63.8,2,0,0
11/30/2017 15:05,50,65.9,68,60.9,118,63,2,0,0
11/30/2017 15:10,58,66,77,61.1,135,63.2,2,0,0
11/30/2017 15:15,59,65.3,77,60.2,136,62.4,2,0,0
11/30/2017 15:20,51,65.9,70,61,121,63.1,2,0,0
11/30/2017 15:25,52,66.3,71,61.4,123,63.4,2,0,0
11/30/2017 15:30,59,66.6,77,61.8,136,63.9,2,0,0
11/30/2017 15:35,56,66.7,75,61.8,131,63.9,2,0,0
11/30/2017 15:40,60,67.6,79,62.8,139,64.9,2,0,0
11/30/2017 15:45,57,66.6,76,61.8,133,63.8,2,0,0
11/30/2017 15:50,58,65.4,78,60.5,136,62.6,2,0,0
11/30/2017 15:55,58,66.4,77,61.6,135,63.7,2,0,0
11/30/2017 16:00,64,67.2,81,62.5,145,64.6,2,0,0
11/30/2017 16:05,56,67.4,75,62.6,131,64.6,2,0,0
11/30/2017 16:10,57,67.2,77,62.3,134,64.4,2,0,0
11/30/2017 16:15,62,67.2,82,62.4,144,64.5,2,0,0
11/30/2017 16:20,56,65.9,76,60.9,132,63,2,0,0
11/30/2017 16:25,58,66.4,77,61.5,135,63.6,2,0,0
11/30/2017 16:30,59,66.1,78,61.2,137,63.3,2,0,0
11/30/2017 16:35,57,64,77,58.9,134,61,2,0,0
11/30/2017 16:40,56,63,76,57.8,132,60,2,0,0
11/30/2017 16:45,52,62.9,70,57.6,122,59.9,2,0,0
11/30/2017 16:50,47,63.1,65,57.8,112,60,2,0,0
11/30/2017 16:55,59,64.1,77,58.8,136,61.1,2,0,0
11/30/2017 17:00,46,63.8,64,58.6,110,60.8,2,0,0
11/30/2017 17:05,53,64.7,71,59.6,124,61.8,2,0,0
11/30/2017 17:10,60,64.1,79,59,139,61.2,2,0,0
11/30/2017 17:15,48,63.9,66,58.8,114,61,2,0,0
11/30/2017 17:20,47,63.7,65,58.6,112,60.7,2,0,0
11/30/2017 17:25,56,63.5,75,58.3,131,60.5,2,0,0
11/30/2017 17:30,52,61.3,71,55.9,123,58.2,2,0,0
11/30/2017 17:35,48,54.5,66,48.3,114,50.9,2,0,0
11/30/2017 17:40,46,54.1,64,47.8,110,50.4,2,0,0
11/30/2017 17:45,47,54.6,66,48.3,113,50.9,2,0,0
11/30/2017 17:50,49,57,66,50.9,115,53.5,2,0,0
11/30/2017 17:55,41,59.2,59,53.4,100,55.8,2,0,0
11/30/2017 18:00,38,62.9,55,57.4,93,59.7,2,0,0
11/30/2017 18:05,55,64,74,58.8,129,61,2,0,0
11/30/2017 18:10,56,64.7,75,59.6,131,61.8,2,0,0
11/30/2017 18:15,61,64.5,80,59.4,141,61.6,2,0,0
11/30/2017 18:20,59,64.7,78,59.7,137,61.9,2,0,0
11/30/2017 18:25,56,64.8,74,59.6,130,61.8,2,0,0
11/30/2017 18:30,50,64.5,69,59.4,119,61.6,2,0,0
11/30/2017 18:35,52,64,70,58.9,122,61.1,2,0,0
11/30/2017 18:40,45,64.9,63,59.9,108,62,2,0,0
11/30/2017 18:45,45,65.5,63,60.5,108,62.6,2,0,0
11/30/2017 18:50,46,64.6,64,59.5,110,61.6,2,0,0
11/30/2017 18:55,39,65.2,57,60.2,96,62.2,2,0,0
11/30/2017 19:00,44,65.4,61,60.4,105,62.5,2,0,0
11/30/2017 19:05,50,66.6,69,61.8,119,63.8,2,0,0
11/30/2017 19:10,49,67.4,68,62.6,117,64.6,2,0,0
11/30/2017 19:15,36,67.2,53,62.3,89,64.3,2,0,0
11/30/2017 19:20,45,66.5,63,61.6,108,63.7,2,0,0
11/30/2017 19:25,39,67,57,62.2,96,64.2,2,0,0
11/30/2017 19:30,45,67.2,63,62.4,108,64.4,2,0,0
11/30/2017 19:35,43,66.9,60,62.1,103,64.1,2,0,0
11/30/2017 19:40,40,67.1,57,62.2,97,64.2,2,0,0
11/30/2017 19:45,33,68,50,63.2,83,65.1,2,0,0
11/30/2017 19:50,37,68.5,53,63.8,90,65.8,2,0,0
11/30/2017 19:55,39,67.9,56,63.1,95,65.1,2,0,0
11/30/2017 20:00,33,67.5,50,62.7,83,64.6,2,0,0
11/30/2017 20:05,38,67.7,55,63,93,64.9,2,0,0
11/30/2017 20:10,34,68.6,51,64,85,65.9,2,0,0
11/30/2017 20:15,36,68.6,53,63.9,89,65.8,2,0,0
11/30/2017 20:20,37,68.5,53,63.8,90,65.7,2,0,0
11/30/2017 20:25,39,67.5,56,62.8,95,64.7,2,0,0
11/30/2017 20:30,33,68.2,49,63.5,82,65.4,2,0,0
11/30/2017 20:35,29,68.9,45,64.2,74,66,2,0,0
11/30/2017 20:40,26,68.6,42,63.9,68,65.7,2,0,0
11/30/2017 20:45,37,68.7,53,64,90,66,2,0,0
11/30/2017 20:50,31,68.6,47,63.9,78,65.7,2,0,0
11/30/2017 20:55,29,69,45,64.4,74,66.2,2,0,0
11/30/2017 21:00,32,69.1,48,64.4,80,66.3,2,0,0
11/30/2017 21:05,28,68.8,44,64.2,72,66,2,0,0
11/30/2017 21:10,33,69,50,64.4,83,66.2,2,0,0
11/30/2017 21:15,23,69,39,64.4,62,66.1,2,0,0
11/30/2017 21:20,27,68.8,43,64.2,70,66,2,0,0
11/30/2017 21:25,25,68.9,42,64.2,67,66,2,0,0
11/30/2017 21:30,25,69.1,41,64.4,66,66.2,2,0,0
11/30/2017 21:35,22,69.1,37,64.4,59,66.2,2,0,0
11/30/2017 21:40,22,68.8,38,64.1,60,65.8,2,0,0
11/30/2017 21:45,24,69.1,40,64.4,64,66.2,2,0,0
11/30/2017 21:50,24,69.2,40,64.5,64,66.3,2,0,0
11/30/2017 21:55,22,69.2,37,64.6,59,66.3,2,0,0
11/30/2017 22:00,24,68.9,40,64.2,64,66,2,0,0
11/30/2017 22:05,20,69,35,64.4,55,66.1,2,0,0
11/30/2017 22:10,23,69.3,38,64.7,61,66.5,2,0,0
11/30/2017 22:15,27,69,44,64.3,71,66.1,2,0,0
11/30/2017 22:20,17,69,33,64.3,50,65.9,2,0,0
11/30/2017 22:25,19,69.3,34,64.7,53,66.4,2,0,0
11/30/2017 22:30,23,69.6,39,65,62,66.7,2,0,0
11/30/2017 22:35,19,69.5,34,64.9,53,66.5,2,0,0
11/30/2017 22:40,20,69.5,36,64.9,56,66.5,2,0,0
11/30/2017 22:45,19,69.5,35,64.9,54,66.5,2,0,0
11/30/2017 22:50,19,69.4,34,64.8,53,66.5,2,0,0
11/30/2017 22:55,13,69.5,29,64.9,42,66.3,2,0,0
11/30/2017 23:00,15,69.4,30,64.8,45,66.3,2,0,0
11/30/2017 23:05,15,69.2,30,64.6,45,66.1,2,0,0
11/30/2017 23:10,17,69.4,33,64.8,50,66.4,2,0,0
11/30/2017 23:15,17,69.4,33,64.8,50,66.3,2,0,0
11/30/2017 23:20,13,69.5,29,64.9,42,66.3,2,0,0
11/30/2017 23:25,14,69.4,29,64.8,43,66.3,2,0,0
11/30/2017 23:30,14,69.3,30,64.7,44,66.2,2,0,0
11/30/2017 23:35,13,69.4,29,64.8,42,66.3,2,0,0
11/30/2017 23:40,17,69.4,32,64.8,49,66.4,2,0,0
11/30/2017 23:45,14,69.5,30,64.9,44,66.4,2,0,0
11/30/2017 23:50,9,69.5,24,64.9,33,66.1,2,0,0
11/30/2017 23:55,12,69.5,27,64.9,39,66.3,2,0,0
12/01/2017 0:00,12,69.3,28,64.7,40,66.1,2,0,0
12/01/2017 0:05,10,69.4,25,64.8,35,66.1,2,0,0
12/01/2017 0:10,8,69.4,24,64.8,32,65.9,2,0,0
12/01/2017 0:15,11,69.3,26,64.7,37,66.1,2,0,0
12/01/2017 0:20,13,69.1,28,64.5,41,65.9,2,0,0
12/01/2017 0:25,13,69.3,29,64.7,42,66.1,2,0,0
12/01/2017 0:30,8,69.4,23,64.8,31,66,2,0,0
12/01/2017 0:35,11,69.5,26,64.9,37,66.3,2,0,0
12/01/2017 0:40,11,69.4,26,64.8,37,66.2,2,0,0
12/01/2017 0:45,10,69.5,25,64.9,35,66.2,2,0,0
12/01/2017 0:50,9,69.3,24,64.7,33,65.9,2,0,0
12/01/2017 0:55,6,69.4,21,64.8,27,65.8,2,0,0
12/01/2017 1:00,9,69.2,24,64.5,33,65.8,2,0,0
12/01/2017 1:05,7,69.3,22,64.7,29,65.8,2,0,0
12/01/2017 1:10,5,69.2,20,64.6,25,65.5,2,0,0
12/01/2017 1:15,8,69.4,23,64.8,31,66,2,0,0
12/01/2017 1:20,9,69.2,24,64.6,33,65.9,2,0,0
12/01/2017 1:25,6,69.1,21,64.5,27,65.5,2,0,0
12/01/2017 1:30,6,69.2,21,64.6,27,65.6,2,0,0
12/01/2017 1:35,11,69.3,27,64.7,38,66,2,0,0
12/01/2017 1:40,6,69.4,21,64.8,27,65.8,2,0,0
12/01/2017 1:45,7,69.4,22,64.8,29,65.9,2,0,0
12/01/2017 1:50,6,69.1,22,64.5,28,65.5,2,0,0
12/01/2017 1:55,6,69.2,21,64.5,27,65.6,2,0,0
12/01/2017 2:00,5,69.1,21,64.5,26,65.4,2,0,0
12/01/2017 2:05,5,69.2,21,64.6,26,65.5,2,0,0
12/01/2017 2:10,9,69.3,25,64.7,34,65.9,2,0,0
12/01/2017 2:15,10,69.3,25,64.7,35,66.1,2,0,0
12/01/2017 2:20,9,69.1,24,64.5,33,65.8,2,0,0
12/01/2017 2:25,9,69.2,24,64.5,33,65.8,2,0,0
12/01/2017 2:30,8,69.3,24,64.7,32,65.9,2,0,0
12/01/2017 2:35,8,69.4,24,64.8,32,65.9,2,0,0
12/01/2017 2:40,7,69.3,22,64.7,29,65.8,2,0,0
12/01/2017 2:45,11,69.3,27,64.7,38,66,2,0,0
12/01/2017 2:50,9,68.8,25,64.1,34,65.3,2,0,0
12/01/2017 2:55,7,69.1,23,64.5,30,65.5,2,0,0
12/01/2017 3:00,11,69.3,27,64.7,38,66,2,0,0
12/01/2017 3:05,12,69,28,64.4,40,65.8,2,0,0
12/01/2017 3:10,13,68.8,29,64.2,42,65.6,2,0,0
12/01/2017 3:15,10,69.1,25,64.5,35,65.8,2,0,0
12/01/2017 3:20,8,68.9,23,64.2,31,65.4,2,0,0
12/01/2017 3:25,11,68.5,26,63.8,37,65.2,2,0,0
12/01/2017 3:30,16,68.8,32,64.2,48,65.7,2,0,0
12/01/2017 3:35,16,68.7,32,64.1,48,65.6,2,0,0
12/01/2017 3:40,15,69,31,64.4,46,65.9,2,0,0
12/01/2017 3:45,14,69.3,30,64.7,44,66.1,2,0,0
12/01/2017 3:50,14,69.3,30,64.7,44,66.2,2,0,0
12/01/2017 3:55,12,69.3,28,64.7,40,66,2,0,0
12/01/2017 4:00,16,69.2,31,64.6,47,66.2,2,0,0
12/01/2017 4:05,18,69.2,34,64.6,52,66.2,2,0,0
12/01/2017 4:10,22,69.3,38,64.7,60,66.4,2,0,0
12/01/2017 4:15,19,69,35,64.4,54,66,2,0,0
12/01/2017 4:20,24,69.1,41,64.4,65,66.1,2,0,0
12/01/2017 4:25,22,69,38,64.3,60,66,2,0,0
12/01/2017 4:30,25,68.5,41,63.8,66,65.6,2,0,0
12/01/2017 4:35,29,68.6,46,64,75,65.8,2,0,0
12/01/2017 4:40,37,68.5,55,63.9,92,65.8,2,0,0
12/01/2017 4:45,34,68.2,51,63.5,85,65.4,2,0,0
12/01/2017 4:50,32,68.4,48,63.7,80,65.6,2,0,0
12/01/2017 4:55,34,69,52,64.4,86,66.2,2,0,0
12/01/2017 5:00,39,68.9,58,64.3,97,66.1,2,0,0
12/01/2017 5:05,37,69.2,55,64.5,92,66.4,2,0,0
12/01/2017 5:10,37,67.4,55,62.7,92,64.6,2,0,0
12/01/2017 5:15,51,68.9,70,64.1,121,66.1,2,0,0
12/01/2017 5:20,52,69.1,72,64.3,124,66.3,2,0,0
12/01/2017 5:25,49,68.7,69,63.9,118,65.9,2,0,0
12/01/2017 5:30,55,67.7,77,62.8,132,64.8,2,0,0
12/01/2017 5:35,52,67.6,73,62.8,125,64.8,2,0,0
12/01/2017 5:40,66,66.6,87,61.7,153,63.8,2,0,0
12/01/2017 5:45,66,66.4,87,61.5,153,63.6,2,0,0
12/01/2017 5:50,60,67.4,80,62.5,140,64.6,2,0,0
12/01/2017 5:55,47,67.6,66,62.8,113,64.8,2,0,0
12/01/2017 6:00,50,67.5,70,62.6,120,64.6,2,0,0
12/01/2017 6:05,46,68.6,65,63.8,111,65.8,2,0,0
12/01/2017 6:10,54,67.9,75,63.1,129,65.1,2,0,0
12/01/2017 6:15,51,68.8,70,64,121,66.1,2,0,0
12/01/2017 6:20,57,68.4,77,63.6,134,65.6,2,0,0
12/01/2017 6:25,64,67.8,85,62.9,149,65,2,0,0
12/01/2017 6:30,56,67.4,78,62.5,134,64.6,2,0,0
12/01/2017 6:35,64,67.4,86,62.5,150,64.6,2,0,0
12/01/2017 6:40,71,67.4,94,62.5,165,64.6,2,0,0
12/01/2017 6:45,73,66.2,96,61.3,169,63.4,2,0,0
12/01/2017 6:50,74,66.9,96,62.1,170,64.2,2,0,0
12/01/2017 6:55,65,68.5,86,63.7,151,65.8,2,0,0
12/01/2017 7:00,62,69.4,83,64.8,145,66.8,2,0,0
12/01/2017 7:05,65,68.7,86,64,151,66,2,0,0
12/01/2017 7:10,71,69,92,64.4,163,66.4,2,0,0
12/01/2017 7:15,77,68.6,100,64,177,66,2,0,0
12/01/2017 7:20,84,68.3,108,63.6,192,65.7,2,0,0
12/01/2017 7:25,87,68.1,110,63.3,197,65.4,2,0,0
12/01/2017 7:30,76,68.8,98,64.1,174,66.1,2,0,0
12/01/2017 7:35,90,68.2,114,63.5,204,65.5,2,0,0
12/01/2017 7:40,86,67.4,110,62.6,196,64.7,2,0,0
12/01/2017 7:45,81,68.2,104,63.5,185,65.6,2,0,0
12/01/2017 7:50,88,67.2,111,62.4,199,64.5,2,0,0
12/01/2017 7:55,85,65.9,108,61,193,63.1,2,0,0
12/01/2017 8:00,69,66.8,91,62.1,160,64.1,2,0,0
12/01/2017 8:05,77,66.6,99,61.9,176,63.9,2,0,0
12/01/2017 8:10,70,67.8,91,63.1,161,65.1,2,0,0
12/01/2017 8:15,75,68.8,96,64.2,171,66.2,2,0,0
12/01/2017 8:20,66,67,88,62.2,154,64.2,2,0,0
12/01/2017 8:25,71,67.6,92,62.8,163,64.9,2,0,0
12/01/2017 8:30,84,66.7,107,61.8,191,63.9,2,0,0
12/01/2017 8:35,68,67.3,89,62.5,157,64.6,2,0,0
12/01/2017 8:40,71,66.9,93,62.1,164,64.2,2,0,0
12/01/2017 8:45,76,66.4,97,61.6,173,63.7,2,0,0
12/01/2017 8:50,76,68.1,98,63.3,174,65.4,2,0,0
12/01/2017 8:55,75,67.6,97,62.8,172,64.9,2,0,0
12/01/2017 9:00,77,66.9,98,62,175,64.2,2,0,0
12/01/2017 9:05,84,64.2,107,59,191,61.3,2,0,0
12/01/2017 9:10,81,64.7,103,59.6,184,61.9,2,0,0
12/01/2017 9:15,67,65.2,86,60.2,153,62.4,2,0,0
12/01/2017 9:20,68,65.9,88,60.9,156,63.1,2,0,0
12/01/2017 9:25,66,66.4,86,61.5,152,63.6,2,0,0
12/01/2017 9:30,69,67.3,89,62.4,158,64.5,2,0,0
12/01/2017 9:35,72,66.4,92,61.5,164,63.7,2,0,0
12/01/2017 9:40,67,66.7,87,61.8,154,63.9,2,0,0
12/01/2017 9:45,69,67.3,89,62.4,158,64.5,2,0,0
12/01/2017 9:50,68,66.9,87,62.1,155,64.2,2,0,0
12/01/2017 9:55,64,68,84,63.3,148,65.3,2,0,0
12/01/2017 10:00,69,67.1,89,62.3,158,64.4,2,0,0
12/01/2017 10:05,62,66.3,81,61.4,143,63.5,2,0,0
12/01/2017 10:10,56,66.9,76,62.2,132,64.2,2,0,0
12/01/2017 10:15,73,66.5,91,61.7,164,63.8,2,0,0
12/01/2017 10:20,63,66.8,81,62.1,144,64.1,2,0,0
12/01/2017 10:25,63,66.3,83,61.5,146,63.6,2,0,0
12/01/2017 10:30,48,66.5,66,61.7,114,63.7,2,0,0
12/01/2017 10:35,61,65.6,80,60.7,141,62.8,2,0,0
12/01/2017 10:40,61,67.3,81,62.5,142,64.6,2,0,0
12/01/2017 10:45,71,67,92,62.2,163,64.3,2,0,0
12/01/2017 10:50,72,67.6,92,62.9,164,65,2,0,0
12/01/2017 10:55,61,68,80,63.3,141,65.3,2,0,0
12/01/2017 11:00,50,66.9,69,62.1,119,64.1,2,0,0
12/01/2017 11:05,63,67.3,83,62.6,146,64.6,2,0,0
12/01/2017 11:10,54,67.4,73,62.7,127,64.7,2,0,0
12/01/2017 11:15,63,66.7,83,62,146,64,2,0,0
12/01/2017 11:20,55,67.4,74,62.7,129,64.7,2,0,0
12/01/2017 11:25,56,68.2,75,63.5,131,65.5,2,0,0
12/01/2017 11:30,72,67,92,62.2,164,64.3,2,0,0
12/01/2017 11:35,53,66.8,72,61.9,125,64,2,0,0
12/01/2017 11:40,57,68.1,75,63.4,132,65.5,2,0,0
12/01/2017 11:45,51,68.3,69,63.6,120,65.6,2,0,0
12/01/2017 11:50,66,67.5,84,62.8,150,64.8,2,0,0
12/01/2017 11:55,56,68.6,75,64,131,66,2,0,0
12/01/2017 12:00,54,69,72,64.3,126,66.3,2,0,0
12/01/2017 12:05,55,69.4,73,64.8,128,66.8,2,0,0
12/01/2017 12:10,64,68.1,83,63.4,147,65.5,2,0,0
12/01/2017 12:15,59,66.4,77,61.5,136,63.6,2,0,0
12/01/2017 12:20,54,66.3,72,61.4,126,63.5,2,0,0
12/01/2017 12:25,41,61,56,55.2,97,57.7,2,0,0
12/01/2017 12:30,52,62.5,67,56.8,119,59.3,2,0,0
12/01/2017 12:35,48,65.2,65,60,113,62.2,2,0,0
12/01/2017 12:40,52,64.9,70,59.7,122,61.9,2,0,0
12/01/2017 12:45,49,66.6,67,61.7,116,63.8,2,0,0
12/01/2017 12:50,48,67.2,65,62.3,113,64.4,2,0,0
12/01/2017 12:55,48,67.4,66,62.7,114,64.7,2,0,0
12/01/2017 13:00,39,68.2,55,63.4,94,65.4,2,0,0
12/01/2017 13:05,56,68.2,73,63.5,129,65.5,2,0,0
12/01/2017 13:10,49,68.7,67,64.1,116,66.1,2,0,0
12/01/2017 13:15,43,68.3,60,63.6,103,65.6,2,0,0
12/01/2017 13:20,49,67,67,62.2,116,64.2,2,0,0
12/01/2017 13:25,47,65.1,65,60.1,112,62.2,2,0,0
12/01/2017 13:30,49,66.3,67,61.4,116,63.5,2,0,0
12/01/2017 13:35,52,66.4,70,61.5,122,63.6,2,0,0
12/01/2017 13:40,52,66.4,70,61.5,122,63.6,2,0,0
12/01/2017 13:45,51,67.3,69,62.6,120,64.6,2,0,0
12/01/2017 13:50,53,68.9,69,64.3,122,66.3,2,0,0
12/01/2017 13:55,48,68.9,65,64.3,113,66.3,2,0,0
12/01/2017 14:00,45,68.2,62,63.5,107,65.5,2,0,0
12/01/2017 14:05,54,67.7,72,63,126,65,2,0,0
12/01/2017 14:10,56,67.8,75,63,131,65.1,2,0,0
12/01/2017 14:15,49,67.7,67,62.9,116,64.9,2,0,0
12/01/2017 14:20,60,67.9,78,63.2,138,65.2,2,0,0
12/01/2017 14:25,49,66.9,68,62.1,117,64.1,2,0,0
12/01/2017 14:30,58,67.2,77,62.4,135,64.4,2,0,0
12/01/2017 14:35,53,66.7,71,61.9,124,63.9,2,0,0
12/01/2017 14:40,43,65.7,60,60.8,103,62.8,2,0,0
12/01/2017 14:45,49,67.4,67,62.6,116,64.6,2,0,0
12/01/2017 14:50,54,67.1,72,62.3,126,64.4,2,0,0
12/01/2017 14:55,44,68,60,63.3,104,65.3,2,0,0
12/01/2017 15:00,54,67.2,73,62.5,127,64.5,2,0,0
12/01/2017 15:05,50,68.5,69,63.8,119,65.8,2,0,0
12/01/2017 15:10,51,68.7,69,64,120,66,2,0,0
12/01/2017 15:15,61,67.5,80,62.7,141,64.8,2,0,0
12/01/2017 15:20,56,68.6,73,63.9,129,65.9,2,0,0
12/01/2017 15:25,58,69,77,64.4,135,66.4,2,0,0
12/01/2017 15:30,61,68.7,79,64.1,140,66.1,2,0,0
12/01/2017 15:35,52,68,70,63.3,122,65.3,2,0,0
12/01/2017 15:40,50,67.4,68,62.6,118,64.6,2,0,0
12/01/2017 15:45,60,67,78,62.1,138,64.2,2,0,0
12/01/2017 15:50,64,66.9,84,62,148,64.1,2,0,0
12/01/2017 15:55,53,67.7,73,62.9,126,64.9,2,0,0
12/01/2017 16:00,48,67.8,66,63,114,65,2,0,0
12/01/2017 16:05,62,67.8,81,63.1,143,65.1,2,0,0
12/01/2017 16:10,59,67.8,77,63,136,65.1,2,0,0
12/01/2017 16:15,57,66.9,76,62,133,64.1,2,0,0
12/01/2017 16:20,58,65.7,77,60.7,135,62.9,2,0,0
12/01/2017 16:25,63,65.1,83,60.1,146,62.2,2,0,0
12/01/2017 16:30,58,66.4,77,61.5,135,63.6,2,0,0
12/01/2017 16:35,48,66.4,66,61.5,114,63.6,2,0,0
12/01/2017 16:40,62,66.7,81,61.8,143,63.9,2,0,0
12/01/2017 16:45,57,66.6,75,61.7,132,63.8,2,0,0
12/01/2017 16:50,54,66.6,71,61.7,125,63.8,2,0,0
12/01/2017 16:55,56,67.3,74,62.5,130,64.6,2,0,0
12/01/2017 17:00,58,67.3,76,62.5,134,64.6,2,0,0
12/01/2017 17:05,56,67.2,74,62.3,130,64.4,2,0,0
12/01/2017 17:10,59,67.3,78,62.4,137,64.5,2,0,0
12/01/2017 17:15,63,65.8,82,60.8,145,63,2,0,0
12/01/2017 17:20,60,64.9,78,59.7,138,62,2,0,0
12/01/2017 17:25,53,63.6,72,58.3,125,60.6,2,0,0
12/01/2017 17:30,47,64.1,64,58.8,111,61,2,0,0
12/01/2017 17:35,52,64.8,69,59.6,121,61.9,2,0,0
12/01/2017 17:40,53,62.1,70,56.6,123,59,2,0,0
12/01/2017 17:45,48,62.7,66,57.3,114,59.6,2,0,0
12/01/2017 17:50,48,64.5,66,59.3,114,61.5,2,0,0
12/01/2017 17:55,44,66.3,62,61.3,106,63.3,2,0,0
12/01/2017 18:00,48,64.5,65,59.3,113,61.5,2,0,0
12/01/2017 18:05,57,65.7,75,60.6,132,62.8,2,0,0
12/01/2017 18:10,49,65.7,68,60.7,117,62.8,2,0,0
12/01/2017 18:15,57,64.6,75,59.5,132,61.7,2,0,0
12/01/2017 18:20,57,65.9,76,60.9,133,63.1,2,0,0
12/01/2017 18:25,51,66,70,61,121,63.1,2,0,0
12/01/2017 18:30,54,66.3,72,61.3,126,63.5,2,0,0
12/01/2017 18:35,54,67,73,62.1,127,64.2,2,0,0
12/01/2017 18:40,51,66.6,69,61.6,120,63.7,2,0,0
12/01/2017 18:45,52,66.4,71,61.4,123,63.5,2,0,0
12/01/2017 18:50,44,67.5,62,62.6,106,64.6,2,0,0
12/01/2017 18:55,54,67.6,73,62.8,127,64.9,2,0,0
12/01/2017 19:00,52,66.4,70,61.4,122,63.5,2,0,0
12/01/2017 19:05,49,67.8,66,62.9,115,65,2,0,0
12/01/2017 19:10,52,68.2,71,63.4,123,65.4,2,0,0
12/01/2017 19:15,45,67.7,63,62.9,108,64.9,2,0,0
12/01/2017 19:20,42,68.2,59,63.5,101,65.5,2,0,0
12/01/2017 19:25,35,67.6,52,62.8,87,64.7,2,0,0
12/01/2017 19:30,42,66.5,59,61.6,101,63.7,2,0,0
12/01/2017 19:35,43,67.8,61,63,104,65,2,0,0
12/01/2017 19:40,36,69,54,64.3,90,66.2,2,0,0
12/01/2017 19:45,34,68.9,51,64.2,85,66.1,2,0,0
12/01/2017 19:50,35,69.5,52,64.9,87,66.8,2,0,0
12/01/2017 19:55,36,69.2,52,64.6,88,66.5,2,0,0
12/01/2017 20:00,41,68.6,58,64,99,65.9,2,0,0
12/01/2017 20:05,36,69,53,64.4,89,66.3,2,0,0
12/01/2017 20:10,39,68.9,56,64.3,95,66.2,2,0,0
12/01/2017 20:15,34,68.1,50,63.4,84,65.3,2,0,0
12/01/2017 20:20,33,68.8,50,64.2,83,66,2,0,0
12/01/2017 20:25,39,68.8,56,64.1,95,66.1,2,0,0
12/01/2017 20:30,30,68.7,47,64,77,65.8,2,0,0
12/01/2017 20:35,33,68.6,49,63.9,82,65.8,2,0,0
12/01/2017 20:40,34,69.2,50,64.5,84,66.4,2,0,0
12/01/2017 20:45,28,69.3,44,64.7,72,66.5,2,0,0
12/01/2017 20:50,32,69.3,48,64.7,80,66.5,2,0,0
12/01/2017 20:55,32,69.6,48,65,80,66.9,2,0,0
12/01/2017 21:00,30,69.3,46,64.6,76,66.5,2,0,0
12/01/2017 21:05,31,67.5,47,62.8,78,64.7,2,0,0
12/01/2017 21:10,29,67.8,45,63.1,74,64.9,2,0,0
12/01/2017 21:15,35,68.4,51,63.8,86,65.7,2,0,0
12/01/2017 21:20,33,69.2,50,64.6,83,66.4,2,0,0
12/01/2017 21:25,34,68.8,50,64.2,84,66,2,0,0
12/01/2017 21:30,37,67.9,53,63.2,90,65.1,2,0,0
12/01/2017 21:35,26,68.8,42,64.2,68,66,2,0,0
12/01/2017 21:40,28,69.3,44,64.7,72,66.5,2,0,0
12/01/2017 21:45,34,69.1,51,64.4,85,66.3,2,0,0
12/01/2017 21:50,22,69.3,38,64.7,60,66.4,2,0,0
12/01/2017 21:55,26,69.3,41,64.7,67,66.5,2,0,0
12/01/2017 22:00,25,69.3,41,64.7,66,66.4,2,0,0
12/01/2017 22:05,29,68.3,45,63.7,74,65.5,2,0,0
12/01/2017 22:10,26,68.6,43,63.9,69,65.6,2,0,0
12/01/2017 22:15,31,68.3,48,63.6,79,65.5,2,0,0
12/01/2017 22:20,22,68.7,38,64,60,65.7,2,0,0
12/01/2017 22:25,22,69.1,38,64.5,60,66.2,2,0,0
12/01/2017 22:30,26,69,42,64.4,68,66.1,2,0,0
12/01/2017 22:35,22,69.4,37,64.8,59,66.6,2,0,0
12/01/2017 22:40,22,69.3,38,64.7,60,66.4,2,0,0
12/01/2017 22:45,22,69.3,38,64.7,60,66.4,2,0,0
12/01/2017 22:50,17,69.5,33,64.9,50,66.5,2,0,0
12/01/2017 22:55,18,69.5,33,64.9,51,66.5,2,0,0
12/01/2017 23:00,20,69.5,36,65,56,66.6,2,0,0
12/01/2017 23:05,24,69,40,64.3,64,66.1,2,0,0
12/01/2017 23:10,17,69.1,33,64.5,50,66.1,2,0,0
12/01/2017 23:15,21,69.4,36,64.8,57,66.5,2,0,0
12/01/2017 23:20,18,69.3,33,64.7,51,66.3,2,0,0
12/01/2017 23:25,18,69.1,34,64.5,52,66.1,2,0,0
12/01/2017 23:30,17,69.1,34,64.5,51,66.1,2,0,0
12/01/2017 23:35,25,68.8,42,64.2,67,65.9,2,0,0
12/01/2017 23:40,17,69.1,33,64.4,50,66,2,0,0
12/01/2017 23:45,14,69.3,30,64.7,44,66.2,2,0,0
12/01/2017 23:50,16,69.4,31,64.8,47,66.3,2,0,0
12/01/2017 23:55,12,69.4,27,64.8,39,66.2,2,0,0
12/02/2017 0:00,17,69.3,32,64.7,49,66.3,2,0,0
12/02/2017 0:05,18,69.6,33,65,51,66.6,2,0,0
12/02/2017 0:10,12,69.5,27,64.9,39,66.3,2,0,0
12/02/2017 0:15,14,69.3,30,64.7,44,66.1,2,0,0
12/02/2017 0:20,21,69.6,36,65,57,66.7,2,0,0
12/02/2017 0:25,17,69.4,33,64.8,50,66.4,2,0,0
12/02/2017 0:30,13,69.3,29,64.6,42,66.1,2,0,0
12/02/2017 0:35,12,69.4,27,64.7,39,66.2,2,0,0
12/02/2017 0:40,11,69.3,27,64.7,38,66,2,0,0
12/02/2017 0:45,17,69.3,32,64.7,49,66.3,2,0,0
12/02/2017 0:50,11,69.4,27,64.8,38,66.1,2,0,0
12/02/2017 0:55,7,69.2,23,64.6,30,65.7,2,0,0
12/02/2017 1:00,9,69.3,24,64.7,33,65.9,2,0,0
12/02/2017 1:05,12,69.3,27,64.7,39,66.1,2,0,0
12/02/2017 1:10,14,69.2,29,64.6,43,66.1,2,0,0
12/02/2017 1:15,10,69.3,26,64.7,36,66,2,0,0
12/02/2017 1:20,9,69.4,24,64.8,33,66,2,0,0
12/02/2017 1:25,11,69.3,26,64.7,37,66.1,2,0,0
12/02/2017 1:30,9,69,25,64.4,34,65.6,2,0,0
12/02/2017 1:35,9,69.2,25,64.5,34,65.8,2,0,0
12/02/2017 1:40,9,69.2,24,64.5,33,65.8,2,0,0
12/02/2017 1:45,10,69.2,25,64.6,35,65.9,2,0,0
12/02/2017 1:50,9,69.3,24,64.7,33,66,2,0,0
12/02/2017 1:55,8,69.3,23,64.7,31,65.9,2,0,0
12/02/2017 2:00,8,69.2,23,64.6,31,65.8,2,0,0
12/02/2017 2:05,19,69.2,24,64.5,43,66.6,2,0,0
12/02/2017 2:10,10,69.3,25,64.7,35,66,2,0,0
12/02/2017 2:15,11,69.4,27,64.7,38,66.1,2,0,0
12/02/2017 2:20,11,69.3,27,64.7,38,66,2,0,0
12/02/2017 2:25,11,69.4,26,64.8,37,66.1,2,0,0
12/02/2017 2:30,9,69.4,24,64.8,33,66,2,0,0
12/02/2017 2:35,10,69.3,25,64.7,35,66,2,0,0
12/02/2017 2:40,9,69.4,24,64.8,33,66,2,0,0
12/02/2017 2:45,7,69.4,22,64.8,29,65.9,2,0,0
12/02/2017 2:50,8,69.4,23,64.8,31,66,2,0,0
12/02/2017 2:55,7,69.4,22,64.8,29,65.9,2,0,0
12/02/2017 3:00,10,69.4,25,64.8,35,66.2,2,0,0
12/02/2017 3:05,7,69.4,22,64.8,29,65.9,2,0,0
12/02/2017 3:10,13,69.3,29,64.7,42,66.1,2,0,0
12/02/2017 3:15,9,69.4,24,64.8,33,66,2,0,0
12/02/2017 3:20,9,69.1,24,64.5,33,65.8,2,0,0
12/02/2017 3:25,11,69.3,26,64.7,37,66.1,2,0,0
12/02/2017 3:30,9,69.2,25,64.5,34,65.8,2,0,0
12/02/2017 3:35,7,68.9,23,64.3,30,65.4,2,0,0
12/02/2017 3:40,10,68.7,25,64,35,65.4,2,0,0
12/02/2017 3:45,11,68.6,26,63.9,37,65.3,2,0,0
12/02/2017 3:50,8,68.8,24,64.2,32,65.3,2,0,0
12/02/2017 3:55,11,69.1,27,64.5,38,65.8,2,0,0
12/02/2017 4:00,8,69.2,24,64.5,32,65.7,2,0,0
12/02/2017 4:05,10,69.1,25,64.5,35,65.8,2,0,0
12/02/2017 4:10,13,68.9,28,64.3,41,65.8,2,0,0
12/02/2017 4:15,10,69.2,25,64.5,35,65.9,2,0,0
12/02/2017 4:20,13,68.9,29,64.3,42,65.7,2,0,0
12/02/2017 4:25,11,69.1,27,64.5,38,65.8,2,0,0
12/02/2017 4:30,15,69.2,31,64.5,46,66,2,0,0
12/02/2017 4:35,13,69.3,29,64.7,42,66.1,2,0,0
12/02/2017 4:40,14,69,29,64.4,43,65.9,2,0,0
12/02/2017 4:45,16,69.2,32,64.5,48,66.1,2,0,0
12/02/2017 4:50,15,69.2,31,64.6,46,66.1,2,0,0
12/02/2017 4:55,15,69.2,30,64.5,45,66.1,2,0,0
12/02/2017 5:00,15,69.2,31,64.6,46,66.1,2,0,0
12/02/2017 5:05,14,69.3,30,64.7,44,66.2,2,0,0
12/02/2017 5:10,19,69.3,35,64.7,54,66.4,2,0,0
12/02/2017 5:15,16,69.3,31,64.7,47,66.2,2,0,0
12/02/2017 5:20,18,69.2,34,64.5,52,66.1,2,0,0
12/02/2017 5:25,18,69.3,34,64.7,52,66.3,2,0,0
12/02/2017 5:30,16,69.4,32,64.8,48,66.4,2,0,0
12/02/2017 5:35,26,68.5,42,63.8,68,65.6,2,0,0
12/02/2017 5:40,19,68.6,34,63.9,53,65.6,2,0,0
12/02/2017 5:45,18,68.9,34,64.2,52,65.8,2,0,0
12/02/2017 5:50,21,69.1,37,64.5,58,66.2,2,0,0
12/02/2017 5:55,20,69.2,36,64.5,56,66.2,2,0,0
12/02/2017 6:00,19,68.4,35,63.7,54,65.3,2,0,0
12/02/2017 6:05,23,68.9,39,64.2,62,65.9,2,0,0
12/02/2017 6:10,26,69.1,43,64.5,69,66.3,2,0,0
12/02/2017 6:15,26,69.2,42,64.6,68,66.4,2,0,0
12/02/2017 6:20,28,69.2,45,64.5,73,66.3,2,0,0
12/02/2017 6:25,25,69.3,41,64.7,66,66.4,2,0,0
12/02/2017 6:30,22,69.2,38,64.5,60,66.2,2,0,0
12/02/2017 6:35,30,67.8,46,63.1,76,64.9,2,0,0
12/02/2017 6:40,33,66.7,50,61.9,83,63.8,2,0,0
12/02/2017 6:45,38,68.4,55,63.7,93,65.6,2,0,0
12/02/2017 6:50,32,69,50,64.3,82,66.1,2,0,0
12/02/2017 6:55,30,69,46,64.4,76,66.2,2,0,0
12/02/2017 7:00,24,68.8,39,64.2,63,66,2,0,0
12/02/2017 7:05,25,69.2,41,64.6,66,66.4,2,0,0
12/02/2017 7:10,27,69.5,43,64.9,70,66.6,2,0,0
12/02/2017 7:15,28,69.7,44,65.1,72,66.9,2,0,0
12/02/2017 7:20,33,69.5,49,64.8,82,66.7,2,0,0
12/02/2017 7:25,36,69.6,53,65,89,66.8,2,0,0
12/02/2017 7:30,40,69.6,57,64.9,97,66.8,2,0,0
12/02/2017 7:35,37,69.5,55,64.9,92,66.8,2,0,0
12/02/2017 7:40,45,69.2,63,64.6,108,66.5,2,0,0
12/02/2017 7:45,42,68.5,58,63.8,100,65.8,2,0,0
12/02/2017 7:50,50,68.2,68,63.5,118,65.5,2,0,0
12/02/2017 7:55,41,68.4,58,63.7,99,65.6,2,0,0
12/02/2017 8:00,38,68.8,55,64.1,93,66,2,0,0
12/02/2017 8:05,43,69.1,61,64.4,104,66.4,2,0,0
12/02/2017 8:10,41,68.2,59,63.5,100,65.4,2,0,0
12/02/2017 8:15,48,68.8,65,64.1,113,66.1,2,0,0
12/02/2017 8:20,46,68.5,64,63.8,110,65.7,2,0,0
12/02/2017 8:25,47,68.6,65,63.9,112,65.9,2,0,0
12/02/2017 8:30,41,69.1,58,64.4,99,66.3,2,0,0
12/02/2017 8:35,35,68.9,52,64.2,87,66.1,2,0,0
12/02/2017 8:40,64,68.8,84,64.1,148,66.1,2,0,0
12/02/2017 8:45,55,68.7,73,64,128,66,2,0,0
12/02/2017 8:50,54,68.8,72,64.1,126,66.1,2,0,0
12/02/2017 8:55,51,68.7,69,64,120,66,2,0,0
12/02/2017 9:00,44,68.2,61,63.5,105,65.5,2,0,0
12/02/2017 9:05,54,69.3,71,64.7,125,66.7,2,0,0
12/02/2017 9:10,48,69.7,65,65.1,113,67,2,0,0
12/02/2017 9:15,62,68.4,81,63.6,143,65.7,2,0,0
12/02/2017 9:20,51,68.2,69,63.5,120,65.5,2,0,0
12/02/2017 9:25,57,68.6,75,63.9,132,65.9,2,0,0
12/02/2017 9:30,60,68.7,78,63.9,138,66,2,0,0
12/02/2017 9:35,64,68.9,83,64.1,147,66.2,2,0,0
12/02/2017 9:40,77,68.4,97,63.7,174,65.7,2,0,0
12/02/2017 9:45,75,69.4,95,64.7,170,66.8,2,0,0
12/02/2017 9:50,69,69.7,89,65.1,158,67.1,2,0,0
12/02/2017 9:55,66,69,85,64.3,151,66.4,2,0,0
12/02/2017 10:00,70,68.9,88,64.2,158,66.3,2,0,0
12/02/2017 10:05,65,69.4,83,64.8,148,66.9,2,0,0
12/02/2017 10:10,58,69.5,77,64.9,135,66.9,2,0,0
12/02/2017 10:15,71,68.8,92,64.2,163,66.2,2,0,0
12/02/2017 10:20,73,68.1,92,63.4,165,65.5,2,0,0
12/02/2017 10:25,78,68,97,63.3,175,65.4,2,0,0
12/02/2017 10:30,73,68.4,93,63.7,166,65.8,2,0,0
12/02/2017 10:35,67,68.6,86,63.9,153,66,2,0,0
12/02/2017 10:40,76,67.7,96,62.9,172,65,2,0,0
12/02/2017 10:45,69,68.4,89,63.7,158,65.7,2,0,0
12/02/2017 10:50,67,69.2,85,64.5,152,66.6,2,0,0
12/02/2017 10:55,63,69.9,82,65.3,145,67.3,2,0,0
12/02/2017 11:00,70,68.9,90,64.3,160,66.3,2,0,0
12/02/2017 11:05,67,68.9,85,64.2,152,66.3,2,0,0
12/02/2017 11:10,86,68.7,107,64,193,66.1,2,0,0
12/02/2017 11:15,81,69.5,102,64.9,183,66.9,2,0,0
12/02/2017 11:20,94,68.1,115,63.4,209,65.5,2,0,0
12/02/2017 11:25,88,68.4,109,63.8,197,65.9,2,0,0
12/02/2017 11:30,81,68.1,102,63.4,183,65.5,2,0,0
12/02/2017 11:35,80,67.3,101,62.5,181,64.6,2,0,0
12/02/2017 11:40,84,67.9,105,63.2,189,65.3,2,0,0
12/02/2017 11:45,80,68.8,99,64.2,179,66.3,2,0,0
12/02/2017 11:50,68,68.7,87,64,155,66.1,2,0,0
12/02/2017 11:55,80,68,101,63.3,181,65.4,2,0,0
12/02/2017 12:00,66,68.5,85,63.8,151,65.8,2,0,0
12/02/2017 12:05,82,68.5,103,63.8,185,65.9,2,0,0
12/02/2017 12:10,89,68.3,110,63.6,199,65.7,2,0,0
12/02/2017 12:15,88,67.4,109,62.6,197,64.7,2,0,0
12/02/2017 12:20,75,68,94,63.2,169,65.3,2,0,0
12/02/2017 12:25,78,68,98,63.2,176,65.3,2,0,0
12/02/2017 12:30,72,68.6,91,64,163,66,2,0,0
12/02/2017 12:35,84,68.2,106,63.5,190,65.6,2,0,0
12/02/2017 12:40,83,68.4,104,63.7,187,65.8,2,0,0
12/02/2017 12:45,81,68.2,101,63.5,182,65.6,2,0,0
12/02/2017 12:50,88,68.7,107,64,195,66.1,2,0,0
12/02/2017 12:55,73,68,92,63.3,165,65.4,2,0,0
12/02/2017 13:00,70,68.4,89,63.7,159,65.8,2,0,0
12/02/2017 13:05,72,68,92,63.2,164,65.3,2,0,0
12/02/2017 13:10,63,68,82,63.2,145,65.3,2,0,0
12/02/2017 13:15,80,67.6,100,62.8,180,64.9,2,0,0
12/02/2017 13:20,67,68.3,86,63.6,153,65.6,2,0,0
12/02/2017 13:25,74,68.8,94,64.1,168,66.2,2,0,0
12/02/2017 13:30,72,68.3,92,63.6,164,65.7,2,0,0
12/02/2017 13:35,79,67.6,100,62.9,179,65,2,0,0
12/02/2017 13:40,80,68.1,101,63.3,181,65.4,2,0,0
12/02/2017 13:45,78,68.5,98,63.8,176,65.8,2,0,0
12/02/2017 13:50,80,68.4,100,63.6,180,65.7,2,0,0
12/02/2017 13:55,70,67.5,90,62.7,160,64.8,2,0,0
12/02/2017 14:00,79,67.3,100,62.5,179,64.6,2,0,0
12/02/2017 14:05,69,68.1,89,63.4,158,65.4,2,0,0
12/02/2017 14:10,73,66.8,93,61.9,166,64,2,0,0
12/02/2017 14:15,72,66.9,91,62,163,64.2,2,0,0
12/02/2017 14:20,64,68,83,63.2,147,65.3,2,0,0
12/02/2017 14:25,71,68.1,90,63.4,161,65.5,2,0,0
12/02/2017 14:30,80,68.6,100,63.9,180,66,2,0,0
12/02/2017 14:35,78,67.6,97,62.8,175,65,2,0,0
12/02/2017 14:40,73,67,93,62.1,166,64.3,2,0,0
12/02/2017 14:45,73,68.1,93,63.4,166,65.4,2,0,0
12/02/2017 14:50,65,68.6,84,63.9,149,66,2,0,0
12/02/2017 14:55,82,68.1,101,63.4,183,65.5,2,0,0
12/02/2017 15:00,73,66.9,93,62,166,64.1,2,0,0
12/02/2017 15:05,74,67.9,94,63.1,168,65.2,2,0,0
12/02/2017 15:10,66,67.8,85,63,151,65.1,2,0,0
12/02/2017 15:15,78,67.3,97,62.4,175,64.6,2,0,0
12/02/2017 15:20,82,66.9,102,62,184,64.2,2,0,0
12/02/2017 15:25,84,67.1,104,62.2,188,64.4,2,0,0
12/02/2017 15:30,76,66.8,96,61.9,172,64,2,0,0
12/02/2017 15:35,89,66.8,111,61.9,200,64.1,2,0,0
12/02/2017 15:40,89,67,109,62.1,198,64.3,2,0,0
12/02/2017 15:45,75,67.9,94,63.1,169,65.3,2,0,0
12/02/2017 15:50,84,68.2,104,63.4,188,65.6,2,0,0
12/02/2017 15:55,75,68,95,63.2,170,65.3,2,0,0
12/02/2017 16:00,74,68.2,93,63.4,167,65.5,2,0,0
12/02/2017 16:05,81,67.6,101,62.8,182,65,2,0,0
12/02/2017 16:10,68,67.1,86,62.2,154,64.3,2,0,0
12/02/2017 16:15,73,67.8,92,63,165,65.1,2,0,0
12/02/2017 16:20,81,67.8,102,63,183,65.1,2,0,0
12/02/2017 16:25,75,68.3,94,63.6,169,65.7,2,0,0
12/02/2017 16:30,70,68.7,91,64,161,66,2,0,0
12/02/2017 16:35,67,67.7,88,62.9,155,65,2,0,0
12/02/2017 16:40,74,67.3,94,62.5,168,64.6,2,0,0
12/02/2017 16:45,80,67.2,101,62.4,181,64.5,2,0,0
12/02/2017 16:50,80,67,100,62.2,180,64.3,2,0,0
12/02/2017 16:55,79,66.9,100,62,179,64.2,2,0,0
12/02/2017 17:00,79,66.6,99,61.7,178,63.9,2,0,0
12/02/2017 17:05,73,66.9,93,62.1,166,64.2,2,0,0
12/02/2017 17:10,77,66.8,98,61.9,175,64.1,2,0,0
12/02/2017 17:15,67,65.8,87,60.9,154,63,2,0,0
12/02/2017 17:20,76,64.9,96,60,172,62.2,2,0,0
12/02/2017 17:25,68,65.5,88,60.5,156,62.7,2,0,0
12/02/2017 17:30,76,65.8,96,60.8,172,63,2,0,0
12/02/2017 17:35,64,65.2,84,60.1,148,62.3,2,0,0
12/02/2017 17:40,68,63.9,88,58.6,156,60.9,2,0,0
12/02/2017 17:45,83,63.6,106,58.3,189,60.6,2,0,0
12/02/2017 17:50,73,63.7,93,58.5,166,60.8,2,0,0
12/02/2017 17:55,73,64.4,93,59.3,166,61.5,2,0,0
12/02/2017 18:00,67,66.2,86,61.2,153,63.4,2,0,0
12/02/2017 18:05,60,68.2,79,63.4,139,65.4,2,0,0
12/02/2017 18:10,57,68.8,75,64.1,132,66.1,2,0,0
12/02/2017 18:15,70,68.2,88,63.4,158,65.5,2,0,0
12/02/2017 18:20,63,68.6,82,63.9,145,65.9,2,0,0
12/02/2017 18:25,59,68.3,76,63.5,135,65.6,2,0,0
12/02/2017 18:30,78,67.5,99,62.7,177,64.8,2,0,0
12/02/2017 18:35,67,67.2,87,62.4,154,64.5,2,0,0
12/02/2017 18:40,72,67.8,92,63,164,65.1,2,0,0
12/02/2017 18:45,66,68.5,86,63.8,152,65.8,2,0,0
12/02/2017 18:50,68,68.7,88,64,156,66,2,0,0
12/02/2017 18:55,73,68.5,93,63.8,166,65.9,2,0,0
12/02/2017 19:00,70,68.4,90,63.7,160,65.8,2,0,0
12/02/2017 19:05,68,68.2,88,63.4,156,65.5,2,0,0
12/02/2017 19:10,72,67.7,92,62.9,164,65,2,0,0
12/02/2017 19:15,52,67.7,71,62.8,123,64.8,2,0,0
12/02/2017 19:20,52,67.6,70,62.8,122,64.8,2,0,0
12/02/2017 19:25,55,67.2,73,62.4,128,64.5,2,0,0
12/02/2017 19:30,54,67.6,72,62.8,126,64.9,2,0,0
12/02/2017 19:35,58,68.4,75,63.7,133,65.7,2,0,0
12/02/2017 19:40,58,68.6,75,63.9,133,66,2,0,0
12/02/2017 19:45,50,69.2,67,64.5,117,66.5,2,0,0
12/02/2017 19:50,39,68.9,55,64.2,94,66.1,2,0,0
12/02/2017 19:55,38,68.8,54,64.1,92,66.1,2,0,0
12/02/2017 20:00,40,68.9,56,64.3,96,66.2,2,0,0
12/02/2017 20:05,41,68.8,58,64.1,99,66,2,0,0
12/02/2017 20:10,33,69,48,64.4,81,66.3,2,0,0
12/02/2017 20:15,37,68,55,63.2,92,65.1,2,0,0
12/02/2017 20:20,31,68.2,47,63.5,78,65.4,2,0,0
12/02/2017 20:25,35,68.5,52,63.8,87,65.7,2,0,0
12/02/2017 20:30,36,68.5,52,63.9,88,65.8,2,0,0
12/02/2017 20:35,35,68.4,51,63.7,86,65.6,2,0,0
12/02/2017 20:40,38,67.8,55,63.1,93,65,2,0,0
12/02/2017 20:45,25,68.5,42,63.8,67,65.5,2,0,0
12/02/2017 20:50,28,68.7,44,64.1,72,65.9,2,0,0
12/02/2017 20:55,29,68.9,44,64.2,73,66.1,2,0,0
12/02/2017 21:00,30,69.3,46,64.7,76,66.5,2,0,0
12/02/2017 21:05,30,69.1,46,64.4,76,66.3,2,0,0
12/02/2017 21:10,33,69.7,49,65.1,82,67,2,0,0
12/02/2017 21:15,32,69.1,47,64.5,79,66.4,2,0,0
12/02/2017 21:20,43,68,60,63.3,103,65.3,2,0,0
12/02/2017 21:25,34,68.5,51,63.9,85,65.7,2,0,0
12/02/2017 21:30,31,68.7,48,64,79,65.9,2,0,0
12/02/2017 21:35,28,68.7,45,64.1,73,65.9,2,0,0
12/02/2017 21:40,32,68.8,48,64.2,80,66,2,0,0
12/02/2017 21:45,33,68.8,49,64.1,82,66,2,0,0
12/02/2017 21:50,34,69.2,51,64.6,85,66.5,2,0,0
12/02/2017 21:55,34,69.2,51,64.6,85,66.4,2,0,0
12/02/2017 22:00,35,68.9,51,64.2,86,66.1,2,0,0
12/02/2017 22:05,36,68.8,52,64.1,88,66,2,0,0
12/02/2017 22:10,31,68.3,47,63.6,78,65.5,2,0,0
12/02/2017 22:15,35,68.7,51,64,86,65.9,2,0,0
12/02/2017 22:20,35,68.5,53,63.8,88,65.7,2,0,0
12/02/2017 22:25,34,68.7,51,64,85,65.9,2,0,0
12/02/2017 22:30,36,68.8,52,64.2,88,66.1,2,0,0
12/02/2017 22:35,30,69,46,64.4,76,66.2,2,0,0
12/02/2017 22:40,32,69.4,49,64.7,81,66.6,2,0,0
12/02/2017 22:45,29,69.3,45,64.7,74,66.5,2,0,0
12/02/2017 22:50,22,69,38,64.4,60,66.1,2,0,0
12/02/2017 22:55,26,68.8,41,64.2,67,66,2,0,0
12/02/2017 23:00,27,69,43,64.4,70,66.2,2,0,0
12/02/2017 23:05,30,69.1,45,64.5,75,66.3,2,0,0
12/02/2017 23:10,30,68.8,46,64.2,76,66,2,0,0
12/02/2017 23:15,26,69,41,64.3,67,66.1,2,0,0
12/02/2017 23:20,17,69.1,33,64.5,50,66,2,0,0
12/02/2017 23:25,23,69,39,64.4,62,66.1,2,0,0
12/02/2017 23:30,21,69.1,36,64.5,57,66.2,2,0,0
12/02/2017 23:35,24,69.2,39,64.5,63,66.3,2,0,0
12/02/2017 23:40,21,69,36,64.4,57,66.1,2,0,0
12/02/2017 23:45,22,68.7,38,64.1,60,65.8,2,0,0
12/02/2017 23:50,21,68.7,37,64,58,65.7,2,0,0
12/02/2017 23:55,17,68.9,33,64.3,50,65.9,2,0,0
12/03/2017 0:00,25,69.3,41,64.7,66,66.5,2,0,0
12/03/2017 0:05,14,69,29,64.3,43,65.8,2,0,0
12/03/2017 0:10,18,68.9,33,64.3,51,65.9,2,0,0
12/03/2017 0:15,18,68.9,34,64.3,52,65.9,2,0,0
12/03/2017 0:20,16,69,31,64.4,47,65.9,2,0,0
12/03/2017 0:25,13,69.1,29,64.5,42,65.9,2,0,0
12/03/2017 0:30,16,69.2,31,64.6,47,66.2,2,0,0
12/03/2017 0:35,10,69.2,25,64.6,35,65.9,2,0,0
12/03/2017 0:40,12,69.2,27,64.6,39,66,2,0,0
12/03/2017 0:45,16,69.2,31,64.6,47,66.2,2,0,0
12/03/2017 0:50,13,69.3,28,64.7,41,66.1,2,0,0
12/03/2017 0:55,11,69.2,26,64.6,37,66,2,0,0
12/03/2017 1:00,13,69.2,28,64.5,41,66,2,0,0
12/03/2017 1:05,13,69.3,29,64.7,42,66.1,2,0,0
12/03/2017 1:10,11,69.4,26,64.8,37,66.1,2,0,0
12/03/2017 1:15,12,68.8,28,64.1,40,65.5,2,0,0
12/03/2017 1:20,10,69.1,26,64.4,36,65.7,2,0,0
12/03/2017 1:25,7,69.1,22,64.5,29,65.6,2,0,0
12/03/2017 1:30,11,69.2,27,64.6,38,66,2,0,0
12/03/2017 1:35,7,69.2,23,64.6,30,65.7,2,0,0
12/03/2017 1:40,11,69.2,26,64.6,37,66,2,0,0
12/03/2017 1:45,10,69.3,25,64.7,35,66,2,0,0
12/03/2017 1:50,10,69.3,25,64.7,35,66,2,0,0
12/03/2017 1:55,11,66.4,27,61.6,38,63,2,0,0
12/03/2017 2:00,8,67.7,24,63,32,64.2,2,0,0
12/03/2017 2:05,8,68.4,24,63.7,32,64.8,2,0,0
12/03/2017 2:10,8,68.8,24,64.1,32,65.3,2,0,0
12/03/2017 2:15,7,69.1,22,64.4,29,65.6,2,0,0
12/03/2017 2:20,10,69.2,25,64.6,35,65.9,2,0,0
12/03/2017 2:25,9,69.3,25,64.7,34,65.9,2,0,0
12/03/2017 2:30,11,69.3,26,64.7,37,66.1,2,0,0
12/03/2017 2:35,7,69.4,23,64.8,30,65.9,2,0,0
12/03/2017 2:40,10,69.4,26,64.8,36,66,2,0,0
12/03/2017 2:45,8,69.4,23,64.8,31,66,2,0,0
12/03/2017 2:50,8,69.4,24,64.8,32,65.9,2,0,0
12/03/2017 2:55,9,69.4,24,64.8,33,66,2,0,0
12/03/2017 3:00,8,69.3,23,64.7,31,65.8,2,0,0
12/03/2017 3:05,7,69.3,22,64.7,29,65.8,2,0,0
12/03/2017 3:10,7,69.2,22,64.5,29,65.7,2,0,0
12/03/2017 3:15,8,69.2,23,64.6,31,65.8,2,0,0
12/03/2017 3:20,7,69.2,22,64.6,29,65.7,2,0,0
12/03/2017 3:25,7,69.3,22,64.7,29,65.8,2,0,0
12/03/2017 3:30,9,69.3,24,64.7,33,66,2,0,0
12/03/2017 3:35,7,69.2,22,64.5,29,65.7,2,0,0
12/03/2017 3:40,10,69.3,25,64.7,35,66,2,0,0
12/03/2017 3:45,8,69.3,24,64.7,32,65.9,2,0,0
12/03/2017 3:50,9,69.3,25,64.7,34,65.9,2,0,0
12/03/2017 3:55,9,69.2,25,64.6,34,65.8,2,0,0
12/03/2017 4:00,15,69.3,22,64.7,37,66.5,2,0,0
12/03/2017 4:05,7,69.3,22,64.7,29,65.8,2,0,0
12/03/2017 4:10,9,69.2,24,64.6,33,65.9,2,0,0
12/03/2017 4:15,9,69.2,24,64.5,33,65.8,2,0,0
12/03/2017 4:20,9,69.3,25,64.7,34,66,2,0,0
12/03/2017 4:25,10,69.3,25,64.7,35,66,2,0,0
12/03/2017 4:30,11,69.3,27,64.7,38,66,2,0,0
12/03/2017 4:35,12,69.3,27,64.7,39,66.2,2,0,0
12/03/2017 4:40,10,69.3,25,64.7,35,66,2,0,0
12/03/2017 4:45,14,69.3,30,64.7,44,66.1,2,0,0
12/03/2017 4:50,11,69.3,26,64.7,37,66.1,2,0,0
12/03/2017 4:55,11,69.4,26,64.8,37,66.1,2,0,0
12/03/2017 5:00,9,69.4,24,64.7,33,66,2,0,0
12/03/2017 5:05,15,69.4,30,64.8,45,66.3,2,0,0
12/03/2017 5:10,15,69.2,31,64.6,46,66.1,2,0,0
12/03/2017 5:15,13,69.2,28,64.6,41,66.1,2,0,0
12/03/2017 5:20,11,69.2,27,64.6,38,65.9,2,0,0
12/03/2017 5:25,15,69.4,31,64.7,46,66.2,2,0,0
12/03/2017 5:30,17,69.3,33,64.7,50,66.2,2,0,0
12/03/2017 5:35,18,69.1,34,64.5,52,66.1,2,0,0
12/03/2017 5:40,14,69.2,30,64.6,44,66.1,2,0,0
12/03/2017 5:45,17,69.3,33,64.7,50,66.3,2,0,0
12/03/2017 5:50,14,69.4,30,64.8,44,66.2,2,0,0
12/03/2017 5:55,16,69.4,31,64.8,47,66.3,2,0,0
12/03/2017 6:00,11,69.3,26,64.7,37,66.1,2,0,0
12/03/2017 6:05,11,69.1,26,64.5,37,65.8,2,0,0
12/03/2017 6:10,19,69.4,35,64.7,54,66.4,2,0,0
12/03/2017 6:15,18,69.4,34,64.7,52,66.3,2,0,0
12/03/2017 6:20,10,69.3,25,64.7,35,66,2,0,0
12/03/2017 6:25,16,69.4,32,64.7,48,66.3,2,0,0
12/03/2017 6:30,15,69.4,31,64.8,46,66.3,2,0,0
12/03/2017 6:35,17,69.3,33,64.7,50,66.2,2,0,0
12/03/2017 6:40,21,68.9,37,64.3,58,66,2,0,0
12/03/2017 6:45,20,69.1,36,64.5,56,66.2,2,0,0
12/03/2017 6:50,19,69.2,35,64.5,54,66.2,2,0,0
12/03/2017 6:55,13,69.3,29,64.7,42,66.2,2,0,0
12/03/2017 7:00,20,69.5,36,64.9,56,66.5,2,0,0
12/03/2017 7:05,15,69.5,31,64.9,46,66.4,2,0,0
12/03/2017 7:10,24,69.4,40,64.8,64,66.5,2,0,0
12/03/2017 7:15,29,69.4,45,64.8,74,66.6,2,0,0
12/03/2017 7:20,25,69.6,41,65,66,66.7,2,0,0
12/03/2017 7:25,23,69.5,39,65,62,66.7,2,0,0
12/03/2017 7:30,26,69.7,43,65.1,69,66.9,2,0,0
12/03/2017 7:35,30,69.6,47,65.1,77,66.8,2,0,0
12/03/2017 7:40,36,69.7,53,65.2,89,67,2,0,0
12/03/2017 7:45,33,69.3,50,64.7,83,66.5,2,0,0
12/03/2017 7:50,32,69.3,48,64.7,80,66.5,2,0,0
12/03/2017 7:55,35,69.6,51,64.9,86,66.8,2,0,0
12/03/2017 8:00,30,69.6,46,65,76,66.8,2,0,0
12/03/2017 8:05,36,69.3,53,64.6,89,66.5,2,0,0
12/03/2017 8:10,32,69.6,49,65,81,66.8,2,0,0
12/03/2017 8:15,32,69.5,49,65,81,66.8,2,0,0
12/03/2017 8:20,40,68.6,56,63.9,96,65.9,2,0,0
12/03/2017 8:25,40,69,57,64.4,97,66.3,2,0,0
12/03/2017 8:30,41,69.3,58,64.7,99,66.6,2,0,0
12/03/2017 8:35,45,69.3,63,64.7,108,66.6,2,0,0
12/03/2017 8:40,43,68.6,61,64,104,65.9,2,0,0
12/03/2017 8:45,48,69.4,65,64.8,113,66.8,2,0,0
12/03/2017 8:50,40,69.8,57,65.2,97,67.1,2,0,0
12/03/2017 8:55,37,69.5,54,64.8,91,66.7,2,0,0
12/03/2017 9:00,43,69.3,61,64.6,104,66.5,2,0,0
12/03/2017 9:05,43,69.6,61,65,104,66.9,2,0,0
12/03/2017 9:10,42,69.4,59,64.8,101,66.8,2,0,0
12/03/2017 9:15,38,69.6,55,64.9,93,66.8,2,0,0
12/03/2017 9:20,45,69.1,62,64.5,107,66.5,2,0,0
12/03/2017 9:25,51,69.5,68,65,119,66.9,2,0,0
12/03/2017 9:30,52,70,70,65.5,122,67.4,2,0,0
12/03/2017 9:35,45,70.4,63,65.9,108,67.8,2,0,0
12/03/2017 9:40,52,70.4,69,65.8,121,67.8,2,0,0
12/03/2017 9:45,63,69.9,82,65.3,145,67.3,2,0,0
12/03/2017 9:50,61,69.9,80,65.4,141,67.3,2,0,0
12/03/2017 9:55,68,69.3,87,64.7,155,66.7,2,0,0
12/03/2017 10:00,51,70.5,69,66.1,120,68,2,0,0
12/03/2017 10:05,64,69.9,82,65.3,146,67.3,2,0,0
12/03/2017 10:10,54,69.4,72,64.8,126,66.8,2,0,0
12/03/2017 10:15,55,62.8,73,57.4,128,59.7,2,0,0
12/03/2017 10:20,64,63,82,57.6,146,59.9,2,0,0
12/03/2017 10:25,61,65.9,80,60.9,141,63.1,2,0,0
12/03/2017 10:30,62,67.7,80,62.9,142,65,2,0,0
12/03/2017 10:35,62,69.2,81,64.6,143,66.6,2,0,0
12/03/2017 10:40,59,69.5,77,64.9,136,66.9,2,0,0
12/03/2017 10:45,52,70,70,65.5,122,67.4,2,0,0
12/03/2017 10:50,71,69.9,90,65.3,161,67.3,2,0,0
12/03/2017 10:55,53,70.4,73,65.9,126,67.8,2,0,0
12/03/2017 11:00,72,69.1,92,64.4,164,66.5,2,0,0
12/03/2017 11:05,57,69.2,75,64.5,132,66.5,2,0,0
12/03/2017 11:10,67,69.6,87,65,154,67,2,0,0
12/03/2017 11:15,67,69,87,64.4,154,66.4,2,0,0
12/03/2017 11:20,69,68.7,89,64,158,66.1,2,0,0
12/03/2017 11:25,76,69,96,64.4,172,66.4,2,0,0
12/03/2017 11:30,64,69.2,84,64.5,148,66.5,2,0,0
12/03/2017 11:35,73,69,93,64.5,166,66.5,2,0,0
12/03/2017 11:40,76,68.2,96,63.5,172,65.6,2,0,0
12/03/2017 11:45,82,68.4,102,63.7,184,65.8,2,0,0
12/03/2017 11:50,56,68.8,73,64.2,129,66.2,2,0,0
12/03/2017 11:55,66,69.4,85,64.8,151,66.8,2,0,0
12/03/2017 12:00,69,69.2,89,64.6,158,66.6,2,0,0
12/03/2017 12:05,62,69.1,80,64.4,142,66.4,2,0,0
12/03/2017 12:10,69,68.9,88,64.3,157,66.3,2,0,0
12/03/2017 12:15,65,68.3,86,63.6,151,65.6,2,0,0
12/03/2017 12:20,55,69.2,73,64.6,128,66.6,2,0,0
12/03/2017 12:25,59,68.5,78,63.8,137,65.9,2,0,0
12/03/2017 12:30,67,68.7,86,64.1,153,66.1,2,0,0
12/03/2017 12:35,68,68.5,89,63.8,157,65.9,2,0,0
12/03/2017 12:40,61,68.7,79,64,140,66,2,0,0
12/03/2017 12:45,59,69.5,76,65,135,67,2,0,0
12/03/2017 12:50,59,69,79,64.4,138,66.4,2,0,0
12/03/2017 12:55,58,68,77,63.2,135,65.3,2,0,0
12/03/2017 13:00,56,68.7,73,64,129,66,2,0,0
12/03/2017 13:05,61,68.8,79,64.2,140,66.2,2,0,0
12/03/2017 13:10,56,68.8,74,64.1,130,66.1,2,0,0
12/03/2017 13:15,61,69.7,80,65.1,141,67.1,2,0,0
12/03/2017 13:20,54,69.5,71,65,125,67,2,0,0
12/03/2017 13:25,62,69.4,80,64.8,142,66.8,2,0,0
12/03/2017 13:30,48,69.1,65,64.4,113,66.4,2,0,0
12/03/2017 13:35,57,69.2,74,64.5,131,66.5,2,0,0
12/03/2017 13:40,56,68.6,74,63.9,130,66,2,0,0
12/03/2017 13:45,61,68.6,80,63.9,141,65.9,2,0,0
12/03/2017 13:50,62,68.8,82,64.2,144,66.2,2,0,0
12/03/2017 13:55,56,68.4,74,63.6,130,65.7,2,0,0
12/03/2017 14:00,47,67.8,64,63,111,65.1,2,0,0
12/03/2017 14:05,49,67.5,67,62.7,116,64.7,2,0,0
12/03/2017 14:10,46,68.8,64,64.1,110,66.1,2,0,0
12/03/2017 14:15,52,68.4,69,63.7,121,65.8,2,0,0
12/03/2017 14:20,51,68.9,68,64.2,119,66.2,2,0,0
12/03/2017 14:25,49,68.9,68,64.3,117,66.2,2,0,0
12/03/2017 14:30,56,68.9,74,64.3,130,66.3,2,0,0
12/03/2017 14:35,57,69,75,64.3,132,66.3,2,0,0
12/03/2017 14:40,55,68.9,74,64.2,129,66.2,2,0,0
12/03/2017 14:45,62,68.7,80,64.1,142,66.1,2,0,0
12/03/2017 14:50,53,68.7,71,64.1,124,66.1,2,0,0
12/03/2017 14:55,52,69,71,64.4,123,66.3,2,0,0
12/03/2017 15:00,56,69.3,74,64.6,130,66.7,2,0,0
12/03/2017 15:05,50,69.4,67,64.7,117,66.7,2,0,0
12/03/2017 15:10,52,68.7,70,63.9,122,66,2,0,0
12/03/2017 15:15,58,69,76,64.3,134,66.3,2,0,0
12/03/2017 15:20,53,69.2,71,64.5,124,66.5,2,0,0
12/03/2017 15:25,59,68.3,79,63.6,138,65.6,2,0,0
12/03/2017 15:30,51,69.8,69,65.3,120,67.2,2,0,0
12/03/2017 15:35,53,69.1,72,64.5,125,66.5,2,0,0
12/03/2017 15:40,54,69.3,72,64.6,126,66.6,2,0,0
12/03/2017 15:45,50,69,67,64.3,117,66.3,2,0,0
12/03/2017 15:50,49,69.1,67,64.5,116,66.4,2,0,0
12/03/2017 15:55,53,69,70,64.4,123,66.4,2,0,0
12/03/2017 16:00,50,69.6,67,65,117,66.9,2,0,0
12/03/2017 16:05,54,70.4,72,65.9,126,67.8,2,0,0
12/03/2017 16:10,51,70.6,69,66.1,120,68,2,0,0
12/03/2017 16:15,47,70.3,65,65.8,112,67.7,2,0,0
12/03/2017 16:20,53,68.8,70,64.1,123,66.1,2,0,0
12/03/2017 16:25,55,68.9,73,64.2,128,66.2,2,0,0
12/03/2017 16:30,57,68.9,75,64.1,132,66.2,2,0,0
12/03/2017 16:35,52,69.4,70,64.7,122,66.7,2,0,0
12/03/2017 16:40,46,68.8,64,64.1,110,66.1,2,0,0
12/03/2017 16:45,51,69.2,68,64.5,119,66.5,2,0,0
12/03/2017 16:50,52,69.4,70,64.8,122,66.8,2,0,0
12/03/2017 16:55,54,68.9,73,64.2,127,66.2,2,0,0
12/03/2017 17:00,42,69.7,59,65.2,101,67.1,2,0,0
12/03/2017 17:05,40,69.6,57,65.1,97,67,2,0,0
12/03/2017 17:10,46,69.5,63,64.9,109,66.8,2,0,0
12/03/2017 17:15,43,69.8,59,65.2,102,67.2,2,0,0
12/03/2017 17:20,43,70.1,61,65.6,104,67.5,2,0,0
12/03/2017 17:25,46,69.2,65,64.6,111,66.5,2,0,0
12/03/2017 17:30,49,68.5,66,63.8,115,65.8,2,0,0
12/03/2017 17:35,47,68.3,64,63.6,111,65.6,2,0,0
12/03/2017 17:40,42,68.8,59,64.2,101,66.1,2,0,0
12/03/2017 17:45,35,69.1,52,64.5,87,66.3,2,0,0
12/03/2017 17:50,39,69.3,56,64.7,95,66.6,2,0,0
12/03/2017 17:55,43,69.4,60,64.8,103,66.7,2,0,0
12/03/2017 18:00,45,69.9,62,65.3,107,67.3,2,0,0
12/03/2017 18:05,38,69.6,54,65,92,66.9,2,0,0
12/03/2017 18:10,38,68.6,55,63.9,93,65.8,2,0,0
12/03/2017 18:15,41,69,58,64.3,99,66.2,2,0,0
12/03/2017 18:20,42,68.6,59,63.9,101,65.8,2,0,0
12/03/2017 18:25,25,68.9,42,64.3,67,66,2,0,0
12/03/2017 18:30,36,69,54,64.3,90,66.2,2,0,0
12/03/2017 18:35,29,69.1,46,64.5,75,66.3,2,0,0
12/03/2017 18:40,29,68.9,45,64.2,74,66.1,2,0,0
12/03/2017 18:45,29,68.8,46,64.1,75,65.9,2,0,0
12/03/2017 18:50,30,69,47,64.3,77,66.1,2,0,0
12/03/2017 18:55,37,68.9,55,64.2,92,66.1,2,0,0
12/03/2017 19:00,28,69.3,44,64.6,72,66.4,2,0,0
12/03/2017 19:05,20,69.2,36,64.6,56,66.2,2,0,0
12/03/2017 19:10,34,69.4,50,64.8,84,66.7,2,0,0
12/03/2017 19:15,31,69.2,48,64.5,79,66.3,2,0,0
12/03/2017 19:20,30,69.2,47,64.6,77,66.4,2,0,0
12/03/2017 19:25,35,69.4,52,64.8,87,66.7,2,0,0
12/03/2017 19:30,33,69.3,50,64.7,83,66.5,2,0,0
12/03/2017 19:35,32,68.8,48,64.1,80,66,2,0,0
12/03/2017 19:40,30,69.4,47,64.8,77,66.6,2,0,0
12/03/2017 19:45,28,69.3,44,64.7,72,66.5,2,0,0
12/03/2017 19:50,32,69.6,49,65.1,81,66.9,2,0,0
12/03/2017 19:55,24,69.5,39,64.9,63,66.6,2,0,0
12/03/2017 20:00,32,69.7,49,65.1,81,66.9,2,0,0
12/03/2017 20:05,28,69.4,45,64.8,73,66.6,2,0,0
12/03/2017 20:10,33,70,49,65.5,82,67.3,2,0,0
12/03/2017 20:15,22,69.7,38,65.1,60,66.8,2,0,0
12/03/2017 20:20,30,69.4,46,64.8,76,66.6,2,0,0
12/03/2017 20:25,22,68.7,38,64,60,65.8,2,0,0
12/03/2017 20:30,24,69.1,40,64.4,64,66.2,2,0,0
12/03/2017 20:35,26,69.3,42,64.7,68,66.4,2,0,0
12/03/2017 20:40,30,69.1,46,64.5,76,66.3,2,0,0
12/03/2017 20:45,24,69.1,41,64.5,65,66.2,2,0,0
12/03/2017 20:50,24,69,40,64.4,64,66.1,2,0,0
12/03/2017 20:55,20,69.2,36,64.6,56,66.2,2,0,0
12/03/2017 21:00,21,69,37,64.4,58,66.1,2,0,0
12/03/2017 21:05,18,69.1,34,64.4,52,66,2,0,0
12/03/2017 21:10,22,69.3,38,64.7,60,66.4,2,0,0
12/03/2017 21:15,25,69.6,41,65,66,66.7,2,0,0
12/03/2017 21:20,25,69.6,41,65,66,66.7,2,0,0
12/03/2017 21:25,30,69.5,46,64.9,76,66.7,2,0,0
12/03/2017 21:30,21,69.5,36,64.9,57,66.5,2,0,0
12/03/2017 21:35,22,69.5,38,64.9,60,66.6,2,0,0
12/03/2017 21:40,16,69.1,32,64.5,48,66,2,0,0
12/03/2017 21:45,24,69.1,40,64.4,64,66.2,2,0,0
12/03/2017 21:50,19,69.4,34,64.8,53,66.4,2,0,0
12/03/2017 21:55,19,69.3,35,64.7,54,66.4,2,0,0
12/03/2017 22:00,19,69.2,35,64.6,54,66.2,2,0,0
12/03/2017 22:05,17,68.8,32,64.2,49,65.8,2,0,0
12/03/2017 22:10,22,68.9,38,64.2,60,65.9,2,0,0
12/03/2017 22:15,20,69.2,36,64.5,56,66.2,2,0,0
12/03/2017 22:20,19,69.2,34,64.5,53,66.2,2,0,0
12/03/2017 22:25,18,69.3,34,64.7,52,66.3,2,0,0
12/03/2017 22:30,18,69.4,34,64.8,52,66.4,2,0,0
12/03/2017 22:35,17,69.4,33,64.8,50,66.4,2,0,0
12/03/2017 22:40,19,69.4,34,64.8,53,66.5,2,0,0
12/03/2017 22:45,17,69.3,33,64.7,50,66.3,2,0,0
12/03/2017 22:50,19,69.6,35,65,54,66.6,2,0,0
12/03/2017 22:55,16,69.5,31,64.9,47,66.5,2,0,0
12/03/2017 23:00,13,69.4,29,64.7,42,66.2,2,0,0
12/03/2017 23:05,20,69.4,36,64.8,56,66.5,2,0,0
12/03/2017 23:10,16,69.5,31,64.9,47,66.5,2,0,0
12/03/2017 23:15,19,69.4,35,64.8,54,66.4,2,0,0
12/03/2017 23:20,16,69.4,32,64.8,48,66.3,2,0,0
12/03/2017 23:25,13,69.3,28,64.7,41,66.1,2,0,0
12/03/2017 23:30,16,69.2,32,64.6,48,66.1,2,0,0
12/03/2017 23:35,18,69.2,33,64.5,51,66.2,2,0,0
12/03/2017 23:40,12,69.1,27,64.5,39,65.9,2,0,0
12/03/2017 23:45,15,69.1,30,64.4,45,66,2,0,0
12/03/2017 23:50,16,69.3,32,64.7,48,66.2,2,0,0
12/03/2017 23:55,13,69.4,29,64.8,42,66.2,2,0,0
