5 Minutes,Lane 1 Flow (Veh/5 Minutes),Lane 1 Speed (mph),Lane 2 Flow (Veh/5 Minutes),Lane 2 Speed (mph),Flow (Veh/5 Minutes),Speed (mph),# Lane Points,% Observed,Holiday
12/18/2017 0:00,11,69.3,27,64.7,38,66.1,2,0,0
12/18/2017 0:05,10,69.4,25,64.8,35,66.1,2,0,0
12/18/2017 0:10,8,69.4,23,64.8,31,66,2,0,0
12/18/2017 0:15,7,69.4,23,64.8,30,65.9,2,0,0
12/18/2017 0:20,10,69.1,25,64.4,35,65.8,2,0,0
12/18/2017 0:25,8,69.2,23,64.6,31,65.8,2,0,0
12/18/2017 0:30,12,69.2,26,64.6,38,66.1,2,0,0
12/18/2017 0:35,8,69.2,23,64.6,31,65.8,2,0,0
12/18/2017 0:40,10,69.4,25,64.8,35,66.1,2,0,0
12/18/2017 0:45,5,69.4,21,64.8,26,65.7,2,0,0
12/18/2017 0:50,10,69.4,20,64.8,30,66.3,2,0,0
12/18/2017 0:55,8,69.4,23,64.8,31,66,2,0,0
12/18/2017 1:00,6,69.4,21,64.8,27,65.8,2,0,0
12/18/2017 1:05,6,69.4,21,64.8,27,65.8,2,0,0
12/18/2017 1:10,10,69.4,25,64.8,35,66.1,2,0,0
12/18/2017 1:15,5,69.4,20,64.8,25,65.7,2,0,0
12/18/2017 1:20,10,69.4,20,64.8,30,66.3,2,0,0
12/18/2017 1:25,6,69.4,21,64.8,27,65.8,2,0,0
12/18/2017 1:30,6,69.3,21,64.7,27,65.7,2,0,0
12/18/2017 1:35,6,69.4,21,64.8,27,65.8,2,0,0
12/18/2017 1:40,5,69.4,21,64.8,26,65.7,2,0,0
12/18/2017 1:45,11,69.3,21,64.7,32,66.3,2,0,0
12/18/2017 1:50,6,69.4,21,64.8,27,65.8,2,0,0
12/18/2017 1:55,10,69.3,20,64.7,30,66.3,2,0,0
12/18/2017 2:00,6,69.3,21,64.7,27,65.7,2,0,0
12/18/2017 2:05,10,69.3,20,64.7,30,66.3,2,0,0
12/18/2017 2:10,5,69.3,21,64.7,26,65.6,2,0,0
12/18/2017 2:15,6,69.3,21,64.7,27,65.7,2,0,0
12/18/2017 2:20,6,69.4,22,64.8,28,65.8,2,0,0
12/18/2017 2:25,6,69.4,21,64.8,27,65.8,2,0,0
12/18/2017 2:30,6,69.4,21,64.7,27,65.8,2,0,0
12/18/2017 2:35,6,69.1,21,64.5,27,65.5,2,0,0
12/18/2017 2:40,7,69.3,22,64.6,29,65.7,2,0,0
12/18/2017 2:45,14,69.5,29,64.9,43,66.4,2,0,0
12/18/2017 2:50,9,69.2,24,64.6,33,65.8,2,0,0
12/18/2017 2:55,9,69.2,24,64.6,33,65.9,2,0,0
12/18/2017 3:00,8,69.1,23,64.5,31,65.7,2,0,0
12/18/2017 3:05,7,69.3,22,64.7,29,65.8,2,0,0
12/18/2017 3:10,10,69.1,26,64.5,36,65.8,2,0,0
12/18/2017 3:15,7,69.3,23,64.7,30,65.8,2,0,0
12/18/2017 3:20,11,69.4,27,64.8,38,66.1,2,0,0
12/18/2017 3:25,10,69.1,26,64.5,36,65.8,2,0,0
12/18/2017 3:30,10,69,26,64.4,36,65.7,2,0,0
12/18/2017 3:35,14,69.1,30,64.5,44,66,2,0,0
12/18/2017 3:40,14,69.2,30,64.6,44,66.1,2,0,0
12/18/2017 3:45,13,69.3,29,64.7,42,66.2,2,0,0
12/18/2017 3:50,14,69.5,30,64.9,44,66.3,2,0,0
12/18/2017 3:55,17,69.5,33,64.9,50,66.5,2,0,0
12/18/2017 4:00,15,69.5,31,64.9,46,66.4,2,0,0
12/18/2017 4:05,17,69.4,33,64.8,50,66.3,2,0,0
12/18/2017 4:10,19,69.2,35,64.6,54,66.2,2,0,0
12/18/2017 4:15,20,69.1,36,64.4,56,66.1,2,0,0
12/18/2017 4:20,25,69.4,42,64.7,67,66.5,2,0,0
12/18/2017 4:25,25,68.9,42,64.3,67,66,2,0,0
12/18/2017 4:30,24,69,41,64.4,65,66.1,2,0,0
12/18/2017 4:35,31,68.3,49,63.6,80,65.4,2,0,0
12/18/2017 4:40,31,69.4,48,64.9,79,66.7,2,0,0
12/18/2017 4:45,36,69.8,54,65.3,90,67.1,2,0,0
12/18/2017 4:50,34,70.3,50,65.8,84,67.6,2,0,0
12/18/2017 4:55,37,70,55,65.5,92,67.3,2,0,0
12/18/2017 5:00,44,69.2,63,64.6,107,66.5,2,0,0
12/18/2017 5:05,46,70.1,66,65.6,112,67.4,2,0,0
12/18/2017 5:10,41,68.5,60,64,101,65.8,2,0,0
12/18/2017 5:15,63,67.9,84,63.3,147,65.2,2,0,0
12/18/2017 5:20,57,68.5,77,63.9,134,65.9,2,0,0
12/18/2017 5:25,58,69.8,78,65.3,136,67.2,2,0,0
12/18/2017 5:30,72,69.2,94,64.6,166,66.6,2,0,0
12/18/2017 5:35,61,68.9,82,64.3,143,66.2,2,0,0
12/18/2017 5:40,61,70.2,82,65.7,143,67.7,2,0,0
12/18/2017 5:45,73,70.7,95,66.2,168,68.2,2,0,0
12/18/2017 5:50,68,70.2,89,65.8,157,67.7,2,0,0
12/18/2017 5:55,57,70.1,78,65.6,135,67.5,2,0,0
12/18/2017 6:00,59,69.2,79,64.6,138,66.6,2,0,0
12/18/2017 6:05,52,68.6,73,63.9,125,65.9,2,0,0
12/18/2017 6:10,70,67.9,91,63.1,161,65.2,2,0,0
12/18/2017 6:15,54,67.3,74,62.5,128,64.5,2,0,0
12/18/2017 6:20,76,67.3,99,62.4,175,64.5,2,0,0
12/18/2017 6:25,65,68.1,87,63.4,152,65.4,2,0,0
12/18/2017 6:30,60,68.5,82,63.8,142,65.8,2,0,0
12/18/2017 6:35,70,67.8,92,63,162,65.1,2,0,0
12/18/2017 6:40,59,68.4,79,63.6,138,65.7,2,0,0
12/18/2017 6:45,82,67.1,106,62.1,188,64.3,2,0,0
12/18/2017 6:50,71,67.3,93,62.4,164,64.5,2,0,0
12/18/2017 6:55,64,68.6,84,63.9,148,66,2,0,0
12/18/2017 7:00,64,67.9,84,63,148,65.1,2,0,0
12/18/2017 7:05,69,67.5,91,62.7,160,64.8,2,0,0
12/18/2017 7:10,85,66.5,110,61.6,195,63.7,2,0,0
12/18/2017 7:15,82,66.3,105,61.4,187,63.6,2,0,0
12/18/2017 7:20,92,66.4,116,61.5,208,63.6,2,0,0
12/18/2017 7:25,82,67.7,105,62.9,187,65,2,0,0
12/18/2017 7:30,83,67.5,105,62.6,188,64.8,2,0,0
12/18/2017 7:35,87,68.2,111,63.4,198,65.5,2,0,0
12/18/2017 7:40,75,67.3,97,62.4,172,64.6,2,0,0
12/18/2017 7:45,90,67.1,115,62.2,205,64.3,2,0,0
12/18/2017 7:50,88,67.8,111,62.9,199,65.1,2,0,0
12/18/2017 7:55,78,67.1,100,62.2,178,64.3,2,0,0
12/18/2017 8:00,80,67.3,102,62.4,182,64.5,2,0,0
12/18/2017 8:05,84,67.4,107,62.5,191,64.7,2,0,0
12/18/2017 8:10,93,64.8,117,59.7,210,62,2,0,0
12/18/2017 8:15,85,64.5,110,59.3,195,61.6,2,0,0
12/18/2017 8:20,75,65.4,97,60.3,172,62.5,2,0,0
12/18/2017 8:25,76,65.6,99,60.6,175,62.8,2,0,0
12/18/2017 8:30,78,64,100,58.8,178,61.1,2,0,0
12/18/2017 8:35,75,64.9,95,59.8,170,62,2,0,0
12/18/2017 8:40,68,66.1,89,61.1,157,63.3,2,0,0
12/18/2017 8:45,80,65.8,102,60.8,182,63,2,0,0
12/18/2017 8:50,74,66.2,97,61.2,171,63.4,2,0,0
12/18/2017 8:55,62,66.3,82,61.4,144,63.5,2,0,0
12/18/2017 9:00,72,66.3,93,61.3,165,63.5,2,0,0
12/18/2017 9:05,64,65.4,85,60.5,149,62.6,2,0,0
12/18/2017 9:10,63,66.6,83,61.8,146,63.9,2,0,0
12/18/2017 9:15,60,67.6,79,62.8,139,64.9,2,0,0
12/18/2017 9:20,54,66.2,73,61.4,127,63.5,2,0,0
12/18/2017 9:25,63,65.7,83,60.8,146,62.9,2,0,0
12/18/2017 9:30,61,65.5,81,60.6,142,62.7,2,0,0
12/18/2017 9:35,65,66.2,84,61.3,149,63.4,2,0,0
12/18/2017 9:40,60,66.8,79,61.9,139,64,2,0,0
12/18/2017 9:45,56,67,75,62.2,131,64.3,2,0,0
12/18/2017 9:50,59,68,78,63.2,137,65.3,2,0,0
12/18/2017 9:55,63,67.7,84,62.9,147,65,2,0,0
12/18/2017 10:00,64,67.2,84,62.4,148,64.5,2,0,0
12/18/2017 10:05,52,67.5,71,62.8,123,64.8,2,0,0
12/18/2017 10:10,55,66.9,75,62.1,130,64.1,2,0,0
12/18/2017 10:15,46,68.5,65,63.9,111,65.8,2,0,0
12/18/2017 10:20,68,66.3,89,61.5,157,63.5,2,0,0
12/18/2017 10:25,63,66.7,83,61.9,146,64,2,0,0
12/18/2017 10:30,50,66.8,69,62,119,64,2,0,0
12/18/2017 10:35,54,67.4,72,62.7,126,64.7,2,0,0
12/18/2017 10:40,57,66.3,76,61.5,133,63.6,2,0,0
12/18/2017 10:45,60,67.8,78,63.1,138,65.1,2,0,0
12/18/2017 10:50,55,67.8,74,63,129,65,2,0,0
12/18/2017 10:55,49,67.6,66,62.8,115,64.8,2,0,0
12/18/2017 11:00,57,69.8,75,65.1,132,67.1,2,0,0
12/18/2017 11:05,51,67.8,70,63,121,65,2,0,0
12/18/2017 11:10,48,69,66,64.3,114,66.3,2,0,0
12/18/2017 11:15,53,68.4,70,63.7,123,65.7,2,0,0
12/18/2017 11:20,53,67.7,71,63,124,65,2,0,0
12/18/2017 11:25,57,68.6,75,64,132,66,2,0,0
12/18/2017 11:30,48,68.7,66,64,114,66,2,0,0
12/18/2017 11:35,50,69.4,68,64.8,118,66.7,2,0,0
12/18/2017 11:40,50,69.7,68,65.1,118,67.1,2,0,0
12/18/2017 11:45,61,69.1,80,64.4,141,66.5,2,0,0
12/18/2017 11:50,60,68,79,63.2,139,65.3,2,0,0
12/18/2017 11:55,48,68.2,66,63.5,114,65.5,2,0,0
12/18/2017 12:00,59,67.6,78,62.7,137,64.8,2,0,0
12/18/2017 12:05,46,68.2,63,63.4,109,65.5,2,0,0
12/18/2017 12:10,56,67.9,75,63,131,65.1,2,0,0
12/18/2017 12:15,60,68.6,78,63.9,138,65.9,2,0,0
12/18/2017 12:20,54,67.8,72,63,126,65.1,2,0,0
12/18/2017 12:25,60,68.6,78,63.8,138,65.9,2,0,0
12/18/2017 12:30,49,68.8,67,64.1,116,66.1,2,0,0
12/18/2017 12:35,51,69.8,69,65.1,120,67.1,2,0,0
12/18/2017 12:40,55,68.1,73,63.3,128,65.3,2,0,0
12/18/2017 12:45,54,68.5,72,63.8,126,65.8,2,0,0
12/18/2017 12:50,49,68.8,68,64.1,117,66.1,2,0,0
12/18/2017 12:55,47,68.1,64,63.4,111,65.4,2,0,0
12/18/2017 13:00,48,69.5,66,64.9,114,66.9,2,0,0
12/18/2017 13:05,53,67.7,71,62.9,124,65,2,0,0
12/18/2017 13:10,39,68.9,56,64.2,95,66.1,2,0,0
12/18/2017 13:15,51,68.2,69,63.5,120,65.5,2,0,0
12/18/2017 13:20,56,68.3,73,63.5,129,65.6,2,0,0
12/18/2017 13:25,54,68.5,72,63.8,126,65.8,2,0,0
12/18/2017 13:30,46,68,64,63.4,110,65.3,2,0,0
12/18/2017 13:35,61,70.1,80,65.6,141,67.6,2,0,0
12/18/2017 13:40,48,69.9,65,65.3,113,67.2,2,0,0
12/18/2017 13:45,52,69.1,70,64.4,122,66.4,2,0,0
12/18/2017 13:50,49,69.5,66,64.9,115,66.9,2,0,0
12/18/2017 13:55,48,69.2,66,64.5,114,66.5,2,0,0
12/18/2017 14:00,52,67.4,71,62.5,123,64.6,2,0,0
12/18/2017 14:05,47,68.3,65,63.6,112,65.6,2,0,0
12/18/2017 14:10,48,68.7,66,64,114,66,2,0,0
12/18/2017 14:15,56,69.8,74,65.2,130,67.2,2,0,0
12/18/2017 14:20,46,68.1,64,63.4,110,65.4,2,0,0
12/18/2017 14:25,46,66.5,63,61.8,109,63.8,2,0,0
12/18/2017 14:30,52,67.3,70,62.6,122,64.6,2,0,0
12/18/2017 14:35,50,67.2,68,62.4,118,64.4,2,0,0
12/18/2017 14:40,39,68.8,56,64.1,95,66,2,0,0
12/18/2017 14:45,43,69.2,61,64.6,104,66.5,2,0,0
12/18/2017 14:50,48,68.8,65,64.1,113,66.1,2,0,0
12/18/2017 14:55,48,68.5,65,63.9,113,65.8,2,0,0
12/18/2017 15:00,42,68.2,59,63.5,101,65.4,2,0,0
12/18/2017 15:05,44,69,61,64.4,105,66.4,2,0,0
12/18/2017 15:10,48,70.3,66,65.8,114,67.7,2,0,0
12/18/2017 15:15,47,69.2,65,64.7,112,66.6,2,0,0
12/18/2017 15:20,51,68.9,69,64.3,120,66.3,2,0,0
12/18/2017 15:25,59,68.6,78,63.9,137,65.9,2,0,0
12/18/2017 15:30,50,68.7,67,64,117,66,2,0,0
12/18/2017 15:35,60,68.7,78,64,138,66.1,2,0,0
12/18/2017 15:40,52,68.7,71,64,123,66,2,0,0
12/18/2017 15:45,59,68.4,77,63.7,136,65.8,2,0,0
12/18/2017 15:50,60,68.6,78,63.9,138,66,2,0,0
12/18/2017 15:55,55,69.2,73,64.6,128,66.6,2,0,0
12/18/2017 16:00,54,70.2,71,65.7,125,67.6,2,0,0
12/18/2017 16:05,66,69.5,85,64.9,151,66.9,2,0,0
12/18/2017 16:10,52,69.9,70,65.3,122,67.3,2,0,0
12/18/2017 16:15,55,68.6,74,63.9,129,65.9,2,0,0
12/18/2017 16:20,53,68.1,71,63.3,124,65.4,2,0,0
12/18/2017 16:25,60,67.1,78,62.2,138,64.4,2,0,0
12/18/2017 16:30,53,67.8,71,63.1,124,65.1,2,0,0
12/18/2017 16:35,58,66.8,76,62,134,64.1,2,0,0
12/18/2017 16:40,62,67.9,81,63.2,143,65.2,2,0,0
12/18/2017 16:45,55,68.8,72,64.2,127,66.2,2,0,0
12/18/2017 16:50,50,69.3,69,64.7,119,66.7,2,0,0
12/18/2017 16:55,51,69.3,68,64.7,119,66.7,2,0,0
12/18/2017 17:00,35,69.2,52,64.6,87,66.4,2,0,0
12/18/2017 17:05,48,69.5,65,64.9,113,66.9,2,0,0
12/18/2017 17:10,49,68.6,68,63.9,117,65.8,2,0,0
12/18/2017 17:15,55,67.5,73,62.7,128,64.8,2,0,0
12/18/2017 17:20,46,67.6,65,62.8,111,64.8,2,0,0
12/18/2017 17:25,50,67.3,69,62.6,119,64.6,2,0,0
12/18/2017 17:30,48,68.1,66,63.4,114,65.4,2,0,0
12/18/2017 17:35,43,67.3,61,62.5,104,64.5,2,0,0
12/18/2017 17:40,41,66.8,57,62.1,98,64.1,2,0,0
12/18/2017 17:45,34,67.4,52,62.7,86,64.6,2,0,0
12/18/2017 17:50,47,67.4,65,62.6,112,64.6,2,0,0
12/18/2017 17:55,41,66.4,59,61.5,100,63.5,2,0,0
12/18/2017 18:00,42,67.3,60,62.5,102,64.5,2,0,0
12/18/2017 18:05,39,69.1,56,64.5,95,66.4,2,0,0
12/18/2017 18:10,38,69.4,55,64.8,93,66.7,2,0,0
12/18/2017 18:15,43,67.4,61,62.6,104,64.6,2,0,0
12/18/2017 18:20,37,67,54,62.2,91,64.2,2,0,0
12/18/2017 18:25,38,66.9,56,62.2,94,64.1,2,0,0
12/18/2017 18:30,36,68.4,53,63.7,89,65.6,2,0,0
12/18/2017 18:35,35,68.8,53,64,88,65.9,2,0,0
12/18/2017 18:40,43,69.7,60,65.1,103,67,2,0,0
12/18/2017 18:45,34,69.4,50,64.7,84,66.6,2,0,0
12/18/2017 18:50,44,69.1,62,64.4,106,66.4,2,0,0
12/18/2017 18:55,44,66.6,62,61.8,106,63.8,2,0,0
12/18/2017 19:00,33,68.5,50,63.8,83,65.7,2,0,0
12/18/2017 19:05,38,68.7,54,64.1,92,66,2,0,0
12/18/2017 19:10,42,69.8,59,65.2,101,67.1,2,0,0
12/18/2017 19:15,46,69.7,63,65.2,109,67.1,2,0,0
12/18/2017 19:20,39,70.1,56,65.5,95,67.4,2,0,0
12/18/2017 19:25,41,70.1,58,65.5,99,67.4,2,0,0
12/18/2017 19:30,35,70.2,51,65.6,86,67.5,2,0,0
12/18/2017 19:35,35,69.1,51,64.5,86,66.4,2,0,0
12/18/2017 19:40,33,69.4,49,64.8,82,66.6,2,0,0
12/18/2017 19:45,30,69.2,47,64.5,77,66.3,2,0,0
12/18/2017 19:50,26,69.1,43,64.5,69,66.2,2,0,0
12/18/2017 19:55,32,69.1,48,64.5,80,66.3,2,0,0
12/18/2017 20:00,35,68.4,52,63.8,87,65.7,2,0,0
12/18/2017 20:05,32,68,47,63.3,79,65.2,2,0,0
12/18/2017 20:10,37,69.2,54,64.6,91,66.4,2,0,0
12/18/2017 20:15,29,69,44,64.4,73,66.2,2,0,0
12/18/2017 20:20,28,69.6,44,65,72,66.8,2,0,0
12/18/2017 20:25,33,69.4,49,64.8,82,66.7,2,0,0
12/18/2017 20:30,33,68.8,49,64.1,82,66,2,0,0
12/18/2017 20:35,33,68.9,49,64.2,82,66.1,2,0,0
12/18/2017 20:40,32,69.3,48,64.6,80,66.5,2,0,0
12/18/2017 20:45,23,69.5,39,64.9,62,66.6,2,0,0
12/18/2017 20:50,25,69.6,41,65,66,66.7,2,0,0
12/18/2017 20:55,30,69.8,47,65.2,77,67,2,0,0
12/18/2017 21:00,24,69,40,64.4,64,66.2,2,0,0
12/18/2017 21:05,21,68.7,37,64,58,65.7,2,0,0
12/18/2017 21:10,24,69,40,64.4,64,66.1,2,0,0
12/18/2017 21:15,28,69.5,44,64.9,72,66.7,2,0,0
12/18/2017 21:20,27,69.3,43,64.7,70,66.5,2,0,0
12/18/2017 21:25,26,69.2,43,64.6,69,66.4,2,0,0
12/18/2017 21:30,27,69.3,43,64.7,70,66.5,2,0,0
12/18/2017 21:35,25,69.4,42,64.8,67,66.5,2,0,0
12/18/2017 21:40,21,69.4,37,64.8,58,66.4,2,0,0
12/18/2017 21:45,27,68.3,44,63.7,71,65.4,2,0,0
12/18/2017 21:50,23,68.8,39,64.2,62,65.9,2,0,0
12/18/2017 21:55,19,68.6,35,64,54,65.6,2,0,0
12/18/2017 22:00,25,68.4,42,63.7,67,65.4,2,0,0
12/18/2017 22:05,24,67.8,40,63.2,64,64.9,2,0,0
12/18/2017 22:10,21,68.5,37,63.8,58,65.5,2,0,0
12/18/2017 22:15,22,68.6,39,63.9,61,65.6,2,0,0
12/18/2017 22:20,16,68.9,32,64.2,48,65.8,2,0,0
12/18/2017 22:25,18,68.9,34,64.2,52,65.8,2,0,0
12/18/2017 22:30,20,68.9,36,64.3,56,65.9,2,0,0
12/18/2017 22:35,28,69.1,45,64.4,73,66.2,2,0,0
12/18/2017 22:40,25,69.4,41,64.7,66,66.5,2,0,0
12/18/2017 22:45,25,69.5,42,64.9,67,66.6,2,0,0
12/18/2017 22:50,19,69.2,35,64.6,54,66.2,2,0,0
12/18/2017 22:55,23,69.4,40,64.7,63,66.4,2,0,0
12/18/2017 23:00,19,69.4,35,64.7,54,66.4,2,0,0
12/18/2017 23:05,18,69,34,64.4,52,66,2,0,0
12/18/2017 23:10,19,69.2,34,64.6,53,66.2,2,0,0
12/18/2017 23:15,17,69.2,34,64.6,51,66.1,2,0,0
12/18/2017 23:20,13,69.1,28,64.5,41,66,2,0,0
12/18/2017 23:25,19,68.1,35,63.4,54,65.1,2,0,0
12/18/2017 23:30,17,68.7,33,64,50,65.6,2,0,0
12/18/2017 23:35,19,69,35,64.4,54,66,2,0,0
12/18/2017 23:40,18,69.1,35,64.4,53,66,2,0,0
12/18/2017 23:45,12,69.1,28,64.5,40,65.9,2,0,0
12/18/2017 23:50,11,69.2,26,64.5,37,65.9,2,0,0
12/18/2017 23:55,12,69.2,28,64.6,40,66,2,0,0
12/19/2017 0:00,8,69.3,23,64.7,31,65.9,2,0,0
12/19/2017 0:05,12,69.4,27,64.8,39,66.2,2,0,0
12/19/2017 0:10,11,69,27,64.4,38,65.7,2,0,0
12/19/2017 0:15,9,69.2,24,64.5,33,65.8,2,0,0
12/19/2017 0:20,8,69.3,24,64.7,32,65.8,2,0,0
12/19/2017 0:25,8,69.3,24,64.7,32,65.8,2,0,0
12/19/2017 0:30,8,69.3,23,64.7,31,65.8,2,0,0
12/19/2017 0:35,9,69.3,25,64.7,34,65.9,2,0,0
12/19/2017 0:40,10,69.3,25,64.7,35,66,2,0,0
12/19/2017 0:45,9,69.3,24,64.7,33,65.9,2,0,0
12/19/2017 0:50,10,69.1,26,64.4,36,65.7,2,0,0
12/19/2017 0:55,9,69.2,24,64.5,33,65.8,2,0,0
12/19/2017 1:00,7,69.3,22,64.7,29,65.8,2,0,0
12/19/2017 1:05,9,69.3,25,64.7,34,66,2,0,0
12/19/2017 1:10,8,69.4,23,64.8,31,66,2,0,0
12/19/2017 1:15,8,69.1,24,64.5,32,65.7,2,0,0
12/19/2017 1:20,8,68.8,24,64.2,32,65.3,2,0,0
12/19/2017 1:25,6,69.1,21,64.5,27,65.5,2,0,0
12/19/2017 1:30,7,68.9,22,64.3,29,65.4,2,0,0
12/19/2017 1:35,7,68.7,22,64.1,29,65.2,2,0,0
12/19/2017 1:40,7,69,23,64.4,30,65.4,2,0,0
12/19/2017 1:45,8,69.2,24,64.6,32,65.7,2,0,0
12/19/2017 1:50,6,69.2,22,64.6,28,65.6,2,0,0
12/19/2017 1:55,9,68.8,24,64.1,33,65.4,2,0,0
12/19/2017 2:00,10,69,26,64.4,36,65.7,2,0,0
12/19/2017 2:05,6,69.1,21,64.5,27,65.5,2,0,0
12/19/2017 2:10,8,69.1,23,64.5,31,65.7,2,0,0
12/19/2017 2:15,7,69.2,23,64.5,30,65.6,2,0,0
12/19/2017 2:20,6,69.2,21,64.6,27,65.6,2,0,0
12/19/2017 2:25,7,69.4,23,64.8,30,65.9,2,0,0
12/19/2017 2:30,6,69.2,22,64.6,28,65.6,2,0,0
12/19/2017 2:35,9,69.2,26,64.5,35,65.7,2,0,0
12/19/2017 2:40,7,69.3,22,64.6,29,65.7,2,0,0
12/19/2017 2:45,11,68.5,27,63.9,38,65.2,2,0,0
12/19/2017 2:50,8,68.7,24,64,32,65.2,2,0,0
12/19/2017 2:55,10,68.7,26,64,36,65.3,2,0,0
12/19/2017 3:00,10,68.8,26,64.1,36,65.4,2,0,0
12/19/2017 3:05,11,69.1,27,64.5,38,65.8,2,0,0
12/19/2017 3:10,7,69.1,22,64.5,29,65.6,2,0,0
12/19/2017 3:15,10,69,25,64.4,35,65.7,2,0,0
12/19/2017 3:20,8,69.1,24,64.5,32,65.6,2,0,0
12/19/2017 3:25,11,69.1,27,64.4,38,65.8,2,0,0
12/19/2017 3:30,18,69.2,35,64.5,53,66.1,2,0,0
12/19/2017 3:35,13,69.3,29,64.7,42,66.1,2,0,0
12/19/2017 3:40,13,69,29,64.4,42,65.8,2,0,0
12/19/2017 3:45,12,69.2,29,64.5,41,65.9,2,0,0
12/19/2017 3:50,19,69.2,36,64.5,55,66.1,2,0,0
12/19/2017 3:55,15,69.2,32,64.6,47,66.1,2,0,0
12/19/2017 4:00,18,69.1,34,64.5,52,66.1,2,0,0
12/19/2017 4:05,19,69.4,35,64.7,54,66.4,2,0,0
12/19/2017 4:10,23,69.2,40,64.6,63,66.3,2,0,0
12/19/2017 4:15,20,69.2,36,64.6,56,66.2,2,0,0
12/19/2017 4:20,26,69.2,43,64.6,69,66.4,2,0,0
12/19/2017 4:25,23,69.4,39,64.8,62,66.5,2,0,0
12/19/2017 4:30,27,69.6,43,65,70,66.7,2,0,0
12/19/2017 4:35,31,69.8,48,65.2,79,67,2,0,0
12/19/2017 4:40,38,69.7,56,65.1,94,67,2,0,0
12/19/2017 4:45,36,69.1,54,64.4,90,66.3,2,0,0
12/19/2017 4:50,38,70,56,65.4,94,67.3,2,0,0
12/19/2017 4:55,42,69.7,62,65.1,104,67,2,0,0
12/19/2017 5:00,38,68.7,56,64.1,94,65.9,2,0,0
12/19/2017 5:05,44,68.6,63,64,107,65.9,2,0,0
12/19/2017 5:10,48,68.4,67,63.7,115,65.7,2,0,0
12/19/2017 5:15,44,68.7,64,64.1,108,66,2,0,0
12/19/2017 5:20,55,67.2,75,62.4,130,64.4,2,0,0
12/19/2017 5:25,55,69.1,77,64.5,132,66.4,2,0,0
12/19/2017 5:30,51,69.4,71,64.8,122,66.7,2,0,0
12/19/2017 5:35,68,68,90,63.3,158,65.3,2,0,0
12/19/2017 5:40,63,69.1,85,64.5,148,66.5,2,0,0
12/19/2017 5:45,37,68.8,56,64.1,93,66,2,0,0
12/19/2017 5:50,41,68.1,60,63.4,101,65.3,2,0,0
12/19/2017 5:55,46,68.6,66,63.9,112,65.9,2,0,0
12/19/2017 6:00,27,69,44,64.3,71,66.1,2,0,0
12/19/2017 6:05,29,68.8,47,64.1,76,65.9,2,0,0
12/19/2017 6:10,34,68,52,63.2,86,65.1,2,0,0
12/19/2017 6:15,49,67.7,69,62.8,118,64.8,2,0,0
12/19/2017 6:20,65,66.7,87,61.8,152,63.9,2,0,0
12/19/2017 6:25,55,66.9,76,61.9,131,64,2,0,0
12/19/2017 6:30,63,67.1,84,62.1,147,64.2,2,0,0
12/19/2017 6:35,71,67.4,93,62.5,164,64.7,2,0,0
12/19/2017 6:40,67,67.4,89,62.5,156,64.6,2,0,0
12/19/2017 6:45,65,68.2,86,63.4,151,65.5,2,0,0
12/19/2017 6:50,72,67.8,94,63,166,65.1,2,0,0
12/19/2017 6:55,74,67.1,96,62.2,170,64.3,2,0,0
12/19/2017 7:00,70,66.6,92,61.6,162,63.8,2,0,0
12/19/2017 7:05,75,67,98,62.1,173,64.2,2,0,0
12/19/2017 7:10,81,66.7,104,61.7,185,63.9,2,0,0
12/19/2017 7:15,86,67.1,108,62.2,194,64.4,2,0,0
12/19/2017 7:20,88,67.1,112,62.2,200,64.3,2,0,0
12/19/2017 7:25,76,66.9,98,61.9,174,64.1,2,0,0
12/19/2017 7:30,87,66.3,111,61.3,198,63.5,2,0,0
12/19/2017 7:35,87,66.5,111,61.6,198,63.8,2,0,0
12/19/2017 7:40,86,67.1,108,62.3,194,64.4,2,0,0
12/19/2017 7:45,89,66.7,112,61.8,201,64,2,0,0
12/19/2017 7:50,91,67,115,62.1,206,64.3,2,0,0
12/19/2017 7:55,89,66.5,112,61.5,201,63.7,2,0,0
12/19/2017 8:00,74,64.8,97,59.7,171,61.9,2,0,0
12/19/2017 8:05,74,64.7,97,59.6,171,61.9,2,0,0
12/19/2017 8:10,79,63.3,101,58.1,180,60.4,2,0,0
12/19/2017 8:15,81,61.7,103,56.3,184,58.7,2,0,0
12/19/2017 8:20,76,60.5,98,54.9,174,57.4,2,0,0
12/19/2017 8:25,72,62.6,93,57.2,165,59.6,2,0,0
12/19/2017 8:30,74,65.6,95,60.6,169,62.8,2,0,0
12/19/2017 8:35,70,65.6,92,60.6,162,62.8,2,0,0
12/19/2017 8:40,75,63.8,97,58.7,172,60.9,2,0,0
12/19/2017 8:45,76,65.1,97,60,173,62.2,2,0,0
12/19/2017 8:50,83,64.6,105,59.5,188,61.7,2,0,0
12/19/2017 8:55,79,64.5,101,59.4,180,61.6,2,0,0
12/19/2017 9:00,81,65.6,103,60.7,184,62.9,2,0,0
12/19/2017 9:05,69,65.5,91,60.5,160,62.7,2,0,0
12/19/2017 9:10,72,66.7,92,61.8,164,64,2,0,0
12/19/2017 9:15,68,67,88,62.2,156,64.3,2,0,0
12/19/2017 9:20,69,67.9,89,63.1,158,65.2,2,0,0
12/19/2017 9:25,66,67.6,86,62.8,152,64.9,2,0,0
12/19/2017 9:30,54,67.8,74,63.1,128,65.1,2,0,0
12/19/2017 9:35,60,66.5,80,61.7,140,63.8,2,0,0
12/19/2017 9:40,73,66.5,94,61.7,167,63.8,2,0,0
12/19/2017 9:45,68,67.3,88,62.5,156,64.6,2,0,0
12/19/2017 9:50,70,67,91,62.1,161,64.2,2,0,0
12/19/2017 9:55,63,67.9,82,63.1,145,65.2,2,0,0
12/19/2017 10:00,61,66.5,80,61.6,141,63.8,2,0,0
12/19/2017 10:05,61,66.5,81,61.6,142,63.7,2,0,0
12/19/2017 10:10,64,66.4,83,61.5,147,63.6,2,0,0
12/19/2017 10:15,60,66,80,61.1,140,63.2,2,0,0
12/19/2017 10:20,67,66.9,86,62.1,153,64.2,2,0,0
12/19/2017 10:25,54,66.8,73,62.1,127,64.1,2,0,0
12/19/2017 10:30,61,67.5,80,62.7,141,64.8,2,0,0
12/19/2017 10:35,64,68.6,82,64,146,66,2,0,0
12/19/2017 10:40,64,68.6,84,64,148,66,2,0,0
12/19/2017 10:45,55,68.2,74,63.6,129,65.6,2,0,0
12/19/2017 10:50,72,66.8,93,62,165,64.1,2,0,0
12/19/2017 10:55,59,65.5,78,60.6,137,62.7,2,0,0
12/19/2017 11:00,60,65.3,80,60.5,140,62.6,2,0,0
12/19/2017 11:05,52,65.9,72,61.1,124,63.1,2,0,0
12/19/2017 11:10,58,66.4,78,61.7,136,63.7,2,0,0
12/19/2017 11:15,59,65.4,78,60.6,137,62.6,2,0,0
12/19/2017 11:20,45,65.8,64,61,109,63,2,0,0
12/19/2017 11:25,52,66.5,71,61.7,123,63.8,2,0,0
12/19/2017 11:30,46,67.5,63,62.7,109,64.7,2,0,0
12/19/2017 11:35,62,66.2,82,61.3,144,63.4,2,0,0
12/19/2017 11:40,61,66.3,81,61.4,142,63.5,2,0,0
12/19/2017 11:45,52,66.4,71,61.5,123,63.6,2,0,0
12/19/2017 11:50,64,66.2,83,61.3,147,63.4,2,0,0
12/19/2017 11:55,49,65.9,67,61,116,63.1,2,0,0
12/19/2017 12:00,50,67.7,67,62.9,117,64.9,2,0,0
12/19/2017 12:05,55,68.4,74,63.6,129,65.7,2,0,0
12/19/2017 12:10,54,68.6,71,63.9,125,65.9,2,0,0
12/19/2017 12:15,54,69,73,64.4,127,66.4,2,0,0
12/19/2017 12:20,56,69.6,74,65,130,67,2,0,0
12/19/2017 12:25,56,68.3,75,63.5,131,65.5,2,0,0
12/19/2017 12:30,54,68.1,73,63.4,127,65.4,2,0,0
12/19/2017 12:35,54,68.2,73,63.6,127,65.6,2,0,0
12/19/2017 12:40,48,68.5,65,63.9,113,65.8,2,0,0
12/19/2017 12:45,49,68.4,68,63.8,117,65.7,2,0,0
12/19/2017 12:50,54,68.6,72,63.8,126,65.9,2,0,0
12/19/2017 12:55,45,68.7,63,64,108,66,2,0,0
12/19/2017 13:00,41,69.5,58,64.9,99,66.8,2,0,0
12/19/2017 13:05,49,67.8,67,63.1,116,65,2,0,0
12/19/2017 13:10,57,69.1,76,64.5,133,66.5,2,0,0
12/19/2017 13:15,62,66.8,80,61.9,142,64,2,0,0
12/19/2017 13:20,61,67.6,80,62.8,141,64.9,2,0,0
12/19/2017 13:25,53,67.9,71,63.2,124,65.2,2,0,0
12/19/2017 13:30,49,67.6,67,62.7,116,64.8,2,0,0
12/19/2017 13:35,61,69.8,81,65.2,142,67.1,2,0,0
12/19/2017 13:40,50,68.8,67,64.1,117,66.1,2,0,0
12/19/2017 13:45,44,67.8,62,63.1,106,65.1,2,0,0
12/19/2017 13:50,62,67.3,81,62.5,143,64.6,2,0,0
12/19/2017 13:55,58,67.4,77,62.7,135,64.7,2,0,0
12/19/2017 14:00,52,68.1,70,63.4,122,65.4,2,0,0
12/19/2017 14:05,45,69,62,64.3,107,66.3,2,0,0
12/19/2017 14:10,53,69.7,70,65,123,67,2,0,0
12/19/2017 14:15,52,68.4,70,63.7,122,65.7,2,0,0
12/19/2017 14:20,51,68.4,69,63.7,120,65.7,2,0,0
12/19/2017 14:25,56,69,75,64.3,131,66.3,2,0,0
12/19/2017 14:30,48,67.8,66,63.2,114,65.1,2,0,0
12/19/2017 14:35,50,67.6,68,62.7,118,64.8,2,0,0
12/19/2017 14:40,64,68.5,82,63.8,146,65.9,2,0,0
12/19/2017 14:45,49,68.2,67,63.5,116,65.5,2,0,0
12/19/2017 14:50,54,68.4,71,63.6,125,65.7,2,0,0
12/19/2017 14:55,51,67.8,69,63,120,65,2,0,0
12/19/2017 15:00,50,67.9,68,63.2,118,65.2,2,0,0
12/19/2017 15:05,53,69.4,71,64.7,124,66.7,2,0,0
12/19/2017 15:10,52,69.8,70,65.2,122,67.1,2,0,0
12/19/2017 15:15,56,70.3,75,65.8,131,67.7,2,0,0
12/19/2017 15:20,53,69.3,72,64.7,125,66.7,2,0,0
12/19/2017 15:25,59,69.9,77,65.4,136,67.4,2,0,0
12/19/2017 15:30,61,69.8,79,65.3,140,67.2,2,0,0
12/19/2017 15:35,55,70.5,73,66,128,67.9,2,0,0
12/19/2017 15:40,70,69.8,89,65.3,159,67.3,2,0,0
12/19/2017 15:45,61,68.7,79,64.1,140,66.1,2,0,0
12/19/2017 15:50,60,69.5,80,64.9,140,66.8,2,0,0
12/19/2017 15:55,64,69,82,64.3,146,66.4,2,0,0
12/19/2017 16:00,55,69.2,73,64.5,128,66.5,2,0,0
12/19/2017 16:05,58,69,77,64.4,135,66.4,2,0,0
12/19/2017 16:10,58,70.1,76,65.5,134,67.5,2,0,0
12/19/2017 16:15,52,69.3,70,64.7,122,66.7,2,0,0
12/19/2017 16:20,56,68.7,75,64.1,131,66.1,2,0,0
12/19/2017 16:25,57,69.1,75,64.5,132,66.5,2,0,0
12/19/2017 16:30,58,69.8,76,65.2,134,67.2,2,0,0
12/19/2017 16:35,58,69.7,77,65,135,67,2,0,0
12/19/2017 16:40,55,69.1,73,64.3,128,66.4,2,0,0
12/19/2017 16:45,56,70,74,65.4,130,67.4,2,0,0
12/19/2017 16:50,47,69.6,66,64.9,113,66.8,2,0,0
12/19/2017 16:55,48,69.5,66,64.9,114,66.8,2,0,0
12/19/2017 17:00,53,68.8,70,64.1,123,66.1,2,0,0
12/19/2017 17:05,49,69.8,67,65.2,116,67.2,2,0,0
12/19/2017 17:10,53,69.2,72,64.5,125,66.5,2,0,0
12/19/2017 17:15,55,68.8,73,64.2,128,66.2,2,0,0
12/19/2017 17:20,47,68.2,64,63.5,111,65.5,2,0,0
12/19/2017 17:25,51,68,69,63.3,120,65.3,2,0,0
12/19/2017 17:30,48,67.9,65,63.2,113,65.2,2,0,0
12/19/2017 17:35,47,67.4,65,62.6,112,64.6,2,0,0
12/19/2017 17:40,38,68.1,55,63.4,93,65.3,2,0,0
12/19/2017 17:45,42,67.5,59,62.7,101,64.7,2,0,0
12/19/2017 17:50,39,67.5,56,62.7,95,64.7,2,0,0
12/19/2017 17:55,42,65.9,59,60.8,101,62.9,2,0,0
12/19/2017 18:00,50,66.3,67,61.4,117,63.5,2,0,0
12/19/2017 18:05,43,67.4,61,62.6,104,64.5,2,0,0
12/19/2017 18:10,39,67.2,56,62.4,95,64.3,2,0,0
12/19/2017 18:15,54,67.6,72,62.9,126,64.9,2,0,0
12/19/2017 18:20,44,67.6,62,62.8,106,64.8,2,0,0
12/19/2017 18:25,41,68.4,58,63.7,99,65.7,2,0,0
12/19/2017 18:30,52,69.2,70,64.5,122,66.5,2,0,0
12/19/2017 18:35,43,70,61,65.4,104,67.3,2,0,0
12/19/2017 18:40,45,69.6,62,65,107,66.9,2,0,0
12/19/2017 18:45,40,69.4,57,64.8,97,66.7,2,0,0
12/19/2017 18:50,35,69.4,51,64.8,86,66.7,2,0,0
12/19/2017 18:55,44,69.9,60,65.4,104,67.3,2,0,0
12/19/2017 19:00,41,68.9,58,64.3,99,66.2,2,0,0
12/19/2017 19:05,42,68.1,60,63.4,102,65.3,2,0,0
12/19/2017 19:10,40,68.2,57,63.6,97,65.5,2,0,0
12/19/2017 19:15,37,68.5,54,63.8,91,65.7,2,0,0
12/19/2017 19:20,37,67.2,55,62.4,92,64.3,2,0,0
12/19/2017 19:25,41,67.4,59,62.7,100,64.6,2,0,0
12/19/2017 19:30,38,67.5,54,62.8,92,64.8,2,0,0
12/19/2017 19:35,31,68.9,48,64.3,79,66.1,2,0,0
12/19/2017 19:40,34,68.6,50,63.9,84,65.8,2,0,0
12/19/2017 19:45,35,69,52,64.3,87,66.2,2,0,0
12/19/2017 19:50,40,68.1,57,63.4,97,65.3,2,0,0
12/19/2017 19:55,35,68.4,52,63.7,87,65.6,2,0,0
12/19/2017 20:00,29,69,45,64.3,74,66.2,2,0,0
12/19/2017 20:05,27,69.1,44,64.4,71,66.2,2,0,0
12/19/2017 20:10,30,69.5,47,64.9,77,66.7,2,0,0
12/19/2017 20:15,34,69.6,51,64.9,85,66.8,2,0,0
12/19/2017 20:20,30,69.2,46,64.5,76,66.4,2,0,0
12/19/2017 20:25,33,67.5,50,62.8,83,64.7,2,0,0
12/19/2017 20:30,31,67.4,47,62.6,78,64.5,2,0,0
12/19/2017 20:35,32,68.3,47,63.7,79,65.6,2,0,0
12/19/2017 20:40,30,68.5,47,63.8,77,65.6,2,0,0
12/19/2017 20:45,36,68.7,52,64.1,88,66,2,0,0
12/19/2017 20:50,29,69.1,45,64.5,74,66.3,2,0,0
12/19/2017 20:55,25,69.3,41,64.7,66,66.4,2,0,0
12/19/2017 21:00,23,69.4,39,64.7,62,66.5,2,0,0
12/19/2017 21:05,22,69.1,38,64.5,60,66.2,2,0,0
12/19/2017 21:10,33,69.1,49,64.5,82,66.3,2,0,0
12/19/2017 21:15,34,68.8,51,64.1,85,66,2,0,0
12/19/2017 21:20,32,68.7,48,63.9,80,65.8,2,0,0
12/19/2017 21:25,27,68.1,42,63.3,69,65.2,2,0,0
12/19/2017 21:30,24,68.4,40,63.7,64,65.5,2,0,0
12/19/2017 21:35,30,68.8,46,64.1,76,65.9,2,0,0
12/19/2017 21:40,22,68.9,38,64.2,60,65.9,2,0,0
12/19/2017 21:45,26,68.9,43,64.3,69,66,2,0,0
12/19/2017 21:50,23,68.4,39,63.7,62,65.5,2,0,0
12/19/2017 21:55,21,68.9,36,64.2,57,65.9,2,0,0
12/19/2017 22:00,23,69,39,64.4,62,66.1,2,0,0
12/19/2017 22:05,22,69.4,37,64.7,59,66.5,2,0,0
12/19/2017 22:10,20,69.5,35,64.9,55,66.6,2,0,0
12/19/2017 22:15,23,68.9,40,64.3,63,66,2,0,0
12/19/2017 22:20,22,68.7,38,64,60,65.7,2,0,0
12/19/2017 22:25,23,69.3,38,64.7,61,66.4,2,0,0
12/19/2017 22:30,25,67.6,41,62.9,66,64.7,2,0,0
12/19/2017 22:35,20,68.3,36,63.7,56,65.3,2,0,0
12/19/2017 22:40,18,68.8,33,64.1,51,65.8,2,0,0
12/19/2017 22:45,20,69.1,36,64.5,56,66.1,2,0,0
12/19/2017 22:50,22,69.3,39,64.7,61,66.3,2,0,0
12/19/2017 22:55,21,69.2,37,64.5,58,66.2,2,0,0
12/19/2017 23:00,22,69.3,38,64.7,60,66.4,2,0,0
12/19/2017 23:05,13,69.4,29,64.8,42,66.2,2,0,0
12/19/2017 23:10,19,68.9,35,64.3,54,65.9,2,0,0
12/19/2017 23:15,19,68.5,35,63.9,54,65.5,2,0,0
12/19/2017 23:20,14,68.9,30,64.3,44,65.8,2,0,0
12/19/2017 23:25,13,69.2,28,64.5,41,66,2,0,0
12/19/2017 23:30,16,69.1,32,64.5,48,66,2,0,0
12/19/2017 23:35,16,69.2,31,64.6,47,66.2,2,0,0
12/19/2017 23:40,14,69.3,29,64.7,43,66.2,2,0,0
12/19/2017 23:45,16,69.3,31,64.7,47,66.3,2,0,0
12/19/2017 23:50,12,69.3,27,64.7,39,66.2,2,0,0
12/19/2017 23:55,13,69.4,29,64.8,42,66.2,2,0,0
12/20/2017 0:00,12,69.3,27,64.7,39,66.2,2,0,0
12/20/2017 0:05,16,69.2,31,64.5,47,66.1,2,0,0
12/20/2017 0:10,8,69.3,23,64.7,31,65.8,2,0,0
12/20/2017 0:15,10,69.2,25,64.6,35,65.9,2,0,0
12/20/2017 0:20,10,69.2,26,64.5,36,65.8,2,0,0
12/20/2017 0:25,8,69.3,24,64.7,32,65.8,2,0,0
12/20/2017 0:30,10,69.3,20,64.7,30,66.3,2,0,0
12/20/2017 0:35,7,69.3,22,64.7,29,65.8,2,0,0
12/20/2017 0:40,10,69.3,25,64.7,35,66.1,2,0,0
12/20/2017 0:45,9,69.3,24,64.7,33,66,2,0,0
12/20/2017 0:50,7,69.2,22,64.6,29,65.7,2,0,0
12/20/2017 0:55,7,69.3,22,64.7,29,65.8,2,0,0
12/20/2017 1:00,9,69.2,24,64.6,33,65.9,2,0,0
12/20/2017 1:05,6,69.1,21,64.5,27,65.5,2,0,0
12/20/2017 1:10,5,69.1,21,64.5,26,65.4,2,0,0
12/20/2017 1:15,6,69.3,21,64.7,27,65.7,2,0,0
12/20/2017 1:20,5,69.2,21,64.6,26,65.5,2,0,0
12/20/2017 1:25,7,69.3,22,64.7,29,65.8,2,0,0
12/20/2017 1:30,6,69.2,22,64.6,28,65.6,2,0,0
12/20/2017 1:35,8,69.2,23,64.6,31,65.8,2,0,0
12/20/2017 1:40,10,69.1,25,64.5,35,65.8,2,0,0
12/20/2017 1:45,5,69.2,21,64.5,26,65.4,2,0,0
12/20/2017 1:50,7,69.2,22,64.5,29,65.7,2,0,0
12/20/2017 1:55,10,69.2,20,64.6,30,66.1,2,0,0
12/20/2017 2:00,12,69.3,21,64.7,33,66.3,2,0,0
12/20/2017 2:05,7,69.2,22,64.5,29,65.7,2,0,0
12/20/2017 2:10,6,69.2,21,64.6,27,65.6,2,0,0
12/20/2017 2:15,6,69.2,21,64.6,27,65.6,2,0,0
12/20/2017 2:20,8,69.2,23,64.5,31,65.7,2,0,0
12/20/2017 2:25,7,69.1,23,64.4,30,65.5,2,0,0
12/20/2017 2:30,7,69,22,64.3,29,65.4,2,0,0
12/20/2017 2:35,8,69.2,23,64.5,31,65.7,2,0,0
12/20/2017 2:40,8,69.2,23,64.6,31,65.8,2,0,0
12/20/2017 2:45,9,69.3,24,64.7,33,66,2,0,0
12/20/2017 2:50,7,69.2,22,64.6,29,65.7,2,0,0
12/20/2017 2:55,10,68.8,26,64.2,36,65.4,2,0,0
12/20/2017 3:00,9,68.7,24,64.1,33,65.4,2,0,0
12/20/2017 3:05,10,68.9,26,64.3,36,65.6,2,0,0
12/20/2017 3:10,9,69.1,24,64.5,33,65.7,2,0,0
12/20/2017 3:15,10,69,26,64.4,36,65.6,2,0,0
12/20/2017 3:20,11,69,26,64.3,37,65.7,2,0,0
12/20/2017 3:25,11,69.2,26,64.5,37,65.9,2,0,0
12/20/2017 3:30,12,69.3,27,64.7,39,66.2,2,0,0
12/20/2017 3:35,16,69.1,32,64.5,48,66,2,0,0
12/20/2017 3:40,12,68.9,27,64.3,39,65.7,2,0,0
12/20/2017 3:45,16,69.1,31,64.5,47,66.1,2,0,0
12/20/2017 3:50,18,69,34,64.4,52,66,2,0,0
12/20/2017 3:55,16,69.3,31,64.7,47,66.3,2,0,0
12/20/2017 4:00,16,68.6,31,63.9,47,65.5,2,0,0
12/20/2017 4:05,18,68.7,34,64,52,65.6,2,0,0
12/20/2017 4:10,24,67.8,41,63.1,65,64.8,2,0,0
12/20/2017 4:15,24,68.4,40,63.8,64,65.5,2,0,0
12/20/2017 4:20,24,68.8,40,64.2,64,65.9,2,0,0
12/20/2017 4:25,23,69.2,40,64.6,63,66.3,2,0,0
12/20/2017 4:30,25,69.5,41,64.9,66,66.7,2,0,0
12/20/2017 4:35,28,69.8,44,65.2,72,67,2,0,0
12/20/2017 4:40,41,69.4,59,64.8,100,66.7,2,0,0
12/20/2017 4:45,35,68.4,52,63.7,87,65.6,2,0,0
12/20/2017 4:50,41,68.8,59,64.1,100,66,2,0,0
12/20/2017 4:55,41,69.8,59,65.3,100,67.1,2,0,0
12/20/2017 5:00,41,70.6,60,66.1,101,68,2,0,0
12/20/2017 5:05,40,69.9,58,65.3,98,67.2,2,0,0
12/20/2017 5:10,39,69.2,58,64.6,97,66.4,2,0,0
12/20/2017 5:15,55,69.4,76,64.8,131,66.7,2,0,0
12/20/2017 5:20,42,68.8,61,64.2,103,66.1,2,0,0
12/20/2017 5:25,48,68.7,68,64.1,116,66,2,0,0
12/20/2017 5:30,57,69.9,78,65.4,135,67.3,2,0,0
12/20/2017 5:35,60,67.8,81,63.1,141,65.1,2,0,0
12/20/2017 5:40,69,68.7,90,64.1,159,66.1,2,0,0
12/20/2017 5:45,53,69.4,73,64.8,126,66.7,2,0,0
12/20/2017 5:50,68,68,90,63.3,158,65.3,2,0,0
12/20/2017 5:55,68,67.3,90,62.6,158,64.6,2,0,0
12/20/2017 6:00,60,66.2,81,61.4,141,63.4,2,0,0
12/20/2017 6:05,62,64.9,84,59.9,146,62,2,0,0
12/20/2017 6:10,62,65.5,84,60.5,146,62.6,2,0,0
12/20/2017 6:15,58,66.1,79,61.2,137,63.3,2,0,0
12/20/2017 6:20,67,66.2,89,61.3,156,63.4,2,0,0
12/20/2017 6:25,66,66.3,88,61.2,154,63.4,2,0,0
12/20/2017 6:30,64,67.1,86,62.1,150,64.2,2,0,0
12/20/2017 6:35,71,68.3,93,63.5,164,65.6,2,0,0
12/20/2017 6:40,70,67.8,93,62.9,163,65,2,0,0
12/20/2017 6:45,71,68.2,93,63.4,164,65.5,2,0,0
12/20/2017 6:50,69,69,91,64.2,160,66.3,2,0,0
12/20/2017 6:55,74,69.1,95,64.4,169,66.4,2,0,0
12/20/2017 7:00,75,67.3,97,62.4,172,64.5,2,0,0
12/20/2017 7:05,68,67,90,62.1,158,64.2,2,0,0
12/20/2017 7:10,77,66.8,100,61.8,177,63.9,2,0,0
12/20/2017 7:15,81,67.2,105,62.2,186,64.4,2,0,0
12/20/2017 7:20,84,66.2,107,61.2,191,63.4,2,0,0
12/20/2017 7:25,83,67,106,62.1,189,64.2,2,0,0
12/20/2017 7:30,84,67.3,106,62.4,190,64.5,2,0,0
12/20/2017 7:35,82,67.1,106,62.2,188,64.3,2,0,0
12/20/2017 7:40,85,67,108,62.1,193,64.3,2,0,0
12/20/2017 7:45,93,66.3,116,61.3,209,63.5,2,0,0
12/20/2017 7:50,88,66.9,112,62,200,64.1,2,0,0
12/20/2017 7:55,80,67.8,102,62.9,182,65,2,0,0
12/20/2017 8:00,69,67.7,91,62.9,160,65,2,0,0
12/20/2017 8:05,65,67.1,86,62.2,151,64.3,2,0,0
12/20/2017 8:10,72,67.2,94,62.4,166,64.5,2,0,0
12/20/2017 8:15,88,67,112,62.1,200,64.2,2,0,0
12/20/2017 8:20,76,66.2,98,61.2,174,63.4,2,0,0
12/20/2017 8:25,68,66.5,89,61.6,157,63.7,2,0,0
12/20/2017 8:30,84,65.8,106,60.8,190,63,2,0,0
12/20/2017 8:35,75,64.8,97,59.7,172,61.9,2,0,0
12/20/2017 8:40,77,65.7,99,60.7,176,62.9,2,0,0
12/20/2017 8:45,76,65.7,97,60.7,173,62.9,2,0,0
12/20/2017 8:50,76,66.7,97,61.8,173,63.9,2,0,0
12/20/2017 8:55,76,67.3,98,62.5,174,64.6,2,0,0
12/20/2017 9:00,80,66.3,101,61.4,181,63.6,2,0,0
12/20/2017 9:05,71,65.8,92,60.9,163,63,2,0,0
12/20/2017 9:10,66,65.3,86,60.4,152,62.5,2,0,0
12/20/2017 9:15,62,66,81,61.1,143,63.2,2,0,0
12/20/2017 9:20,64,66,84,61,148,63.2,2,0,0
12/20/2017 9:25,56,67.4,75,62.6,131,64.6,2,0,0
12/20/2017 9:30,65,68.6,84,63.9,149,66,2,0,0
12/20/2017 9:35,69,68.7,88,64,157,66,2,0,0
12/20/2017 9:40,62,68.7,81,64,143,66,2,0,0
12/20/2017 9:45,66,68.1,86,63.3,152,65.4,2,0,0
12/20/2017 9:50,64,66.9,84,62,148,64.1,2,0,0
12/20/2017 9:55,67,65.8,87,60.8,154,63,2,0,0
12/20/2017 10:00,76,65.2,96,60.2,172,62.4,2,0,0
12/20/2017 10:05,61,65.6,80,60.6,141,62.8,2,0,0
12/20/2017 10:10,62,65.2,81,60.2,143,62.3,2,0,0
12/20/2017 10:15,68,66.1,86,61.2,154,63.4,2,0,0
12/20/2017 10:20,62,67.8,82,63,144,65.1,2,0,0
12/20/2017 10:25,59,67.3,77,62.5,136,64.6,2,0,0
12/20/2017 10:30,64,66.9,84,62.1,148,64.2,2,0,0
12/20/2017 10:35,60,66.7,79,61.8,139,63.9,2,0,0
12/20/2017 10:40,78,66.4,98,61.6,176,63.8,2,0,0
12/20/2017 10:45,73,65.1,94,60.1,167,62.3,2,0,0
12/20/2017 10:50,70,66,90,61.1,160,63.2,2,0,0
12/20/2017 10:55,62,67,81,62.2,143,64.3,2,0,0
12/20/2017 11:00,68,66.7,88,61.9,156,64,2,0,0
12/20/2017 11:05,57,68.5,75,63.8,132,65.8,2,0,0
12/20/2017 11:10,57,66.9,76,62,133,64.1,2,0,0
12/20/2017 11:15,64,68.7,83,64,147,66.1,2,0,0
12/20/2017 11:20,62,68.8,81,64.1,143,66.1,2,0,0
12/20/2017 11:25,54,69.8,72,65.2,126,67.2,2,0,0
12/20/2017 11:30,64,69,85,64.4,149,66.4,2,0,0
12/20/2017 11:35,64,68.6,84,63.9,148,66,2,0,0
12/20/2017 11:40,59,68.3,78,63.5,137,65.6,2,0,0
12/20/2017 11:45,55,68.9,74,64.3,129,66.3,2,0,0
12/20/2017 11:50,60,67.8,79,63.1,139,65.2,2,0,0
12/20/2017 11:55,57,66.2,77,61.3,134,63.4,2,0,0
12/20/2017 12:00,55,67.8,73,63.1,128,65.1,2,0,0
12/20/2017 12:05,58,69.3,76,64.7,134,66.7,2,0,0
12/20/2017 12:10,65,67.9,85,63.1,150,65.2,2,0,0
12/20/2017 12:15,65,67.6,84,62.8,149,64.9,2,0,0
12/20/2017 12:20,65,69.3,83,64.5,148,66.6,2,0,0
12/20/2017 12:25,53,69.9,72,65.3,125,67.2,2,0,0
12/20/2017 12:30,54,70.7,72,66.2,126,68.1,2,0,0
12/20/2017 12:35,56,70.6,74,66,130,68,2,0,0
12/20/2017 12:40,52,70,70,65.4,122,67.3,2,0,0
12/20/2017 12:45,55,70.4,74,65.8,129,67.8,2,0,0
12/20/2017 12:50,63,71.4,81,66.9,144,68.9,2,0,0
12/20/2017 12:55,62,70.9,80,66.4,142,68.4,2,0,0
12/20/2017 13:00,46,69.6,64,65,110,66.9,2,0,0
12/20/2017 13:05,55,69,74,64.5,129,66.4,2,0,0
12/20/2017 13:10,52,69.7,71,65.2,123,67.1,2,0,0
12/20/2017 13:15,38,69.8,54,65.3,92,67.2,2,0,0
12/20/2017 13:20,46,69.2,64,64.6,110,66.5,2,0,0
12/20/2017 13:25,65,68.5,83,63.8,148,65.8,2,0,0
12/20/2017 13:30,60,70,78,65.5,138,67.5,2,0,0
12/20/2017 13:35,44,70,61,65.4,105,67.3,2,0,0
12/20/2017 13:40,58,69.1,78,64.5,136,66.5,2,0,0
12/20/2017 13:45,52,70.1,70,65.6,122,67.5,2,0,0
12/20/2017 13:50,47,69,65,64.5,112,66.4,2,0,0
12/20/2017 13:55,60,69,79,64.5,139,66.5,2,0,0
12/20/2017 14:00,53,68.3,72,63.7,125,65.7,2,0,0
12/20/2017 14:05,60,68.8,79,64.1,139,66.1,2,0,0
12/20/2017 14:10,41,68.5,58,63.8,99,65.7,2,0,0
12/20/2017 14:15,46,68,64,63.3,110,65.3,2,0,0
12/20/2017 14:20,43,67.7,61,63,104,64.9,2,0,0
12/20/2017 14:25,48,67.5,66,62.7,114,64.7,2,0,0
12/20/2017 14:30,46,69.9,65,65.3,111,67.2,2,0,0
12/20/2017 14:35,52,70,70,65.4,122,67.3,2,0,0
12/20/2017 14:40,55,69.6,74,65,129,66.9,2,0,0
12/20/2017 14:45,45,68.9,62,64.2,107,66.2,2,0,0
12/20/2017 14:50,47,68.7,65,64.1,112,66,2,0,0
12/20/2017 14:55,47,68.4,65,63.8,112,65.7,2,0,0
12/20/2017 15:00,44,68.8,62,64.1,106,66.1,2,0,0
12/20/2017 15:05,49,68.6,67,64,116,66,2,0,0
12/20/2017 15:10,60,69.5,78,64.9,138,66.9,2,0,0
12/20/2017 15:15,59,68.4,78,63.8,137,65.8,2,0,0
12/20/2017 15:20,54,69.4,73,64.8,127,66.7,2,0,0
12/20/2017 15:25,46,69,64,64.4,110,66.3,2,0,0
12/20/2017 15:30,52,68.9,71,64.3,123,66.3,2,0,0
12/20/2017 15:35,58,69.6,76,65,134,67,2,0,0
12/20/2017 15:40,58,69.2,78,64.6,136,66.6,2,0,0
12/20/2017 15:45,60,68.6,79,63.9,139,66,2,0,0
12/20/2017 15:50,58,68.4,77,63.7,135,65.7,2,0,0
12/20/2017 15:55,50,68.6,68,63.9,118,65.9,2,0,0
12/20/2017 16:00,47,69,65,64.3,112,66.3,2,0,0
12/20/2017 16:05,57,68.9,76,64.2,133,66.2,2,0,0
12/20/2017 16:10,51,69.1,69,64.5,120,66.5,2,0,0
12/20/2017 16:15,54,69.5,73,64.9,127,66.8,2,0,0
12/20/2017 16:20,51,69.2,69,64.5,120,66.5,2,0,0
12/20/2017 16:25,60,69.1,78,64.4,138,66.4,2,0,0
12/20/2017 16:30,57,70.1,75,65.5,132,67.4,2,0,0
12/20/2017 16:35,56,70,75,65.4,131,67.3,2,0,0
12/20/2017 16:40,61,70,80,65.4,141,67.4,2,0,0
12/20/2017 16:45,62,69.5,80,64.8,142,66.9,2,0,0
12/20/2017 16:50,51,69.5,69,64.8,120,66.8,2,0,0
12/20/2017 16:55,45,68.5,62,63.7,107,65.7,2,0,0
12/20/2017 17:00,52,67.8,70,62.9,122,65,2,0,0
12/20/2017 17:05,51,68.7,69,64,120,66,2,0,0
12/20/2017 17:10,47,70.1,65,65.5,112,67.4,2,0,0
12/20/2017 17:15,55,69.8,73,65.2,128,67.2,2,0,0
12/20/2017 17:20,58,64,78,58.9,136,61.1,2,0,0
12/20/2017 17:25,53,54.6,72,48.3,125,50.9,2,0,0
12/20/2017 17:30,49,44.3,67,36.8,116,40,2,0,0
12/20/2017 17:35,59,38,78,29.9,137,33.4,2,0,0
12/20/2017 17:40,46,39.5,65,31.6,111,34.9,2,0,0
12/20/2017 17:45,43,44.1,62,36.7,105,39.7,2,0,0
12/20/2017 17:50,50,49.4,69,42.5,119,45.4,2,0,0
12/20/2017 17:55,50,54.5,69,48.2,119,50.9,2,0,0
12/20/2017 18:00,49,56.5,68,50.4,117,52.9,2,0,0
12/20/2017 18:05,50,55,70,48.7,120,51.3,2,0,0
12/20/2017 18:10,50,56.7,69,50.5,119,53.1,2,0,0
12/20/2017 18:15,49,58.1,68,52.2,117,54.7,2,0,0
12/20/2017 18:20,47,62.6,65,57.1,112,59.4,2,0,0
12/20/2017 18:25,47,65.3,64,60.2,111,62.4,2,0,0
12/20/2017 18:30,63,66.9,82,61.9,145,64.1,2,0,0
12/20/2017 18:35,58,67.5,77,62.7,135,64.7,2,0,0
12/20/2017 18:40,47,67.3,65,62.5,112,64.6,2,0,0
12/20/2017 18:45,38,68.9,55,64.2,93,66.1,2,0,0
12/20/2017 18:50,54,67.9,72,63.1,126,65.2,2,0,0
12/20/2017 18:55,42,67.7,59,62.9,101,64.9,2,0,0
12/20/2017 19:00,49,68.8,66,64.2,115,66.1,2,0,0
12/20/2017 19:05,53,67.7,72,62.9,125,65,2,0,0
12/20/2017 19:10,45,68.7,62,64,107,66,2,0,0
12/20/2017 19:15,46,69.4,63,64.8,109,66.8,2,0,0
12/20/2017 19:20,37,70.1,54,65.5,91,67.4,2,0,0
12/20/2017 19:25,42,69,59,64.2,101,66.2,2,0,0
12/20/2017 19:30,36,68.5,52,63.8,88,65.7,2,0,0
12/20/2017 19:35,39,69.6,56,65,95,66.9,2,0,0
12/20/2017 19:40,30,69.8,46,65.2,76,67,2,0,0
12/20/2017 19:45,34,69.7,50,65.1,84,66.9,2,0,0
12/20/2017 19:50,31,69.8,47,65.2,78,67.1,2,0,0
12/20/2017 19:55,36,69.2,54,64.5,90,66.4,2,0,0
12/20/2017 20:00,30,69,46,64.3,76,66.1,2,0,0
12/20/2017 20:05,29,69.2,45,64.6,74,66.4,2,0,0
12/20/2017 20:10,33,69.1,50,64.5,83,66.3,2,0,0
12/20/2017 20:15,28,69.8,44,65.2,72,67,2,0,0
12/20/2017 20:20,29,69.9,45,65.3,74,67.1,2,0,0
12/20/2017 20:25,40,69.3,57,64.7,97,66.6,2,0,0
12/20/2017 20:30,31,69.6,47,65,78,66.8,2,0,0
12/20/2017 20:35,31,69.3,47,64.6,78,66.5,2,0,0
12/20/2017 20:40,34,69.2,51,64.5,85,66.4,2,0,0
12/20/2017 20:45,28,68.7,44,64,72,65.8,2,0,0
12/20/2017 20:50,27,68.4,43,63.7,70,65.5,2,0,0
12/20/2017 20:55,32,68.4,48,63.7,80,65.6,2,0,0
12/20/2017 21:00,30,68.9,47,64.2,77,66,2,0,0
12/20/2017 21:05,29,69.3,45,64.6,74,66.4,2,0,0
12/20/2017 21:10,27,68.9,43,64.3,70,66.1,2,0,0
12/20/2017 21:15,33,69.1,49,64.5,82,66.3,2,0,0
12/20/2017 21:20,30,69.8,46,65.2,76,67,2,0,0
12/20/2017 21:25,26,69.1,42,64.4,68,66.2,2,0,0
12/20/2017 21:30,28,69.4,45,64.8,73,66.6,2,0,0
12/20/2017 21:35,24,69.5,40,64.9,64,66.6,2,0,0
12/20/2017 21:40,29,69.3,46,64.7,75,66.5,2,0,0
12/20/2017 21:45,30,69.8,45,65.2,75,67.1,2,0,0
12/20/2017 21:50,24,68.9,40,64.3,64,66,2,0,0
12/20/2017 21:55,29,69.1,45,64.5,74,66.3,2,0,0
12/20/2017 22:00,24,68,39,63.2,63,65,2,0,0
12/20/2017 22:05,29,69,45,64.3,74,66.2,2,0,0
12/20/2017 22:10,25,69.4,40,64.8,65,66.5,2,0,0
12/20/2017 22:15,29,69.8,45,65.2,74,67,2,0,0
12/20/2017 22:20,22,69.8,38,65.3,60,66.9,2,0,0
12/20/2017 22:25,21,69.7,37,65.2,58,66.8,2,0,0
12/20/2017 22:30,27,70,44,65.5,71,67.2,2,0,0
12/20/2017 22:35,21,70.1,36,65.6,57,67.2,2,0,0
12/20/2017 22:40,23,69.7,39,65.2,62,66.9,2,0,0
12/20/2017 22:45,19,68.9,35,64.3,54,65.9,2,0,0
12/20/2017 22:50,24,69.5,39,64.9,63,66.7,2,0,0
12/20/2017 22:55,20,69.3,35,64.7,55,66.4,2,0,0
12/20/2017 23:00,16,69.4,31,64.8,47,66.3,2,0,0
12/20/2017 23:05,20,69.3,36,64.7,56,66.3,2,0,0
12/20/2017 23:10,15,69.3,30,64.7,45,66.2,2,0,0
12/20/2017 23:15,21,69.4,36,64.8,57,66.5,2,0,0
12/20/2017 23:20,25,69.6,41,65,66,66.8,2,0,0
12/20/2017 23:25,14,69.6,30,65,44,66.4,2,0,0
12/20/2017 23:30,16,69.5,32,64.9,48,66.4,2,0,0
12/20/2017 23:35,19,69.6,35,65,54,66.6,2,0,0
12/20/2017 23:40,16,69.5,31,64.9,47,66.4,2,0,0
12/20/2017 23:45,16,69.4,32,64.8,48,66.4,2,0,0
12/20/2017 23:50,21,69,37,64.4,58,66.1,2,0,0
12/20/2017 23:55,9,69.2,24,64.5,33,65.8,2,0,0
12/21/2017 0:00,14,69.3,30,64.7,44,66.2,2,0,0
12/21/2017 0:05,15,69.1,30,64.5,45,66,2,0,0
12/21/2017 0:10,12,69.2,27,64.6,39,66,2,0,0
12/21/2017 0:15,10,69.3,25,64.7,35,66,2,0,0
12/21/2017 0:20,14,69.4,29,64.8,43,66.3,2,0,0
12/21/2017 0:25,12,69.3,28,64.7,40,66.1,2,0,0
12/21/2017 0:30,10,69.5,25,64.9,35,66.2,2,0,0
12/21/2017 0:35,10,69.5,25,64.9,35,66.2,2,0,0
12/21/2017 0:40,10,69.4,25,64.8,35,66.1,2,0,0
12/21/2017 0:45,9,69.5,24,64.9,33,66.2,2,0,0
12/21/2017 0:50,4,69.5,19,64.9,23,65.7,2,0,0
12/21/2017 0:55,7,69.5,22,64.9,29,66,2,0,0
12/21/2017 1:00,6,69.5,21,64.9,27,65.9,2,0,0
12/21/2017 1:05,9,69.4,24,64.8,33,66,2,0,0
12/21/2017 1:10,8,69.4,24,64.8,32,65.9,2,0,0
12/21/2017 1:15,10,69.4,26,64.8,36,66.1,2,0,0
12/21/2017 1:20,8,69.4,23,64.8,31,66,2,0,0
12/21/2017 1:25,7,69.4,22,64.8,29,66,2,0,0
12/21/2017 1:30,7,69.4,22,64.8,29,65.9,2,0,0
12/21/2017 1:35,12,69.2,28,64.6,40,66,2,0,0
12/21/2017 1:40,8,69.1,23,64.5,31,65.7,2,0,0
12/21/2017 1:45,7,69.3,22,64.7,29,65.8,2,0,0
12/21/2017 1:50,8,69.4,23,64.8,31,66,2,0,0
12/21/2017 1:55,12,69.4,21,64.8,33,66.5,2,0,0
12/21/2017 2:00,8,69.3,23,64.7,31,65.8,2,0,0
12/21/2017 2:05,6,69.3,22,64.7,28,65.6,2,0,0
12/21/2017 2:10,9,69.3,24,64.7,33,66,2,0,0
12/21/2017 2:15,9,69.4,24,64.8,33,66,2,0,0
12/21/2017 2:20,9,68.6,24,63.9,33,65.2,2,0,0
12/21/2017 2:25,7,68.7,22,64.1,29,65.2,2,0,0
12/21/2017 2:30,10,69.1,25,64.4,35,65.8,2,0,0
12/21/2017 2:35,12,69.1,28,64.5,40,65.9,2,0,0
12/21/2017 2:40,8,69.2,24,64.6,32,65.7,2,0,0
12/21/2017 2:45,12,69.2,28,64.6,40,66,2,0,0
12/21/2017 2:50,8,69.4,23,64.8,31,66,2,0,0
12/21/2017 2:55,8,69.4,24,64.8,32,66,2,0,0
12/21/2017 3:00,9,69.4,25,64.8,34,66.1,2,0,0
12/21/2017 3:05,7,69.4,22,64.8,29,65.9,2,0,0
12/21/2017 3:10,10,69.4,25,64.8,35,66.1,2,0,0
12/21/2017 3:15,10,69.2,25,64.6,35,65.9,2,0,0
12/21/2017 3:20,6,69,21,64.4,27,65.5,2,0,0
12/21/2017 3:25,7,69.2,22,64.6,29,65.7,2,0,0
12/21/2017 3:30,12,69.4,27,64.8,39,66.2,2,0,0
12/21/2017 3:35,8,69.2,24,64.6,32,65.8,2,0,0
12/21/2017 3:40,8,69.3,24,64.7,32,65.8,2,0,0
12/21/2017 3:45,15,69.4,31,64.8,46,66.3,2,0,0
12/21/2017 3:50,9,69.4,24,64.8,33,66,2,0,0
12/21/2017 3:55,13,69.3,29,64.7,42,66.1,2,0,0
12/21/2017 4:00,13,69.3,28,64.7,41,66.2,2,0,0
12/21/2017 4:05,18,69.3,33,64.7,51,66.3,2,0,0
12/21/2017 4:10,13,69.2,29,64.6,42,66,2,0,0
12/21/2017 4:15,13,69.3,29,64.7,42,66.1,2,0,0
12/21/2017 4:20,18,69.2,34,64.5,52,66.1,2,0,0
12/21/2017 4:25,15,69.3,31,64.7,46,66.2,2,0,0
12/21/2017 4:30,18,69.2,34,64.6,52,66.2,2,0,0
12/21/2017 4:35,20,69.3,36,64.7,56,66.4,2,0,0
12/21/2017 4:40,21,69.1,37,64.5,58,66.2,2,0,0
12/21/2017 4:45,25,69.2,42,64.6,67,66.3,2,0,0
12/21/2017 4:50,25,69.7,42,65.1,67,66.8,2,0,0
12/21/2017 4:55,24,69.6,41,65,65,66.7,2,0,0
12/21/2017 5:00,29,69.6,47,65,76,66.8,2,0,0
12/21/2017 5:05,25,69.9,42,65.3,67,67,2,0,0
12/21/2017 5:10,19,69.8,36,65.2,55,66.8,2,0,0
12/21/2017 5:15,28,69.5,45,64.9,73,66.7,2,0,0
12/21/2017 5:20,34,70.3,52,65.8,86,67.6,2,0,0
12/21/2017 5:25,28,69.6,46,65,74,66.8,2,0,0
12/21/2017 5:30,32,68.9,50,64.3,82,66.1,2,0,0
12/21/2017 5:35,37,68.9,54,64.3,91,66.1,2,0,0
12/21/2017 5:40,33,65.3,51,60.3,84,62.2,2,0,0
12/21/2017 5:45,42,68,60,63.3,102,65.2,2,0,0
12/21/2017 5:50,36,69.1,53,64.4,89,66.3,2,0,0
12/21/2017 5:55,34,69.4,52,64.7,86,66.5,2,0,0
12/21/2017 6:00,30,68.1,47,63.3,77,65.2,2,0,0
12/21/2017 6:05,33,69.1,51,64.4,84,66.3,2,0,0
12/21/2017 6:10,40,69.3,58,64.7,98,66.6,2,0,0
12/21/2017 6:15,40,69.6,59,65,99,66.8,2,0,0
12/21/2017 6:20,28,69.8,45,65.2,73,67,2,0,0
12/21/2017 6:25,36,70.1,54,65.6,90,67.4,2,0,0
12/21/2017 6:30,43,70,62,65.5,105,67.3,2,0,0
12/21/2017 6:35,36,68.8,54,64.1,90,66,2,0,0
12/21/2017 6:40,34,69.1,51,64.5,85,66.3,2,0,0
12/21/2017 6:45,41,70,59,65.5,100,67.3,2,0,0
12/21/2017 6:50,46,69.9,64,65.3,110,67.2,2,0,0
12/21/2017 6:55,42,69.9,61,65.3,103,67.2,2,0,0
12/21/2017 7:00,40,69.9,58,65.3,98,67.2,2,0,0
12/21/2017 7:05,38,67.8,56,63.1,94,65,2,0,0
12/21/2017 7:10,45,68.8,64,64.2,109,66.1,2,0,0
12/21/2017 7:15,40,69.1,58,64.5,98,66.4,2,0,0
12/21/2017 7:20,42,70,59,65.4,101,67.3,2,0,0
12/21/2017 7:25,42,70.7,60,66.2,102,68.1,2,0,0
12/21/2017 7:30,52,70.1,71,65.6,123,67.5,2,0,0
12/21/2017 7:35,45,70.3,64,65.8,109,67.7,2,0,0
12/21/2017 7:40,45,69.1,65,64.5,110,66.4,2,0,0
12/21/2017 7:45,43,69.6,61,65,104,66.9,2,0,0
12/21/2017 7:50,58,69.7,77,65.1,135,67.1,2,0,0
12/21/2017 7:55,38,70,56,65.4,94,67.3,2,0,0
12/21/2017 8:00,46,69.4,65,64.8,111,66.7,2,0,0
12/21/2017 8:05,42,69.3,60,64.8,102,66.6,2,0,0
12/21/2017 8:10,50,69.1,69,64.4,119,66.4,2,0,0
12/21/2017 8:15,39,69.4,57,64.8,96,66.7,2,0,0
12/21/2017 8:20,55,68.8,75,64.2,130,66.1,2,0,0
12/21/2017 8:25,54,68.7,73,64,127,66,2,0,0
12/21/2017 8:30,64,68.3,84,63.6,148,65.6,2,0,0
12/21/2017 8:35,59,67.6,79,62.9,138,64.9,2,0,0
12/21/2017 8:40,75,67.5,96,62.7,171,64.8,2,0,0
12/21/2017 8:45,75,66.8,96,62,171,64.1,2,0,0
12/21/2017 8:50,74,67.4,96,62.6,170,64.7,2,0,0
12/21/2017 8:55,77,66.6,98,61.8,175,63.9,2,0,0
12/21/2017 9:00,68,66.2,89,61.3,157,63.4,2,0,0
12/21/2017 9:05,69,68.3,90,63.6,159,65.7,2,0,0
12/21/2017 9:10,58,67.8,77,63,135,65.1,2,0,0
12/21/2017 9:15,64,67.4,83,62.7,147,64.7,2,0,0
12/21/2017 9:20,65,67.6,85,62.8,150,64.9,2,0,0
12/21/2017 9:25,69,67.2,90,62.4,159,64.5,2,0,0
12/21/2017 9:30,67,67,87,62.2,154,64.3,2,0,0
12/21/2017 9:35,76,65.8,97,60.8,173,63,2,0,0
12/21/2017 9:40,63,64.8,84,59.9,147,62,2,0,0
12/21/2017 9:45,67,65.9,87,60.9,154,63.1,2,0,0
12/21/2017 9:50,67,65.6,88,60.6,155,62.8,2,0,0
12/21/2017 9:55,55,65.8,74,60.8,129,63,2,0,0
12/21/2017 10:00,51,66.8,70,62,121,64,2,0,0
12/21/2017 10:05,63,68.1,81,63.5,144,65.5,2,0,0
12/21/2017 10:10,55,68.5,75,63.9,130,65.9,2,0,0
12/21/2017 10:15,62,67.4,81,62.7,143,64.7,2,0,0
12/21/2017 10:20,67,68.2,87,63.6,154,65.6,2,0,0
12/21/2017 10:25,61,67.7,82,63.1,143,65,2,0,0
12/21/2017 10:30,61,66.5,81,61.6,142,63.7,2,0,0
12/21/2017 10:35,76,67.2,97,62.4,173,64.5,2,0,0
12/21/2017 10:40,62,66.6,81,61.8,143,63.9,2,0,0
12/21/2017 10:45,68,66.5,88,61.7,156,63.8,2,0,0
12/21/2017 10:50,63,66.8,83,62,146,64.1,2,0,0
12/21/2017 10:55,56,67,76,62.2,132,64.2,2,0,0
12/21/2017 11:00,54,67.9,72,63.2,126,65.2,2,0,0
12/21/2017 11:05,55,68.9,75,64.2,130,66.2,2,0,0
12/21/2017 11:10,61,68.1,81,63.3,142,65.4,2,0,0
12/21/2017 11:15,56,66.1,76,61.2,132,63.3,2,0,0
12/21/2017 11:20,55,67.7,74,62.9,129,65,2,0,0
12/21/2017 11:25,59,69.3,78,64.6,137,66.6,2,0,0
12/21/2017 11:30,65,69.6,85,65,150,67,2,0,0
12/21/2017 11:35,58,70.3,76,65.8,134,67.8,2,0,0
12/21/2017 11:40,61,70.3,80,65.8,141,67.8,2,0,0
12/21/2017 11:45,56,69.3,75,64.7,131,66.6,2,0,0
12/21/2017 11:50,60,69.5,80,64.9,140,66.8,2,0,0
12/21/2017 11:55,56,70,76,65.4,132,67.4,2,0,0
12/21/2017 12:00,58,69.2,78,64.6,136,66.6,2,0,0
12/21/2017 12:05,56,69,75,64.4,131,66.3,2,0,0
12/21/2017 12:10,62,69.1,81,64.4,143,66.4,2,0,0
12/21/2017 12:15,55,69.8,74,65.2,129,67.1,2,0,0
12/21/2017 12:20,66,67.9,86,63.1,152,65.2,2,0,0
12/21/2017 12:25,55,68.7,73,64,128,66,2,0,0
12/21/2017 12:30,60,68.2,78,63.5,138,65.5,2,0,0
12/21/2017 12:35,53,69.5,70,64.9,123,66.9,2,0,0
12/21/2017 12:40,54,69.7,73,65.1,127,67,2,0,0
12/21/2017 12:45,47,70,64,65.4,111,67.3,2,0,0
12/21/2017 12:50,54,67.3,72,62.6,126,64.6,2,0,0
12/21/2017 12:55,51,69.1,68,64.4,119,66.4,2,0,0
12/21/2017 13:00,47,69.9,66,65.3,113,67.2,2,0,0
12/21/2017 13:05,41,68.4,59,63.8,100,65.7,2,0,0
12/21/2017 13:10,44,69.1,61,64.4,105,66.4,2,0,0
12/21/2017 13:15,43,70,61,65.5,104,67.4,2,0,0
12/21/2017 13:20,41,70.4,58,65.9,99,67.8,2,0,0
12/21/2017 13:25,55,69.8,74,65.2,129,67.2,2,0,0
12/21/2017 13:30,58,70.1,77,65.5,135,67.5,2,0,0
12/21/2017 13:35,50,69.7,67,65.1,117,67.1,2,0,0
12/21/2017 13:40,49,69.8,67,65.2,116,67.2,2,0,0
12/21/2017 13:45,56,69.3,74,64.6,130,66.6,2,0,0
12/21/2017 13:50,56,68.9,74,64.2,130,66.2,2,0,0
12/21/2017 13:55,56,69.3,74,64.7,130,66.7,2,0,0
12/21/2017 14:00,49,69.1,67,64.5,116,66.4,2,0,0
12/21/2017 14:05,57,69,75,64.5,132,66.4,2,0,0
12/21/2017 14:10,61,68.5,80,63.9,141,65.9,2,0,0
12/21/2017 14:15,56,68,74,63.3,130,65.4,2,0,0
12/21/2017 14:20,60,68.6,78,64,138,66,2,0,0
12/21/2017 14:25,53,68,71,63.4,124,65.4,2,0,0
12/21/2017 14:30,48,68.4,65,63.8,113,65.8,2,0,0
12/21/2017 14:35,53,67.9,71,63.3,124,65.2,2,0,0
12/21/2017 14:40,53,68.4,72,63.8,125,65.8,2,0,0
12/21/2017 14:45,49,67.6,67,62.9,116,64.9,2,0,0
12/21/2017 14:50,64,67.8,83,63.1,147,65.1,2,0,0
12/21/2017 14:55,56,67.1,74,62.4,130,64.4,2,0,0
12/21/2017 15:00,54,67.5,72,62.7,126,64.7,2,0,0
12/21/2017 15:05,64,67.7,83,63,147,65.1,2,0,0
12/21/2017 15:10,53,68.4,71,63.7,124,65.7,2,0,0
12/21/2017 15:15,57,68.4,75,63.6,132,65.7,2,0,0
12/21/2017 15:20,65,67.5,85,62.8,150,64.8,2,0,0
12/21/2017 15:25,63,67.4,82,62.6,145,64.7,2,0,0
12/21/2017 15:30,59,67.1,78,62.4,137,64.4,2,0,0
12/21/2017 15:35,55,66.4,73,61.5,128,63.6,2,0,0
12/21/2017 15:40,57,66.8,76,61.9,133,64,2,0,0
12/21/2017 15:45,60,66.6,79,61.7,139,63.8,2,0,0
12/21/2017 15:50,65,66.4,86,61.5,151,63.6,2,0,0
12/21/2017 15:55,54,66,73,61,127,63.2,2,0,0
12/21/2017 16:00,63,66.8,82,62,145,64.1,2,0,0
12/21/2017 16:05,63,67.6,83,62.9,146,65,2,0,0
12/21/2017 16:10,58,68.5,77,63.9,135,65.9,2,0,0
12/21/2017 16:15,59,69.1,78,64.5,137,66.5,2,0,0
12/21/2017 16:20,49,68.5,66,64,115,65.9,2,0,0
12/21/2017 16:25,41,68.9,58,64.4,99,66.3,2,0,0
12/21/2017 16:30,52,67.4,70,62.7,122,64.7,2,0,0
12/21/2017 16:35,41,68.1,58,63.4,99,65.4,2,0,0
12/21/2017 16:40,49,69.3,67,64.7,116,66.7,2,0,0
12/21/2017 16:45,49,67.9,66,63.2,115,65.2,2,0,0
12/21/2017 16:50,49,67.2,66,62.3,115,64.4,2,0,0
12/21/2017 16:55,44,67.2,62,62.4,106,64.4,2,0,0
12/21/2017 17:00,47,68.3,64,63.5,111,65.5,2,0,0
12/21/2017 17:05,55,68.6,74,63.9,129,65.9,2,0,0
12/21/2017 17:10,51,69,69,64.3,120,66.3,2,0,0
12/21/2017 17:15,51,69.9,70,65.4,121,67.3,2,0,0
12/21/2017 17:20,50,69.6,68,65,118,67,2,0,0
12/21/2017 17:25,39,69.1,56,64.4,95,66.4,2,0,0
12/21/2017 17:30,41,69.1,58,64.4,99,66.3,2,0,0
12/21/2017 17:35,38,69.4,55,64.8,93,66.7,2,0,0
12/21/2017 17:40,44,68.5,62,63.9,106,65.8,2,0,0
12/21/2017 17:45,47,68.7,66,64,113,66,2,0,0
12/21/2017 17:50,44,67.9,62,63.1,106,65,2,0,0
12/21/2017 17:55,40,68.1,57,63.3,97,65.3,2,0,0
12/21/2017 18:00,43,68.7,61,63.9,104,65.9,2,0,0
12/21/2017 18:05,43,68.8,60,64,103,66,2,0,0
12/21/2017 18:10,51,68.7,68,64,119,66,2,0,0
12/21/2017 18:15,61,68.3,79,63.5,140,65.6,2,0,0
12/21/2017 18:20,56,67.9,74,63,130,65.1,2,0,0
12/21/2017 18:25,46,68.1,63,63.4,109,65.4,2,0,0
12/21/2017 18:30,47,69,64,64.4,111,66.3,2,0,0
12/21/2017 18:35,47,69.5,65,64.9,112,66.8,2,0,0
12/21/2017 18:40,40,69.6,57,65.1,97,66.9,2,0,0
12/21/2017 18:45,41,70.4,58,66,99,67.8,2,0,0
12/21/2017 18:50,42,69.2,59,64.6,101,66.5,2,0,0
12/21/2017 18:55,45,69.6,62,65,107,66.9,2,0,0
12/21/2017 19:00,42,69.4,60,64.8,102,66.7,2,0,0
12/21/2017 19:05,36,68.5,53,63.8,89,65.7,2,0,0
12/21/2017 19:10,44,68.3,61,63.6,105,65.6,2,0,0
12/21/2017 19:15,46,68.2,63,63.4,109,65.4,2,0,0
12/21/2017 19:20,49,69.8,67,65.2,116,67.2,2,0,0
12/21/2017 19:25,42,68.6,59,63.9,101,65.8,2,0,0
12/21/2017 19:30,35,69.2,51,64.5,86,66.4,2,0,0
12/21/2017 19:35,42,69.7,59,65.1,101,67,2,0,0
12/21/2017 19:40,42,69.7,59,65.1,101,67,2,0,0
12/21/2017 19:45,32,69.1,48,64.5,80,66.4,2,0,0
12/21/2017 19:50,31,69.9,48,65.3,79,67.1,2,0,0
12/21/2017 19:55,35,68.7,51,64.1,86,66,2,0,0
12/21/2017 20:00,33,68.5,50,63.9,83,65.7,2,0,0
12/21/2017 20:05,35,68.7,51,64,86,65.9,2,0,0
12/21/2017 20:10,36,68.9,52,64.3,88,66.2,2,0,0
12/21/2017 20:15,38,69.5,55,64.9,93,66.8,2,0,0
12/21/2017 20:20,34,69.8,51,65.2,85,67,2,0,0
12/21/2017 20:25,29,70,45,65.5,74,67.3,2,0,0
12/21/2017 20:30,32,69.4,49,64.7,81,66.6,2,0,0
12/21/2017 20:35,33,69,50,64.3,83,66.2,2,0,0
12/21/2017 20:40,30,69.4,45,64.8,75,66.6,2,0,0
12/21/2017 20:45,29,69.9,44,65.3,73,67.1,2,0,0
12/21/2017 20:50,32,69.6,49,65,81,66.8,2,0,0
12/21/2017 20:55,33,68.5,50,63.8,83,65.7,2,0,0
12/21/2017 21:00,37,68.1,53,63.3,90,65.3,2,0,0
12/21/2017 21:05,28,68.1,44,63.4,72,65.2,2,0,0
12/21/2017 21:10,30,67.5,46,62.8,76,64.6,2,0,0
12/21/2017 21:15,35,67.7,51,63,86,64.9,2,0,0
12/21/2017 21:20,31,68.1,48,63.4,79,65.2,2,0,0
12/21/2017 21:25,30,68.8,47,64.2,77,66,2,0,0
12/21/2017 21:30,29,69,45,64.4,74,66.2,2,0,0
12/21/2017 21:35,28,68.4,44,63.7,72,65.5,2,0,0
12/21/2017 21:40,34,66.9,50,62.1,84,64.1,2,0,0
12/21/2017 21:45,36,66.8,53,62,89,63.9,2,0,0
12/21/2017 21:50,31,67.5,48,62.7,79,64.6,2,0,0
12/21/2017 21:55,28,67.6,44,62.8,72,64.7,2,0,0
12/21/2017 22:00,28,67.7,44,63,72,64.9,2,0,0
12/21/2017 22:05,23,68.7,39,64,62,65.7,2,0,0
12/21/2017 22:10,25,68.9,41,64.2,66,66,2,0,0
12/21/2017 22:15,25,68.6,42,63.9,67,65.7,2,0,0
12/21/2017 22:20,22,69.2,38,64.5,60,66.2,2,0,0
12/21/2017 22:25,25,69.4,41,64.8,66,66.6,2,0,0
12/21/2017 22:30,21,69.4,37,64.8,58,66.5,2,0,0
12/21/2017 22:35,24,69.6,40,65,64,66.7,2,0,0
12/21/2017 22:40,30,69.4,46,64.7,76,66.6,2,0,0
12/21/2017 22:45,26,69.1,42,64.5,68,66.3,2,0,0
12/21/2017 22:50,25,69,41,64.3,66,66.1,2,0,0
12/21/2017 22:55,23,69.2,38,64.6,61,66.3,2,0,0
12/21/2017 23:00,17,69.4,32,64.8,49,66.4,2,0,0
12/21/2017 23:05,17,69.5,33,64.9,50,66.4,2,0,0
12/21/2017 23:10,20,69.3,36,64.7,56,66.3,2,0,0
12/21/2017 23:15,23,69.4,39,64.8,62,66.5,2,0,0
12/21/2017 23:20,20,69.4,36,64.7,56,66.4,2,0,0
12/21/2017 23:25,20,69.2,35,64.6,55,66.3,2,0,0
12/21/2017 23:30,21,68.9,37,64.2,58,65.9,2,0,0
12/21/2017 23:35,18,68.8,34,64.1,52,65.7,2,0,0
12/21/2017 23:40,15,69.1,30,64.5,45,66,2,0,0
12/21/2017 23:45,20,69.2,35,64.6,55,66.3,2,0,0
12/21/2017 23:50,12,69.2,28,64.6,40,66,2,0,0
12/21/2017 23:55,13,69.1,28,64.5,41,66,2,0,0
12/22/2017 0:00,14,69.3,30,64.7,44,66.2,2,0,0
12/22/2017 0:05,14,69.3,29,64.7,43,66.2,2,0,0
12/22/2017 0:10,8,69.2,24,64.5,32,65.7,2,0,0
12/22/2017 0:15,12,69.3,27,64.7,39,66.1,2,0,0
12/22/2017 0:20,16,69.3,32,64.7,48,66.2,2,0,0
12/22/2017 0:25,11,69,26,64.4,37,65.8,2,0,0
12/22/2017 0:30,9,69.1,24,64.5,33,65.7,2,0,0
12/22/2017 0:35,12,69,27,64.4,39,65.8,2,0,0
12/22/2017 0:40,10,69.1,26,64.5,36,65.8,2,0,0
12/22/2017 0:45,8,69.3,23,64.7,31,65.9,2,0,0
12/22/2017 0:50,10,69.3,26,64.7,36,65.9,2,0,0
12/22/2017 0:55,8,69.3,23,64.7,31,65.9,2,0,0
12/22/2017 1:00,9,69.4,24,64.8,33,66.1,2,0,0
12/22/2017 1:05,7,69.2,22,64.6,29,65.7,2,0,0
12/22/2017 1:10,8,69.3,23,64.7,31,65.8,2,0,0
12/22/2017 1:15,10,69.3,26,64.7,36,66,2,0,0
12/22/2017 1:20,8,69.1,23,64.4,31,65.6,2,0,0
12/22/2017 1:25,5,69.3,20,64.7,25,65.6,2,0,0
12/22/2017 1:30,8,69.3,24,64.7,32,65.9,2,0,0
12/22/2017 1:35,8,69.3,24,64.7,32,65.8,2,0,0
12/22/2017 1:40,9,69.1,24,64.5,33,65.7,2,0,0
12/22/2017 1:45,7,69.3,22,64.7,29,65.8,2,0,0
12/22/2017 1:50,9,69,24,64.4,33,65.7,2,0,0
12/22/2017 1:55,15,69.2,22,64.6,37,66.5,2,0,0
12/22/2017 2:00,10,69.3,20,64.7,30,66.2,2,0,0
12/22/2017 2:05,9,69.4,25,64.8,34,66,2,0,0
12/22/2017 2:10,7,69.4,23,64.8,30,65.9,2,0,0
12/22/2017 2:15,8,69.4,24,64.8,32,66,2,0,0
12/22/2017 2:20,8,69,23,64.3,31,65.5,2,0,0
12/22/2017 2:25,10,68.8,25,64.2,35,65.5,2,0,0
12/22/2017 2:30,7,69.1,23,64.4,30,65.5,2,0,0
12/22/2017 2:35,9,69.1,24,64.4,33,65.7,2,0,0
12/22/2017 2:40,8,69.1,24,64.4,32,65.6,2,0,0
12/22/2017 2:45,12,69.2,27,64.6,39,66,2,0,0
12/22/2017 2:50,8,69.2,24,64.5,32,65.7,2,0,0
12/22/2017 2:55,11,69.2,27,64.6,38,66,2,0,0
12/22/2017 3:00,9,69.3,25,64.7,34,65.9,2,0,0
12/22/2017 3:05,9,69.4,25,64.8,34,66.1,2,0,0
12/22/2017 3:10,7,69.4,23,64.8,30,65.8,2,0,0
12/22/2017 3:15,12,69.4,28,64.8,40,66.2,2,0,0
12/22/2017 3:20,10,69.2,25,64.5,35,65.9,2,0,0
12/22/2017 3:25,9,69.3,25,64.7,34,66,2,0,0
12/22/2017 3:30,12,69.3,28,64.7,40,66.1,2,0,0
12/22/2017 3:35,15,69.5,30,64.9,45,66.4,2,0,0
12/22/2017 3:40,16,69.1,32,64.5,48,66,2,0,0
12/22/2017 3:45,13,69.3,29,64.7,42,66.1,2,0,0
12/22/2017 3:50,15,69.3,30,64.7,45,66.3,2,0,0
12/22/2017 3:55,14,69.3,30,64.7,44,66.2,2,0,0
12/22/2017 4:00,15,69.3,30,64.7,45,66.2,2,0,0
12/22/2017 4:05,12,69.5,28,64.9,40,66.3,2,0,0
12/22/2017 4:10,19,69.1,35,64.5,54,66.1,2,0,0
12/22/2017 4:15,20,68.9,37,64.2,57,65.8,2,0,0
12/22/2017 4:20,22,69.3,38,64.7,60,66.4,2,0,0
12/22/2017 4:25,27,69.7,43,65.2,70,66.9,2,0,0
12/22/2017 4:30,23,69.4,39,64.9,62,66.6,2,0,0
12/22/2017 4:35,29,69.6,46,65,75,66.7,2,0,0
12/22/2017 4:40,31,69.5,48,64.9,79,66.7,2,0,0
12/22/2017 4:45,38,70,56,65.5,94,67.3,2,0,0
12/22/2017 4:50,30,70.2,46,65.7,76,67.5,2,0,0
12/22/2017 4:55,34,70.5,51,66,85,67.8,2,0,0
12/22/2017 5:00,36,70,54,65.5,90,67.3,2,0,0
12/22/2017 5:05,34,69.6,52,65.1,86,66.9,2,0,0
12/22/2017 5:10,33,69.3,51,64.7,84,66.5,2,0,0
12/22/2017 5:15,37,69.8,55,65.3,92,67.1,2,0,0
12/22/2017 5:20,42,70.2,61,65.7,103,67.6,2,0,0
12/22/2017 5:25,43,70.7,61,66.3,104,68.1,2,0,0
12/22/2017 5:30,45,70.7,63,66.2,108,68.1,2,0,0
12/22/2017 5:35,44,69.7,63,65.2,107,67.1,2,0,0
12/22/2017 5:40,54,70,74,65.5,128,67.4,2,0,0
12/22/2017 5:45,50,70.2,69,65.6,119,67.5,2,0,0
12/22/2017 5:50,49,69.6,69,65,118,66.9,2,0,0
12/22/2017 5:55,49,68.9,68,64.2,117,66.2,2,0,0
12/22/2017 6:00,51,67.5,70,62.7,121,64.7,2,0,0
12/22/2017 6:05,46,68.1,64,63.3,110,65.3,2,0,0
12/22/2017 6:10,50,67.9,69,63.2,119,65.2,2,0,0
12/22/2017 6:15,49,67.9,68,63.1,117,65.1,2,0,0
12/22/2017 6:20,52,68.1,71,63.2,123,65.3,2,0,0
12/22/2017 6:25,46,68.2,66,63.3,112,65.3,2,0,0
12/22/2017 6:30,51,66.8,71,61.9,122,63.9,2,0,0
12/22/2017 6:35,51,67.2,70,62.2,121,64.3,2,0,0
12/22/2017 6:40,49,67.7,69,62.9,118,64.9,2,0,0
12/22/2017 6:45,61,68.1,81,63.3,142,65.4,2,0,0
12/22/2017 6:50,49,69.3,67,64.6,116,66.6,2,0,0
12/22/2017 6:55,46,69.2,64,64.4,110,66.4,2,0,0
12/22/2017 7:00,52,69.1,71,64.4,123,66.4,2,0,0
12/22/2017 7:05,50,68.5,69,63.7,119,65.7,2,0,0
12/22/2017 7:10,52,68.8,71,64,123,66,2,0,0
12/22/2017 7:15,62,68.7,84,63.9,146,65.9,2,0,0
12/22/2017 7:20,58,67.5,77,62.6,135,64.7,2,0,0
12/22/2017 7:25,59,67.1,79,62.2,138,64.3,2,0,0
12/22/2017 7:30,63,66.7,84,61.8,147,63.9,2,0,0
12/22/2017 7:35,72,67.8,94,62.9,166,65,2,0,0
12/22/2017 7:40,56,67.2,75,62.3,131,64.4,2,0,0
12/22/2017 7:45,61,67.3,82,62.4,143,64.5,2,0,0
12/22/2017 7:50,68,68.2,90,63.4,158,65.5,2,0,0
12/22/2017 7:55,54,68.5,74,63.7,128,65.7,2,0,0
12/22/2017 8:00,60,68.5,79,63.8,139,65.8,2,0,0
12/22/2017 8:05,67,68.7,88,64.1,155,66.1,2,0,0
12/22/2017 8:10,61,68.4,81,63.7,142,65.8,2,0,0
12/22/2017 8:15,66,67.9,86,63.1,152,65.2,2,0,0
12/22/2017 8:20,62,67.1,82,62.3,144,64.4,2,0,0
12/22/2017 8:25,65,67.5,85,62.7,150,64.8,2,0,0
12/22/2017 8:30,60,68.7,79,64.1,139,66.1,2,0,0
12/22/2017 8:35,58,68.9,77,64.3,135,66.2,2,0,0
12/22/2017 8:40,68,68,88,63.4,156,65.4,2,0,0
12/22/2017 8:45,56,68.4,75,63.7,131,65.7,2,0,0
12/22/2017 8:50,68,67.8,88,63.1,156,65.1,2,0,0
12/22/2017 8:55,58,67.3,76,62.6,134,64.6,2,0,0
12/22/2017 9:00,48,67.5,66,62.8,114,64.8,2,0,0
12/22/2017 9:05,54,69.7,72,65.2,126,67.2,2,0,0
12/22/2017 9:10,54,67.6,73,62.8,127,64.8,2,0,0
12/22/2017 9:15,53,67.4,71,62.7,124,64.7,2,0,0
12/22/2017 9:20,63,67,82,62.2,145,64.3,2,0,0
12/22/2017 9:25,66,67.3,85,62.5,151,64.6,2,0,0
12/22/2017 9:30,60,67.8,79,63,139,65.1,2,0,0
12/22/2017 9:35,65,68.3,84,63.5,149,65.6,2,0,0
12/22/2017 9:40,76,67.1,97,62.3,173,64.4,2,0,0
12/22/2017 9:45,72,67.5,92,62.7,164,64.8,2,0,0
12/22/2017 9:50,57,67.4,76,62.7,133,64.7,2,0,0
12/22/2017 9:55,57,66.6,75,61.7,132,63.8,2,0,0
12/22/2017 10:00,65,67.7,85,63,150,65,2,0,0
12/22/2017 10:05,53,68.3,71,63.7,124,65.7,2,0,0
12/22/2017 10:10,66,67.2,86,62.4,152,64.5,2,0,0
12/22/2017 10:15,61,67.8,80,63.1,141,65.1,2,0,0
12/22/2017 10:20,65,67.4,85,62.7,150,64.7,2,0,0
12/22/2017 10:25,66,66.3,84,61.5,150,63.6,2,0,0
12/22/2017 10:30,62,68,81,63.3,143,65.4,2,0,0
12/22/2017 10:35,66,67.7,87,63,153,65,2,0,0
12/22/2017 10:40,65,67.7,85,63.1,150,65.1,2,0,0
12/22/2017 10:45,60,67.7,79,63,139,65.1,2,0,0
12/22/2017 10:50,62,67.3,81,62.5,143,64.6,2,0,0
12/22/2017 10:55,63,66.3,82,61.4,145,63.5,2,0,0
12/22/2017 11:00,56,67.3,75,62.5,131,64.5,2,0,0
12/22/2017 11:05,53,67.4,72,62.6,125,64.6,2,0,0
12/22/2017 11:10,58,67.4,77,62.6,135,64.7,2,0,0
12/22/2017 11:15,65,67.1,85,62.3,150,64.4,2,0,0
12/22/2017 11:20,57,67.8,77,63.1,134,65.1,2,0,0
12/22/2017 11:25,63,67.3,81,62.5,144,64.6,2,0,0
12/22/2017 11:30,62,68,82,63.3,144,65.3,2,0,0
12/22/2017 11:35,59,68.6,79,63.9,138,65.9,2,0,0
12/22/2017 11:40,51,68.1,69,63.4,120,65.4,2,0,0
12/22/2017 11:45,72,68.2,93,63.4,165,65.5,2,0,0
12/22/2017 11:50,54,66.9,72,62.1,126,64.1,2,0,0
12/22/2017 11:55,60,67.8,78,63.1,138,65.2,2,0,0
12/22/2017 12:00,65,67.1,85,62.3,150,64.4,2,0,0
12/22/2017 12:05,57,67.2,76,62.4,133,64.5,2,0,0
12/22/2017 12:10,50,68.9,68,64.2,118,66.2,2,0,0
12/22/2017 12:15,54,68.4,72,63.7,126,65.7,2,0,0
12/22/2017 12:20,59,68.9,79,64.2,138,66.2,2,0,0
12/22/2017 12:25,59,68.9,78,64.2,137,66.2,2,0,0
12/22/2017 12:30,52,68.9,70,64.2,122,66.2,2,0,0
12/22/2017 12:35,56,67.4,74,62.6,130,64.7,2,0,0
12/22/2017 12:40,53,68,73,63.3,126,65.2,2,0,0
12/22/2017 12:45,48,68.2,67,63.4,115,65.4,2,0,0
12/22/2017 12:50,56,67.8,75,63.1,131,65.1,2,0,0
12/22/2017 12:55,61,68.3,80,63.7,141,65.7,2,0,0
12/22/2017 13:00,57,67.3,75,62.5,132,64.6,2,0,0
12/22/2017 13:05,49,67.5,67,62.8,116,64.8,2,0,0
12/22/2017 13:10,54,66.9,73,62,127,64.1,2,0,0
12/22/2017 13:15,59,66.7,78,61.9,137,64,2,0,0
12/22/2017 13:20,50,67.1,69,62.4,119,64.4,2,0,0
12/22/2017 13:25,61,65.6,81,60.8,142,62.9,2,0,0
12/22/2017 13:30,51,67.3,69,62.5,120,64.6,2,0,0
12/22/2017 13:35,67,68.2,87,63.5,154,65.6,2,0,0
12/22/2017 13:40,59,67.4,77,62.6,136,64.7,2,0,0
12/22/2017 13:45,47,68.3,65,63.6,112,65.6,2,0,0
12/22/2017 13:50,42,67.7,59,63,101,65,2,0,0
12/22/2017 13:55,47,68.2,65,63.5,112,65.4,2,0,0
12/22/2017 14:00,48,67.9,66,63.2,114,65.2,2,0,0
12/22/2017 14:05,58,68.3,76,63.6,134,65.6,2,0,0
12/22/2017 14:10,54,69.1,72,64.5,126,66.4,2,0,0
12/22/2017 14:15,51,68.6,68,63.9,119,65.9,2,0,0
12/22/2017 14:20,47,68,64,63.2,111,65.2,2,0,0
12/22/2017 14:25,53,66.9,72,62.1,125,64.1,2,0,0
12/22/2017 14:30,48,67.8,66,63.1,114,65.1,2,0,0
12/22/2017 14:35,49,67.9,67,63.2,116,65.2,2,0,0
12/22/2017 14:40,45,69.2,63,64.6,108,66.5,2,0,0
12/22/2017 14:45,47,69.3,66,64.7,113,66.6,2,0,0
12/22/2017 14:50,50,69.5,68,64.8,118,66.8,2,0,0
12/22/2017 14:55,50,68.6,68,64,118,65.9,2,0,0
12/22/2017 15:00,48,69.2,65,64.6,113,66.6,2,0,0
12/22/2017 15:05,53,70.5,71,66,124,67.9,2,0,0
12/22/2017 15:10,52,70.1,71,65.7,123,67.6,2,0,0
12/22/2017 15:15,53,69.6,71,65.1,124,67,2,0,0
12/22/2017 15:20,60,69.4,79,64.9,139,66.9,2,0,0
12/22/2017 15:25,54,69.6,73,65,127,67,2,0,0
12/22/2017 15:30,59,68.5,79,63.9,138,65.8,2,0,0
12/22/2017 15:35,57,68.8,76,64.2,133,66.1,2,0,0
12/22/2017 15:40,50,67.9,68,63.1,118,65.2,2,0,0
12/22/2017 15:45,50,68.8,68,64.2,118,66.2,2,0,0
12/22/2017 15:50,59,69,78,64.4,137,66.4,2,0,0
12/22/2017 15:55,57,69.6,76,65.1,133,67,2,0,0
12/22/2017 16:00,53,70,70,65.5,123,67.5,2,0,0
12/22/2017 16:05,54,70.3,72,65.8,126,67.7,2,0,0
12/22/2017 16:10,58,69.8,77,65.2,135,67.2,2,0,0
12/22/2017 16:15,58,70,77,65.4,135,67.4,2,0,0
12/22/2017 16:20,65,69.5,84,64.9,149,66.9,2,0,0
12/22/2017 16:25,54,69.3,71,64.6,125,66.6,2,0,0
12/22/2017 16:30,58,70,78,65.5,136,67.4,2,0,0
12/22/2017 16:35,59,69,78,64.4,137,66.4,2,0,0
12/22/2017 16:40,54,68.7,71,64.1,125,66.1,2,0,0
12/22/2017 16:45,53,68.1,72,63.4,125,65.4,2,0,0
12/22/2017 16:50,43,68.4,60,63.7,103,65.7,2,0,0
12/22/2017 16:55,56,68.6,74,63.9,130,66,2,0,0
12/22/2017 17:00,53,69.8,71,65.3,124,67.2,2,0,0
12/22/2017 17:05,40,68.9,58,64.3,98,66.2,2,0,0
12/22/2017 17:10,48,69.1,66,64.6,114,66.5,2,0,0
12/22/2017 17:15,49,68.8,67,64.3,116,66.2,2,0,0
12/22/2017 17:20,53,69.2,72,64.7,125,66.6,2,0,0
12/22/2017 17:25,55,68.3,73,63.7,128,65.7,2,0,0
12/22/2017 17:30,60,68.2,79,63.6,139,65.6,2,0,0
12/22/2017 17:35,55,68.7,74,64.1,129,66.1,2,0,0
12/22/2017 17:40,53,68.1,71,63.5,124,65.5,2,0,0
12/22/2017 17:45,64,67.5,83,62.8,147,64.8,2,0,0
12/22/2017 17:50,53,67.2,71,62.4,124,64.5,2,0,0
12/22/2017 17:55,66,67,84,62.2,150,64.3,2,0,0
12/22/2017 18:00,51,67.1,69,62.2,120,64.3,2,0,0
12/22/2017 18:05,62,67.7,81,63,143,65,2,0,0
12/22/2017 18:10,52,67.4,70,62.7,122,64.7,2,0,0
12/22/2017 18:15,55,67,74,62.2,129,64.2,2,0,0
12/22/2017 18:20,66,67.1,85,62.4,151,64.5,2,0,0
12/22/2017 18:25,58,67.5,76,62.7,134,64.8,2,0,0
12/22/2017 18:30,57,67.1,76,62.3,133,64.4,2,0,0
12/22/2017 18:35,55,67.3,74,62.6,129,64.6,2,0,0
12/22/2017 18:40,57,67.7,76,62.9,133,64.9,2,0,0
12/22/2017 18:45,50,67.7,68,63,118,65,2,0,0
12/22/2017 18:50,51,68.1,69,63.4,120,65.4,2,0,0
12/22/2017 18:55,50,68.8,68,64.2,118,66.1,2,0,0
12/22/2017 19:00,55,68.7,72,64,127,66.1,2,0,0
12/22/2017 19:05,52,68.2,70,63.5,122,65.5,2,0,0
12/22/2017 19:10,51,68,69,63.3,120,65.3,2,0,0
12/22/2017 19:15,53,67.9,71,63.2,124,65.2,2,0,0
12/22/2017 19:20,42,69.1,59,64.5,101,66.4,2,0,0
12/22/2017 19:25,41,69,59,64.3,100,66.3,2,0,0
12/22/2017 19:30,43,69.5,61,64.9,104,66.8,2,0,0
12/22/2017 19:35,36,68.7,53,64.1,89,66,2,0,0
12/22/2017 19:40,39,69.5,56,64.9,95,66.8,2,0,0
12/22/2017 19:45,40,69.7,57,65.1,97,67,2,0,0
12/22/2017 19:50,40,69.5,57,64.9,97,66.8,2,0,0
12/22/2017 19:55,38,70.6,53,66,91,67.9,2,0,0
12/22/2017 20:00,45,70.1,62,65.6,107,67.4,2,0,0
12/22/2017 20:05,35,70.6,52,66.1,87,67.9,2,0,0
12/22/2017 20:10,32,69.9,49,65.4,81,67.2,2,0,0
12/22/2017 20:15,33,70.4,48,65.9,81,67.7,2,0,0
12/22/2017 20:20,38,70.3,54,65.8,92,67.6,2,0,0
12/22/2017 20:25,36,70.2,52,65.6,88,67.5,2,0,0
12/22/2017 20:30,30,70.1,46,65.5,76,67.3,2,0,0
12/22/2017 20:35,33,70.2,49,65.6,82,67.5,2,0,0
12/22/2017 20:40,36,69.4,53,64.8,89,66.7,2,0,0
12/22/2017 20:45,37,69.1,54,64.5,91,66.3,2,0,0
12/22/2017 20:50,32,67.9,48,63.2,80,65.1,2,0,0
12/22/2017 20:55,32,68.8,48,64.1,80,66,2,0,0
12/22/2017 21:00,40,69.2,57,64.5,97,66.4,2,0,0
12/22/2017 21:05,34,69.3,51,64.7,85,66.5,2,0,0
12/22/2017 21:10,35,70.2,52,65.6,87,67.4,2,0,0
12/22/2017 21:15,31,69.5,47,64.9,78,66.7,2,0,0
12/22/2017 21:20,36,69.5,52,64.9,88,66.7,2,0,0
12/22/2017 21:25,33,69.5,49,64.9,82,66.7,2,0,0
12/22/2017 21:30,32,69.5,48,65,80,66.8,2,0,0
12/22/2017 21:35,37,69.8,54,65.2,91,67,2,0,0
12/22/2017 21:40,31,70.1,47,65.5,78,67.3,2,0,0
12/22/2017 21:45,26,69.9,42,65.3,68,67.1,2,0,0
12/22/2017 21:50,29,69.6,45,65,74,66.8,2,0,0
12/22/2017 21:55,31,69.9,47,65.4,78,67.2,2,0,0
12/22/2017 22:00,28,69.5,44,64.9,72,66.7,2,0,0
12/22/2017 22:05,31,69.6,46,65,77,66.9,2,0,0
12/22/2017 22:10,24,68.7,40,64,64,65.8,2,0,0
12/22/2017 22:15,28,69.2,44,64.6,72,66.4,2,0,0
12/22/2017 22:20,28,68.4,44,63.7,72,65.5,2,0,0
12/22/2017 22:25,28,68.4,44,63.7,72,65.6,2,0,0
12/22/2017 22:30,29,69,44,64.4,73,66.2,2,0,0
12/22/2017 22:35,37,69.2,54,64.6,91,66.5,2,0,0
12/22/2017 22:40,25,69.2,41,64.6,66,66.3,2,0,0
12/22/2017 22:45,33,69.6,49,64.9,82,66.8,2,0,0
12/22/2017 22:50,30,69.6,46,65,76,66.8,2,0,0
12/22/2017 22:55,27,69.4,43,64.8,70,66.6,2,0,0
12/22/2017 23:00,27,69.3,43,64.7,70,66.4,2,0,0
12/22/2017 23:05,27,69.2,43,64.6,70,66.4,2,0,0
12/22/2017 23:10,21,69.3,36,64.7,57,66.4,2,0,0
12/22/2017 23:15,25,69.3,41,64.7,66,66.4,2,0,0
12/22/2017 23:20,29,69.4,45,64.7,74,66.6,2,0,0
12/22/2017 23:25,21,69.4,36,64.8,57,66.5,2,0,0
12/22/2017 23:30,23,69.4,39,64.7,62,66.5,2,0,0
12/22/2017 23:35,28,68.3,45,63.5,73,65.4,2,0,0
12/22/2017 23:40,27,68.6,43,63.9,70,65.7,2,0,0
12/22/2017 23:45,9,68.9,25,64.2,34,65.5,2,0,0
12/22/2017 23:50,18,69.2,33,64.6,51,66.2,2,0,0
12/22/2017 23:55,21,68.7,36,64,57,65.7,2,0,0
12/23/2017 0:00,19,69.3,35,64.7,54,66.4,2,0,0
12/23/2017 0:05,20,69.3,36,64.7,56,66.3,2,0,0
12/23/2017 0:10,16,69.4,32,64.8,48,66.3,2,0,0
12/23/2017 0:15,13,69.3,29,64.7,42,66.2,2,0,0
12/23/2017 0:20,16,69.3,31,64.7,47,66.3,2,0,0
12/23/2017 0:25,13,69.2,28,64.6,41,66,2,0,0
12/23/2017 0:30,12,69.3,27,64.7,39,66.1,2,0,0
12/23/2017 0:35,16,68.8,32,64.1,48,65.7,2,0,0
12/23/2017 0:40,12,69,27,64.4,39,65.8,2,0,0
12/23/2017 0:45,15,69.1,30,64.5,45,66,2,0,0
12/23/2017 0:50,14,69.3,30,64.7,44,66.2,2,0,0
12/23/2017 0:55,12,69.3,28,64.7,40,66.1,2,0,0
12/23/2017 1:00,11,69.4,27,64.8,38,66.1,2,0,0
12/23/2017 1:05,12,69.2,27,64.6,39,66,2,0,0
12/23/2017 1:10,12,69.2,27,64.6,39,66,2,0,0
12/23/2017 1:15,10,69.2,25,64.6,35,65.9,2,0,0
12/23/2017 1:20,10,69.1,25,64.5,35,65.8,2,0,0
12/23/2017 1:25,10,69.3,26,64.7,36,66,2,0,0
12/23/2017 1:30,11,69.4,26,64.8,37,66.2,2,0,0
12/23/2017 1:35,8,69.2,24,64.6,32,65.8,2,0,0
12/23/2017 1:40,8,69.2,24,64.6,32,65.7,2,0,0
12/23/2017 1:45,19,69.3,24,64.7,43,66.7,2,0,0
12/23/2017 1:50,13,69.3,21,64.7,34,66.5,2,0,0
12/23/2017 1:55,12,69.5,27,65,39,66.4,2,0,0
12/23/2017 2:00,10,69.5,25,64.9,35,66.2,2,0,0
12/23/2017 2:05,8,69.4,24,64.8,32,66,2,0,0
12/23/2017 2:10,8,69.4,23,64.8,31,66,2,0,0
12/23/2017 2:15,8,69.2,24,64.5,32,65.7,2,0,0
12/23/2017 2:20,6,69.2,21,64.6,27,65.6,2,0,0
12/23/2017 2:25,8,69.3,23,64.7,31,65.9,2,0,0
12/23/2017 2:30,9,69.3,24,64.7,33,66,2,0,0
12/23/2017 2:35,7,69.3,22,64.7,29,65.8,2,0,0
12/23/2017 2:40,11,69.2,27,64.6,38,66,2,0,0
12/23/2017 2:45,7,69.4,22,64.8,29,65.9,2,0,0
12/23/2017 2:50,9,69.3,24,64.7,33,66,2,0,0
12/23/2017 2:55,9,69.2,25,64.5,34,65.7,2,0,0
12/23/2017 3:00,11,69.3,26,64.7,37,66.1,2,0,0
12/23/2017 3:05,7,69.4,23,64.8,30,65.8,2,0,0
12/23/2017 3:10,12,69.1,28,64.5,40,65.9,2,0,0
12/23/2017 3:15,12,69.2,27,64.6,39,66,2,0,0
12/23/2017 3:20,9,69.3,24,64.7,33,66,2,0,0
12/23/2017 3:25,10,69.3,25,64.7,35,66.1,2,0,0
12/23/2017 3:30,10,69.4,26,64.8,36,66.1,2,0,0
12/23/2017 3:35,11,69.4,26,64.8,37,66.1,2,0,0
12/23/2017 3:40,11,69.4,27,64.8,38,66.1,2,0,0
12/23/2017 3:45,17,69.4,32,64.8,49,66.4,2,0,0
12/23/2017 3:50,12,69.3,28,64.7,40,66.1,2,0,0
12/23/2017 3:55,13,69.4,29,64.8,42,66.2,2,0,0
12/23/2017 4:00,11,69.4,26,64.8,37,66.1,2,0,0
12/23/2017 4:05,13,69.4,28,64.7,41,66.2,2,0,0
12/23/2017 4:10,13,69.3,29,64.7,42,66.1,2,0,0
12/23/2017 4:15,12,69.4,28,64.7,40,66.1,2,0,0
12/23/2017 4:20,15,69.3,30,64.7,45,66.3,2,0,0
12/23/2017 4:25,15,69.3,30,64.7,45,66.3,2,0,0
12/23/2017 4:30,15,69.4,31,64.8,46,66.3,2,0,0
12/23/2017 4:35,16,69.5,32,64.9,48,66.5,2,0,0
12/23/2017 4:40,17,68.5,32,63.8,49,65.4,2,0,0
12/23/2017 4:45,15,68.8,31,64.2,46,65.7,2,0,0
12/23/2017 4:50,17,69.2,33,64.6,50,66.2,2,0,0
12/23/2017 4:55,13,69.3,29,64.7,42,66.1,2,0,0
12/23/2017 5:00,12,69.3,27,64.7,39,66.1,2,0,0
12/23/2017 5:05,13,69.3,29,64.7,42,66.2,2,0,0
12/23/2017 5:10,15,69.2,31,64.6,46,66.1,2,0,0
12/23/2017 5:15,20,69.5,36,64.9,56,66.6,2,0,0
12/23/2017 5:20,20,69.3,37,64.7,57,66.4,2,0,0
12/23/2017 5:25,22,69.3,38,64.7,60,66.4,2,0,0
12/23/2017 5:30,17,69.5,33,64.9,50,66.4,2,0,0
12/23/2017 5:35,21,68.9,38,64.3,59,65.9,2,0,0
12/23/2017 5:40,23,69,39,64.3,62,66,2,0,0
12/23/2017 5:45,17,69.3,34,64.7,51,66.2,2,0,0
12/23/2017 5:50,19,69.3,34,64.7,53,66.3,2,0,0
12/23/2017 5:55,14,68.9,30,64.2,44,65.7,2,0,0
12/23/2017 6:00,15,68.6,30,64,45,65.5,2,0,0
12/23/2017 6:05,13,68.6,28,64,41,65.4,2,0,0
12/23/2017 6:10,17,69,34,64.4,51,65.9,2,0,0
12/23/2017 6:15,18,69.2,34,64.5,52,66.1,2,0,0
12/23/2017 6:20,23,69.3,39,64.7,62,66.4,2,0,0
12/23/2017 6:25,22,69.4,38,64.8,60,66.5,2,0,0
12/23/2017 6:30,18,69,34,64.4,52,66,2,0,0
12/23/2017 6:35,20,69,36,64.4,56,66,2,0,0
12/23/2017 6:40,23,68.9,39,64.3,62,66,2,0,0
12/23/2017 6:45,25,68.5,42,63.8,67,65.5,2,0,0
12/23/2017 6:50,26,68.3,43,63.6,69,65.4,2,0,0
12/23/2017 6:55,22,68.8,38,64.2,60,65.9,2,0,0
12/23/2017 7:00,24,69.2,40,64.6,64,66.3,2,0,0
12/23/2017 7:05,17,69.2,32,64.6,49,66.2,2,0,0
12/23/2017 7:10,30,68.8,46,64.1,76,65.9,2,0,0
12/23/2017 7:15,31,68.2,48,63.4,79,65.3,2,0,0
12/23/2017 7:20,28,68.8,44,64.1,72,65.9,2,0,0
12/23/2017 7:25,23,69.3,39,64.7,62,66.4,2,0,0
12/23/2017 7:30,29,69.2,45,64.6,74,66.4,2,0,0
12/23/2017 7:35,27,68,44,63.4,71,65.1,2,0,0
12/23/2017 7:40,34,68.2,51,63.5,85,65.4,2,0,0
12/23/2017 7:45,29,68.4,45,63.7,74,65.6,2,0,0
12/23/2017 7:50,28,68.9,44,64.3,72,66.1,2,0,0
12/23/2017 7:55,32,69.4,49,64.8,81,66.6,2,0,0
12/23/2017 8:00,40,69.7,57,65.2,97,67.1,2,0,0
12/23/2017 8:05,30,69.4,46,64.8,76,66.7,2,0,0
12/23/2017 8:10,36,69.1,53,64.4,89,66.3,2,0,0
12/23/2017 8:15,38,68.1,55,63.3,93,65.3,2,0,0
12/23/2017 8:20,36,67.5,53,62.7,89,64.6,2,0,0
12/23/2017 8:25,38,68.2,57,63.4,95,65.3,2,0,0
12/23/2017 8:30,35,68.9,52,64.2,87,66.1,2,0,0
12/23/2017 8:35,34,68.5,51,63.9,85,65.7,2,0,0
12/23/2017 8:40,38,68.9,55,64.2,93,66.1,2,0,0
12/23/2017 8:45,38,68.5,55,63.8,93,65.7,2,0,0
12/23/2017 8:50,42,68.5,59,63.8,101,65.7,2,0,0
12/23/2017 8:55,45,68.8,62,64.2,107,66.1,2,0,0
12/23/2017 9:00,37,69.5,54,64.9,91,66.7,2,0,0
12/23/2017 9:05,40,70,57,65.4,97,67.3,2,0,0
12/23/2017 9:10,47,69.7,64,65.2,111,67.1,2,0,0
12/23/2017 9:15,44,68.9,62,64.3,106,66.2,2,0,0
12/23/2017 9:20,42,69.6,59,65,101,66.9,2,0,0
12/23/2017 9:25,42,69.3,59,64.7,101,66.6,2,0,0
12/23/2017 9:30,42,68.3,59,63.6,101,65.5,2,0,0
12/23/2017 9:35,50,68.4,68,63.7,118,65.7,2,0,0
12/23/2017 9:40,51,68.7,69,64,120,66,2,0,0
12/23/2017 9:45,46,69.5,64,64.9,110,66.8,2,0,0
12/23/2017 9:50,50,69.7,67,65.2,117,67.1,2,0,0
12/23/2017 9:55,49,70.1,67,65.6,116,67.5,2,0,0
12/23/2017 10:00,49,70.2,67,65.6,116,67.6,2,0,0
12/23/2017 10:05,42,68.5,59,63.8,101,65.8,2,0,0
12/23/2017 10:10,51,68.4,69,63.8,120,65.8,2,0,0
12/23/2017 10:15,43,68.6,60,63.9,103,65.9,2,0,0
12/23/2017 10:20,53,69,70,64.4,123,66.4,2,0,0
12/23/2017 10:25,47,69.3,64,64.7,111,66.7,2,0,0
12/23/2017 10:30,58,68.4,77,63.7,135,65.7,2,0,0
12/23/2017 10:35,52,68.5,68,63.9,120,65.9,2,0,0
12/23/2017 10:40,50,69.5,68,64.9,118,66.8,2,0,0
12/23/2017 10:45,57,68.6,76,63.9,133,65.9,2,0,0
12/23/2017 10:50,50,69.6,68,64.9,118,66.9,2,0,0
12/23/2017 10:55,61,69.4,79,64.8,140,66.9,2,0,0
12/23/2017 11:00,56,69.9,74,65.4,130,67.3,2,0,0
12/23/2017 11:05,58,68.7,76,64.1,134,66.1,2,0,0
12/23/2017 11:10,45,69,63,64.4,108,66.3,2,0,0
12/23/2017 11:15,56,68.2,75,63.5,131,65.5,2,0,0
12/23/2017 11:20,62,68.9,80,64.3,142,66.3,2,0,0
12/23/2017 11:25,61,68.3,80,63.6,141,65.6,2,0,0
12/23/2017 11:30,55,68.3,72,63.6,127,65.7,2,0,0
12/23/2017 11:35,54,68.6,72,64,126,66,2,0,0
12/23/2017 11:40,60,69.1,78,64.5,138,66.5,2,0,0
12/23/2017 11:45,57,69.9,75,65.4,132,67.3,2,0,0
12/23/2017 11:50,58,70.4,74,66,132,67.9,2,0,0
12/23/2017 11:55,49,69.9,67,65.4,116,67.3,2,0,0
12/23/2017 12:00,50,69,68,64.4,118,66.3,2,0,0
12/23/2017 12:05,51,69.2,69,64.6,120,66.6,2,0,0
12/23/2017 12:10,52,69.1,69,64.5,121,66.5,2,0,0
12/23/2017 12:15,57,69.3,75,64.7,132,66.7,2,0,0
12/23/2017 12:20,53,69.6,70,65,123,66.9,2,0,0
12/23/2017 12:25,54,69.3,72,64.7,126,66.7,2,0,0
12/23/2017 12:30,50,68.7,68,64,118,66,2,0,0
12/23/2017 12:35,61,68.8,80,64.2,141,66.2,2,0,0
12/23/2017 12:40,64,68.8,82,64.2,146,66.2,2,0,0
12/23/2017 12:45,62,68.7,81,64,143,66,2,0,0
12/23/2017 12:50,56,69.3,74,64.8,130,66.7,2,0,0
12/23/2017 12:55,61,69.2,79,64.7,140,66.7,2,0,0
12/23/2017 13:00,52,69.4,71,64.9,123,66.8,2,0,0
12/23/2017 13:05,54,70.1,71,65.6,125,67.5,2,0,0
12/23/2017 13:10,46,69.5,64,64.9,110,66.8,2,0,0
12/23/2017 13:15,58,69.1,76,64.4,134,66.4,2,0,0
12/23/2017 13:20,55,69,72,64.4,127,66.4,2,0,0
12/23/2017 13:25,56,69.4,73,64.8,129,66.8,2,0,0
12/23/2017 13:30,61,69.3,79,64.7,140,66.7,2,0,0
12/23/2017 13:35,56,69.2,74,64.7,130,66.7,2,0,0
12/23/2017 13:40,59,69.3,78,64.7,137,66.6,2,0,0
12/23/2017 13:45,52,68.9,70,64.3,122,66.3,2,0,0
12/23/2017 13:50,59,68.9,78,64.2,137,66.2,2,0,0
12/23/2017 13:55,59,68.7,77,64,136,66,2,0,0
12/23/2017 14:00,52,68.2,70,63.5,122,65.5,2,0,0
12/23/2017 14:05,64,68.8,82,64.2,146,66.2,2,0,0
12/23/2017 14:10,57,69.1,75,64.5,132,66.5,2,0,0
12/23/2017 14:15,56,68.5,74,63.8,130,65.8,2,0,0
12/23/2017 14:20,59,69.2,79,64.5,138,66.5,2,0,0
12/23/2017 14:25,56,68.9,74,64.2,130,66.2,2,0,0
12/23/2017 14:30,61,69.8,80,65.3,141,67.2,2,0,0
12/23/2017 14:35,62,69.6,81,65.1,143,67,2,0,0
12/23/2017 14:40,66,69.2,86,64.7,152,66.7,2,0,0
12/23/2017 14:45,47,69.4,66,64.9,113,66.8,2,0,0
12/23/2017 14:50,52,68.7,70,64,122,66,2,0,0
12/23/2017 14:55,49,69.5,67,64.9,116,66.8,2,0,0
12/23/2017 15:00,60,69.4,78,64.8,138,66.8,2,0,0
12/23/2017 15:05,53,70,71,65.5,124,67.4,2,0,0
12/23/2017 15:10,61,69.5,80,65,141,66.9,2,0,0
12/23/2017 15:15,57,69.4,75,64.8,132,66.8,2,0,0
12/23/2017 15:20,61,68.9,79,64.2,140,66.3,2,0,0
12/23/2017 15:25,67,68.9,86,64.3,153,66.3,2,0,0
12/23/2017 15:30,65,69.3,84,64.7,149,66.7,2,0,0
12/23/2017 15:35,63,69.4,82,64.8,145,66.8,2,0,0
12/23/2017 15:40,55,69.2,73,64.6,128,66.6,2,0,0
12/23/2017 15:45,63,69.2,82,64.7,145,66.7,2,0,0
12/23/2017 15:50,66,69.5,85,65,151,67,2,0,0
12/23/2017 15:55,62,69.7,81,65.2,143,67.1,2,0,0
12/23/2017 16:00,63,69.5,81,65.1,144,67,2,0,0
12/23/2017 16:05,59,69.3,79,64.7,138,66.7,2,0,0
12/23/2017 16:10,59,69.8,78,65.4,137,67.3,2,0,0
12/23/2017 16:15,59,69.5,76,65,135,67,2,0,0
12/23/2017 16:20,63,69.3,81,64.7,144,66.7,2,0,0
12/23/2017 16:25,64,67.9,84,63.2,148,65.2,2,0,0
12/23/2017 16:30,72,68.7,92,64.1,164,66.1,2,0,0
12/23/2017 16:35,59,68.3,78,63.6,137,65.6,2,0,0
12/23/2017 16:40,72,67.7,92,63,164,65.1,2,0,0
12/23/2017 16:45,62,68,80,63.3,142,65.3,2,0,0
12/23/2017 16:50,68,68.1,88,63.3,156,65.4,2,0,0
12/23/2017 16:55,60,68.1,79,63.4,139,65.4,2,0,0
12/23/2017 17:00,56,68.4,76,63.7,132,65.7,2,0,0
12/23/2017 17:05,68,68.4,86,63.7,154,65.8,2,0,0
12/23/2017 17:10,57,67.8,75,63,132,65.1,2,0,0
12/23/2017 17:15,55,68.3,73,63.6,128,65.6,2,0,0
12/23/2017 17:20,57,67.8,75,63.1,132,65.1,2,0,0
12/23/2017 17:25,61,67.9,79,63.2,140,65.3,2,0,0
12/23/2017 17:30,56,68.6,74,64.1,130,66.1,2,0,0
12/23/2017 17:35,56,68,75,63.3,131,65.3,2,0,0
12/23/2017 17:40,57,67.9,75,63.2,132,65.3,2,0,0
12/23/2017 17:45,46,68.3,64,63.7,110,65.6,2,0,0
12/23/2017 17:50,44,68.1,62,63.4,106,65.3,2,0,0
12/23/2017 17:55,57,68.3,75,63.6,132,65.6,2,0,0
12/23/2017 18:00,52,68.3,70,63.7,122,65.7,2,0,0
12/23/2017 18:05,45,68,63,63.3,108,65.3,2,0,0
12/23/2017 18:10,52,68,70,63.3,122,65.3,2,0,0
12/23/2017 18:15,49,67.8,66,63.1,115,65.1,2,0,0
12/23/2017 18:20,47,68.3,65,63.7,112,65.6,2,0,0
12/23/2017 18:25,51,67.8,69,63.2,120,65.1,2,0,0
12/23/2017 18:30,47,67.9,65,63.1,112,65.1,2,0,0
12/23/2017 18:35,47,68.5,64,63.8,111,65.8,2,0,0
12/23/2017 18:40,49,66.6,67,61.8,116,63.8,2,0,0
12/23/2017 18:45,43,67.5,60,62.7,103,64.7,2,0,0
12/23/2017 18:50,43,67.9,60,63.2,103,65.2,2,0,0
12/23/2017 18:55,50,68.1,67,63.4,117,65.4,2,0,0
12/23/2017 19:00,47,68.6,65,63.8,112,65.8,2,0,0
12/23/2017 19:05,49,68.9,67,64.2,116,66.2,2,0,0
12/23/2017 19:10,43,69.1,61,64.4,104,66.4,2,0,0
12/23/2017 19:15,42,69.1,60,64.4,102,66.3,2,0,0
12/23/2017 19:20,46,68.7,63,63.9,109,65.9,2,0,0
12/23/2017 19:25,37,69.3,54,64.7,91,66.6,2,0,0
12/23/2017 19:30,41,70.1,59,65.5,100,67.4,2,0,0
12/23/2017 19:35,43,69.9,60,65.3,103,67.2,2,0,0
12/23/2017 19:40,38,70.3,55,65.7,93,67.6,2,0,0
12/23/2017 19:45,39,69.7,56,65.1,95,67,2,0,0
12/23/2017 19:50,39,68.7,56,63.9,95,65.9,2,0,0
12/23/2017 19:55,31,69.2,47,64.5,78,66.4,2,0,0
12/23/2017 20:00,34,69.2,50,64.5,84,66.4,2,0,0
12/23/2017 20:05,37,70.2,53,65.6,90,67.5,2,0,0
12/23/2017 20:10,40,69.8,57,65.2,97,67.1,2,0,0
12/23/2017 20:15,42,69.7,58,65.1,100,67,2,0,0
12/23/2017 20:20,35,69.9,51,65.4,86,67.2,2,0,0
12/23/2017 20:25,31,70,46,65.4,77,67.3,2,0,0
12/23/2017 20:30,28,70,44,65.5,72,67.2,2,0,0
12/23/2017 20:35,32,69.6,48,65,80,66.9,2,0,0
12/23/2017 20:40,33,69.1,49,64.4,82,66.3,2,0,0
12/23/2017 20:45,27,69,43,64.4,70,66.2,2,0,0
12/23/2017 20:50,29,69.2,45,64.5,74,66.4,2,0,0
12/23/2017 20:55,33,69.5,49,65,82,66.8,2,0,0
12/23/2017 21:00,31,69.8,47,65.2,78,67,2,0,0
12/23/2017 21:05,24,69.7,39,65.1,63,66.9,2,0,0
12/23/2017 21:10,26,69.8,42,65.2,68,67,2,0,0
12/23/2017 21:15,34,69.8,50,65.2,84,67.1,2,0,0
12/23/2017 21:20,27,69.1,43,64.5,70,66.3,2,0,0
12/23/2017 21:25,26,69.5,42,65,68,66.7,2,0,0
12/23/2017 21:30,33,68.1,49,63.4,82,65.3,2,0,0
12/23/2017 21:35,25,68.7,41,64.1,66,65.8,2,0,0
12/23/2017 21:40,33,69.5,49,65,82,66.8,2,0,0
12/23/2017 21:45,31,69.4,47,64.8,78,66.6,2,0,0
12/23/2017 21:50,30,69.3,47,64.7,77,66.5,2,0,0
12/23/2017 21:55,31,69.4,48,64.8,79,66.7,2,0,0
12/23/2017 22:00,25,69.3,41,64.6,66,66.4,2,0,0
12/23/2017 22:05,25,69.2,41,64.6,66,66.3,2,0,0
12/23/2017 22:10,27,69.7,43,65,70,66.8,2,0,0
12/23/2017 22:15,25,69.4,41,64.8,66,66.6,2,0,0
12/23/2017 22:20,23,69.2,39,64.6,62,66.3,2,0,0
12/23/2017 22:25,29,69.2,44,64.5,73,66.4,2,0,0
12/23/2017 22:30,28,69,45,64.4,73,66.1,2,0,0
12/23/2017 22:35,29,69.2,46,64.5,75,66.3,2,0,0
12/23/2017 22:40,26,69,41,64.4,67,66.2,2,0,0
12/23/2017 22:45,28,69.1,44,64.4,72,66.2,2,0,0
12/23/2017 22:50,29,69,45,64.4,74,66.2,2,0,0
12/23/2017 22:55,20,68.6,36,64,56,65.6,2,0,0
12/23/2017 23:00,23,69.1,39,64.5,62,66.2,2,0,0
12/23/2017 23:05,22,69.2,38,64.5,60,66.2,2,0,0
12/23/2017 23:10,23,69.2,38,64.6,61,66.3,2,0,0
12/23/2017 23:15,19,69,34,64.4,53,66.1,2,0,0
12/23/2017 23:20,22,69.1,37,64.5,59,66.2,2,0,0
12/23/2017 23:25,14,69.3,29,64.7,43,66.2,2,0,0
12/23/2017 23:30,24,69.2,40,64.6,64,66.3,2,0,0
12/23/2017 23:35,19,69.5,35,64.9,54,66.5,2,0,0
12/23/2017 23:40,16,69.4,32,64.8,48,66.3,2,0,0
12/23/2017 23:45,22,69.3,38,64.7,60,66.4,2,0,0
12/23/2017 23:50,16,69.2,31,64.6,47,66.2,2,0,0
12/23/2017 23:55,20,68.8,36,64.1,56,65.8,2,0,0
12/24/2017 0:00,20,69.3,35,64.7,55,66.4,2,0,0
12/24/2017 0:05,14,69.2,30,64.6,44,66.1,2,0,0
12/24/2017 0:10,14,69.3,29,64.7,43,66.2,2,0,0
12/24/2017 0:15,12,69.3,27,64.7,39,66.1,2,0,0
12/24/2017 0:20,12,69.2,27,64.6,39,66,2,0,0
12/24/2017 0:25,16,69.2,31,64.5,47,66.1,2,0,0
12/24/2017 0:30,15,69.1,30,64.5,45,66.1,2,0,0
12/24/2017 0:35,10,69.1,26,64.5,36,65.8,2,0,0
12/24/2017 0:40,11,69.3,27,64.7,38,66,2,0,0
12/24/2017 0:45,10,69.3,25,64.7,35,66.1,2,0,0
12/24/2017 0:50,12,69.4,27,64.8,39,66.2,2,0,0
12/24/2017 0:55,7,69.4,22,64.8,29,65.9,2,0,0
12/24/2017 1:00,9,69.3,24,64.7,33,66,2,0,0
12/24/2017 1:05,10,69.1,25,64.5,35,65.8,2,0,0
12/24/2017 1:10,9,69.3,24,64.7,33,65.9,2,0,0
12/24/2017 1:15,10,69.3,25,64.7,35,66,2,0,0
12/24/2017 1:20,8,69.2,24,64.5,32,65.7,2,0,0
12/24/2017 1:25,12,69.3,27,64.7,39,66.1,2,0,0
12/24/2017 1:30,9,69.3,24,64.7,33,66,2,0,0
12/24/2017 1:35,11,69.2,26,64.6,37,66,2,0,0
12/24/2017 1:40,7,69.3,23,64.7,30,65.8,2,0,0
12/24/2017 1:45,8,69.3,23,64.7,31,65.9,2,0,0
12/24/2017 1:50,8,69.4,23,64.8,31,66,2,0,0
12/24/2017 1:55,9,69.2,24,64.6,33,65.9,2,0,0
12/24/2017 2:00,8,69.3,23,64.7,31,65.9,2,0,0
12/24/2017 2:05,9,69.4,24,64.8,33,66.1,2,0,0
12/24/2017 2:10,6,69.4,21,64.8,27,65.8,2,0,0
12/24/2017 2:15,8,69.3,23,64.7,31,65.9,2,0,0
12/24/2017 2:20,7,69.3,22,64.7,29,65.8,2,0,0
12/24/2017 2:25,8,69.3,24,64.7,32,65.8,2,0,0
12/24/2017 2:30,8,69.4,23,64.8,31,66,2,0,0
12/24/2017 2:35,7,69.3,22,64.7,29,65.8,2,0,0
12/24/2017 2:40,8,69.2,24,64.5,32,65.7,2,0,0
12/24/2017 2:45,8,69.2,24,64.5,32,65.7,2,0,0
12/24/2017 2:50,5,69.4,21,64.8,26,65.7,2,0,0
12/24/2017 2:55,5,69.4,21,64.8,26,65.7,2,0,0
12/24/2017 3:00,7,69.3,22,64.7,29,65.8,2,0,0
12/24/2017 3:05,6,69.3,21,64.7,27,65.7,2,0,0
12/24/2017 3:10,5,69.4,21,64.8,26,65.7,2,0,0
12/24/2017 3:15,7,69.1,23,64.5,30,65.6,2,0,0
12/24/2017 3:20,5,69.2,21,64.6,26,65.5,2,0,0
12/24/2017 3:25,9,69.3,24,64.7,33,66,2,0,0
12/24/2017 3:30,9,69.3,24,64.7,33,65.9,2,0,0
12/24/2017 3:35,8,69.4,23,64.8,31,66,2,0,0
12/24/2017 3:40,10,69.4,25,64.8,35,66.1,2,0,0
12/24/2017 3:45,8,69.4,23,64.8,31,66,2,0,0
12/24/2017 3:50,7,69.1,23,64.5,30,65.6,2,0,0
12/24/2017 3:55,14,69.2,22,64.6,36,66.4,2,0,0
12/24/2017 4:00,7,69.3,22,64.7,29,65.8,2,0,0
12/24/2017 4:05,8,69.3,23,64.7,31,65.8,2,0,0
12/24/2017 4:10,8,69.3,24,64.7,32,65.9,2,0,0
12/24/2017 4:15,7,69.3,23,64.7,30,65.8,2,0,0
12/24/2017 4:20,9,69.3,24,64.7,33,65.9,2,0,0
12/24/2017 4:25,10,69.3,25,64.7,35,66,2,0,0
12/24/2017 4:30,11,69.4,27,64.8,38,66.1,2,0,0
12/24/2017 4:35,15,69.6,30,65,45,66.5,2,0,0
12/24/2017 4:40,9,69.4,24,64.8,33,66.1,2,0,0
12/24/2017 4:45,11,69.3,26,64.7,37,66.1,2,0,0
12/24/2017 4:50,10,69,25,64.4,35,65.7,2,0,0
12/24/2017 4:55,12,69.2,27,64.6,39,66,2,0,0
12/24/2017 5:00,13,69.3,28,64.7,41,66.2,2,0,0
12/24/2017 5:05,8,69.3,24,64.7,32,65.9,2,0,0
12/24/2017 5:10,12,69.3,27,64.7,39,66.1,2,0,0
12/24/2017 5:15,13,69.3,28,64.7,41,66.2,2,0,0
12/24/2017 5:20,10,69.4,25,64.8,35,66.1,2,0,0
12/24/2017 5:25,15,69.4,30,64.8,45,66.4,2,0,0
12/24/2017 5:30,14,69.4,30,64.8,44,66.2,2,0,0
12/24/2017 5:35,13,69.3,29,64.7,42,66.1,2,0,0
12/24/2017 5:40,13,69.3,29,64.7,42,66.2,2,0,0
12/24/2017 5:45,14,69.4,29,64.8,43,66.3,2,0,0
12/24/2017 5:50,13,69.4,29,64.8,42,66.3,2,0,0
12/24/2017 5:55,14,69.5,29,64.9,43,66.4,2,0,0
12/24/2017 6:00,10,69.4,25,64.8,35,66.1,2,0,0
12/24/2017 6:05,17,69.3,34,64.7,51,66.2,2,0,0
12/24/2017 6:10,14,69.3,30,64.7,44,66.2,2,0,0
12/24/2017 6:15,15,69.3,30,64.7,45,66.2,2,0,0
12/24/2017 6:20,13,69.3,29,64.7,42,66.1,2,0,0
12/24/2017 6:25,13,69.3,29,64.7,42,66.1,2,0,0
12/24/2017 6:30,15,69.3,30,64.7,45,66.3,2,0,0
12/24/2017 6:35,16,69.2,31,64.6,47,66.2,2,0,0
12/24/2017 6:40,16,69,32,64.3,48,65.9,2,0,0
12/24/2017 6:45,16,69.1,31,64.5,47,66,2,0,0
12/24/2017 6:50,13,69.3,28,64.7,41,66.1,2,0,0
12/24/2017 6:55,12,69.3,28,64.7,40,66,2,0,0
12/24/2017 7:00,19,69.3,35,64.7,54,66.4,2,0,0
12/24/2017 7:05,21,69,36,64.4,57,66.1,2,0,0
12/24/2017 7:10,17,69.1,33,64.4,50,66,2,0,0
12/24/2017 7:15,15,69.2,30,64.5,45,66.1,2,0,0
12/24/2017 7:20,15,69.3,30,64.7,45,66.3,2,0,0
12/24/2017 7:25,17,69.3,33,64.7,50,66.2,2,0,0
12/24/2017 7:30,20,69.2,36,64.6,56,66.3,2,0,0
12/24/2017 7:35,24,68.9,40,64.3,64,66,2,0,0
12/24/2017 7:40,20,69,36,64.4,56,66.1,2,0,0
12/24/2017 7:45,25,69.4,41,64.7,66,66.5,2,0,0
12/24/2017 7:50,25,69.6,41,65,66,66.8,2,0,0
12/24/2017 7:55,25,69.7,41,65.1,66,66.8,2,0,0
12/24/2017 8:00,18,69.5,33,64.9,51,66.5,2,0,0
12/24/2017 8:05,16,69.3,32,64.7,48,66.3,2,0,0
12/24/2017 8:10,21,69.3,37,64.7,58,66.3,2,0,0
12/24/2017 8:15,27,69.3,43,64.7,70,66.4,2,0,0
12/24/2017 8:20,23,69.5,39,64.9,62,66.6,2,0,0
12/24/2017 8:25,26,69.1,42,64.4,68,66.2,2,0,0
12/24/2017 8:30,24,69,40,64.4,64,66.1,2,0,0
12/24/2017 8:35,28,69.4,44,64.8,72,66.6,2,0,0
12/24/2017 8:40,27,69.2,43,64.6,70,66.4,2,0,0
12/24/2017 8:45,28,69.4,44,64.8,72,66.6,2,0,0
12/24/2017 8:50,25,69.5,42,64.9,67,66.6,2,0,0
12/24/2017 8:55,33,68.7,50,64,83,65.9,2,0,0
12/24/2017 9:00,30,69.5,47,64.9,77,66.7,2,0,0
12/24/2017 9:05,30,69.4,46,64.8,76,66.7,2,0,0
12/24/2017 9:10,30,69.7,46,65.1,76,66.9,2,0,0
12/24/2017 9:15,33,69.4,49,64.8,82,66.7,2,0,0
12/24/2017 9:20,32,69.1,48,64.5,80,66.4,2,0,0
12/24/2017 9:25,31,69.3,48,64.7,79,66.5,2,0,0
12/24/2017 9:30,36,69.6,52,65,88,66.9,2,0,0
12/24/2017 9:35,38,69,55,64.3,93,66.2,2,0,0
12/24/2017 9:40,39,68.2,55,63.5,94,65.5,2,0,0
12/24/2017 9:45,39,69.3,56,64.7,95,66.6,2,0,0
12/24/2017 9:50,41,69.8,58,65.2,99,67.1,2,0,0
12/24/2017 9:55,43,69.9,60,65.3,103,67.2,2,0,0
12/24/2017 10:00,41,69.7,57,65.1,98,67,2,0,0
12/24/2017 10:05,34,69.6,52,65,86,66.8,2,0,0
12/24/2017 10:10,44,70,61,65.4,105,67.3,2,0,0
12/24/2017 10:15,42,69.7,59,65.2,101,67.1,2,0,0
12/24/2017 10:20,42,69.9,59,65.3,101,67.2,2,0,0
12/24/2017 10:25,39,69.7,56,65.1,95,67,2,0,0
12/24/2017 10:30,47,69.8,64,65.2,111,67.1,2,0,0
12/24/2017 10:35,46,69.5,64,64.9,110,66.8,2,0,0
12/24/2017 10:40,43,69.3,61,64.7,104,66.6,2,0,0
12/24/2017 10:45,46,70.1,63,65.7,109,67.6,2,0,0
12/24/2017 10:50,51,69.5,69,65,120,66.9,2,0,0
12/24/2017 10:55,52,69.9,70,65.4,122,67.3,2,0,0
12/24/2017 11:00,44,69.8,61,65.3,105,67.2,2,0,0
12/24/2017 11:05,44,69.9,62,65.4,106,67.3,2,0,0
12/24/2017 11:10,46,69.8,63,65.3,109,67.2,2,0,0
12/24/2017 11:15,51,70.3,69,65.8,120,67.7,2,0,0
12/24/2017 11:20,48,70.1,65,65.5,113,67.5,2,0,0
12/24/2017 11:25,50,69.9,68,65.4,118,67.3,2,0,0
12/24/2017 11:30,56,70.6,75,66.2,131,68.1,2,0,0
12/24/2017 11:35,36,69.6,52,65.1,88,66.9,2,0,0
12/24/2017 11:40,42,70,60,65.4,102,67.3,2,0,0
12/24/2017 11:45,44,70,60,65.5,104,67.4,2,0,0
12/24/2017 11:50,40,70.1,57,65.6,97,67.5,2,0,0
12/24/2017 11:55,47,70,64,65.5,111,67.4,2,0,0
12/24/2017 12:00,39,69.8,56,65.2,95,67.1,2,0,0
12/24/2017 12:05,29,69.3,46,64.7,75,66.5,2,0,0
12/24/2017 12:10,48,69.3,65,64.7,113,66.7,2,0,0
12/24/2017 12:15,42,69.2,58,64.6,100,66.5,2,0,0
12/24/2017 12:20,44,68.9,60,64.2,104,66.2,2,0,0
12/24/2017 12:25,45,69.3,63,64.7,108,66.7,2,0,0
12/24/2017 12:30,42,69.6,59,65,101,66.9,2,0,0
12/24/2017 12:35,44,69.2,61,64.6,105,66.5,2,0,0
12/24/2017 12:40,46,68.9,64,64.2,110,66.1,2,0,0
12/24/2017 12:45,49,68.8,67,64.1,116,66.1,2,0,0
12/24/2017 12:50,40,69,57,64.4,97,66.3,2,0,0
12/24/2017 12:55,51,69,67,64.3,118,66.3,2,0,0
12/24/2017 13:00,44,69.4,60,64.8,104,66.8,2,0,0
12/24/2017 13:05,44,69.6,62,65.1,106,67,2,0,0
12/24/2017 13:10,48,69.6,65,65.1,113,67,2,0,0
12/24/2017 13:15,45,69.9,62,65.3,107,67.2,2,0,0
12/24/2017 13:20,48,70.2,65,65.7,113,67.6,2,0,0
12/24/2017 13:25,45,70,62,65.5,107,67.4,2,0,0
12/24/2017 13:30,42,70.2,59,65.7,101,67.6,2,0,0
12/24/2017 13:35,38,69.4,55,64.8,93,66.7,2,0,0
12/24/2017 13:40,50,69.3,68,64.7,118,66.6,2,0,0
12/24/2017 13:45,38,69.5,55,65,93,66.8,2,0,0
12/24/2017 13:50,41,69.4,57,64.8,98,66.7,2,0,0
12/24/2017 13:55,48,69.5,65,64.8,113,66.8,2,0,0
12/24/2017 14:00,29,69.7,45,65.1,74,66.9,2,0,0
12/24/2017 14:05,45,69.5,62,64.9,107,66.9,2,0,0
12/24/2017 14:10,42,69,58,64.4,100,66.3,2,0,0
12/24/2017 14:15,46,69.1,62,64.4,108,66.4,2,0,0
12/24/2017 14:20,49,69.3,65,64.6,114,66.6,2,0,0
12/24/2017 14:25,44,68.9,61,64.3,105,66.2,2,0,0
12/24/2017 14:30,49,69,67,64.3,116,66.2,2,0,0
12/24/2017 14:35,37,69.3,53,64.7,90,66.6,2,0,0
12/24/2017 14:40,42,69.5,59,64.9,101,66.8,2,0,0
12/24/2017 14:45,46,69.5,63,65,109,66.9,2,0,0
12/24/2017 14:50,50,69.6,67,65,117,67,2,0,0
12/24/2017 14:55,45,69.5,62,64.9,107,66.8,2,0,0
12/24/2017 15:00,47,68.4,65,63.7,112,65.6,2,0,0
12/24/2017 15:05,50,69.2,67,64.6,117,66.6,2,0,0
12/24/2017 15:10,44,69.6,61,65,105,66.9,2,0,0
12/24/2017 15:15,38,70,55,65.5,93,67.4,2,0,0
12/24/2017 15:20,48,70.2,65,65.6,113,67.5,2,0,0
12/24/2017 15:25,46,69.8,64,65.2,110,67.1,2,0,0
12/24/2017 15:30,40,69.7,58,65,98,66.9,2,0,0
12/24/2017 15:35,47,69.6,64,65,111,66.9,2,0,0
12/24/2017 15:40,42,69.3,59,64.6,101,66.6,2,0,0
12/24/2017 15:45,44,69.3,61,64.7,105,66.6,2,0,0
12/24/2017 15:50,45,69.2,62,64.6,107,66.5,2,0,0
12/24/2017 15:55,38,69.7,55,65.1,93,66.9,2,0,0
12/24/2017 16:00,47,70.5,64,66,111,67.9,2,0,0
12/24/2017 16:05,43,70.8,59,66.3,102,68.2,2,0,0
12/24/2017 16:10,41,70.1,59,65.5,100,67.4,2,0,0
12/24/2017 16:15,46,70,63,65.4,109,67.3,2,0,0
12/24/2017 16:20,52,70,70,65.5,122,67.4,2,0,0
12/24/2017 16:25,41,70.3,58,65.8,99,67.7,2,0,0
12/24/2017 16:30,48,70.2,66,65.7,114,67.6,2,0,0
12/24/2017 16:35,44,70.1,62,65.5,106,67.4,2,0,0
12/24/2017 16:40,47,70.3,63,65.8,110,67.7,2,0,0
12/24/2017 16:45,50,69.8,68,65.2,118,67.1,2,0,0
12/24/2017 16:50,49,69.7,67,65.1,116,67.1,2,0,0
12/24/2017 16:55,45,69.3,63,64.6,108,66.6,2,0,0
12/24/2017 17:00,39,69.9,56,65.3,95,67.2,2,0,0
12/24/2017 17:05,44,70,60,65.4,104,67.3,2,0,0
12/24/2017 17:10,44,69.9,61,65.3,105,67.3,2,0,0
12/24/2017 17:15,41,69.3,58,64.8,99,66.7,2,0,0
12/24/2017 17:20,50,69.1,67,64.5,117,66.5,2,0,0
12/24/2017 17:25,49,69.4,66,64.8,115,66.8,2,0,0
12/24/2017 17:30,56,69.5,73,64.9,129,66.9,2,0,0
12/24/2017 17:35,47,70,64,65.4,111,67.4,2,0,0
12/24/2017 17:40,44,70.2,61,65.7,105,67.6,2,0,0
12/24/2017 17:45,52,69.1,70,64.4,122,66.4,2,0,0
12/24/2017 17:50,43,68.4,60,63.7,103,65.6,2,0,0
12/24/2017 17:55,48,69.2,65,64.5,113,66.5,2,0,0
12/24/2017 18:00,33,68.9,49,64.3,82,66.1,2,0,0
12/24/2017 18:05,33,69.3,50,64.7,83,66.6,2,0,0
12/24/2017 18:10,39,69.3,56,64.6,95,66.5,2,0,0
12/24/2017 18:15,35,69.6,51,65,86,66.9,2,0,0
12/24/2017 18:20,49,70,66,65.5,115,67.4,2,0,0
12/24/2017 18:25,35,69.5,52,64.9,87,66.7,2,0,0
12/24/2017 18:30,34,68.7,51,64,85,65.9,2,0,0
12/24/2017 18:35,36,69.2,53,64.5,89,66.4,2,0,0
12/24/2017 18:40,35,69.3,51,64.7,86,66.6,2,0,0
12/24/2017 18:45,32,69.9,48,65.3,80,67.1,2,0,0
12/24/2017 18:50,35,69.3,52,64.7,87,66.5,2,0,0
12/24/2017 18:55,32,69.2,47,64.6,79,66.5,2,0,0
12/24/2017 19:00,33,69.5,49,64.9,82,66.7,2,0,0
12/24/2017 19:05,29,69.7,45,65.1,74,66.9,2,0,0
12/24/2017 19:10,35,68.7,51,64,86,65.9,2,0,0
12/24/2017 19:15,25,69.2,41,64.6,66,66.4,2,0,0
12/24/2017 19:20,26,69.5,42,64.9,68,66.7,2,0,0
12/24/2017 19:25,24,69.3,39,64.7,63,66.5,2,0,0
12/24/2017 19:30,24,69.6,40,65,64,66.7,2,0,0
12/24/2017 19:35,30,69.4,46,64.8,76,66.7,2,0,0
12/24/2017 19:40,22,69.5,38,64.9,60,66.6,2,0,0
12/24/2017 19:45,25,69.5,41,64.9,66,66.6,2,0,0
12/24/2017 19:50,23,69.8,39,65.3,62,67,2,0,0
12/24/2017 19:55,28,69.7,44,65.1,72,66.9,2,0,0
12/24/2017 20:00,21,69.7,36,65.1,57,66.8,2,0,0
12/24/2017 20:05,25,69.5,41,64.9,66,66.6,2,0,0
12/24/2017 20:10,29,69.2,45,64.5,74,66.4,2,0,0
12/24/2017 20:15,23,69.2,39,64.5,62,66.3,2,0,0
12/24/2017 20:20,24,69,39,64.4,63,66.2,2,0,0
12/24/2017 20:25,29,69.2,45,64.6,74,66.4,2,0,0
12/24/2017 20:30,26,69.4,42,64.8,68,66.5,2,0,0
12/24/2017 20:35,20,69.5,36,64.9,56,66.5,2,0,0
12/24/2017 20:40,28,69.4,45,64.8,73,66.6,2,0,0
12/24/2017 20:45,28,69,44,64.4,72,66.2,2,0,0
12/24/2017 20:50,27,69.1,43,64.5,70,66.3,2,0,0
12/24/2017 20:55,29,69,45,64.3,74,66.1,2,0,0
12/24/2017 21:00,27,69.1,43,64.5,70,66.3,2,0,0
12/24/2017 21:05,25,69.2,41,64.6,66,66.4,2,0,0
12/24/2017 21:10,35,69.4,50,64.8,85,66.7,2,0,0
12/24/2017 21:15,30,69.2,46,64.6,76,66.4,2,0,0
12/24/2017 21:20,25,69.2,41,64.6,66,66.3,2,0,0
12/24/2017 21:25,34,69.1,50,64.5,84,66.3,2,0,0
12/24/2017 21:30,31,69.2,48,64.6,79,66.4,2,0,0
12/24/2017 21:35,27,69.5,43,64.9,70,66.7,2,0,0
12/24/2017 21:40,20,69.4,36,64.8,56,66.5,2,0,0
12/24/2017 21:45,29,69.4,45,64.8,74,66.6,2,0,0
12/24/2017 21:50,22,69,37,64.4,59,66.1,2,0,0
12/24/2017 21:55,26,69.3,42,64.7,68,66.5,2,0,0
12/24/2017 22:00,22,69.1,37,64.5,59,66.2,2,0,0
12/24/2017 22:05,31,69.1,47,64.5,78,66.4,2,0,0
12/24/2017 22:10,22,68.9,38,64.3,60,66,2,0,0
12/24/2017 22:15,21,68.9,37,64.2,58,65.9,2,0,0
12/24/2017 22:20,20,68.7,36,64.1,56,65.8,2,0,0
12/24/2017 22:25,24,68.8,40,64.2,64,65.9,2,0,0
12/24/2017 22:30,22,69,38,64.4,60,66.1,2,0,0
12/24/2017 22:35,22,69.2,39,64.6,61,66.3,2,0,0
12/24/2017 22:40,26,69.1,42,64.5,68,66.3,2,0,0
12/24/2017 22:45,18,69.1,33,64.5,51,66.1,2,0,0
12/24/2017 22:50,19,69.3,35,64.7,54,66.3,2,0,0
12/24/2017 22:55,19,69.2,35,64.6,54,66.2,2,0,0
12/24/2017 23:00,16,69.3,32,64.7,48,66.2,2,0,0
12/24/2017 23:05,19,69.2,35,64.5,54,66.2,2,0,0
12/24/2017 23:10,24,69.1,40,64.5,64,66.2,2,0,0
12/24/2017 23:15,19,69.2,35,64.6,54,66.2,2,0,0
12/24/2017 23:20,15,69.2,30,64.5,45,66.1,2,0,0
12/24/2017 23:25,17,69.3,33,64.7,50,66.2,2,0,0
12/24/2017 23:30,23,69.4,39,64.8,62,66.5,2,0,0
12/24/2017 23:35,13,69.3,29,64.7,42,66.2,2,0,0
12/24/2017 23:40,22,69.1,39,64.5,61,66.1,2,0,0
12/24/2017 23:45,18,69.3,34,64.7,52,66.3,2,0,0
12/24/2017 23:50,15,69.1,30,64.5,45,66,2,0,0
12/24/2017 23:55,15,69.1,31,64.4,46,65.9,2,0,0
