5 Minutes,Lane 1 Flow (Veh/5 Minutes),Lane 1 Speed (mph),Lane 2 Flow (Veh/5 Minutes),Lane 2 Speed (mph),Flow (Veh/5 Minutes),Speed (mph),# Lane Points,% Observed,Holiday
1/01/2018 0:00,10,69.3,25,64.7,35,66.1,2,0,1
1/01/2018 0:05,9,69.3,24,64.7,33,66,2,0,1
1/01/2018 0:10,10,69.4,26,64.8,36,66.1,2,0,1
1/01/2018 0:15,11,69.1,27,64.5,38,65.8,2,0,1
1/01/2018 0:20,16,69.2,31,64.5,47,66.1,2,0,1
1/01/2018 0:25,16,69.4,32,64.8,48,66.3,2,0,1
1/01/2018 0:30,20,69.5,35,64.9,55,66.6,2,0,1
1/01/2018 0:35,20,69.1,35,64.5,55,66.2,2,0,1
1/01/2018 0:40,21,69.3,37,64.7,58,66.4,2,0,1
1/01/2018 0:45,19,69.4,34,64.8,53,66.5,2,0,1
1/01/2018 0:50,28,69.7,44,65.2,72,66.9,2,0,1
1/01/2018 0:55,19,69,35,64.4,54,66,2,0,1
1/01/2018 1:00,17,69.2,32,64.5,49,66.1,2,0,1
1/01/2018 1:05,14,69.4,29,64.8,43,66.3,2,0,1
1/01/2018 1:10,15,69.4,30,64.8,45,66.3,2,0,1
1/01/2018 1:15,18,69.4,33,64.8,51,66.5,2,0,1
1/01/2018 1:20,14,69.4,29,64.8,43,66.3,2,0,1
1/01/2018 1:25,19,69.5,35,64.9,54,66.5,2,0,1
1/01/2018 1:30,18,69.4,33,64.7,51,66.4,2,0,1
1/01/2018 1:35,13,69.5,28,64.9,41,66.3,2,0,1
1/01/2018 1:40,13,69.3,29,64.7,42,66.1,2,0,1
1/01/2018 1:45,19,69.5,34,64.9,53,66.5,2,0,1
1/01/2018 1:50,16,69.5,31,64.9,47,66.5,2,0,1
1/01/2018 1:55,14,69.5,29,64.9,43,66.4,2,0,1
1/01/2018 2:00,12,69.4,27,64.8,39,66.2,2,0,1
1/01/2018 2:05,11,69.5,26,64.9,37,66.2,2,0,1
1/01/2018 2:10,13,69.4,28,64.8,41,66.2,2,0,1
1/01/2018 2:15,13,69.4,29,64.8,42,66.2,2,0,1
1/01/2018 2:20,11,69.3,26,64.7,37,66.1,2,0,1
1/01/2018 2:25,13,69.3,28,64.7,41,66.2,2,0,1
1/01/2018 2:30,12,69.3,27,64.7,39,66.1,2,0,1
1/01/2018 2:35,12,69.4,27,64.8,39,66.2,2,0,1
1/01/2018 2:40,15,69.4,30,64.8,45,66.3,2,0,1
1/01/2018 2:45,15,69.4,30,64.7,45,66.3,2,0,1
1/01/2018 2:50,12,69.1,27,64.5,39,65.9,2,0,1
1/01/2018 2:55,12,69.2,27,64.5,39,66,2,0,1
1/01/2018 3:00,12,69.2,27,64.6,39,66,2,0,1
1/01/2018 3:05,15,69.2,31,64.6,46,66.1,2,0,1
1/01/2018 3:10,8,69.4,24,64.7,32,65.9,2,0,1
1/01/2018 3:15,17,69.2,32,64.5,49,66.1,2,0,1
1/01/2018 3:20,14,69.3,29,64.7,43,66.2,2,0,1
1/01/2018 3:25,13,69.3,29,64.7,42,66.1,2,0,1
1/01/2018 3:30,11,69.4,26,64.8,37,66.2,2,0,1
1/01/2018 3:35,11,69.4,26,64.8,37,66.2,2,0,1
1/01/2018 3:40,22,69.4,26,64.8,48,66.9,2,0,1
1/01/2018 3:45,14,69.2,29,64.6,43,66.1,2,0,1
1/01/2018 3:50,12,69.2,26,64.6,38,66,2,0,1
1/01/2018 3:55,8,69.2,23,64.6,31,65.8,2,0,1
1/01/2018 4:00,9,69.4,25,64.8,34,66,2,0,1
1/01/2018 4:05,12,69.3,27,64.7,39,66.1,2,0,1
1/01/2018 4:10,7,69.3,22,64.7,29,65.8,2,0,1
1/01/2018 4:15,10,69.3,25,64.7,35,66,2,0,1
1/01/2018 4:20,12,69.3,28,64.7,40,66.1,2,0,1
1/01/2018 4:25,11,69.3,26,64.7,37,66,2,0,1
1/01/2018 4:30,11,69.2,26,64.6,37,66,2,0,1
1/01/2018 4:35,18,69.3,24,64.7,42,66.6,2,0,1
1/01/2018 4:40,9,69.3,24,64.7,33,65.9,2,0,1
1/01/2018 4:45,10,69.3,25,64.7,35,66.1,2,0,1
1/01/2018 4:50,9,69.4,24,64.8,33,66,2,0,1
1/01/2018 4:55,18,69.3,24,64.7,42,66.7,2,0,1
1/01/2018 5:00,8,69.4,23,64.8,31,66,2,0,1
1/01/2018 5:05,10,69.4,25,64.8,35,66.2,2,0,1
1/01/2018 5:10,9,69.1,24,64.5,33,65.8,2,0,1
1/01/2018 5:15,12,69.1,28,64.5,40,65.9,2,0,1
1/01/2018 5:20,12,69.1,27,64.5,39,65.9,2,0,1
1/01/2018 5:25,11,69.3,27,64.7,38,66,2,0,1
1/01/2018 5:30,12,69.3,27,64.7,39,66.1,2,0,1
1/01/2018 5:35,11,69.4,26,64.8,37,66.1,2,0,1
1/01/2018 5:40,10,69.3,26,64.7,36,65.9,2,0,1
1/01/2018 5:45,11,69.3,26,64.7,37,66.1,2,0,1
1/01/2018 5:50,9,69.3,25,64.7,34,66,2,0,1
1/01/2018 5:55,12,69.3,27,64.7,39,66.1,2,0,1
1/01/2018 6:00,11,69.3,26,64.7,37,66,2,0,1
1/01/2018 6:05,11,69.3,27,64.7,38,66,2,0,1
1/01/2018 6:10,9,69.3,24,64.7,33,65.9,2,0,1
1/01/2018 6:15,10,69.3,25,64.7,35,66,2,0,1
1/01/2018 6:20,10,69.4,25,64.8,35,66.1,2,0,1
1/01/2018 6:25,10,69.3,25,64.7,35,66,2,0,1
1/01/2018 6:30,9,69.3,24,64.7,33,66,2,0,1
1/01/2018 6:35,12,69.3,27,64.7,39,66.1,2,0,1
1/01/2018 6:40,14,69.2,30,64.6,44,66.1,2,0,1
1/01/2018 6:45,13,69.3,29,64.7,42,66.1,2,0,1
1/01/2018 6:50,11,69.2,27,64.6,38,66,2,0,1
1/01/2018 6:55,12,69.3,27,64.7,39,66.1,2,0,1
1/01/2018 7:00,12,69.2,28,64.6,40,66,2,0,1
1/01/2018 7:05,11,69.2,26,64.6,37,66,2,0,1
1/01/2018 7:10,14,68.9,29,64.3,43,65.8,2,0,1
1/01/2018 7:15,15,69.1,31,64.5,46,66,2,0,1
1/01/2018 7:20,20,69.2,36,64.6,56,66.3,2,0,1
1/01/2018 7:25,18,69.4,34,64.8,52,66.4,2,0,1
1/01/2018 7:30,15,69.3,30,64.7,45,66.3,2,0,1
1/01/2018 7:35,13,69.4,28,64.8,41,66.3,2,0,1
1/01/2018 7:40,16,69.4,32,64.8,48,66.3,2,0,1
1/01/2018 7:45,18,69.4,33,64.8,51,66.4,2,0,1
1/01/2018 7:50,14,69.2,29,64.6,43,66.1,2,0,1
1/01/2018 7:55,13,69.4,29,64.8,42,66.2,2,0,1
1/01/2018 8:00,14,69.2,29,64.6,43,66.1,2,0,1
1/01/2018 8:05,16,69.3,32,64.7,48,66.2,2,0,1
1/01/2018 8:10,14,69.3,30,64.7,44,66.1,2,0,1
1/01/2018 8:15,16,69.3,32,64.7,48,66.2,2,0,1
1/01/2018 8:20,15,69.3,30,64.7,45,66.3,2,0,1
1/01/2018 8:25,15,69.5,31,64.9,46,66.4,2,0,1
1/01/2018 8:30,18,69.3,34,64.7,52,66.3,2,0,1
1/01/2018 8:35,16,69.4,32,64.8,48,66.3,2,0,1
1/01/2018 8:40,20,69.1,35,64.5,55,66.2,2,0,1
1/01/2018 8:45,21,69.4,36,64.8,57,66.5,2,0,1
1/01/2018 8:50,24,69.2,40,64.6,64,66.4,2,0,1
1/01/2018 8:55,21,69.4,36,64.8,57,66.5,2,0,1
1/01/2018 9:00,18,69.4,33,64.8,51,66.4,2,0,1
1/01/2018 9:05,18,69.3,33,64.7,51,66.4,2,0,1
1/01/2018 9:10,18,69.5,34,64.9,52,66.5,2,0,1
1/01/2018 9:15,24,69.4,39,64.8,63,66.6,2,0,1
1/01/2018 9:20,17,69.4,33,64.8,50,66.3,2,0,1
1/01/2018 9:25,26,69.5,42,65,68,66.7,2,0,1
1/01/2018 9:30,19,69.3,36,64.7,55,66.3,2,0,1
1/01/2018 9:35,21,69.3,36,64.7,57,66.4,2,0,1
1/01/2018 9:40,22,69.2,38,64.6,60,66.3,2,0,1
1/01/2018 9:45,21,69.3,37,64.7,58,66.4,2,0,1
1/01/2018 9:50,22,69,38,64.4,60,66.1,2,0,1
1/01/2018 9:55,20,69.2,36,64.6,56,66.2,2,0,1
1/01/2018 10:00,28,69.5,43,64.9,71,66.7,2,0,1
1/01/2018 10:05,26,69.6,42,65,68,66.7,2,0,1
1/01/2018 10:10,29,69.4,45,64.8,74,66.6,2,0,1
1/01/2018 10:15,27,69.4,42,64.8,69,66.6,2,0,1
1/01/2018 10:20,28,69.1,44,64.4,72,66.2,2,0,1
1/01/2018 10:25,27,69.3,43,64.7,70,66.4,2,0,1
1/01/2018 10:30,27,69.5,43,64.9,70,66.7,2,0,1
1/01/2018 10:35,33,68.9,49,64.2,82,66.1,2,0,1
1/01/2018 10:40,31,69.3,48,64.7,79,66.5,2,0,1
1/01/2018 10:45,30,69.4,46,64.8,76,66.6,2,0,1
1/01/2018 10:50,31,69.4,47,64.8,78,66.7,2,0,1
1/01/2018 10:55,31,69.2,48,64.5,79,66.4,2,0,1
1/01/2018 11:00,28,69.2,44,64.6,72,66.4,2,0,1
1/01/2018 11:05,34,69.3,50,64.7,84,66.6,2,0,1
1/01/2018 11:10,29,69.6,46,65,75,66.8,2,0,1
1/01/2018 11:15,29,69.5,45,64.9,74,66.7,2,0,1
1/01/2018 11:20,31,69.6,48,65,79,66.8,2,0,1
1/01/2018 11:25,37,69.6,54,65,91,66.9,2,0,1
1/01/2018 11:30,32,69.7,49,65.1,81,66.9,2,0,1
1/01/2018 11:35,35,69.2,52,64.6,87,66.5,2,0,1
1/01/2018 11:40,37,69.1,54,64.4,91,66.3,2,0,1
1/01/2018 11:45,38,69.7,55,65.1,93,67,2,0,1
1/01/2018 11:50,34,69.3,51,64.6,85,66.5,2,0,1
1/01/2018 11:55,40,69,57,64.3,97,66.2,2,0,1
1/01/2018 12:00,36,69.1,52,64.4,88,66.3,2,0,1
1/01/2018 12:05,39,69,56,64.3,95,66.2,2,0,1
1/01/2018 12:10,38,69.2,54,64.6,92,66.5,2,0,1
1/01/2018 12:15,38,68.9,53,64.3,91,66.2,2,0,1
1/01/2018 12:20,39,69,56,64.3,95,66.2,2,0,1
1/01/2018 12:25,40,69.4,57,64.8,97,66.7,2,0,1
1/01/2018 12:30,32,69.4,48,64.8,80,66.6,2,0,1
1/01/2018 12:35,35,69.2,52,64.6,87,66.4,2,0,1
1/01/2018 12:40,35,69,52,64.4,87,66.3,2,0,1
1/01/2018 12:45,38,69.3,54,64.7,92,66.6,2,0,1
1/01/2018 12:50,40,69.9,57,65.3,97,67.2,2,0,1
1/01/2018 12:55,40,69.3,57,64.7,97,66.5,2,0,1
1/01/2018 13:00,37,69.5,53,65,90,66.8,2,0,1
1/01/2018 13:05,39,68.6,56,63.9,95,65.8,2,0,1
1/01/2018 13:10,29,69.2,45,64.6,74,66.4,2,0,1
1/01/2018 13:15,45,69,61,64.4,106,66.3,2,0,1
1/01/2018 13:20,43,69.2,58,64.5,101,66.5,2,0,1
1/01/2018 13:25,39,69.3,56,64.7,95,66.6,2,0,1
1/01/2018 13:30,34,69,50,64.3,84,66.2,2,0,1
1/01/2018 13:35,41,69.2,58,64.5,99,66.4,2,0,1
1/01/2018 13:40,35,69.2,51,64.6,86,66.4,2,0,1
1/01/2018 13:45,39,69.5,55,64.9,94,66.8,2,0,1
1/01/2018 13:50,40,69.1,56,64.5,96,66.4,2,0,1
1/01/2018 13:55,35,69.1,51,64.5,86,66.4,2,0,1
1/01/2018 14:00,36,69.2,52,64.6,88,66.5,2,0,1
1/01/2018 14:05,30,69.6,46,65,76,66.8,2,0,1
1/01/2018 14:10,39,69.7,56,65.1,95,67,2,0,1
1/01/2018 14:15,44,69.6,61,65.1,105,67,2,0,1
1/01/2018 14:20,42,69.5,58,64.9,100,66.8,2,0,1
1/01/2018 14:25,37,69.4,53,64.8,90,66.7,2,0,1
1/01/2018 14:30,39,69.2,55,64.7,94,66.6,2,0,1
1/01/2018 14:35,37,69.5,54,65,91,66.8,2,0,1
1/01/2018 14:40,39,70.1,56,65.6,95,67.4,2,0,1
1/01/2018 14:45,44,69.5,60,65,104,66.9,2,0,1
1/01/2018 14:50,40,70.1,55,65.5,95,67.4,2,0,1
1/01/2018 14:55,39,70,56,65.4,95,67.3,2,0,1
1/01/2018 15:00,45,69.4,62,64.9,107,66.8,2,0,1
1/01/2018 15:05,45,69.3,62,64.7,107,66.6,2,0,1
1/01/2018 15:10,41,69.9,58,65.3,99,67.2,2,0,1
1/01/2018 15:15,39,69.9,56,65.4,95,67.2,2,0,1
1/01/2018 15:20,44,69.7,61,65.2,105,67.1,2,0,1
1/01/2018 15:25,46,69.6,64,65,110,67,2,0,1
1/01/2018 15:30,45,69.7,61,65.2,106,67.1,2,0,1
1/01/2018 15:35,38,69.3,55,64.7,93,66.6,2,0,1
1/01/2018 15:40,39,69.5,56,64.9,95,66.7,2,0,1
1/01/2018 15:45,41,69.2,57,64.5,98,66.5,2,0,1
1/01/2018 15:50,42,69.4,59,64.8,101,66.7,2,0,1
1/01/2018 15:55,38,70.1,54,65.6,92,67.4,2,0,1
1/01/2018 16:00,38,69.8,56,65.2,94,67.1,2,0,1
1/01/2018 16:05,42,69.6,58,65,100,66.9,2,0,1
1/01/2018 16:10,34,69.7,50,65.2,84,67,2,0,1
1/01/2018 16:15,35,69.4,51,64.8,86,66.7,2,0,1
1/01/2018 16:20,40,69.1,56,64.5,96,66.4,2,0,1
1/01/2018 16:25,43,69.9,60,65.4,103,67.3,2,0,1
1/01/2018 16:30,43,69.6,58,65,101,66.9,2,0,1
1/01/2018 16:35,42,69.4,59,64.8,101,66.7,2,0,1
1/01/2018 16:40,38,69.2,54,64.6,92,66.5,2,0,1
1/01/2018 16:45,45,69.6,62,65,107,67,2,0,1
1/01/2018 16:50,37,69.2,54,64.6,91,66.5,2,0,1
1/01/2018 16:55,38,69.5,54,64.9,92,66.8,2,0,1
1/01/2018 17:00,35,70,51,65.4,86,67.3,2,0,1
1/01/2018 17:05,43,69.8,60,65.2,103,67.1,2,0,1
1/01/2018 17:10,39,69.8,55,65.2,94,67.1,2,0,1
1/01/2018 17:15,41,70.4,58,65.9,99,67.8,2,0,1
1/01/2018 17:20,34,69.6,51,65.1,85,66.9,2,0,1
1/01/2018 17:25,47,69.3,64,64.7,111,66.6,2,0,1
1/01/2018 17:30,44,69,61,64.3,105,66.3,2,0,1
1/01/2018 17:35,35,68.4,51,63.7,86,65.6,2,0,1
1/01/2018 17:40,36,68.6,52,63.9,88,65.9,2,0,1
1/01/2018 17:45,41,68.7,58,64.1,99,66,2,0,1
1/01/2018 17:50,41,69.2,57,64.6,98,66.5,2,0,1
1/01/2018 17:55,35,69.2,51,64.6,86,66.4,2,0,1
1/01/2018 18:00,39,68.5,56,63.8,95,65.7,2,0,1
1/01/2018 18:05,30,68.6,46,63.9,76,65.7,2,0,1
1/01/2018 18:10,43,68.8,60,64.1,103,66,2,0,1
1/01/2018 18:15,35,69.2,51,64.5,86,66.4,2,0,1
1/01/2018 18:20,31,69.3,48,64.7,79,66.5,2,0,1
1/01/2018 18:25,34,69.1,50,64.5,84,66.4,2,0,1
1/01/2018 18:30,39,69.8,56,65.2,95,67.1,2,0,1
1/01/2018 18:35,42,69.8,59,65.3,101,67.1,2,0,1
1/01/2018 18:40,32,70.1,48,65.6,80,67.4,2,0,1
1/01/2018 18:45,29,70,45,65.4,74,67.2,2,0,1
1/01/2018 18:50,31,69.9,48,65.3,79,67.1,2,0,1
1/01/2018 18:55,32,69.1,49,64.5,81,66.4,2,0,1
1/01/2018 19:00,33,68.9,49,64.3,82,66.2,2,0,1
1/01/2018 19:05,40,68.3,57,63.6,97,65.6,2,0,1
1/01/2018 19:10,30,68.8,48,64.1,78,65.9,2,0,1
1/01/2018 19:15,28,69.3,44,64.7,72,66.5,2,0,1
1/01/2018 19:20,32,69.2,48,64.6,80,66.4,2,0,1
1/01/2018 19:25,23,69.4,39,64.8,62,66.5,2,0,1
1/01/2018 19:30,27,69.4,42,64.8,69,66.6,2,0,1
1/01/2018 19:35,22,69.5,38,64.9,60,66.6,2,0,1
1/01/2018 19:40,27,69.4,43,64.8,70,66.6,2,0,1
1/01/2018 19:45,24,69.4,39,64.8,63,66.6,2,0,1
1/01/2018 19:50,25,69.6,41,65,66,66.8,2,0,1
1/01/2018 19:55,21,69.6,38,65,59,66.6,2,0,1
1/01/2018 20:00,26,69.4,42,64.8,68,66.6,2,0,1
1/01/2018 20:05,27,69.7,43,65.1,70,66.9,2,0,1
1/01/2018 20:10,23,69.7,39,65.2,62,66.9,2,0,1
1/01/2018 20:15,23,69.8,39,65.2,62,66.9,2,0,1
1/01/2018 20:20,26,69.4,42,64.7,68,66.5,2,0,1
1/01/2018 20:25,24,69.5,39,64.9,63,66.7,2,0,1
1/01/2018 20:30,21,69.3,36,64.7,57,66.4,2,0,1
1/01/2018 20:35,29,69.5,45,64.9,74,66.7,2,0,1
1/01/2018 20:40,22,69.5,38,64.9,60,66.6,2,0,1
1/01/2018 20:45,29,69.6,45,65,74,66.8,2,0,1
1/01/2018 20:50,27,69.8,43,65.2,70,67,2,0,1
1/01/2018 20:55,21,69.6,37,65,58,66.7,2,0,1
1/01/2018 21:00,24,69.5,40,64.9,64,66.6,2,0,1
1/01/2018 21:05,26,69.3,41,64.7,67,66.5,2,0,1
1/01/2018 21:10,23,69.5,39,64.9,62,66.6,2,0,1
1/01/2018 21:15,23,69.6,39,65,62,66.7,2,0,1
1/01/2018 21:20,21,69.3,36,64.6,57,66.3,2,0,1
1/01/2018 21:25,19,69.2,34,64.6,53,66.3,2,0,1
1/01/2018 21:30,21,69.3,36,64.7,57,66.4,2,0,1
1/01/2018 21:35,22,68.9,37,64.2,59,66,2,0,1
1/01/2018 21:40,17,69.1,33,64.5,50,66.1,2,0,1
1/01/2018 21:45,22,69.3,37,64.7,59,66.4,2,0,1
1/01/2018 21:50,22,69.3,38,64.7,60,66.4,2,0,1
1/01/2018 21:55,21,69.5,37,64.9,58,66.5,2,0,1
1/01/2018 22:00,18,69.4,34,64.7,52,66.3,2,0,1
1/01/2018 22:05,20,69.5,36,64.9,56,66.5,2,0,1
1/01/2018 22:10,21,69.6,36,65,57,66.7,2,0,1
1/01/2018 22:15,26,69.7,42,65.1,68,66.8,2,0,1
1/01/2018 22:20,21,69.6,37,65,58,66.7,2,0,1
1/01/2018 22:25,18,69.4,34,64.8,52,66.4,2,0,1
1/01/2018 22:30,18,69.3,33,64.7,51,66.3,2,0,1
1/01/2018 22:35,14,69.2,30,64.6,44,66.1,2,0,1
1/01/2018 22:40,17,69.4,32,64.8,49,66.4,2,0,1
1/01/2018 22:45,12,69.4,27,64.8,39,66.2,2,0,1
1/01/2018 22:50,17,69.4,33,64.8,50,66.4,2,0,1
1/01/2018 22:55,15,69.4,30,64.8,45,66.4,2,0,1
1/01/2018 23:00,16,69.3,32,64.7,48,66.2,2,0,1
1/01/2018 23:05,13,69.2,29,64.6,42,66,2,0,1
1/01/2018 23:10,13,69.3,28,64.7,41,66.2,2,0,1
1/01/2018 23:15,12,69.4,27,64.8,39,66.2,2,0,1
1/01/2018 23:20,15,69.5,31,64.9,46,66.4,2,0,1
1/01/2018 23:25,12,69.3,27,64.7,39,66.2,2,0,1
1/01/2018 23:30,11,69.4,26,64.8,37,66.2,2,0,1
1/01/2018 23:35,15,69.5,30,64.9,45,66.4,2,0,1
1/01/2018 23:40,15,69.3,30,64.7,45,66.3,2,0,1
1/01/2018 23:45,12,69.4,27,64.8,39,66.2,2,0,1
1/01/2018 23:50,15,69.4,30,64.8,45,66.4,2,0,1
1/01/2018 23:55,12,69.4,27,64.8,39,66.2,2,0,1
1/02/2018 0:00,9,69.3,24,64.7,33,66,2,0,0
1/02/2018 0:05,7,69.4,22,64.8,29,65.9,2,0,0
1/02/2018 0:10,8,69.4,23,64.8,31,66,2,0,0
1/02/2018 0:15,14,69.2,29,64.6,43,66.1,2,0,0
1/02/2018 0:20,8,69.3,24,64.7,32,65.9,2,0,0
1/02/2018 0:25,10,69.5,25,64.9,35,66.2,2,0,0
1/02/2018 0:30,10,69.4,25,64.8,35,66.1,2,0,0
1/02/2018 0:35,7,69.4,22,64.8,29,65.9,2,0,0
1/02/2018 0:40,6,69.4,22,64.8,28,65.8,2,0,0
1/02/2018 0:45,7,69.4,22,64.8,29,65.9,2,0,0
1/02/2018 0:50,5,69.4,21,64.8,26,65.7,2,0,0
1/02/2018 0:55,7,69.5,22,64.9,29,66,2,0,0
1/02/2018 1:00,7,69.4,23,64.8,30,65.9,2,0,0
1/02/2018 1:05,9,69.4,24,64.8,33,66.1,2,0,0
1/02/2018 1:10,8,69.3,24,64.7,32,65.9,2,0,0
1/02/2018 1:15,7,69.3,22,64.7,29,65.8,2,0,0
1/02/2018 1:20,7,69.3,23,64.7,30,65.7,2,0,0
1/02/2018 1:25,7,69.3,22,64.7,29,65.8,2,0,0
1/02/2018 1:30,5,69.3,21,64.7,26,65.6,2,0,0
1/02/2018 1:35,8,69.3,23,64.7,31,65.9,2,0,0
1/02/2018 1:40,7,69.3,22,64.7,29,65.8,2,0,0
1/02/2018 1:45,9,69.3,24,64.7,33,66,2,0,0
1/02/2018 1:50,7,69.4,22,64.8,29,65.9,2,0,0
1/02/2018 1:55,7,69.4,22,64.8,29,65.9,2,0,0
1/02/2018 2:00,15,69.3,22,64.7,37,66.6,2,0,0
1/02/2018 2:05,12,69.3,21,64.7,33,66.4,2,0,0
1/02/2018 2:10,10,69.4,20,64.8,30,66.3,2,0,0
1/02/2018 2:15,5,69.4,20,64.8,25,65.7,2,0,0
1/02/2018 2:20,7,69.5,22,64.9,29,66,2,0,0
1/02/2018 2:25,8,69.4,23,64.8,31,66,2,0,0
1/02/2018 2:30,8,69.3,23,64.7,31,65.9,2,0,0
1/02/2018 2:35,8,69.4,23,64.8,31,66,2,0,0
1/02/2018 2:40,6,69.4,22,64.8,28,65.8,2,0,0
1/02/2018 2:45,7,69.2,22,64.6,29,65.7,2,0,0
1/02/2018 2:50,10,69.1,26,64.5,36,65.8,2,0,0
1/02/2018 2:55,10,69.3,26,64.7,36,65.9,2,0,0
1/02/2018 3:00,8,69.3,23,64.7,31,65.8,2,0,0
1/02/2018 3:05,9,69,25,64.3,34,65.5,2,0,0
1/02/2018 3:10,9,69,25,64.4,34,65.6,2,0,0
1/02/2018 3:15,11,69.1,27,64.5,38,65.8,2,0,0
1/02/2018 3:20,9,69.2,24,64.6,33,65.8,2,0,0
1/02/2018 3:25,8,69.3,23,64.7,31,65.9,2,0,0
1/02/2018 3:30,15,69.4,31,64.8,46,66.3,2,0,0
1/02/2018 3:35,11,69.3,27,64.7,38,66,2,0,0
1/02/2018 3:40,15,69.4,30,64.8,45,66.3,2,0,0
1/02/2018 3:45,16,69.5,32,64.9,48,66.4,2,0,0
1/02/2018 3:50,15,69.5,31,64.9,46,66.4,2,0,0
1/02/2018 3:55,11,69.4,27,64.8,38,66.2,2,0,0
1/02/2018 4:00,15,69.3,31,64.7,46,66.2,2,0,0
1/02/2018 4:05,17,69.2,33,64.5,50,66.1,2,0,0
1/02/2018 4:10,15,69.2,31,64.6,46,66.1,2,0,0
1/02/2018 4:15,24,69.7,40,65.1,64,66.8,2,0,0
1/02/2018 4:20,20,69.6,37,65,57,66.7,2,0,0
1/02/2018 4:25,24,69.3,41,64.6,65,66.3,2,0,0
1/02/2018 4:30,23,69.4,40,64.8,63,66.5,2,0,0
1/02/2018 4:35,27,69.8,43,65.2,70,67,2,0,0
1/02/2018 4:40,32,69.4,49,64.8,81,66.6,2,0,0
1/02/2018 4:45,34,70.1,50,65.5,84,67.4,2,0,0
1/02/2018 4:50,36,69.8,54,65.3,90,67.1,2,0,0
1/02/2018 4:55,39,69.3,56,64.7,95,66.6,2,0,0
1/02/2018 5:00,36,68.1,55,63.4,91,65.3,2,0,0
1/02/2018 5:05,38,69.2,55,64.7,93,66.5,2,0,0
1/02/2018 5:10,46,69.5,66,65,112,66.8,2,0,0
1/02/2018 5:15,43,69.3,62,64.8,105,66.6,2,0,0
1/02/2018 5:20,49,68,69,63.3,118,65.3,2,0,0
1/02/2018 5:25,53,68.5,74,63.8,127,65.7,2,0,0
1/02/2018 5:30,52,67.9,72,63.1,124,65.1,2,0,0
1/02/2018 5:35,52,69.3,71,64.7,123,66.6,2,0,0
1/02/2018 5:40,58,69.8,79,65.2,137,67.2,2,0,0
1/02/2018 5:45,56,68.4,76,63.6,132,65.6,2,0,0
1/02/2018 5:50,62,68.2,82,63.4,144,65.5,2,0,0
1/02/2018 5:55,52,67.3,73,62.5,125,64.5,2,0,0
1/02/2018 6:00,61,67.6,81,62.8,142,64.9,2,0,0
1/02/2018 6:05,51,68.8,70,64.1,121,66.1,2,0,0
1/02/2018 6:10,56,68,77,63.3,133,65.2,2,0,0
1/02/2018 6:15,66,68.5,87,63.8,153,65.8,2,0,0
1/02/2018 6:20,58,67.9,79,63.1,137,65.2,2,0,0
1/02/2018 6:25,57,67.4,78,62.6,135,64.6,2,0,0
1/02/2018 6:30,62,67.3,83,62.4,145,64.5,2,0,0
1/02/2018 6:35,65,66.6,85,61.7,150,63.8,2,0,0
1/02/2018 6:40,63,67.1,84,62.3,147,64.3,2,0,0
1/02/2018 6:45,62,68.6,83,63.9,145,65.9,2,0,0
1/02/2018 6:50,70,68.6,91,64,161,66,2,0,0
1/02/2018 6:55,54,67.8,74,63.1,128,65.1,2,0,0
1/02/2018 7:00,53,67.7,73,62.9,126,64.9,2,0,0
1/02/2018 7:05,54,66.6,75,61.8,129,63.8,2,0,0
1/02/2018 7:10,57,67.4,77,62.6,134,64.6,2,0,0
1/02/2018 7:15,57,67.7,77,62.9,134,65,2,0,0
1/02/2018 7:20,63,67.9,83,63.2,146,65.2,2,0,0
1/02/2018 7:25,59,67.4,79,62.5,138,64.6,2,0,0
1/02/2018 7:30,63,68.2,84,63.4,147,65.4,2,0,0
1/02/2018 7:35,65,68.2,86,63.5,151,65.5,2,0,0
1/02/2018 7:40,65,68.8,86,64.1,151,66.1,2,0,0
1/02/2018 7:45,64,70,84,65.5,148,67.4,2,0,0
1/02/2018 7:50,68,70.6,89,66.1,157,68,2,0,0
1/02/2018 7:55,66,69.9,87,65.3,153,67.3,2,0,0
1/02/2018 8:00,65,69.3,86,64.7,151,66.7,2,0,0
1/02/2018 8:05,63,67.3,84,62.5,147,64.5,2,0,0
1/02/2018 8:10,65,67.5,85,62.7,150,64.8,2,0,0
1/02/2018 8:15,65,68.6,86,64,151,66,2,0,0
1/02/2018 8:20,73,68.4,93,63.8,166,65.8,2,0,0
1/02/2018 8:25,58,69.6,78,65,136,67,2,0,0
1/02/2018 8:30,64,69.4,84,64.8,148,66.8,2,0,0
1/02/2018 8:35,67,69,87,64.4,154,66.4,2,0,0
1/02/2018 8:40,60,68.3,80,63.6,140,65.6,2,0,0
1/02/2018 8:45,62,68.5,82,63.9,144,65.9,2,0,0
1/02/2018 8:50,59,69.8,79,65.3,138,67.2,2,0,0
1/02/2018 8:55,59,68.2,78,63.5,137,65.5,2,0,0
1/02/2018 9:00,46,69.2,65,64.6,111,66.5,2,0,0
1/02/2018 9:05,62,69.7,80,65.1,142,67.1,2,0,0
1/02/2018 9:10,51,69.2,69,64.6,120,66.6,2,0,0
1/02/2018 9:15,66,69.3,86,64.6,152,66.6,2,0,0
1/02/2018 9:20,49,68.4,67,63.7,116,65.7,2,0,0
1/02/2018 9:25,51,69,70,64.4,121,66.3,2,0,0
1/02/2018 9:30,55,69.4,73,64.7,128,66.7,2,0,0
1/02/2018 9:35,61,70,80,65.5,141,67.4,2,0,0
1/02/2018 9:40,55,69.8,74,65.2,129,67.2,2,0,0
1/02/2018 9:45,60,68.8,79,64.2,139,66.2,2,0,0
1/02/2018 9:50,57,69.7,76,65.2,133,67.1,2,0,0
1/02/2018 9:55,52,68.7,70,64,122,66,2,0,0
1/02/2018 10:00,59,69.7,77,65.2,136,67.1,2,0,0
1/02/2018 10:05,51,69,69,64.4,120,66.3,2,0,0
1/02/2018 10:10,65,71.2,84,66.7,149,68.7,2,0,0
1/02/2018 10:15,50,70.5,67,66,117,67.9,2,0,0
1/02/2018 10:20,51,68.8,69,64.2,120,66.1,2,0,0
1/02/2018 10:25,53,68.4,72,63.7,125,65.7,2,0,0
1/02/2018 10:30,60,69.2,78,64.5,138,66.5,2,0,0
1/02/2018 10:35,51,68.6,69,63.9,120,65.9,2,0,0
1/02/2018 10:40,46,68.4,64,63.7,110,65.7,2,0,0
1/02/2018 10:45,57,68.4,75,63.7,132,65.7,2,0,0
1/02/2018 10:50,54,69.1,73,64.5,127,66.5,2,0,0
1/02/2018 10:55,45,69.3,62,64.6,107,66.6,2,0,0
1/02/2018 11:00,50,69.4,67,64.8,117,66.8,2,0,0
1/02/2018 11:05,52,69.6,70,65.1,122,67,2,0,0
1/02/2018 11:10,46,69.2,63,64.6,109,66.6,2,0,0
1/02/2018 11:15,51,69.7,68,65.1,119,67,2,0,0
1/02/2018 11:20,48,70.3,65,65.8,113,67.7,2,0,0
1/02/2018 11:25,49,70,67,65.5,116,67.4,2,0,0
1/02/2018 11:30,49,68.6,67,63.9,116,65.9,2,0,0
1/02/2018 11:35,53,69.7,71,65.1,124,67.1,2,0,0
1/02/2018 11:40,52,71,71,66.6,123,68.4,2,0,0
1/02/2018 11:45,47,70,65,65.5,112,67.4,2,0,0
1/02/2018 11:50,54,70.4,71,65.9,125,67.9,2,0,0
1/02/2018 11:55,46,70.1,64,65.6,110,67.5,2,0,0
1/02/2018 12:00,45,69.7,63,65.1,108,67,2,0,0
1/02/2018 12:05,50,69.7,67,65.1,117,67.1,2,0,0
1/02/2018 12:10,49,68.8,67,64.2,116,66.2,2,0,0
1/02/2018 12:15,49,67.3,66,62.5,115,64.6,2,0,0
1/02/2018 12:20,56,67.3,74,62.5,130,64.6,2,0,0
1/02/2018 12:25,51,67.9,68,63.1,119,65.2,2,0,0
1/02/2018 12:30,42,68.4,59,63.8,101,65.7,2,0,0
1/02/2018 12:35,50,69.4,67,64.8,117,66.8,2,0,0
1/02/2018 12:40,45,70,63,65.4,108,67.3,2,0,0
1/02/2018 12:45,48,69.2,66,64.6,114,66.6,2,0,0
1/02/2018 12:50,45,69.8,63,65.3,108,67.2,2,0,0
1/02/2018 12:55,46,69.6,63,65,109,66.9,2,0,0
1/02/2018 13:00,40,69.4,58,64.8,98,66.7,2,0,0
1/02/2018 13:05,59,68.7,77,64,136,66,2,0,0
1/02/2018 13:10,47,68,64,63.2,111,65.2,2,0,0
1/02/2018 13:15,51,66.9,68,62.2,119,64.2,2,0,0
1/02/2018 13:20,54,68.1,73,63.4,127,65.4,2,0,0
1/02/2018 13:25,49,69.2,66,64.6,115,66.5,2,0,0
1/02/2018 13:30,44,68.9,61,64.2,105,66.2,2,0,0
1/02/2018 13:35,51,67.9,69,63.1,120,65.1,2,0,0
1/02/2018 13:40,49,68.7,66,64,115,66,2,0,0
1/02/2018 13:45,45,69.2,62,64.6,107,66.6,2,0,0
1/02/2018 13:50,47,68.7,63,64.1,110,66.1,2,0,0
1/02/2018 13:55,42,69,59,64.4,101,66.3,2,0,0
1/02/2018 14:00,42,68.5,60,63.9,102,65.8,2,0,0
1/02/2018 14:05,47,67.5,64,62.8,111,64.8,2,0,0
1/02/2018 14:10,48,67.8,65,63.1,113,65.1,2,0,0
1/02/2018 14:15,57,67.4,75,62.7,132,64.7,2,0,0
1/02/2018 14:20,47,68.7,64,64.1,111,66.1,2,0,0
1/02/2018 14:25,54,68.9,72,64.2,126,66.2,2,0,0
1/02/2018 14:30,42,69.9,60,65.4,102,67.2,2,0,0
1/02/2018 14:35,50,69.3,67,64.7,117,66.6,2,0,0
1/02/2018 14:40,46,69.5,64,64.9,110,66.8,2,0,0
1/02/2018 14:45,51,68.9,69,64.3,120,66.3,2,0,0
1/02/2018 14:50,47,69.4,64,64.8,111,66.7,2,0,0
1/02/2018 14:55,41,68.1,58,63.4,99,65.4,2,0,0
1/02/2018 15:00,55,68.4,73,63.8,128,65.8,2,0,0
1/02/2018 15:05,54,68.5,72,63.8,126,65.8,2,0,0
1/02/2018 15:10,49,68.3,67,63.6,116,65.6,2,0,0
1/02/2018 15:15,43,69,61,64.4,104,66.3,2,0,0
1/02/2018 15:20,48,68.6,65,63.9,113,65.9,2,0,0
1/02/2018 15:25,50,69.4,69,64.8,119,66.8,2,0,0
1/02/2018 15:30,52,69.5,70,65,122,66.9,2,0,0
1/02/2018 15:35,50,69.3,67,64.7,117,66.7,2,0,0
1/02/2018 15:40,56,68.3,74,63.5,130,65.6,2,0,0
1/02/2018 15:45,58,67.6,76,62.8,134,64.9,2,0,0
1/02/2018 15:50,54,68.7,72,64.1,126,66.1,2,0,0
1/02/2018 15:55,48,69.1,66,64.5,114,66.5,2,0,0
1/02/2018 16:00,47,69.4,64,64.8,111,66.8,2,0,0
1/02/2018 16:05,52,68.1,70,63.4,122,65.4,2,0,0
1/02/2018 16:10,45,69.2,62,64.6,107,66.5,2,0,0
1/02/2018 16:15,46,68.5,63,63.8,109,65.8,2,0,0
1/02/2018 16:20,43,68.9,61,64.2,104,66.2,2,0,0
1/02/2018 16:25,42,69.3,59,64.7,101,66.6,2,0,0
1/02/2018 16:30,40,68.5,56,63.8,96,65.7,2,0,0
1/02/2018 16:35,48,68.3,66,63.6,114,65.6,2,0,0
1/02/2018 16:40,52,69,70,64.3,122,66.3,2,0,0
1/02/2018 16:45,49,69.1,66,64.4,115,66.4,2,0,0
1/02/2018 16:50,44,69.6,62,65,106,66.9,2,0,0
1/02/2018 16:55,45,69.2,63,64.6,108,66.5,2,0,0
1/02/2018 17:00,51,69.8,68,65.3,119,67.2,2,0,0
1/02/2018 17:05,45,70.6,62,66.2,107,68,2,0,0
1/02/2018 17:10,46,69,65,64.4,111,66.3,2,0,0
1/02/2018 17:15,49,68.4,67,63.7,116,65.7,2,0,0
1/02/2018 17:20,54,68.7,72,64.1,126,66.1,2,0,0
1/02/2018 17:25,47,69,65,64.3,112,66.3,2,0,0
1/02/2018 17:30,42,67.9,59,63.1,101,65.1,2,0,0
1/02/2018 17:35,46,67.2,63,62.4,109,64.4,2,0,0
1/02/2018 17:40,43,67.8,60,63.1,103,65.1,2,0,0
1/02/2018 17:45,47,67.9,64,63.1,111,65.1,2,0,0
1/02/2018 17:50,39,68.9,56,64.3,95,66.2,2,0,0
1/02/2018 17:55,50,67.7,67,63,117,65,2,0,0
1/02/2018 18:00,48,67.5,66,62.8,114,64.8,2,0,0
1/02/2018 18:05,39,68.3,55,63.6,94,65.5,2,0,0
1/02/2018 18:10,47,67.6,64,62.7,111,64.8,2,0,0
1/02/2018 18:15,45,67.9,63,63.1,108,65.1,2,0,0
1/02/2018 18:20,45,68,63,63.2,108,65.2,2,0,0
1/02/2018 18:25,47,68.8,65,64.1,112,66.1,2,0,0
1/02/2018 18:30,46,69.7,63,65.1,109,67.1,2,0,0
1/02/2018 18:35,38,69.8,56,65.2,94,67.1,2,0,0
1/02/2018 18:40,47,68.3,64,63.7,111,65.6,2,0,0
1/02/2018 18:45,46,68.6,63,64,109,66,2,0,0
1/02/2018 18:50,45,68.5,63,63.8,108,65.8,2,0,0
1/02/2018 18:55,33,69.3,49,64.7,82,66.5,2,0,0
1/02/2018 19:00,36,68.9,51,64.3,87,66.2,2,0,0
1/02/2018 19:05,33,69.5,49,64.9,82,66.7,2,0,0
1/02/2018 19:10,41,67.6,58,62.8,99,64.8,2,0,0
1/02/2018 19:15,33,68.6,50,63.9,83,65.8,2,0,0
1/02/2018 19:20,32,69.5,47,64.9,79,66.8,2,0,0
1/02/2018 19:25,34,68.6,51,64,85,65.9,2,0,0
1/02/2018 19:30,29,69.2,45,64.6,74,66.4,2,0,0
1/02/2018 19:35,26,69.4,42,64.7,68,66.5,2,0,0
1/02/2018 19:40,32,69.3,48,64.7,80,66.6,2,0,0
1/02/2018 19:45,29,69.5,44,65,73,66.8,2,0,0
1/02/2018 19:50,28,69.5,45,65,73,66.7,2,0,0
1/02/2018 19:55,32,69.3,49,64.7,81,66.5,2,0,0
1/02/2018 20:00,23,69.7,39,65.1,62,66.8,2,0,0
1/02/2018 20:05,34,69.3,51,64.7,85,66.6,2,0,0
1/02/2018 20:10,25,69.4,42,64.8,67,66.5,2,0,0
1/02/2018 20:15,28,69.2,44,64.7,72,66.4,2,0,0
1/02/2018 20:20,29,68.7,45,64.1,74,65.9,2,0,0
1/02/2018 20:25,26,68.8,42,64.1,68,65.9,2,0,0
1/02/2018 20:30,21,69.3,37,64.7,58,66.3,2,0,0
1/02/2018 20:35,26,68.8,42,64.2,68,66,2,0,0
1/02/2018 20:40,26,69.2,42,64.5,68,66.3,2,0,0
1/02/2018 20:45,27,69.9,43,65.3,70,67.1,2,0,0
1/02/2018 20:50,30,69,46,64.3,76,66.2,2,0,0
1/02/2018 20:55,31,69.3,47,64.7,78,66.5,2,0,0
1/02/2018 21:00,23,69.3,39,64.7,62,66.4,2,0,0
1/02/2018 21:05,19,69.3,35,64.7,54,66.4,2,0,0
1/02/2018 21:10,20,68.9,35,64.3,55,66,2,0,0
1/02/2018 21:15,26,69.2,43,64.6,69,66.4,2,0,0
1/02/2018 21:20,19,69.2,35,64.6,54,66.2,2,0,0
1/02/2018 21:25,23,69.3,39,64.7,62,66.4,2,0,0
1/02/2018 21:30,18,69.2,34,64.6,52,66.2,2,0,0
1/02/2018 21:35,22,69.2,37,64.6,59,66.3,2,0,0
1/02/2018 21:40,21,69.3,37,64.7,58,66.4,2,0,0
1/02/2018 21:45,19,69.1,35,64.5,54,66.1,2,0,0
1/02/2018 21:50,22,69.3,38,64.7,60,66.4,2,0,0
1/02/2018 21:55,19,68.9,35,64.3,54,65.9,2,0,0
1/02/2018 22:00,20,69.1,36,64.5,56,66.2,2,0,0
1/02/2018 22:05,14,69.4,29,64.8,43,66.3,2,0,0
1/02/2018 22:10,20,69.5,35,64.9,55,66.6,2,0,0
1/02/2018 22:15,22,69.5,38,64.9,60,66.6,2,0,0
1/02/2018 22:20,19,69.4,34,64.8,53,66.5,2,0,0
1/02/2018 22:25,17,69.4,33,64.8,50,66.4,2,0,0
1/02/2018 22:30,19,69.4,35,64.8,54,66.5,2,0,0
1/02/2018 22:35,18,69,33,64.4,51,66,2,0,0
1/02/2018 22:40,18,69.1,34,64.5,52,66.1,2,0,0
1/02/2018 22:45,22,69.4,38,64.8,60,66.5,2,0,0
1/02/2018 22:50,18,69.4,33,64.8,51,66.4,2,0,0
1/02/2018 22:55,16,69.4,32,64.8,48,66.3,2,0,0
1/02/2018 23:00,13,69.2,28,64.6,41,66,2,0,0
1/02/2018 23:05,15,69.3,30,64.7,45,66.2,2,0,0
1/02/2018 23:10,14,69.4,30,64.8,44,66.3,2,0,0
1/02/2018 23:15,11,69.2,27,64.6,38,66,2,0,0
1/02/2018 23:20,16,69,32,64.3,48,65.9,2,0,0
1/02/2018 23:25,16,69.3,31,64.7,47,66.2,2,0,0
1/02/2018 23:30,13,69.3,29,64.7,42,66.2,2,0,0
1/02/2018 23:35,19,69.4,34,64.8,53,66.5,2,0,0
1/02/2018 23:40,12,69.4,27,64.8,39,66.2,2,0,0
1/02/2018 23:45,13,69.4,28,64.7,41,66.2,2,0,0
1/02/2018 23:50,14,69.1,30,64.5,44,66,2,0,0
1/02/2018 23:55,9,69.4,24,64.8,33,66,2,0,0
1/03/2018 0:00,10,69.3,25,64.7,35,66.1,2,0,0
1/03/2018 0:05,10,69.4,26,64.8,36,66.1,2,0,0
1/03/2018 0:10,11,69.2,26,64.5,37,65.9,2,0,0
1/03/2018 0:15,10,69.1,26,64.5,36,65.8,2,0,0
1/03/2018 0:20,9,69.3,24,64.6,33,65.9,2,0,0
1/03/2018 0:25,10,69.3,26,64.7,36,66,2,0,0
1/03/2018 0:30,8,69.4,24,64.8,32,65.9,2,0,0
1/03/2018 0:35,10,69.4,25,64.8,35,66.1,2,0,0
1/03/2018 0:40,10,69.5,25,64.9,35,66.2,2,0,0
1/03/2018 0:45,10,69.1,26,64.5,36,65.8,2,0,0
1/03/2018 0:50,9,69,25,64.4,34,65.7,2,0,0
1/03/2018 0:55,8,69.2,23,64.5,31,65.7,2,0,0
1/03/2018 1:00,6,69.2,21,64.6,27,65.6,2,0,0
1/03/2018 1:05,8,69.2,24,64.6,32,65.8,2,0,0
1/03/2018 1:10,9,69.2,24,64.6,33,65.8,2,0,0
1/03/2018 1:15,8,68.3,24,63.6,32,64.8,2,0,0
1/03/2018 1:20,7,68.8,22,64.2,29,65.3,2,0,0
1/03/2018 1:25,11,69,21,64.4,32,66,2,0,0
1/03/2018 1:30,9,69.2,24,64.5,33,65.8,2,0,0
1/03/2018 1:35,9,69.2,25,64.5,34,65.8,2,0,0
1/03/2018 1:40,8,69.3,24,64.7,32,65.8,2,0,0
1/03/2018 1:45,6,69.2,21,64.6,27,65.6,2,0,0
1/03/2018 1:50,6,69.3,21,64.7,27,65.7,2,0,0
1/03/2018 1:55,8,69.3,24,64.7,32,65.9,2,0,0
1/03/2018 2:00,7,69.3,22,64.7,29,65.8,2,0,0
1/03/2018 2:05,10,69.3,20,64.7,30,66.2,2,0,0
1/03/2018 2:10,6,69.1,21,64.5,27,65.5,2,0,0
1/03/2018 2:15,7,69.1,22,64.4,29,65.6,2,0,0
1/03/2018 2:20,7,69.1,23,64.5,30,65.6,2,0,0
1/03/2018 2:25,5,69.3,20,64.7,25,65.6,2,0,0
1/03/2018 2:30,7,69.3,22,64.7,29,65.8,2,0,0
1/03/2018 2:35,9,69.3,24,64.7,33,66,2,0,0
1/03/2018 2:40,8,69.3,24,64.7,32,65.8,2,0,0
1/03/2018 2:45,6,69.4,21,64.8,27,65.8,2,0,0
1/03/2018 2:50,11,69.4,26,64.8,37,66.2,2,0,0
1/03/2018 2:55,7,69.4,22,64.8,29,66,2,0,0
1/03/2018 3:00,7,69.2,22,64.6,29,65.7,2,0,0
1/03/2018 3:05,12,69,27,64.4,39,65.8,2,0,0
1/03/2018 3:10,11,69.3,27,64.7,38,66,2,0,0
1/03/2018 3:15,7,69.2,23,64.6,30,65.7,2,0,0
1/03/2018 3:20,7,69.3,23,64.7,30,65.7,2,0,0
1/03/2018 3:25,11,69.4,26,64.8,37,66.2,2,0,0
1/03/2018 3:30,15,69.4,31,64.8,46,66.3,2,0,0
1/03/2018 3:35,12,69.4,28,64.8,40,66.2,2,0,0
1/03/2018 3:40,13,69.4,28,64.8,41,66.3,2,0,0
1/03/2018 3:45,17,69.3,33,64.7,50,66.3,2,0,0
1/03/2018 3:50,16,69.4,32,64.7,48,66.3,2,0,0
1/03/2018 3:55,13,69.4,29,64.8,42,66.2,2,0,0
1/03/2018 4:00,15,69.2,30,64.6,45,66.1,2,0,0
1/03/2018 4:05,21,69.2,38,64.6,59,66.2,2,0,0
1/03/2018 4:10,18,69.3,34,64.7,52,66.3,2,0,0
1/03/2018 4:15,23,69.5,39,64.9,62,66.6,2,0,0
1/03/2018 4:20,23,69.5,40,64.9,63,66.6,2,0,0
1/03/2018 4:25,21,69.4,37,64.8,58,66.5,2,0,0
1/03/2018 4:30,24,69.5,41,64.9,65,66.6,2,0,0
1/03/2018 4:35,24,69.6,41,65,65,66.7,2,0,0
1/03/2018 4:40,33,69.6,51,65,84,66.8,2,0,0
1/03/2018 4:45,40,69.2,57,64.5,97,66.4,2,0,0
1/03/2018 4:50,35,69.3,53,64.7,88,66.5,2,0,0
1/03/2018 4:55,29,69.6,46,64.9,75,66.7,2,0,0
1/03/2018 5:00,34,69.5,51,64.9,85,66.7,2,0,0
1/03/2018 5:05,38,69.1,56,64.5,94,66.4,2,0,0
1/03/2018 5:10,41,69.4,59,64.8,100,66.7,2,0,0
1/03/2018 5:15,45,68.3,64,63.6,109,65.5,2,0,0
1/03/2018 5:20,47,68.5,66,63.9,113,65.8,2,0,0
1/03/2018 5:25,52,69,72,64.4,124,66.3,2,0,0
1/03/2018 5:30,55,69.5,76,64.9,131,66.8,2,0,0
1/03/2018 5:35,55,68.7,76,64.1,131,66,2,0,0
1/03/2018 5:40,59,68.3,80,63.7,139,65.7,2,0,0
1/03/2018 5:45,53,69.5,74,65,127,66.9,2,0,0
1/03/2018 5:50,66,69.3,88,64.6,154,66.6,2,0,0
1/03/2018 5:55,63,68.3,84,63.6,147,65.6,2,0,0
1/03/2018 6:00,48,69.5,67,64.9,115,66.8,2,0,0
1/03/2018 6:05,55,70,75,65.5,130,67.4,2,0,0
1/03/2018 6:10,65,68.7,85,64,150,66,2,0,0
1/03/2018 6:15,66,68.3,88,63.6,154,65.6,2,0,0
1/03/2018 6:20,61,67.4,82,62.6,143,64.7,2,0,0
1/03/2018 6:25,56,68.2,76,63.5,132,65.5,2,0,0
1/03/2018 6:30,63,69,84,64.4,147,66.4,2,0,0
1/03/2018 6:35,63,68.5,85,63.8,148,65.8,2,0,0
1/03/2018 6:40,63,68.4,85,63.7,148,65.7,2,0,0
1/03/2018 6:45,69,67.4,91,62.7,160,64.7,2,0,0
1/03/2018 6:50,68,68,90,63.3,158,65.4,2,0,0
1/03/2018 6:55,65,67.4,88,62.6,153,64.7,2,0,0
1/03/2018 7:00,62,68.3,83,63.6,145,65.6,2,0,0
1/03/2018 7:05,62,69,83,64.4,145,66.4,2,0,0
1/03/2018 7:10,60,68.5,81,63.8,141,65.8,2,0,0
1/03/2018 7:15,63,68.6,84,63.9,147,65.9,2,0,0
1/03/2018 7:20,68,69.8,89,65.2,157,67.2,2,0,0
1/03/2018 7:25,66,68.2,88,63.5,154,65.5,2,0,0
1/03/2018 7:30,72,68.9,94,64.3,166,66.3,2,0,0
1/03/2018 7:35,74,70,95,65.5,169,67.5,2,0,0
1/03/2018 7:40,68,69.5,90,65,158,66.9,2,0,0
1/03/2018 7:45,75,69.7,97,65.1,172,67.1,2,0,0
1/03/2018 7:50,75,69.1,98,64.5,173,66.5,2,0,0
1/03/2018 7:55,79,69.5,101,64.9,180,66.9,2,0,0
1/03/2018 8:00,76,70.5,98,66,174,68,2,0,0
1/03/2018 8:05,76,70.9,97,66.4,173,68.4,2,0,0
1/03/2018 8:10,70,69.5,91,65,161,66.9,2,0,0
1/03/2018 8:15,72,70.6,94,66.1,166,68.1,2,0,0
1/03/2018 8:20,77,69.2,100,64.6,177,66.6,2,0,0
1/03/2018 8:25,74,70,96,65.4,170,67.4,2,0,0
1/03/2018 8:30,76,69.1,97,64.4,173,66.4,2,0,0
1/03/2018 8:35,74,70.2,95,65.6,169,67.6,2,0,0
1/03/2018 8:40,78,70,98,65.5,176,67.5,2,0,0
1/03/2018 8:45,77,69.9,99,65.3,176,67.3,2,0,0
1/03/2018 8:50,67,69.7,87,65.2,154,67.2,2,0,0
1/03/2018 8:55,68,69.5,89,65,157,67,2,0,0
1/03/2018 9:00,61,70.2,80,65.7,141,67.6,2,0,0
1/03/2018 9:05,60,70.1,79,65.5,139,67.5,2,0,0
1/03/2018 9:10,63,69.3,83,64.7,146,66.7,2,0,0
1/03/2018 9:15,58,68.8,77,64.1,135,66.1,2,0,0
1/03/2018 9:20,54,68.9,73,64.1,127,66.2,2,0,0
1/03/2018 9:25,64,68.3,83,63.6,147,65.7,2,0,0
1/03/2018 9:30,63,67.8,84,63.1,147,65.1,2,0,0
1/03/2018 9:35,57,68.9,77,64.3,134,66.3,2,0,0
1/03/2018 9:40,57,69.5,77,64.9,134,66.9,2,0,0
1/03/2018 9:45,64,67.7,84,63,148,65,2,0,0
1/03/2018 9:50,63,69.8,83,65.3,146,67.2,2,0,0
1/03/2018 9:55,61,69.7,80,65.2,141,67.1,2,0,0
1/03/2018 10:00,64,69.5,82,64.9,146,66.9,2,0,0
1/03/2018 10:05,53,68.8,70,64.1,123,66.1,2,0,0
1/03/2018 10:10,54,69.1,73,64.5,127,66.4,2,0,0
1/03/2018 10:15,61,68.7,81,64.1,142,66.1,2,0,0
1/03/2018 10:20,54,67.5,72,62.8,126,64.8,2,0,0
1/03/2018 10:25,56,67.3,74,62.6,130,64.6,2,0,0
1/03/2018 10:30,51,67.3,69,62.7,120,64.6,2,0,0
1/03/2018 10:35,48,67.2,66,62.5,114,64.5,2,0,0
1/03/2018 10:40,58,67.5,77,62.7,135,64.8,2,0,0
1/03/2018 10:45,62,67.3,81,62.6,143,64.6,2,0,0
1/03/2018 10:50,62,66.1,81,61.3,143,63.4,2,0,0
1/03/2018 10:55,51,65.5,69,60.6,120,62.7,2,0,0
1/03/2018 11:00,57,66,75,61.1,132,63.2,2,0,0
1/03/2018 11:05,51,67.2,69,62.4,120,64.4,2,0,0
1/03/2018 11:10,50,67.5,68,62.8,118,64.8,2,0,0
1/03/2018 11:15,51,67.4,69,62.5,120,64.6,2,0,0
1/03/2018 11:20,49,64.6,67,59.5,116,61.7,2,0,0
1/03/2018 11:25,48,66.6,65,61.7,113,63.8,2,0,0
1/03/2018 11:30,50,66.3,67,61.4,117,63.5,2,0,0
1/03/2018 11:35,55,66.1,73,61.3,128,63.4,2,0,0
1/03/2018 11:40,52,65.7,71,60.7,123,62.8,2,0,0
1/03/2018 11:45,50,65.8,68,60.8,118,62.9,2,0,0
1/03/2018 11:50,61,66.2,80,61.3,141,63.4,2,0,0
1/03/2018 11:55,50,64.8,68,59.8,118,61.9,2,0,0
1/03/2018 12:00,49,65.1,67,60.1,116,62.2,2,0,0
1/03/2018 12:05,49,65.8,66,60.9,115,63,2,0,0
1/03/2018 12:10,42,66.1,59,61.2,101,63.2,2,0,0
1/03/2018 12:15,51,66.2,69,61.3,120,63.4,2,0,0
1/03/2018 12:20,51,66.2,68,61.3,119,63.4,2,0,0
1/03/2018 12:25,50,66.9,67,62.1,117,64.2,2,0,0
1/03/2018 12:30,48,67.1,66,62.3,114,64.3,2,0,0
1/03/2018 12:35,54,66.3,72,61.3,126,63.5,2,0,0
1/03/2018 12:40,45,66.2,63,61.3,108,63.3,2,0,0
1/03/2018 12:45,46,65.6,64,60.6,110,62.7,2,0,0
1/03/2018 12:50,50,64.8,68,59.8,118,61.9,2,0,0
1/03/2018 12:55,53,65.5,71,60.6,124,62.7,2,0,0
1/03/2018 13:00,42,66.2,60,61.3,102,63.3,2,0,0
1/03/2018 13:05,42,65.8,60,60.9,102,62.9,2,0,0
1/03/2018 13:10,60,66.2,79,61.3,139,63.4,2,0,0
1/03/2018 13:15,40,65.8,57,60.9,97,62.9,2,0,0
1/03/2018 13:20,48,66.2,65,61.3,113,63.4,2,0,0
1/03/2018 13:25,44,67.3,62,62.6,106,64.6,2,0,0
1/03/2018 13:30,35,66.8,51,62,86,63.9,2,0,0
1/03/2018 13:35,50,66.9,67,62.1,117,64.1,2,0,0
1/03/2018 13:40,49,66.4,67,61.6,116,63.6,2,0,0
1/03/2018 13:45,44,66.8,61,62,105,64,2,0,0
1/03/2018 13:50,47,67.3,63,62.5,110,64.5,2,0,0
1/03/2018 13:55,41,66.3,58,61.4,99,63.4,2,0,0
1/03/2018 14:00,44,67.8,60,63.1,104,65.1,2,0,0
1/03/2018 14:05,44,66.9,61,62,105,64.1,2,0,0
1/03/2018 14:10,40,66.4,57,61.5,97,63.5,2,0,0
1/03/2018 14:15,35,67.6,51,62.8,86,64.8,2,0,0
1/03/2018 14:20,40,66.9,57,62,97,64,2,0,0
1/03/2018 14:25,34,66.3,51,61.4,85,63.4,2,0,0
1/03/2018 14:30,33,65.8,50,60.8,83,62.8,2,0,0
1/03/2018 14:35,37,66.9,53,62.1,90,64.1,2,0,0
1/03/2018 14:40,39,65.6,56,60.7,95,62.7,2,0,0
1/03/2018 14:45,39,67.2,56,62.4,95,64.4,2,0,0
1/03/2018 14:50,37,66.8,54,61.9,91,63.9,2,0,0
1/03/2018 14:55,39,67.3,56,62.5,95,64.5,2,0,0
1/03/2018 15:00,38,67.2,55,62.4,93,64.4,2,0,0
1/03/2018 15:05,39,66.9,57,62.1,96,64,2,0,0
1/03/2018 15:10,48,66.9,66,62,114,64,2,0,0
1/03/2018 15:15,51,67.1,69,62.3,120,64.3,2,0,0
1/03/2018 15:20,44,66.9,62,62.1,106,64.1,2,0,0
1/03/2018 15:25,45,67.8,62,63,107,65.1,2,0,0
1/03/2018 15:30,39,68.1,56,63.4,95,65.3,2,0,0
1/03/2018 15:35,50,67.9,68,63.2,118,65.2,2,0,0
1/03/2018 15:40,47,68.6,65,63.9,112,65.8,2,0,0
1/03/2018 15:45,40,69.2,56,64.5,96,66.5,2,0,0
1/03/2018 15:50,44,69.1,61,64.4,105,66.4,2,0,0
1/03/2018 15:55,50,67,68,62.1,118,64.2,2,0,0
1/03/2018 16:00,49,67.7,67,63,116,65,2,0,0
1/03/2018 16:05,50,68.4,69,63.7,119,65.6,2,0,0
1/03/2018 16:10,64,67.8,84,63,148,65.1,2,0,0
1/03/2018 16:15,56,67.7,75,62.8,131,64.9,2,0,0
1/03/2018 16:20,59,67.9,79,63.1,138,65.1,2,0,0
1/03/2018 16:25,46,68.4,64,63.6,110,65.6,2,0,0
1/03/2018 16:30,46,67.5,62,62.7,108,64.8,2,0,0
1/03/2018 16:35,49,67.4,66,62.5,115,64.5,2,0,0
1/03/2018 16:40,53,67.2,71,62.3,124,64.4,2,0,0
1/03/2018 16:45,38,68.2,55,63.5,93,65.4,2,0,0
1/03/2018 16:50,48,67.8,66,63.1,114,65.1,2,0,0
1/03/2018 16:55,43,68,60,63.3,103,65.3,2,0,0
1/03/2018 17:00,39,68.5,56,63.8,95,65.7,2,0,0
1/03/2018 17:05,46,69.7,62,65.2,108,67.1,2,0,0
1/03/2018 17:10,46,67.4,64,62.6,110,64.6,2,0,0
1/03/2018 17:15,48,67,66,62.2,114,64.2,2,0,0
1/03/2018 17:20,44,67.8,62,63.1,106,65,2,0,0
1/03/2018 17:25,44,67.3,63,62.5,107,64.5,2,0,0
1/03/2018 17:30,44,67.4,62,62.6,106,64.6,2,0,0
1/03/2018 17:35,46,66.8,63,62,109,64,2,0,0
1/03/2018 17:40,55,66.5,74,61.6,129,63.7,2,0,0
1/03/2018 17:45,43,67.5,60,62.7,103,64.7,2,0,0
1/03/2018 17:50,46,68.8,63,64.1,109,66.1,2,0,0
1/03/2018 17:55,46,68.6,63,64,109,65.9,2,0,0
1/03/2018 18:00,47,68.2,64,63.5,111,65.5,2,0,0
1/03/2018 18:05,47,68.3,64,63.6,111,65.6,2,0,0
1/03/2018 18:10,48,68.4,65,63.7,113,65.7,2,0,0
1/03/2018 18:15,49,68,67,63.3,116,65.3,2,0,0
1/03/2018 18:20,47,68.2,64,63.4,111,65.5,2,0,0
1/03/2018 18:25,47,68.9,65,64.2,112,66.2,2,0,0
1/03/2018 18:30,50,68.2,68,63.4,118,65.4,2,0,0
1/03/2018 18:35,43,67.8,61,63.1,104,65,2,0,0
1/03/2018 18:40,43,67.4,60,62.5,103,64.5,2,0,0
1/03/2018 18:45,35,67.4,51,62.6,86,64.6,2,0,0
1/03/2018 18:50,39,67.3,55,62.5,94,64.5,2,0,0
1/03/2018 18:55,33,66.4,50,61.5,83,63.4,2,0,0
1/03/2018 19:00,32,67.2,49,62.4,81,64.3,2,0,0
1/03/2018 19:05,37,66.8,53,62,90,64,2,0,0
1/03/2018 19:10,35,66.9,51,62.1,86,64.1,2,0,0
1/03/2018 19:15,34,67.3,50,62.5,84,64.4,2,0,0
1/03/2018 19:20,36,67.6,52,62.8,88,64.8,2,0,0
1/03/2018 19:25,34,66.1,51,61.3,85,63.2,2,0,0
1/03/2018 19:30,39,66.1,55,61.3,94,63.3,2,0,0
1/03/2018 19:35,39,66.8,55,62,94,64,2,0,0
1/03/2018 19:40,32,67.4,48,62.7,80,64.6,2,0,0
1/03/2018 19:45,29,68.1,45,63.4,74,65.3,2,0,0
1/03/2018 19:50,30,69,46,64.4,76,66.2,2,0,0
1/03/2018 19:55,26,68.8,42,64.1,68,65.9,2,0,0
1/03/2018 20:00,33,67.6,49,62.9,82,64.8,2,0,0
1/03/2018 20:05,24,68.3,39,63.6,63,65.4,2,0,0
1/03/2018 20:10,28,67.4,45,62.7,73,64.5,2,0,0
1/03/2018 20:15,25,67.9,41,63.2,66,65,2,0,0
1/03/2018 20:20,27,67.4,43,62.6,70,64.4,2,0,0
1/03/2018 20:25,32,66.7,48,61.9,80,63.8,2,0,0
1/03/2018 20:30,28,66.5,44,61.7,72,63.6,2,0,0
1/03/2018 20:35,32,66,48,61.1,80,63,2,0,0
1/03/2018 20:40,30,66.4,47,61.6,77,63.5,2,0,0
1/03/2018 20:45,28,66.7,44,61.9,72,63.8,2,0,0
1/03/2018 20:50,26,66.7,41,61.9,67,63.7,2,0,0
1/03/2018 20:55,23,65.6,39,60.7,62,62.5,2,0,0
1/03/2018 21:00,24,66.1,40,61.3,64,63.1,2,0,0
1/03/2018 21:05,28,65.3,44,60.5,72,62.4,2,0,0
1/03/2018 21:10,24,64.8,39,59.9,63,61.8,2,0,0
1/03/2018 21:15,26,64.8,43,59.8,69,61.7,2,0,0
1/03/2018 21:20,27,65.1,43,60.2,70,62.1,2,0,0
1/03/2018 21:25,23,66.2,39,61.4,62,63.2,2,0,0
1/03/2018 21:30,19,67,35,62.2,54,63.9,2,0,0
1/03/2018 21:35,24,66.7,39,62,63,63.8,2,0,0
1/03/2018 21:40,19,67.3,35,62.6,54,64.3,2,0,0
1/03/2018 21:45,20,67.5,35,62.8,55,64.5,2,0,0
1/03/2018 21:50,22,67.8,38,63.1,60,64.8,2,0,0
1/03/2018 21:55,22,67.2,38,62.5,60,64.2,2,0,0
1/03/2018 22:00,23,67.7,39,63,62,64.8,2,0,0
1/03/2018 22:05,19,67.9,35,63.2,54,64.8,2,0,0
1/03/2018 22:10,22,68.2,37,63.6,59,65.3,2,0,0
1/03/2018 22:15,16,68.4,31,63.7,47,65.3,2,0,0
1/03/2018 22:20,21,64.6,37,59.5,58,61.4,2,0,0
1/03/2018 22:25,14,66.8,30,62,44,63.5,2,0,0
1/03/2018 22:30,18,67.9,34,63.2,52,64.8,2,0,0
1/03/2018 22:35,13,68.6,29,63.9,42,65.3,2,0,0
1/03/2018 22:40,16,68.7,32,64.1,48,65.6,2,0,0
1/03/2018 22:45,21,69.1,36,64.5,57,66.2,2,0,0
1/03/2018 22:50,15,69.2,30,64.6,45,66.1,2,0,0
1/03/2018 22:55,13,69.1,29,64.5,42,65.9,2,0,0
1/03/2018 23:00,9,69.2,25,64.6,34,65.8,2,0,0
1/03/2018 23:05,13,69.3,28,64.7,41,66.1,2,0,0
1/03/2018 23:10,12,69.2,27,64.5,39,66,2,0,0
1/03/2018 23:15,16,68.9,31,64.3,47,65.9,2,0,0
1/03/2018 23:20,11,69.2,26,64.5,37,65.9,2,0,0
1/03/2018 23:25,14,68.9,29,64.3,43,65.8,2,0,0
1/03/2018 23:30,13,68.7,29,64.1,42,65.5,2,0,0
1/03/2018 23:35,13,69,29,64.4,42,65.8,2,0,0
1/03/2018 23:40,11,69.1,27,64.5,38,65.8,2,0,0
1/03/2018 23:45,11,69.3,27,64.7,38,66,2,0,0
1/03/2018 23:50,9,69.3,25,64.7,34,65.9,2,0,0
1/03/2018 23:55,7,69.3,23,64.7,30,65.8,2,0,0
1/04/2018 0:00,11,69.3,26,64.7,37,66.1,2,0,0
1/04/2018 0:05,8,69.3,23,64.7,31,65.9,2,0,0
1/04/2018 0:10,10,69,26,64.3,36,65.6,2,0,0
1/04/2018 0:15,14,68.9,29,64.3,43,65.8,2,0,0
1/04/2018 0:20,11,69.1,26,64.4,37,65.8,2,0,0
1/04/2018 0:25,10,69.1,25,64.5,35,65.8,2,0,0
1/04/2018 0:30,10,69,25,64.4,35,65.7,2,0,0
1/04/2018 0:35,9,69.2,25,64.5,34,65.8,2,0,0
1/04/2018 0:40,8,69.2,23,64.6,31,65.8,2,0,0
1/04/2018 0:45,7,69.3,22,64.7,29,65.8,2,0,0
1/04/2018 0:50,10,69.3,25,64.7,35,66.1,2,0,0
1/04/2018 0:55,6,69.8,21,65.3,27,66.3,2,0,0
1/04/2018 1:00,7,69.6,22,65.1,29,66.2,2,0,0
1/04/2018 1:05,10,69.4,25,64.8,35,66.2,2,0,0
1/04/2018 1:10,7,69.3,22,64.7,29,65.8,2,0,0
1/04/2018 1:15,7,69.1,23,64.5,30,65.6,2,0,0
1/04/2018 1:20,9,69.1,24,64.5,33,65.8,2,0,0
1/04/2018 1:25,8,69.2,24,64.6,32,65.8,2,0,0
1/04/2018 1:30,7,69,22,64.4,29,65.5,2,0,0
1/04/2018 1:35,10,69.1,25,64.5,35,65.8,2,0,0
1/04/2018 1:40,6,69.1,22,64.5,28,65.5,2,0,0
1/04/2018 1:45,8,69.1,23,64.5,31,65.7,2,0,0
1/04/2018 1:50,8,69.2,23,64.6,31,65.8,2,0,0
1/04/2018 1:55,9,69.2,19,64.6,28,66.1,2,0,0
1/04/2018 2:00,10,69.3,20,64.7,30,66.2,2,0,0
1/04/2018 2:05,6,69.2,21,64.6,27,65.6,2,0,0
1/04/2018 2:10,8,69.3,23,64.7,31,65.9,2,0,0
1/04/2018 2:15,7,69.4,22,64.8,29,65.9,2,0,0
1/04/2018 2:20,7,69.4,23,64.8,30,65.9,2,0,0
1/04/2018 2:25,16,69.4,23,64.8,39,66.7,2,0,0
1/04/2018 2:30,6,69.5,22,64.9,28,65.9,2,0,0
1/04/2018 2:35,8,69.3,23,64.7,31,65.9,2,0,0
1/04/2018 2:40,8,69.3,23,64.7,31,65.9,2,0,0
1/04/2018 2:45,16,69.4,23,64.8,39,66.7,2,0,0
1/04/2018 2:50,10,69.2,25,64.5,35,65.9,2,0,0
1/04/2018 2:55,8,68.8,23,64.2,31,65.4,2,0,0
1/04/2018 3:00,8,69.1,24,64.5,32,65.6,2,0,0
1/04/2018 3:05,8,69.3,23,64.7,31,65.8,2,0,0
1/04/2018 3:10,8,69.2,24,64.6,32,65.7,2,0,0
1/04/2018 3:15,10,69.3,25,64.7,35,66.1,2,0,0
1/04/2018 3:20,12,69.3,27,64.7,39,66.1,2,0,0
1/04/2018 3:25,10,69.3,25,64.7,35,66,2,0,0
1/04/2018 3:30,10,69,26,64.4,36,65.7,2,0,0
1/04/2018 3:35,11,69.2,27,64.5,38,65.9,2,0,0
1/04/2018 3:40,13,69.4,28,64.8,41,66.2,2,0,0
1/04/2018 3:45,13,69.5,28,64.9,41,66.4,2,0,0
1/04/2018 3:50,17,69.5,33,64.9,50,66.5,2,0,0
1/04/2018 3:55,17,69.4,33,64.7,50,66.3,2,0,0
1/04/2018 4:00,15,69.3,31,64.7,46,66.2,2,0,0
1/04/2018 4:05,21,69.3,36,64.7,57,66.4,2,0,0
1/04/2018 4:10,12,69.2,28,64.6,40,66,2,0,0
1/04/2018 4:15,16,68.9,32,64.2,48,65.8,2,0,0
1/04/2018 4:20,25,69.4,42,64.8,67,66.5,2,0,0
1/04/2018 4:25,20,69.4,36,64.8,56,66.5,2,0,0
1/04/2018 4:30,23,69.5,40,64.9,63,66.6,2,0,0
1/04/2018 4:35,28,69.1,45,64.5,73,66.3,2,0,0
1/04/2018 4:40,28,69.2,45,64.6,73,66.4,2,0,0
1/04/2018 4:45,38,68.6,55,63.9,93,65.8,2,0,0
1/04/2018 4:50,25,69.2,41,64.6,66,66.3,2,0,0
1/04/2018 4:55,36,68.8,54,64.1,90,66,2,0,0
1/04/2018 5:00,29,69,46,64.3,75,66.1,2,0,0
1/04/2018 5:05,37,68.2,55,63.6,92,65.4,2,0,0
1/04/2018 5:10,40,68.7,59,64,99,65.9,2,0,0
1/04/2018 5:15,46,69,65,64.3,111,66.2,2,0,0
1/04/2018 5:20,48,68,68,63.2,116,65.2,2,0,0
1/04/2018 5:25,44,66.9,64,62,108,64,2,0,0
1/04/2018 5:30,46,67,66,62.1,112,64.1,2,0,0
1/04/2018 5:35,55,65.2,75,60.1,130,62.2,2,0,0
1/04/2018 5:40,52,65.6,72,60.6,124,62.7,2,0,0
1/04/2018 5:45,55,65.5,74,60.4,129,62.6,2,0,0
1/04/2018 5:50,59,66.7,80,61.7,139,63.8,2,0,0
1/04/2018 5:55,61,66.8,81,61.8,142,63.9,2,0,0
1/04/2018 6:00,46,67.1,65,62.2,111,64.2,2,0,0
1/04/2018 6:05,50,66.9,69,62,119,64,2,0,0
1/04/2018 6:10,47,68,67,63.3,114,65.2,2,0,0
1/04/2018 6:15,50,67.1,70,62.1,120,64.2,2,0,0
1/04/2018 6:20,51,67.5,72,62.6,123,64.7,2,0,0
1/04/2018 6:25,39,68.3,58,63.6,97,65.5,2,0,0
1/04/2018 6:30,59,67.3,80,62.5,139,64.5,2,0,0
1/04/2018 6:35,55,67.1,76,62.2,131,64.3,2,0,0
1/04/2018 6:40,59,66.1,80,61.1,139,63.2,2,0,0
1/04/2018 6:45,69,66.2,92,61.2,161,63.3,2,0,0
1/04/2018 6:50,60,67,81,62.2,141,64.2,2,0,0
1/04/2018 6:55,62,66.3,82,61.4,144,63.5,2,0,0
1/04/2018 7:00,60,65.9,81,60.9,141,63,2,0,0
1/04/2018 7:05,68,66.7,88,61.8,156,63.9,2,0,0
1/04/2018 7:10,67,67,88,62.1,155,64.2,2,0,0
1/04/2018 7:15,62,67.5,83,62.6,145,64.7,2,0,0
1/04/2018 7:20,69,66,90,61,159,63.2,2,0,0
1/04/2018 7:25,60,67.2,80,62.3,140,64.4,2,0,0
1/04/2018 7:30,67,67.6,88,62.7,155,64.8,2,0,0
1/04/2018 7:35,79,67.6,101,62.7,180,64.8,2,0,0
1/04/2018 7:40,75,66.8,97,61.8,172,64,2,0,0
1/04/2018 7:45,78,67.2,100,62.3,178,64.4,2,0,0
1/04/2018 7:50,67,67.5,88,62.6,155,64.7,2,0,0
1/04/2018 7:55,74,67.6,95,62.7,169,64.9,2,0,0
1/04/2018 8:00,60,67.9,78,63,138,65.1,2,0,0
1/04/2018 8:05,63,66.8,83,61.8,146,63.9,2,0,0
1/04/2018 8:10,58,67.2,78,62.2,136,64.4,2,0,0
1/04/2018 8:15,77,67.1,99,62.2,176,64.3,2,0,0
1/04/2018 8:20,80,67.9,102,63.1,182,65.2,2,0,0
1/04/2018 8:25,72,68.9,94,64.1,166,66.2,2,0,0
1/04/2018 8:30,69,67.7,91,62.8,160,64.9,2,0,0
1/04/2018 8:35,80,67.8,102,63,182,65.1,2,0,0
1/04/2018 8:40,82,67.5,104,62.6,186,64.7,2,0,0
1/04/2018 8:45,86,67.2,109,62.3,195,64.5,2,0,0
1/04/2018 8:50,84,66.6,106,61.6,190,63.8,2,0,0
1/04/2018 8:55,71,67.2,93,62.2,164,64.4,2,0,0
1/04/2018 9:00,67,67.2,87,62.2,154,64.4,2,0,0
1/04/2018 9:05,72,68,92,63.1,164,65.2,2,0,0
1/04/2018 9:10,60,67.1,80,62.3,140,64.4,2,0,0
1/04/2018 9:15,59,68.4,78,63.6,137,65.7,2,0,0
1/04/2018 9:20,66,69.1,86,64.4,152,66.5,2,0,0
1/04/2018 9:25,65,66.4,85,61.5,150,63.6,2,0,0
1/04/2018 9:30,63,67.2,83,62.4,146,64.5,2,0,0
1/04/2018 9:35,63,67.8,82,62.9,145,65,2,0,0
1/04/2018 9:40,63,67.4,83,62.5,146,64.6,2,0,0
1/04/2018 9:45,70,67.7,90,62.8,160,64.9,2,0,0
1/04/2018 9:50,65,67,84,62.1,149,64.2,2,0,0
1/04/2018 9:55,61,67,81,62.1,142,64.2,2,0,0
1/04/2018 10:00,55,67.8,73,63,128,65.1,2,0,0
1/04/2018 10:05,59,68.6,78,63.9,137,65.9,2,0,0
1/04/2018 10:10,54,67,74,62.3,128,64.3,2,0,0
1/04/2018 10:15,58,67.6,76,62.9,134,64.9,2,0,0
1/04/2018 10:20,57,68.6,76,63.9,133,65.9,2,0,0
1/04/2018 10:25,50,67.7,68,63,118,65,2,0,0
1/04/2018 10:30,46,67.7,63,63,109,65,2,0,0
1/04/2018 10:35,48,67.4,66,62.6,114,64.7,2,0,0
1/04/2018 10:40,50,66.3,68,61.5,118,63.5,2,0,0
1/04/2018 10:45,54,66.9,72,62.1,126,64.2,2,0,0
1/04/2018 10:50,57,67.2,75,62.4,132,64.5,2,0,0
1/04/2018 10:55,59,66,77,61.2,136,63.3,2,0,0
1/04/2018 11:00,53,66.2,69,61.3,122,63.4,2,0,0
1/04/2018 11:05,51,65.9,68,61,119,63.1,2,0,0
1/04/2018 11:10,51,67.1,69,62.3,120,64.3,2,0,0
1/04/2018 11:15,49,67,67,62.3,116,64.3,2,0,0
1/04/2018 11:20,54,68.1,72,63.5,126,65.4,2,0,0
1/04/2018 11:25,52,67.5,69,62.9,121,64.9,2,0,0
1/04/2018 11:30,52,67.1,70,62.5,122,64.5,2,0,0
1/04/2018 11:35,48,66.7,66,62,114,64,2,0,0
1/04/2018 11:40,48,67.7,66,63,114,65,2,0,0
1/04/2018 11:45,58,68.5,76,63.8,134,65.8,2,0,0
1/04/2018 11:50,58,69.1,76,64.5,134,66.5,2,0,0
1/04/2018 11:55,45,69.7,63,65.2,108,67.1,2,0,0
1/04/2018 12:00,58,68,76,63.2,134,65.3,2,0,0
1/04/2018 12:05,56,67.8,74,63.1,130,65.1,2,0,0
1/04/2018 12:10,48,67.4,65,62.6,113,64.7,2,0,0
1/04/2018 12:15,54,68.6,71,63.9,125,66,2,0,0
1/04/2018 12:20,50,67.4,67,62.6,117,64.6,2,0,0
1/04/2018 12:25,43,68.8,60,64.2,103,66.1,2,0,0
1/04/2018 12:30,44,69.4,62,64.8,106,66.7,2,0,0
1/04/2018 12:35,52,69.4,70,64.7,122,66.7,2,0,0
1/04/2018 12:40,58,68.5,77,63.8,135,65.8,2,0,0
1/04/2018 12:45,40,68,57,63.3,97,65.2,2,0,0
1/04/2018 12:50,48,66.8,66,62.1,114,64.1,2,0,0
1/04/2018 12:55,49,67.8,66,63.1,115,65.1,2,0,0
1/04/2018 13:00,47,68.4,64,63.8,111,65.8,2,0,0
1/04/2018 13:05,48,69.1,65,64.5,113,66.5,2,0,0
1/04/2018 13:10,50,68.9,68,64.2,118,66.2,2,0,0
1/04/2018 13:15,47,69.2,64,64.6,111,66.5,2,0,0
1/04/2018 13:20,58,68.7,77,64,135,66,2,0,0
1/04/2018 13:25,51,68.4,69,63.6,120,65.7,2,0,0
1/04/2018 13:30,50,69.2,67,64.6,117,66.5,2,0,0
1/04/2018 13:35,44,67.4,62,62.5,106,64.5,2,0,0
1/04/2018 13:40,51,68.7,70,64,121,66,2,0,0
1/04/2018 13:45,44,68.7,62,64.1,106,66,2,0,0
1/04/2018 13:50,50,68.9,69,64.2,119,66.2,2,0,0
1/04/2018 13:55,45,68.4,62,63.7,107,65.7,2,0,0
1/04/2018 14:00,50,67.7,68,63,118,65,2,0,0
1/04/2018 14:05,39,68.5,56,63.8,95,65.7,2,0,0
1/04/2018 14:10,54,67.9,72,63.1,126,65.1,2,0,0
1/04/2018 14:15,53,69.1,72,64.4,125,66.4,2,0,0
1/04/2018 14:20,53,68.7,72,64.1,125,66,2,0,0
1/04/2018 14:25,45,68,63,63.3,108,65.2,2,0,0
1/04/2018 14:30,53,67.5,71,62.8,124,64.8,2,0,0
1/04/2018 14:35,47,67.5,65,62.7,112,64.7,2,0,0
1/04/2018 14:40,49,68.1,66,63.4,115,65.4,2,0,0
1/04/2018 14:45,49,69.2,67,64.6,116,66.6,2,0,0
1/04/2018 14:50,48,68.8,65,64.2,113,66.1,2,0,0
1/04/2018 14:55,43,67.2,61,62.4,104,64.4,2,0,0
1/04/2018 15:00,35,67,52,62.2,87,64.2,2,0,0
1/04/2018 15:05,42,67.3,58,62.6,100,64.6,2,0,0
1/04/2018 15:10,47,68,64,63.3,111,65.3,2,0,0
1/04/2018 15:15,44,68.4,61,63.7,105,65.7,2,0,0
1/04/2018 15:20,42,68.5,59,63.8,101,65.8,2,0,0
1/04/2018 15:25,38,68.5,55,63.9,93,65.8,2,0,0
1/04/2018 15:30,50,68.2,69,63.6,119,65.5,2,0,0
1/04/2018 15:35,47,68.7,64,64.1,111,66,2,0,0
1/04/2018 15:40,42,68.8,59,64.1,101,66.1,2,0,0
1/04/2018 15:45,59,68.5,77,63.8,136,65.9,2,0,0
1/04/2018 15:50,54,68.8,72,64.1,126,66.1,2,0,0
1/04/2018 15:55,51,67.3,69,62.5,120,64.5,2,0,0
1/04/2018 16:00,51,67.9,69,63.1,120,65.1,2,0,0
1/04/2018 16:05,57,69.3,75,64.6,132,66.7,2,0,0
1/04/2018 16:10,51,68.6,69,63.9,120,65.9,2,0,0
1/04/2018 16:15,57,69.4,75,64.8,132,66.8,2,0,0
1/04/2018 16:20,60,69.5,79,64.9,139,66.9,2,0,0
1/04/2018 16:25,60,68.4,79,63.7,139,65.7,2,0,0
1/04/2018 16:30,53,68.9,71,64.3,124,66.3,2,0,0
1/04/2018 16:35,50,68.6,69,63.9,119,65.9,2,0,0
1/04/2018 16:40,51,69.5,68,65,119,66.9,2,0,0
1/04/2018 16:45,55,67.8,73,63,128,65,2,0,0
1/04/2018 16:50,54,67.4,72,62.6,126,64.6,2,0,0
1/04/2018 16:55,57,68.8,75,64.2,132,66.2,2,0,0
1/04/2018 17:00,50,69,68,64.4,118,66.4,2,0,0
1/04/2018 17:05,51,69.1,69,64.5,120,66.4,2,0,0
1/04/2018 17:10,54,67,74,62.3,128,64.3,2,0,0
1/04/2018 17:15,48,68.4,67,63.7,115,65.7,2,0,0
1/04/2018 17:20,47,67.8,64,63,111,65.1,2,0,0
1/04/2018 17:25,56,67.7,74,62.9,130,64.9,2,0,0
1/04/2018 17:30,57,67.9,75,63.1,132,65.2,2,0,0
1/04/2018 17:35,55,67.2,73,62.3,128,64.4,2,0,0
1/04/2018 17:40,52,67.5,70,62.6,122,64.7,2,0,0
1/04/2018 17:45,42,67.8,59,62.9,101,65,2,0,0
1/04/2018 17:50,47,68.5,64,63.7,111,65.7,2,0,0
1/04/2018 17:55,43,68.2,61,63.4,104,65.4,2,0,0
1/04/2018 18:00,50,68.6,67,63.8,117,65.9,2,0,0
1/04/2018 18:05,46,67.8,63,63,109,65,2,0,0
1/04/2018 18:10,57,67.3,76,62.4,133,64.5,2,0,0
1/04/2018 18:15,53,66.5,71,61.5,124,63.7,2,0,0
1/04/2018 18:20,48,65.4,67,60.3,115,62.4,2,0,0
1/04/2018 18:25,39,66.8,56,61.8,95,63.9,2,0,0
1/04/2018 18:30,40,67.5,57,62.6,97,64.6,2,0,0
1/04/2018 18:35,42,67.6,59,62.8,101,64.8,2,0,0
1/04/2018 18:40,35,68.3,52,63.5,87,65.5,2,0,0
1/04/2018 18:45,34,68.8,50,64.1,84,66,2,0,0
1/04/2018 18:50,37,69.6,53,65,90,66.9,2,0,0
1/04/2018 18:55,37,68.5,53,63.8,90,65.7,2,0,0
1/04/2018 19:00,30,68.8,46,64.2,76,66,2,0,0
1/04/2018 19:05,32,69,48,64.4,80,66.2,2,0,0
1/04/2018 19:10,31,68.6,47,64,78,65.8,2,0,0
1/04/2018 19:15,41,68.4,58,63.7,99,65.7,2,0,0
1/04/2018 19:20,41,68.2,58,63.5,99,65.4,2,0,0
1/04/2018 19:25,35,68.3,52,63.6,87,65.5,2,0,0
1/04/2018 19:30,37,67.3,53,62.5,90,64.4,2,0,0
1/04/2018 19:35,33,67.6,50,62.8,83,64.7,2,0,0
1/04/2018 19:40,32,68.2,48,63.5,80,65.4,2,0,0
1/04/2018 19:45,30,68.4,46,63.7,76,65.6,2,0,0
1/04/2018 19:50,28,68.9,43,64.3,71,66.1,2,0,0
1/04/2018 19:55,32,68.6,48,63.9,80,65.8,2,0,0
1/04/2018 20:00,23,69.1,39,64.5,62,66.2,2,0,0
1/04/2018 20:05,27,69.7,44,65.1,71,66.9,2,0,0
1/04/2018 20:10,25,69.8,41,65.2,66,66.9,2,0,0
1/04/2018 20:15,32,68.6,48,63.9,80,65.8,2,0,0
1/04/2018 20:20,37,69,54,64.3,91,66.2,2,0,0
1/04/2018 20:25,25,69.7,41,65.1,66,66.9,2,0,0
1/04/2018 20:30,29,69.7,45,65.1,74,66.9,2,0,0
1/04/2018 20:35,24,69.7,40,65.1,64,66.8,2,0,0
1/04/2018 20:40,30,69.9,47,65.3,77,67.1,2,0,0
1/04/2018 20:45,28,70.1,45,65.6,73,67.3,2,0,0
1/04/2018 20:50,24,69.2,40,64.6,64,66.3,2,0,0
1/04/2018 20:55,28,68.9,44,64.3,72,66.1,2,0,0
1/04/2018 21:00,27,69.3,43,64.7,70,66.4,2,0,0
1/04/2018 21:05,22,69.3,38,64.7,60,66.4,2,0,0
1/04/2018 21:10,32,69.1,49,64.5,81,66.3,2,0,0
1/04/2018 21:15,33,69,50,64.4,83,66.2,2,0,0
1/04/2018 21:20,25,68.7,41,64,66,65.8,2,0,0
1/04/2018 21:25,23,68.9,39,64.2,62,66,2,0,0
1/04/2018 21:30,27,68.4,43,63.7,70,65.5,2,0,0
1/04/2018 21:35,25,68.6,41,64,66,65.7,2,0,0
1/04/2018 21:40,29,68.3,46,63.6,75,65.4,2,0,0
1/04/2018 21:45,24,68.4,40,63.7,64,65.5,2,0,0
1/04/2018 21:50,34,68.7,51,64,85,65.9,2,0,0
1/04/2018 21:55,27,68,44,63.2,71,65,2,0,0
1/04/2018 22:00,23,68.6,38,63.9,61,65.6,2,0,0
1/04/2018 22:05,22,68.8,38,64.1,60,65.8,2,0,0
1/04/2018 22:10,24,69,39,64.4,63,66.1,2,0,0
1/04/2018 22:15,18,69.1,34,64.5,52,66.1,2,0,0
1/04/2018 22:20,21,69.2,37,64.5,58,66.2,2,0,0
1/04/2018 22:25,18,68.7,33,64,51,65.7,2,0,0
1/04/2018 22:30,19,69,35,64.3,54,65.9,2,0,0
1/04/2018 22:35,20,69,35,64.3,55,66,2,0,0
1/04/2018 22:40,21,68.8,37,64.2,58,65.9,2,0,0
1/04/2018 22:45,16,69.1,32,64.5,48,66,2,0,0
1/04/2018 22:50,20,69.3,35,64.7,55,66.4,2,0,0
1/04/2018 22:55,18,69.1,33,64.5,51,66.1,2,0,0
1/04/2018 23:00,17,68.9,33,64.2,50,65.8,2,0,0
1/04/2018 23:05,15,69.1,30,64.5,45,66,2,0,0
1/04/2018 23:10,12,69.2,27,64.6,39,66,2,0,0
1/04/2018 23:15,11,69.2,26,64.5,37,65.9,2,0,0
1/04/2018 23:20,17,69.3,32,64.7,49,66.3,2,0,0
1/04/2018 23:25,10,69.3,25,64.7,35,66,2,0,0
1/04/2018 23:30,16,69.2,31,64.6,47,66.2,2,0,0
1/04/2018 23:35,11,69.3,27,64.7,38,66,2,0,0
1/04/2018 23:40,13,69.3,28,64.7,41,66.2,2,0,0
1/04/2018 23:45,10,69.3,25,64.7,35,66.1,2,0,0
1/04/2018 23:50,11,69.3,26,64.7,37,66.1,2,0,0
1/04/2018 23:55,11,69.3,26,64.7,37,66.1,2,0,0
1/05/2018 0:00,9,69.3,24,64.7,33,66,2,0,0
1/05/2018 0:05,12,69.4,27,64.7,39,66.2,2,0,0
1/05/2018 0:10,11,69.3,26,64.7,37,66.1,2,0,0
1/05/2018 0:15,14,69.3,30,64.6,44,66.1,2,0,0
1/05/2018 0:20,9,69.3,25,64.6,34,65.9,2,0,0
1/05/2018 0:25,9,69,24,64.4,33,65.7,2,0,0
1/05/2018 0:30,9,69.1,24,64.4,33,65.7,2,0,0
1/05/2018 0:35,10,68.8,25,64.2,35,65.5,2,0,0
1/05/2018 0:40,11,69.1,26,64.5,37,65.8,2,0,0
1/05/2018 0:45,9,69.3,24,64.7,33,66,2,0,0
1/05/2018 0:50,7,69.3,22,64.7,29,65.8,2,0,0
1/05/2018 0:55,12,69.4,21,64.8,33,66.5,2,0,0
1/05/2018 1:00,7,69.4,22,64.8,29,65.9,2,0,0
1/05/2018 1:05,4,69.3,20,64.7,24,65.5,2,0,0
1/05/2018 1:10,7,69.4,22,64.8,29,65.9,2,0,0
1/05/2018 1:15,6,69.2,21,64.5,27,65.6,2,0,0
1/05/2018 1:20,6,69.2,21,64.6,27,65.6,2,0,0
1/05/2018 1:25,10,69.1,20,64.4,30,66,2,0,0
1/05/2018 1:30,8,69.2,24,64.6,32,65.8,2,0,0
1/05/2018 1:35,10,69,25,64.3,35,65.6,2,0,0
1/05/2018 1:40,8,69.2,23,64.5,31,65.7,2,0,0
1/05/2018 1:45,10,69.2,20,64.6,30,66.1,2,0,0
1/05/2018 1:50,7,69.3,22,64.7,29,65.8,2,0,0
1/05/2018 1:55,11,69.2,21,64.5,32,66.1,2,0,0
1/05/2018 2:00,5,69,20,64.4,25,65.4,2,0,0
1/05/2018 2:05,8,69.2,23,64.6,31,65.8,2,0,0
1/05/2018 2:10,7,69.2,22,64.5,29,65.7,2,0,0
1/05/2018 2:15,6,69.2,21,64.6,27,65.6,2,0,0
1/05/2018 2:20,6,69.3,22,64.7,28,65.7,2,0,0
1/05/2018 2:25,8,69.3,24,64.7,32,65.9,2,0,0
1/05/2018 2:30,5,69.1,20,64.5,25,65.4,2,0,0
1/05/2018 2:35,8,69.2,23,64.6,31,65.8,2,0,0
1/05/2018 2:40,11,69.3,26,64.7,37,66.1,2,0,0
1/05/2018 2:45,8,69.2,23,64.5,31,65.7,2,0,0
1/05/2018 2:50,5,69.2,21,64.6,26,65.5,2,0,0
1/05/2018 2:55,9,69.3,24,64.7,33,66,2,0,0
1/05/2018 3:00,9,69.2,24,64.6,33,65.9,2,0,0
1/05/2018 3:05,11,69,26,64.4,37,65.7,2,0,0
1/05/2018 3:10,15,69.2,31,64.6,46,66.1,2,0,0
1/05/2018 3:15,12,69.4,27,64.8,39,66.2,2,0,0
1/05/2018 3:20,10,69,26,64.4,36,65.7,2,0,0
1/05/2018 3:25,11,68.9,27,64.3,38,65.7,2,0,0
1/05/2018 3:30,11,69.1,26,64.5,37,65.9,2,0,0
1/05/2018 3:35,14,69.3,30,64.7,44,66.1,2,0,0
1/05/2018 3:40,14,68.8,29,64.2,43,65.7,2,0,0
1/05/2018 3:45,15,69,31,64.4,46,65.9,2,0,0
1/05/2018 3:50,15,69,30,64.3,45,65.9,2,0,0
1/05/2018 3:55,16,69.3,32,64.7,48,66.2,2,0,0
1/05/2018 4:00,14,69.2,30,64.6,44,66.1,2,0,0
1/05/2018 4:05,14,69.2,30,64.6,44,66.1,2,0,0
1/05/2018 4:10,15,69.4,31,64.8,46,66.3,2,0,0
1/05/2018 4:15,15,69.3,31,64.7,46,66.2,2,0,0
1/05/2018 4:20,22,69.7,39,65.1,61,66.7,2,0,0
1/05/2018 4:25,21,69.6,37,65,58,66.7,2,0,0
1/05/2018 4:30,22,69.5,38,64.9,60,66.6,2,0,0
1/05/2018 4:35,28,69.9,44,65.3,72,67.1,2,0,0
1/05/2018 4:40,32,69.8,49,65.3,81,67,2,0,0
1/05/2018 4:45,30,69.5,47,65,77,66.7,2,0,0
1/05/2018 4:50,35,70.2,53,65.6,88,67.4,2,0,0
1/05/2018 4:55,32,69.2,50,64.6,82,66.4,2,0,0
1/05/2018 5:00,29,69.7,47,65,76,66.8,2,0,0
1/05/2018 5:05,31,69.8,48,65.2,79,67,2,0,0
1/05/2018 5:10,39,68.2,57,63.6,96,65.5,2,0,0
1/05/2018 5:15,41,68,59,63.3,100,65.3,2,0,0
1/05/2018 5:20,45,68.2,65,63.4,110,65.4,2,0,0
1/05/2018 5:25,38,68.5,56,63.8,94,65.7,2,0,0
1/05/2018 5:30,39,68.5,57,63.7,96,65.6,2,0,0
1/05/2018 5:35,47,69,66,64.2,113,66.2,2,0,0
1/05/2018 5:40,54,68.1,74,63.4,128,65.4,2,0,0
1/05/2018 5:45,55,68.2,75,63.5,130,65.5,2,0,0
1/05/2018 5:50,56,67.1,77,62.3,133,64.3,2,0,0
1/05/2018 5:55,60,68.3,81,63.6,141,65.6,2,0,0
1/05/2018 6:00,41,68.2,60,63.4,101,65.3,2,0,0
1/05/2018 6:05,49,66.1,70,61.2,119,63.3,2,0,0
1/05/2018 6:10,57,66.1,78,61.3,135,63.3,2,0,0
1/05/2018 6:15,48,67.1,67,62.3,115,64.3,2,0,0
1/05/2018 6:20,51,68.4,71,63.7,122,65.6,2,0,0
1/05/2018 6:25,61,67.5,83,62.8,144,64.8,2,0,0
1/05/2018 6:30,62,66.5,83,61.6,145,63.7,2,0,0
1/05/2018 6:35,50,67.1,70,62.2,120,64.2,2,0,0
1/05/2018 6:40,63,66.9,84,62,147,64.1,2,0,0
1/05/2018 6:45,62,67.4,83,62.6,145,64.7,2,0,0
1/05/2018 6:50,62,67.2,83,62.4,145,64.4,2,0,0
1/05/2018 6:55,65,67.6,86,62.8,151,64.9,2,0,0
1/05/2018 7:00,52,68.1,71,63.3,123,65.3,2,0,0
1/05/2018 7:05,50,68.7,70,64,120,66,2,0,0
1/05/2018 7:10,61,67.6,83,62.8,144,64.9,2,0,0
1/05/2018 7:15,63,68.4,84,63.8,147,65.8,2,0,0
1/05/2018 7:20,54,67.9,74,63.1,128,65.1,2,0,0
1/05/2018 7:25,57,67.9,77,63.2,134,65.2,2,0,0
1/05/2018 7:30,49,69.3,68,64.7,117,66.6,2,0,0
1/05/2018 7:35,62,69.1,83,64.4,145,66.4,2,0,0
1/05/2018 7:40,70,69.4,90,64.7,160,66.8,2,0,0
1/05/2018 7:45,72,69.5,94,64.8,166,66.9,2,0,0
1/05/2018 7:50,76,70,98,65.4,174,67.4,2,0,0
1/05/2018 7:55,68,70.4,89,65.9,157,67.9,2,0,0
1/05/2018 8:00,63,69.8,83,65.3,146,67.2,2,0,0
1/05/2018 8:05,74,69.4,96,64.9,170,66.9,2,0,0
1/05/2018 8:10,77,70.4,98,65.9,175,67.9,2,0,0
1/05/2018 8:15,69,70.4,90,65.9,159,67.9,2,0,0
1/05/2018 8:20,79,70.3,102,65.7,181,67.7,2,0,0
1/05/2018 8:25,79,69.7,102,65.2,181,67.1,2,0,0
1/05/2018 8:30,81,69.3,104,64.7,185,66.7,2,0,0
1/05/2018 8:35,84,69.6,107,65,191,67,2,0,0
1/05/2018 8:40,80,68.9,102,64.2,182,66.3,2,0,0
1/05/2018 8:45,67,69.3,87,64.6,154,66.6,2,0,0
1/05/2018 8:50,73,68.4,95,63.8,168,65.8,2,0,0
1/05/2018 8:55,71,68,92,63.3,163,65.3,2,0,0
1/05/2018 9:00,55,69.1,74,64.5,129,66.5,2,0,0
1/05/2018 9:05,53,69.3,72,64.7,125,66.6,2,0,0
1/05/2018 9:10,63,67.4,83,62.7,146,64.7,2,0,0
1/05/2018 9:15,62,66.9,82,62.1,144,64.2,2,0,0
1/05/2018 9:20,67,68.8,88,64.1,155,66.1,2,0,0
1/05/2018 9:25,55,69,74,64.3,129,66.3,2,0,0
1/05/2018 9:30,61,67.5,80,62.8,141,64.8,2,0,0
1/05/2018 9:35,64,67.4,83,62.7,147,64.8,2,0,0
1/05/2018 9:40,59,66.6,79,61.9,138,63.9,2,0,0
1/05/2018 9:45,64,67,83,62.1,147,64.2,2,0,0
1/05/2018 9:50,65,66.7,86,61.8,151,63.9,2,0,0
1/05/2018 9:55,47,67.5,65,62.6,112,64.7,2,0,0
1/05/2018 10:00,61,66.7,80,61.9,141,64,2,0,0
1/05/2018 10:05,51,67.4,69,62.7,120,64.7,2,0,0
1/05/2018 10:10,48,69,66,64.4,114,66.3,2,0,0
1/05/2018 10:15,50,68,68,63.4,118,65.4,2,0,0
1/05/2018 10:20,54,67.4,72,62.7,126,64.7,2,0,0
1/05/2018 10:25,60,67.9,78,63.2,138,65.3,2,0,0
1/05/2018 10:30,34,68.5,51,63.8,85,65.7,2,0,0
1/05/2018 10:35,49,67.1,67,62.2,116,64.3,2,0,0
1/05/2018 10:40,60,65.8,80,60.9,140,63,2,0,0
1/05/2018 10:45,56,66.6,74,61.7,130,63.8,2,0,0
1/05/2018 10:50,55,64.7,74,59.7,129,61.8,2,0,0
1/05/2018 10:55,50,65.6,67,60.7,117,62.8,2,0,0
1/05/2018 11:00,50,65.5,67,60.5,117,62.6,2,0,0
1/05/2018 11:05,46,65.7,63,60.8,109,62.9,2,0,0
1/05/2018 11:10,54,63.7,72,58.6,126,60.8,2,0,0
1/05/2018 11:15,51,64.2,69,59.1,120,61.3,2,0,0
1/05/2018 11:20,58,63.4,77,58.3,135,60.5,2,0,0
1/05/2018 11:25,54,63.6,73,58.5,127,60.7,2,0,0
1/05/2018 11:30,51,64.4,68,59.3,119,61.5,2,0,0
1/05/2018 11:35,50,65.2,68,60.1,118,62.3,2,0,0
1/05/2018 11:40,55,63.5,74,58.4,129,60.6,2,0,0
1/05/2018 11:45,58,63.4,77,58.3,135,60.5,2,0,0
1/05/2018 11:50,46,64.8,64,59.8,110,61.9,2,0,0
1/05/2018 11:55,48,64.6,66,59.6,114,61.7,2,0,0
1/05/2018 12:00,46,64.6,63,59.5,109,61.7,2,0,0
1/05/2018 12:05,45,63.2,63,58,108,60.2,2,0,0
1/05/2018 12:10,38,64.7,54,59.7,92,61.8,2,0,0
1/05/2018 12:15,47,64.5,64,59.4,111,61.6,2,0,0
1/05/2018 12:20,41,64.1,58,59,99,61.1,2,0,0
1/05/2018 12:25,48,63.6,65,58.5,113,60.6,2,0,0
1/05/2018 12:30,46,65.1,62,60.2,108,62.3,2,0,0
1/05/2018 12:35,51,64.4,68,59.4,119,61.5,2,0,0
1/05/2018 12:40,43,63,60,57.8,103,60,2,0,0
1/05/2018 12:45,39,64.4,55,59.3,94,61.4,2,0,0
1/05/2018 12:50,44,63.4,63,58.2,107,60.4,2,0,0
1/05/2018 12:55,46,62.5,64,57.3,110,59.5,2,0,0
1/05/2018 13:00,37,63,53,57.8,90,59.9,2,0,0
1/05/2018 13:05,41,63.4,59,58.1,100,60.3,2,0,0
1/05/2018 13:10,49,64.6,67,59.5,116,61.7,2,0,0
1/05/2018 13:15,51,65.1,68,60,119,62.2,2,0,0
1/05/2018 13:20,47,65.3,65,60.3,112,62.4,2,0,0
1/05/2018 13:25,48,65.2,66,60.1,114,62.3,2,0,0
1/05/2018 13:30,48,65.9,65,60.9,113,63,2,0,0
1/05/2018 13:35,50,66.2,67,61.3,117,63.4,2,0,0
1/05/2018 13:40,47,66.2,64,61.2,111,63.3,2,0,0
1/05/2018 13:45,42,66.1,59,61.2,101,63.2,2,0,0
1/05/2018 13:50,47,65.7,64,60.8,111,62.9,2,0,0
1/05/2018 13:55,43,66.3,60,61.4,103,63.4,2,0,0
1/05/2018 14:00,45,65.3,63,60.3,108,62.4,2,0,0
1/05/2018 14:05,46,66.6,63,61.7,109,63.8,2,0,0
1/05/2018 14:10,41,67,58,62.3,99,64.2,2,0,0
1/05/2018 14:15,54,66.6,72,61.7,126,63.8,2,0,0
1/05/2018 14:20,41,66.7,57,61.9,98,63.9,2,0,0
1/05/2018 14:25,55,65.9,74,61,129,63.1,2,0,0
1/05/2018 14:30,42,66.2,58,61.3,100,63.4,2,0,0
1/05/2018 14:35,40,67.3,57,62.5,97,64.5,2,0,0
1/05/2018 14:40,36,67,52,62.2,88,64.2,2,0,0
1/05/2018 14:45,39,67.4,57,62.6,96,64.6,2,0,0
1/05/2018 14:50,35,68,52,63.3,87,65.2,2,0,0
1/05/2018 14:55,37,67.2,54,62.4,91,64.3,2,0,0
1/05/2018 15:00,37,68.8,53,64.1,90,66,2,0,0
1/05/2018 15:05,48,68.5,66,63.8,114,65.8,2,0,0
1/05/2018 15:10,45,68.5,62,63.8,107,65.8,2,0,0
1/05/2018 15:15,46,68.9,63,64.2,109,66.2,2,0,0
1/05/2018 15:20,43,68.7,61,64.1,104,66,2,0,0
1/05/2018 15:25,47,68.5,65,63.8,112,65.7,2,0,0
1/05/2018 15:30,46,68.6,63,63.9,109,65.9,2,0,0
1/05/2018 15:35,57,68.1,77,63.3,134,65.3,2,0,0
1/05/2018 15:40,63,67,82,62.2,145,64.3,2,0,0
1/05/2018 15:45,52,67.7,70,63,122,65,2,0,0
1/05/2018 15:50,49,67.8,68,63,117,65,2,0,0
1/05/2018 15:55,59,65.6,79,60.6,138,62.8,2,0,0
1/05/2018 16:00,43,66.5,60,61.6,103,63.6,2,0,0
1/05/2018 16:05,49,66.8,66,61.9,115,64,2,0,0
1/05/2018 16:10,41,68,58,63.2,99,65.2,2,0,0
1/05/2018 16:15,46,67.9,64,63.1,110,65.1,2,0,0
1/05/2018 16:20,52,67.5,70,62.7,122,64.7,2,0,0
1/05/2018 16:25,53,67.8,71,63,124,65.1,2,0,0
1/05/2018 16:30,41,66.9,58,62,99,64,2,0,0
1/05/2018 16:35,55,66.7,74,61.7,129,63.9,2,0,0
1/05/2018 16:40,56,66.7,73,61.7,129,63.9,2,0,0
1/05/2018 16:45,45,66.7,63,61.8,108,63.8,2,0,0
1/05/2018 16:50,59,66.2,77,61.2,136,63.4,2,0,0
1/05/2018 16:55,51,66.7,70,61.8,121,63.8,2,0,0
1/05/2018 17:00,52,67,71,62.2,123,64.2,2,0,0
1/05/2018 17:05,47,67,65,62.2,112,64.2,2,0,0
1/05/2018 17:10,50,66.8,67,62,117,64,2,0,0
1/05/2018 17:15,52,65.9,70,60.9,122,63,2,0,0
1/05/2018 17:20,60,67.3,79,62.5,139,64.6,2,0,0
1/05/2018 17:25,53,66.5,71,61.7,124,63.7,2,0,0
1/05/2018 17:30,48,67.5,66,62.7,114,64.7,2,0,0
1/05/2018 17:35,45,66.4,62,61.6,107,63.6,2,0,0
1/05/2018 17:40,49,65.6,68,60.6,117,62.7,2,0,0
1/05/2018 17:45,54,66,72,61,126,63.2,2,0,0
1/05/2018 17:50,55,65.1,74,59.9,129,62.1,2,0,0
1/05/2018 17:55,46,65,64,59.9,110,62,2,0,0
1/05/2018 18:00,49,65.1,67,60,116,62.2,2,0,0
1/05/2018 18:05,50,63.9,68,58.7,118,60.9,2,0,0
1/05/2018 18:10,42,64.1,60,58.9,102,61.1,2,0,0
1/05/2018 18:15,44,64.6,61,59.5,105,61.6,2,0,0
1/05/2018 18:20,37,65.3,54,60.3,91,62.4,2,0,0
1/05/2018 18:25,44,65.7,60,60.8,104,62.8,2,0,0
1/05/2018 18:30,51,66.2,69,61.3,120,63.4,2,0,0
1/05/2018 18:35,46,67.3,64,62.5,110,64.5,2,0,0
1/05/2018 18:40,42,68.1,59,63.3,101,65.3,2,0,0
1/05/2018 18:45,54,67.8,73,63.1,127,65.1,2,0,0
1/05/2018 18:50,47,67.1,64,62.4,111,64.4,2,0,0
1/05/2018 18:55,49,67.1,66,62.4,115,64.4,2,0,0
1/05/2018 19:00,48,64.6,66,59.5,114,61.6,2,0,0
1/05/2018 19:05,55,62.9,73,57.6,128,59.9,2,0,0
1/05/2018 19:10,56,63.5,74,58.3,130,60.6,2,0,0
1/05/2018 19:15,60,64.6,77,59.5,137,61.7,2,0,0
1/05/2018 19:20,52,65.5,70,60.5,122,62.6,2,0,0
1/05/2018 19:25,47,65.8,65,60.9,112,63,2,0,0
1/05/2018 19:30,63,65.5,82,60.5,145,62.7,2,0,0
1/05/2018 19:35,53,66.7,71,61.9,124,64,2,0,0
1/05/2018 19:40,51,66.1,69,61.2,120,63.3,2,0,0
1/05/2018 19:45,37,67.4,53,62.6,90,64.6,2,0,0
1/05/2018 19:50,33,67.9,50,63.2,83,65.1,2,0,0
1/05/2018 19:55,34,65.8,51,61,85,62.9,2,0,0
1/05/2018 20:00,37,65,53,60.1,90,62.1,2,0,0
1/05/2018 20:05,44,66.2,61,61.3,105,63.4,2,0,0
1/05/2018 20:10,30,67.2,46,62.4,76,64.3,2,0,0
1/05/2018 20:15,29,68.2,45,63.6,74,65.4,2,0,0
1/05/2018 20:20,38,67.2,54,62.4,92,64.4,2,0,0
1/05/2018 20:25,26,66.2,41,61.4,67,63.3,2,0,0
1/05/2018 20:30,30,67.5,45,62.8,75,64.7,2,0,0
1/05/2018 20:35,31,67.9,47,63.2,78,65.1,2,0,0
1/05/2018 20:40,28,66.9,45,62.1,73,63.9,2,0,0
1/05/2018 20:45,41,65.7,57,60.8,98,62.9,2,0,0
1/05/2018 20:50,31,66.2,47,61.3,78,63.3,2,0,0
1/05/2018 20:55,22,67.2,37,62.4,59,64.2,2,0,0
1/05/2018 21:00,30,67.4,46,62.6,76,64.5,2,0,0
1/05/2018 21:05,27,67.5,42,62.8,69,64.6,2,0,0
1/05/2018 21:10,22,67.9,38,63.1,60,64.9,2,0,0
1/05/2018 21:15,25,68,42,63.3,67,65.1,2,0,0
1/05/2018 21:20,28,67.5,44,62.8,72,64.6,2,0,0
1/05/2018 21:25,25,67.6,41,62.9,66,64.7,2,0,0
1/05/2018 21:30,31,67.1,47,62.3,78,64.2,2,0,0
1/05/2018 21:35,28,65.8,44,60.9,72,62.8,2,0,0
1/05/2018 21:40,23,66.6,38,61.8,61,63.6,2,0,0
1/05/2018 21:45,18,67,34,62.3,52,63.9,2,0,0
1/05/2018 21:50,24,67.4,40,62.6,64,64.4,2,0,0
1/05/2018 21:55,26,67.4,42,62.6,68,64.4,2,0,0
1/05/2018 22:00,22,67.3,38,62.5,60,64.2,2,0,0
1/05/2018 22:05,19,67.8,35,63,54,64.7,2,0,0
1/05/2018 22:10,21,67.9,37,63.1,58,64.8,2,0,0
1/05/2018 22:15,21,68,36,63.3,57,65,2,0,0
1/05/2018 22:20,25,68,41,63.3,66,65,2,0,0
1/05/2018 22:25,29,67.8,45,63.1,74,64.9,2,0,0
1/05/2018 22:30,25,67.7,40,62.9,65,64.8,2,0,0
1/05/2018 22:35,26,67.2,42,62.4,68,64.2,2,0,0
1/05/2018 22:40,21,67.4,37,62.7,58,64.4,2,0,0
1/05/2018 22:45,23,67.6,39,62.9,62,64.6,2,0,0
1/05/2018 22:50,23,68.2,39,63.5,62,65.3,2,0,0
1/05/2018 22:55,17,68.4,32,63.7,49,65.4,2,0,0
1/05/2018 23:00,24,68,39,63.3,63,65.1,2,0,0
1/05/2018 23:05,24,67.7,40,62.9,64,64.7,2,0,0
1/05/2018 23:10,20,68.1,36,63.4,56,65.1,2,0,0
1/05/2018 23:15,15,68.6,30,64,45,65.5,2,0,0
1/05/2018 23:20,15,69,30,64.3,45,65.9,2,0,0
1/05/2018 23:25,21,68.7,36,64.1,57,65.8,2,0,0
1/05/2018 23:30,18,69,33,64.4,51,66,2,0,0
1/05/2018 23:35,14,69.1,29,64.5,43,66,2,0,0
1/05/2018 23:40,11,69.2,26,64.5,37,65.9,2,0,0
1/05/2018 23:45,17,69.1,32,64.5,49,66.1,2,0,0
1/05/2018 23:50,15,69.1,31,64.5,46,66,2,0,0
1/05/2018 23:55,11,69.2,27,64.5,38,65.9,2,0,0
1/06/2018 0:00,15,69.3,30,64.7,45,66.3,2,0,0
1/06/2018 0:05,12,69.3,27,64.7,39,66.1,2,0,0
1/06/2018 0:10,9,69.2,24,64.6,33,65.9,2,0,0
1/06/2018 0:15,9,69.2,25,64.6,34,65.8,2,0,0
1/06/2018 0:20,13,69.2,28,64.6,41,66.1,2,0,0
1/06/2018 0:25,14,69.3,30,64.6,44,66.1,2,0,0
1/06/2018 0:30,12,68.9,28,64.3,40,65.7,2,0,0
1/06/2018 0:35,12,68.8,27,64.1,39,65.6,2,0,0
1/06/2018 0:40,12,69.1,27,64.4,39,65.9,2,0,0
1/06/2018 0:45,11,69.2,26,64.6,37,66,2,0,0
1/06/2018 0:50,8,69.3,23,64.7,31,65.8,2,0,0
1/06/2018 0:55,7,69.3,22,64.7,29,65.8,2,0,0
1/06/2018 1:00,7,69.2,22,64.6,29,65.7,2,0,0
1/06/2018 1:05,8,69.2,23,64.6,31,65.8,2,0,0
1/06/2018 1:10,10,69.3,25,64.7,35,66.1,2,0,0
1/06/2018 1:15,7,69.1,23,64.5,30,65.6,2,0,0
1/06/2018 1:20,7,69.2,22,64.6,29,65.7,2,0,0
1/06/2018 1:25,9,69.2,24,64.6,33,65.9,2,0,0
1/06/2018 1:30,8,69.1,23,64.5,31,65.7,2,0,0
1/06/2018 1:35,14,69.2,30,64.6,44,66.1,2,0,0
1/06/2018 1:40,7,69.3,23,64.7,30,65.7,2,0,0
1/06/2018 1:45,7,69.1,22,64.5,29,65.6,2,0,0
1/06/2018 1:50,8,69.2,23,64.6,31,65.8,2,0,0
1/06/2018 1:55,10,68.8,26,64.2,36,65.5,2,0,0
1/06/2018 2:00,12,69,21,64.4,33,66.1,2,0,0
1/06/2018 2:05,7,69.2,23,64.6,30,65.7,2,0,0
1/06/2018 2:10,8,68.7,23,64,31,65.2,2,0,0
1/06/2018 2:15,9,69.1,24,64.4,33,65.7,2,0,0
1/06/2018 2:20,9,69.2,24,64.6,33,65.8,2,0,0
1/06/2018 2:25,7,69.3,22,64.7,29,65.8,2,0,0
1/06/2018 2:30,7,69.2,22,64.6,29,65.7,2,0,0
1/06/2018 2:35,8,69.1,24,64.4,32,65.6,2,0,0
1/06/2018 2:40,7,69.2,23,64.6,30,65.7,2,0,0
1/06/2018 2:45,10,68.8,25,64.2,35,65.5,2,0,0
1/06/2018 2:50,9,68.9,24,64.3,33,65.5,2,0,0
1/06/2018 2:55,8,69,23,64.4,31,65.5,2,0,0
1/06/2018 3:00,6,69,21,64.4,27,65.4,2,0,0
1/06/2018 3:05,9,69.2,24,64.5,33,65.8,2,0,0
1/06/2018 3:10,6,69.2,22,64.6,28,65.6,2,0,0
1/06/2018 3:15,8,69.3,23,64.7,31,65.9,2,0,0
1/06/2018 3:20,6,69.3,22,64.7,28,65.7,2,0,0
1/06/2018 3:25,7,69.4,22,64.8,29,65.9,2,0,0
1/06/2018 3:30,8,69.4,24,64.8,32,66,2,0,0
1/06/2018 3:35,11,69.4,26,64.8,37,66.2,2,0,0
1/06/2018 3:40,9,69.4,25,64.8,34,66,2,0,0
1/06/2018 3:45,8,69.4,24,64.8,32,66,2,0,0
1/06/2018 3:50,9,69.4,24,64.7,33,66,2,0,0
1/06/2018 3:55,11,69.3,26,64.7,37,66.1,2,0,0
1/06/2018 4:00,7,69.3,22,64.7,29,65.8,2,0,0
1/06/2018 4:05,6,69.3,21,64.7,27,65.7,2,0,0
1/06/2018 4:10,8,69.1,24,64.5,32,65.7,2,0,0
1/06/2018 4:15,9,69.3,25,64.7,34,65.9,2,0,0
1/06/2018 4:20,13,68.8,29,64.2,42,65.6,2,0,0
1/06/2018 4:25,10,69,26,64.4,36,65.7,2,0,0
1/06/2018 4:30,12,69.1,27,64.5,39,65.9,2,0,0
1/06/2018 4:35,15,69.4,31,64.8,46,66.3,2,0,0
1/06/2018 4:40,13,69.4,29,64.8,42,66.2,2,0,0
1/06/2018 4:45,17,69.5,33,64.9,50,66.4,2,0,0
1/06/2018 4:50,18,69.4,34,64.8,52,66.4,2,0,0
1/06/2018 4:55,14,69.4,30,64.8,44,66.2,2,0,0
1/06/2018 5:00,16,69.4,32,64.8,48,66.3,2,0,0
1/06/2018 5:05,15,69.4,30,64.8,45,66.3,2,0,0
1/06/2018 5:10,12,69.4,28,64.8,40,66.2,2,0,0
1/06/2018 5:15,17,69.3,32,64.7,49,66.3,2,0,0
1/06/2018 5:20,15,69.3,31,64.7,46,66.2,2,0,0
1/06/2018 5:25,19,69.1,35,64.5,54,66.2,2,0,0
1/06/2018 5:30,15,69.4,31,64.8,46,66.3,2,0,0
1/06/2018 5:35,16,68.8,31,64.2,47,65.7,2,0,0
1/06/2018 5:40,18,69.1,34,64.5,52,66.1,2,0,0
1/06/2018 5:45,19,69,35,64.4,54,66,2,0,0
1/06/2018 5:50,16,69.2,32,64.6,48,66.1,2,0,0
1/06/2018 5:55,21,69.3,37,64.7,58,66.4,2,0,0
1/06/2018 6:00,19,69.4,35,64.7,54,66.4,2,0,0
1/06/2018 6:05,13,69.3,29,64.7,42,66.1,2,0,0
1/06/2018 6:10,23,68.4,39,63.7,62,65.4,2,0,0
1/06/2018 6:15,21,69.1,37,64.5,58,66.2,2,0,0
1/06/2018 6:20,21,68.8,38,64.2,59,65.8,2,0,0
1/06/2018 6:25,24,68.9,40,64.3,64,66,2,0,0
1/06/2018 6:30,29,69.3,45,64.7,74,66.5,2,0,0
1/06/2018 6:35,21,69.3,37,64.7,58,66.3,2,0,0
1/06/2018 6:40,33,68.8,50,64.1,83,66,2,0,0
1/06/2018 6:45,24,68.9,40,64.2,64,66,2,0,0
1/06/2018 6:50,23,68.6,40,63.9,63,65.6,2,0,0
1/06/2018 6:55,26,67.9,42,63.2,68,65,2,0,0
1/06/2018 7:00,23,68.8,39,64.1,62,65.8,2,0,0
1/06/2018 7:05,22,68.6,38,64,60,65.7,2,0,0
1/06/2018 7:10,21,68.6,37,63.9,58,65.6,2,0,0
1/06/2018 7:15,24,68.7,40,64.1,64,65.8,2,0,0
1/06/2018 7:20,26,68.9,42,64.2,68,66,2,0,0
1/06/2018 7:25,29,68.4,46,63.7,75,65.5,2,0,0
1/06/2018 7:30,27,69.1,44,64.4,71,66.2,2,0,0
1/06/2018 7:35,31,69,47,64.3,78,66.2,2,0,0
1/06/2018 7:40,39,68.8,56,64.1,95,66,2,0,0
1/06/2018 7:45,36,69.6,53,65,89,66.8,2,0,0
1/06/2018 7:50,31,69.3,47,64.7,78,66.5,2,0,0
1/06/2018 7:55,35,69.1,51,64.4,86,66.3,2,0,0
1/06/2018 8:00,31,69.2,47,64.6,78,66.5,2,0,0
1/06/2018 8:05,28,66.3,43,61.3,71,63.3,2,0,0
1/06/2018 8:10,29,66.3,43,61.5,72,63.4,2,0,0
1/06/2018 8:15,35,67.8,49,63,84,65,2,0,0
1/06/2018 8:20,39,68.2,55,63.5,94,65.5,2,0,0
1/06/2018 8:25,32,68.4,49,63.8,81,65.6,2,0,0
1/06/2018 8:30,33,68.6,49,63.9,82,65.8,2,0,0
1/06/2018 8:35,31,69.3,48,64.7,79,66.5,2,0,0
1/06/2018 8:40,46,69.8,63,65.3,109,67.2,2,0,0
1/06/2018 8:45,34,70.1,52,65.7,86,67.4,2,0,0
1/06/2018 8:50,41,69.1,58,64.5,99,66.4,2,0,0
1/06/2018 8:55,42,69,59,64.3,101,66.3,2,0,0
1/06/2018 9:00,43,69,61,64.3,104,66.2,2,0,0
1/06/2018 9:05,38,68.4,55,63.7,93,65.6,2,0,0
1/06/2018 9:10,43,68.5,61,63.8,104,65.8,2,0,0
1/06/2018 9:15,51,69.3,69,64.7,120,66.7,2,0,0
1/06/2018 9:20,40,69.8,58,65.3,98,67.1,2,0,0
1/06/2018 9:25,51,69.6,69,65,120,67,2,0,0
1/06/2018 9:30,46,69,64,64.4,110,66.3,2,0,0
1/06/2018 9:35,51,68.3,69,63.6,120,65.6,2,0,0
1/06/2018 9:40,50,67.8,68,63,118,65,2,0,0
1/06/2018 9:45,51,67.2,70,62.4,121,64.4,2,0,0
1/06/2018 9:50,64,68.4,83,63.7,147,65.7,2,0,0
1/06/2018 9:55,58,68,77,63.2,135,65.3,2,0,0
1/06/2018 10:00,47,68.4,64,63.7,111,65.7,2,0,0
1/06/2018 10:05,48,68,66,63.3,114,65.2,2,0,0
1/06/2018 10:10,52,68.3,69,63.6,121,65.7,2,0,0
1/06/2018 10:15,53,68.6,71,63.9,124,65.9,2,0,0
1/06/2018 10:20,47,67.9,64,63.2,111,65.2,2,0,0
1/06/2018 10:25,52,68.4,70,63.7,122,65.7,2,0,0
1/06/2018 10:30,61,68.2,80,63.4,141,65.5,2,0,0
1/06/2018 10:35,46,67.7,64,62.9,110,64.9,2,0,0
1/06/2018 10:40,51,68.3,68,63.6,119,65.6,2,0,0
1/06/2018 10:45,61,68.8,80,64,141,66.1,2,0,0
1/06/2018 10:50,71,68.2,90,63.4,161,65.5,2,0,0
1/06/2018 10:55,66,68.6,84,63.9,150,65.9,2,0,0
1/06/2018 11:00,53,68.8,71,64.2,124,66.2,2,0,0
1/06/2018 11:05,59,68.7,76,64,135,66.1,2,0,0
1/06/2018 11:10,48,68.7,65,64,113,66,2,0,0
1/06/2018 11:15,55,69.1,73,64.5,128,66.5,2,0,0
1/06/2018 11:20,52,68.9,70,64.3,122,66.2,2,0,0
1/06/2018 11:25,58,69.1,76,64.5,134,66.5,2,0,0
1/06/2018 11:30,54,67.7,72,62.9,126,65,2,0,0
1/06/2018 11:35,62,68.6,80,63.9,142,66,2,0,0
1/06/2018 11:40,52,68.2,71,63.5,123,65.5,2,0,0
1/06/2018 11:45,65,68.3,84,63.6,149,65.7,2,0,0
1/06/2018 11:50,54,68.1,71,63.4,125,65.4,2,0,0
1/06/2018 11:55,62,68.8,81,64.1,143,66.1,2,0,0
1/06/2018 12:00,58,69.5,77,64.9,135,66.9,2,0,0
1/06/2018 12:05,54,68.9,72,64.2,126,66.2,2,0,0
1/06/2018 12:10,63,68.2,81,63.5,144,65.5,2,0,0
1/06/2018 12:15,61,68,80,63.2,141,65.3,2,0,0
1/06/2018 12:20,58,68.1,78,63.3,136,65.4,2,0,0
1/06/2018 12:25,63,68.7,82,64,145,66,2,0,0
1/06/2018 12:30,65,68.7,85,64,150,66,2,0,0
1/06/2018 12:35,64,69.4,83,64.8,147,66.8,2,0,0
1/06/2018 12:40,69,69,88,64.3,157,66.4,2,0,0
1/06/2018 12:45,54,68.9,72,64.2,126,66.2,2,0,0
1/06/2018 12:50,14,69.3,29,64.7,43,66.2,2,0,0
1/06/2018 12:55,42,69.3,59,64.7,101,66.6,2,0,0
1/06/2018 13:00,46,69.6,63,65,109,67,2,0,0
1/06/2018 13:05,63,69.7,81,65.1,144,67.1,2,0,0
1/06/2018 13:10,60,69,78,64.4,138,66.4,2,0,0
1/06/2018 13:15,87,67.9,108,63.1,195,65.3,2,0,0
1/06/2018 13:20,56,67.9,75,63,131,65.1,2,0,0
1/06/2018 13:25,54,69,72,64.3,126,66.3,2,0,0
1/06/2018 13:30,62,68.2,81,63.5,143,65.5,2,0,0
1/06/2018 13:35,53,67.9,71,63.2,124,65.2,2,0,0
1/06/2018 13:40,47,68.2,65,63.5,112,65.5,2,0,0
1/06/2018 13:45,48,68.1,65,63.4,113,65.4,2,0,0
1/06/2018 13:50,51,68.5,68,63.8,119,65.8,2,0,0
1/06/2018 13:55,45,68.3,62,63.5,107,65.5,2,0,0
1/06/2018 14:00,61,69.1,80,64.5,141,66.5,2,0,0
1/06/2018 14:05,50,69.9,67,65.4,117,67.3,2,0,0
1/06/2018 14:10,59,69.2,77,64.6,136,66.6,2,0,0
1/06/2018 14:15,59,67.7,77,62.9,136,65,2,0,0
1/06/2018 14:20,51,68.4,68,63.7,119,65.7,2,0,0
1/06/2018 14:25,58,67.6,76,62.8,134,64.9,2,0,0
1/06/2018 14:30,54,67.3,71,62.5,125,64.6,2,0,0
1/06/2018 14:35,57,67.7,74,62.9,131,65,2,0,0
1/06/2018 14:40,62,68.7,80,64.1,142,66.1,2,0,0
1/06/2018 14:45,65,68.5,84,63.8,149,65.9,2,0,0
1/06/2018 14:50,56,68.3,74,63.6,130,65.6,2,0,0
1/06/2018 14:55,55,68.9,72,64.3,127,66.3,2,0,0
1/06/2018 15:00,62,69.8,80,65.2,142,67.2,2,0,0
1/06/2018 15:05,61,69.8,79,65.3,140,67.2,2,0,0
1/06/2018 15:10,54,69.6,72,65,126,67,2,0,0
1/06/2018 15:15,62,69.4,81,64.8,143,66.8,2,0,0
1/06/2018 15:20,58,69.2,77,64.7,135,66.6,2,0,0
1/06/2018 15:25,58,69.2,76,64.7,134,66.6,2,0,0
1/06/2018 15:30,56,69.1,73,64.5,129,66.5,2,0,0
1/06/2018 15:35,62,68.4,80,63.7,142,65.7,2,0,0
1/06/2018 15:40,56,68.1,73,63.3,129,65.4,2,0,0
1/06/2018 15:45,61,68.1,79,63.4,140,65.5,2,0,0
1/06/2018 15:50,60,68.4,78,63.8,138,65.8,2,0,0
1/06/2018 15:55,64,68.7,84,64.1,148,66.1,2,0,0
1/06/2018 16:00,64,70.1,82,65.6,146,67.6,2,0,0
1/06/2018 16:05,56,69,73,64.4,129,66.4,2,0,0
1/06/2018 16:10,56,69.5,74,65,130,66.9,2,0,0
1/06/2018 16:15,58,68.8,78,64.2,136,66.2,2,0,0
1/06/2018 16:20,55,68.9,74,64.3,129,66.3,2,0,0
1/06/2018 16:25,55,68.6,73,64,128,66,2,0,0
1/06/2018 16:30,57,69.3,77,64.7,134,66.7,2,0,0
1/06/2018 16:35,53,69.4,70,64.9,123,66.8,2,0,0
1/06/2018 16:40,51,69.1,69,64.6,120,66.5,2,0,0
1/06/2018 16:45,59,68.7,78,64.1,137,66.1,2,0,0
1/06/2018 16:50,51,69.5,69,65,120,66.9,2,0,0
1/06/2018 16:55,57,69.5,74,64.9,131,66.9,2,0,0
1/06/2018 17:00,50,69.9,67,65.4,117,67.4,2,0,0
1/06/2018 17:05,60,70.2,79,65.7,139,67.6,2,0,0
1/06/2018 17:10,62,70.1,82,65.6,144,67.5,2,0,0
1/06/2018 17:15,62,70.6,80,66.1,142,68,2,0,0
1/06/2018 17:20,67,69.4,87,64.7,154,66.8,2,0,0
1/06/2018 17:25,61,68.9,79,64.2,140,66.3,2,0,0
1/06/2018 17:30,50,69.4,69,64.8,119,66.8,2,0,0
1/06/2018 17:35,66,70.2,84,65.7,150,67.7,2,0,0
1/06/2018 17:40,65,69.3,85,64.6,150,66.6,2,0,0
1/06/2018 17:45,66,68.6,85,63.9,151,66,2,0,0
1/06/2018 17:50,70,68.7,90,64,160,66.1,2,0,0
1/06/2018 17:55,60,68.4,80,63.7,140,65.7,2,0,0
1/06/2018 18:00,62,68.4,81,63.7,143,65.8,2,0,0
1/06/2018 18:05,68,68.4,88,63.7,156,65.7,2,0,0
1/06/2018 18:10,72,68.4,90,63.7,162,65.8,2,0,0
1/06/2018 18:15,75,68.3,95,63.6,170,65.7,2,0,0
1/06/2018 18:20,72,68.3,91,63.7,163,65.7,2,0,0
1/06/2018 18:25,67,67.9,85,63.2,152,65.3,2,0,0
1/06/2018 18:30,58,68.6,78,64,136,65.9,2,0,0
1/06/2018 18:35,58,69.3,77,64.8,135,66.7,2,0,0
1/06/2018 18:40,51,69.4,69,64.9,120,66.8,2,0,0
1/06/2018 18:45,59,69,78,64.5,137,66.4,2,0,0
1/06/2018 18:50,53,68.6,71,63.9,124,65.9,2,0,0
1/06/2018 18:55,59,69.7,77,65.2,136,67.1,2,0,0
1/06/2018 19:00,57,69.5,75,64.9,132,66.9,2,0,0
1/06/2018 19:05,46,69.1,65,64.5,111,66.4,2,0,0
1/06/2018 19:10,42,68.6,59,63.9,101,65.9,2,0,0
1/06/2018 19:15,52,69,70,64.3,122,66.3,2,0,0
1/06/2018 19:20,51,68.1,69,63.3,120,65.3,2,0,0
1/06/2018 19:25,43,68.9,59,64.2,102,66.2,2,0,0
1/06/2018 19:30,38,69.4,54,64.7,92,66.6,2,0,0
1/06/2018 19:35,39,69.2,56,64.5,95,66.4,2,0,0
1/06/2018 19:40,33,69,49,64.3,82,66.2,2,0,0
1/06/2018 19:45,29,69.3,45,64.6,74,66.4,2,0,0
1/06/2018 19:50,42,69.4,59,64.8,101,66.7,2,0,0
1/06/2018 19:55,30,68.8,46,64.2,76,66,2,0,0
1/06/2018 20:00,27,68.9,44,64.3,71,66,2,0,0
1/06/2018 20:05,33,69,49,64.3,82,66.2,2,0,0
1/06/2018 20:10,31,69.8,47,65.2,78,67,2,0,0
1/06/2018 20:15,30,69.3,47,64.7,77,66.5,2,0,0
1/06/2018 20:20,29,68.4,45,63.8,74,65.6,2,0,0
1/06/2018 20:25,34,69.3,50,64.7,84,66.6,2,0,0
1/06/2018 20:30,28,69,45,64.4,73,66.1,2,0,0
1/06/2018 20:35,36,69.6,52,65.1,88,66.9,2,0,0
1/06/2018 20:40,33,69.7,49,65.1,82,67,2,0,0
1/06/2018 20:45,28,69.8,44,65.2,72,67,2,0,0
1/06/2018 20:50,28,70.1,43,65.5,71,67.3,2,0,0
1/06/2018 20:55,25,69.5,41,64.9,66,66.6,2,0,0
1/06/2018 21:00,32,68.9,49,64.2,81,66,2,0,0
1/06/2018 21:05,30,68.9,46,64.2,76,66.1,2,0,0
1/06/2018 21:10,22,68.6,38,64,60,65.7,2,0,0
1/06/2018 21:15,30,68.9,46,64.3,76,66.1,2,0,0
1/06/2018 21:20,36,69,53,64.4,89,66.2,2,0,0
1/06/2018 21:25,31,69,47,64.4,78,66.2,2,0,0
1/06/2018 21:30,33,68.8,49,64.2,82,66,2,0,0
1/06/2018 21:35,32,68.9,48,64.2,80,66.1,2,0,0
1/06/2018 21:40,23,68.7,39,64.1,62,65.8,2,0,0
1/06/2018 21:45,26,69.3,43,64.7,69,66.4,2,0,0
1/06/2018 21:50,30,69.1,46,64.5,76,66.3,2,0,0
1/06/2018 21:55,27,69.6,42,65,69,66.8,2,0,0
1/06/2018 22:00,29,69.4,45,64.7,74,66.5,2,0,0
1/06/2018 22:05,29,69.6,45,65,74,66.8,2,0,0
1/06/2018 22:10,25,69.3,41,64.7,66,66.5,2,0,0
1/06/2018 22:15,24,69.2,40,64.5,64,66.3,2,0,0
1/06/2018 22:20,24,69.6,39,65,63,66.8,2,0,0
1/06/2018 22:25,19,69.5,34,64.9,53,66.5,2,0,0
1/06/2018 22:30,31,69.6,47,65,78,66.9,2,0,0
1/06/2018 22:35,26,69.3,42,64.7,68,66.4,2,0,0
1/06/2018 22:40,24,69.5,39,64.9,63,66.6,2,0,0
1/06/2018 22:45,26,69.1,43,64.5,69,66.2,2,0,0
1/06/2018 22:50,23,69.3,38,64.6,61,66.4,2,0,0
1/06/2018 22:55,25,69.5,41,64.9,66,66.7,2,0,0
1/06/2018 23:00,21,69.5,37,64.9,58,66.5,2,0,0
1/06/2018 23:05,21,69.5,36,64.9,57,66.6,2,0,0
1/06/2018 23:10,21,69.6,36,65,57,66.7,2,0,0
1/06/2018 23:15,17,69.4,33,64.8,50,66.4,2,0,0
1/06/2018 23:20,19,69.4,34,64.8,53,66.5,2,0,0
1/06/2018 23:25,16,69.6,32,65,48,66.5,2,0,0
1/06/2018 23:30,16,69.3,32,64.7,48,66.2,2,0,0
1/06/2018 23:35,18,69.1,34,64.5,52,66.1,2,0,0
1/06/2018 23:40,21,69.2,36,64.6,57,66.3,2,0,0
1/06/2018 23:45,16,68.8,31,64.2,47,65.8,2,0,0
1/06/2018 23:50,12,69,28,64.4,40,65.8,2,0,0
1/06/2018 23:55,13,69.3,28,64.7,41,66.1,2,0,0
1/07/2018 0:00,17,69.3,32,64.7,49,66.3,2,0,0
1/07/2018 0:05,15,69.4,31,64.8,46,66.3,2,0,0
1/07/2018 0:10,20,69.5,36,64.9,56,66.6,2,0,0
1/07/2018 0:15,19,69.4,35,64.8,54,66.4,2,0,0
1/07/2018 0:20,12,69.3,28,64.7,40,66,2,0,0
1/07/2018 0:25,18,69.3,24,64.7,42,66.6,2,0,0
1/07/2018 0:30,10,69.3,25,64.7,35,66,2,0,0
1/07/2018 0:35,27,68.9,43,64.2,70,66,2,0,0
1/07/2018 0:40,16,68.9,31,64.2,47,65.8,2,0,0
1/07/2018 0:45,16,69.1,31,64.4,47,66,2,0,0
1/07/2018 0:50,12,69.2,28,64.6,40,66,2,0,0
1/07/2018 0:55,8,69.2,24,64.6,32,65.8,2,0,0
1/07/2018 1:00,10,69.2,25,64.5,35,65.9,2,0,0
1/07/2018 1:05,14,69.2,29,64.5,43,66,2,0,0
1/07/2018 1:10,11,69,26,64.3,37,65.7,2,0,0
1/07/2018 1:15,10,69.1,25,64.5,35,65.8,2,0,0
1/07/2018 1:20,13,69.2,28,64.6,41,66,2,0,0
1/07/2018 1:25,11,69.3,26,64.7,37,66.1,2,0,0
1/07/2018 1:30,9,69.3,24,64.7,33,66,2,0,0
1/07/2018 1:35,12,69.4,27,64.8,39,66.2,2,0,0
1/07/2018 1:40,12,69.3,27,64.7,39,66.1,2,0,0
1/07/2018 1:45,10,69.3,25,64.7,35,66,2,0,0
1/07/2018 1:50,9,69.3,24,64.7,33,66,2,0,0
1/07/2018 1:55,8,69.3,24,64.7,32,65.9,2,0,0
1/07/2018 2:00,9,69.4,24,64.8,33,66,2,0,0
1/07/2018 2:05,7,69.3,22,64.7,29,65.8,2,0,0
1/07/2018 2:10,12,69.3,27,64.7,39,66.1,2,0,0
1/07/2018 2:15,7,69.3,23,64.7,30,65.8,2,0,0
1/07/2018 2:20,12,69.3,26,64.7,38,66.1,2,0,0
1/07/2018 2:25,5,69.4,21,64.8,26,65.7,2,0,0
1/07/2018 2:30,10,69.3,25,64.7,35,66.1,2,0,0
1/07/2018 2:35,6,69.3,21,64.7,27,65.7,2,0,0
1/07/2018 2:40,8,69.3,23,64.7,31,65.9,2,0,0
1/07/2018 2:45,9,69.2,24,64.6,33,65.9,2,0,0
1/07/2018 2:50,10,69.3,25,64.7,35,66,2,0,0
1/07/2018 2:55,6,69.3,22,64.7,28,65.7,2,0,0
1/07/2018 3:00,9,69.2,25,64.6,34,65.8,2,0,0
1/07/2018 3:05,10,69.3,25,64.7,35,66,2,0,0
1/07/2018 3:10,11,69.3,21,64.7,32,66.2,2,0,0
1/07/2018 3:15,5,69.3,21,64.7,26,65.6,2,0,0
1/07/2018 3:20,8,69.3,24,64.7,32,65.8,2,0,0
1/07/2018 3:25,9,69.2,24,64.6,33,65.8,2,0,0
1/07/2018 3:30,7,69.2,22,64.6,29,65.7,2,0,0
1/07/2018 3:35,10,69.3,20,64.7,30,66.2,2,0,0
1/07/2018 3:40,8,69.3,23,64.7,31,65.9,2,0,0
1/07/2018 3:45,7,69.2,22,64.5,29,65.7,2,0,0
1/07/2018 3:50,9,69.3,24,64.7,33,66,2,0,0
1/07/2018 3:55,7,69.3,23,64.7,30,65.8,2,0,0
1/07/2018 4:00,7,69.3,22,64.7,29,65.8,2,0,0
1/07/2018 4:05,10,69.3,25,64.7,35,66,2,0,0
1/07/2018 4:10,9,69.2,24,64.6,33,65.9,2,0,0
1/07/2018 4:15,9,69.2,25,64.6,34,65.8,2,0,0
1/07/2018 4:20,10,69.3,25,64.7,35,66,2,0,0
1/07/2018 4:25,10,69.3,26,64.7,36,66,2,0,0
1/07/2018 4:30,10,69.3,25,64.7,35,66,2,0,0
1/07/2018 4:35,11,69.3,26,64.7,37,66.1,2,0,0
1/07/2018 4:40,12,69.3,28,64.7,40,66.1,2,0,0
1/07/2018 4:45,14,69.3,29,64.7,43,66.2,2,0,0
1/07/2018 4:50,12,68.8,28,64.2,40,65.6,2,0,0
1/07/2018 4:55,14,68.9,29,64.3,43,65.8,2,0,0
1/07/2018 5:00,10,69.1,25,64.5,35,65.8,2,0,0
1/07/2018 5:05,17,69.2,33,64.5,50,66.1,2,0,0
1/07/2018 5:10,15,69.2,31,64.6,46,66.1,2,0,0
1/07/2018 5:15,13,69.2,29,64.6,42,66,2,0,0
1/07/2018 5:20,15,69.2,31,64.5,46,66.1,2,0,0
1/07/2018 5:25,15,69.2,31,64.6,46,66.1,2,0,0
1/07/2018 5:30,17,69.1,32,64.4,49,66,2,0,0
1/07/2018 5:35,16,69.1,31,64.5,47,66.1,2,0,0
1/07/2018 5:40,14,69.1,30,64.5,44,66,2,0,0
1/07/2018 5:45,16,69.3,31,64.7,47,66.2,2,0,0
1/07/2018 5:50,14,69.2,30,64.5,44,66,2,0,0
1/07/2018 5:55,13,69.1,28,64.5,41,66,2,0,0
1/07/2018 6:00,15,69,30,64.4,45,65.9,2,0,0
1/07/2018 6:05,11,69,26,64.4,37,65.7,2,0,0
1/07/2018 6:10,14,68.9,30,64.2,44,65.7,2,0,0
1/07/2018 6:15,11,69,26,64.4,37,65.8,2,0,0
1/07/2018 6:20,16,69.1,32,64.5,48,66,2,0,0
1/07/2018 6:25,16,69.3,32,64.7,48,66.2,2,0,0
1/07/2018 6:30,13,69.3,29,64.7,42,66.1,2,0,0
1/07/2018 6:35,15,69.3,30,64.7,45,66.2,2,0,0
1/07/2018 6:40,14,69.2,30,64.6,44,66.1,2,0,0
1/07/2018 6:45,15,69.1,31,64.5,46,66,2,0,0
1/07/2018 6:50,15,69,31,64.4,46,65.9,2,0,0
1/07/2018 6:55,17,69.1,32,64.5,49,66.1,2,0,0
1/07/2018 7:00,22,69.1,38,64.4,60,66.1,2,0,0
1/07/2018 7:05,20,69.1,36,64.4,56,66.1,2,0,0
1/07/2018 7:10,20,68.8,36,64.1,56,65.8,2,0,0
1/07/2018 7:15,23,68.6,40,63.9,63,65.6,2,0,0
1/07/2018 7:20,17,69,32,64.3,49,65.9,2,0,0
1/07/2018 7:25,18,69,33,64.4,51,66,2,0,0
1/07/2018 7:30,22,69,38,64.4,60,66.1,2,0,0
1/07/2018 7:35,22,69.1,39,64.5,61,66.2,2,0,0
1/07/2018 7:40,24,69.3,39,64.7,63,66.5,2,0,0
1/07/2018 7:45,21,69.4,37,64.8,58,66.5,2,0,0
1/07/2018 7:50,27,69.2,43,64.6,70,66.4,2,0,0
1/07/2018 7:55,21,69.3,38,64.7,59,66.3,2,0,0
1/07/2018 8:00,18,69.2,34,64.6,52,66.2,2,0,0
1/07/2018 8:05,28,68.6,44,64,72,65.8,2,0,0
1/07/2018 8:10,28,68.8,45,64.2,73,65.9,2,0,0
1/07/2018 8:15,23,68.9,39,64.3,62,66,2,0,0
1/07/2018 8:20,27,69.2,43,64.5,70,66.3,2,0,0
1/07/2018 8:25,31,68.9,47,64.3,78,66.1,2,0,0
1/07/2018 8:30,28,69.2,44,64.6,72,66.4,2,0,0
1/07/2018 8:35,29,69.5,46,64.9,75,66.7,2,0,0
1/07/2018 8:40,33,69,50,64.4,83,66.2,2,0,0
1/07/2018 8:45,38,69.1,55,64.5,93,66.4,2,0,0
1/07/2018 8:50,36,69.3,52,64.7,88,66.6,2,0,0
1/07/2018 8:55,28,69.2,45,64.5,73,66.3,2,0,0
1/07/2018 9:00,27,69.4,43,64.7,70,66.5,2,0,0
1/07/2018 9:05,35,68.8,51,64.1,86,66,2,0,0
1/07/2018 9:10,33,68.2,50,63.5,83,65.4,2,0,0
1/07/2018 9:15,33,69.1,49,64.5,82,66.4,2,0,0
1/07/2018 9:20,40,69.2,58,64.6,98,66.5,2,0,0
1/07/2018 9:25,36,68.8,53,64.1,89,66,2,0,0
1/07/2018 9:30,37,69.5,54,64.9,91,66.8,2,0,0
1/07/2018 9:35,42,69.2,60,64.6,102,66.5,2,0,0
1/07/2018 9:40,44,69.5,61,64.9,105,66.8,2,0,0
1/07/2018 9:45,50,69,68,64.3,118,66.3,2,0,0
1/07/2018 9:50,40,69.4,58,64.8,98,66.7,2,0,0
1/07/2018 9:55,46,69.2,64,64.6,110,66.5,2,0,0
1/07/2018 10:00,43,68.6,61,63.9,104,65.9,2,0,0
1/07/2018 10:05,46,68.9,64,64.3,110,66.2,2,0,0
1/07/2018 10:10,56,68.9,74,64.2,130,66.2,2,0,0
1/07/2018 10:15,49,68.4,67,63.7,116,65.7,2,0,0
1/07/2018 10:20,53,68.7,70,63.9,123,66,2,0,0
1/07/2018 10:25,53,69.3,70,64.6,123,66.6,2,0,0
1/07/2018 10:30,57,69.1,75,64.4,132,66.4,2,0,0
1/07/2018 10:35,50,69.3,67,64.7,117,66.6,2,0,0
1/07/2018 10:40,45,69,62,64.3,107,66.3,2,0,0
1/07/2018 10:45,55,68.2,73,63.4,128,65.5,2,0,0
1/07/2018 10:50,50,68.8,67,64,117,66,2,0,0
1/07/2018 10:55,60,68.7,78,64,138,66,2,0,0
1/07/2018 11:00,52,68.8,70,64.1,122,66.1,2,0,0
1/07/2018 11:05,57,68.3,75,63.6,132,65.6,2,0,0
1/07/2018 11:10,57,67.8,75,63,132,65.1,2,0,0
1/07/2018 11:15,58,68.2,77,63.4,135,65.5,2,0,0
1/07/2018 11:20,50,68.4,68,63.6,118,65.6,2,0,0
1/07/2018 11:25,60,68.5,79,63.7,139,65.7,2,0,0
1/07/2018 11:30,49,68,66,63.2,115,65.3,2,0,0
1/07/2018 11:35,54,68.1,71,63.3,125,65.4,2,0,0
1/07/2018 11:40,43,68.7,60,64,103,66,2,0,0
1/07/2018 11:45,59,68.1,78,63.3,137,65.4,2,0,0
1/07/2018 11:50,58,68.1,77,63.4,135,65.4,2,0,0
1/07/2018 11:55,52,68.9,70,64.2,122,66.2,2,0,0
1/07/2018 12:00,54,68.7,72,64.1,126,66.1,2,0,0
1/07/2018 12:05,46,68.9,64,64.3,110,66.2,2,0,0
1/07/2018 12:10,39,69,56,64.3,95,66.2,2,0,0
1/07/2018 12:15,51,69.3,68,64.7,119,66.6,2,0,0
1/07/2018 12:20,55,69.3,73,64.7,128,66.7,2,0,0
1/07/2018 12:25,48,69,65,64.3,113,66.3,2,0,0
1/07/2018 12:30,50,68.6,68,64,118,66,2,0,0
1/07/2018 12:35,44,68.9,61,64.3,105,66.2,2,0,0
1/07/2018 12:40,52,69.2,71,64.6,123,66.5,2,0,0
1/07/2018 12:45,53,69.3,69,64.7,122,66.7,2,0,0
1/07/2018 12:50,55,68.9,73,64.3,128,66.3,2,0,0
1/07/2018 12:55,54,69.1,72,64.5,126,66.5,2,0,0
1/07/2018 13:00,44,69.3,61,64.7,105,66.6,2,0,0
1/07/2018 13:05,54,69.2,72,64.6,126,66.6,2,0,0
1/07/2018 13:10,50,69.2,67,64.6,117,66.5,2,0,0
1/07/2018 13:15,62,68.6,80,63.9,142,66,2,0,0
1/07/2018 13:20,54,68.8,72,64.2,126,66.2,2,0,0
1/07/2018 13:25,50,68.9,68,64.2,118,66.2,2,0,0
1/07/2018 13:30,54,68.7,72,64,126,66,2,0,0
1/07/2018 13:35,53,68.6,70,64,123,66,2,0,0
1/07/2018 13:40,65,68.7,83,64,148,66,2,0,0
1/07/2018 13:45,62,67.6,79,62.8,141,64.9,2,0,0
1/07/2018 13:50,59,67.5,76,62.6,135,64.7,2,0,0
1/07/2018 13:55,48,68.3,65,63.6,113,65.6,2,0,0
1/07/2018 14:00,49,68.3,66,63.5,115,65.6,2,0,0
1/07/2018 14:05,46,68.4,63,63.6,109,65.6,2,0,0
1/07/2018 14:10,56,68.2,74,63.5,130,65.5,2,0,0
1/07/2018 14:15,46,68.8,63,64.1,109,66.1,2,0,0
1/07/2018 14:20,51,69.2,69,64.6,120,66.5,2,0,0
1/07/2018 14:25,58,68.9,75,64.2,133,66.2,2,0,0
1/07/2018 14:30,51,68.9,68,64.2,119,66.2,2,0,0
1/07/2018 14:35,49,68.9,67,64.2,116,66.2,2,0,0
1/07/2018 14:40,49,68.6,67,63.9,116,65.8,2,0,0
1/07/2018 14:45,60,68,78,63.3,138,65.3,2,0,0
1/07/2018 14:50,48,68.3,66,63.5,114,65.5,2,0,0
1/07/2018 14:55,46,67.9,64,63.2,110,65.2,2,0,0
1/07/2018 15:00,54,68.2,73,63.5,127,65.5,2,0,0
1/07/2018 15:05,47,68.3,65,63.6,112,65.6,2,0,0
1/07/2018 15:10,48,68.8,66,64.1,114,66,2,0,0
1/07/2018 15:15,53,69.3,69,64.6,122,66.6,2,0,0
1/07/2018 15:20,54,69,72,64.4,126,66.3,2,0,0
1/07/2018 15:25,49,68.9,66,64.3,115,66.3,2,0,0
1/07/2018 15:30,48,68.7,65,64.1,113,66,2,0,0
1/07/2018 15:35,50,68.5,68,63.8,118,65.7,2,0,0
1/07/2018 15:40,56,68.5,73,63.8,129,65.8,2,0,0
1/07/2018 15:45,59,68.6,76,63.9,135,65.9,2,0,0
1/07/2018 15:50,50,68.2,68,63.4,118,65.4,2,0,0
1/07/2018 15:55,47,69.1,64,64.5,111,66.4,2,0,0
1/07/2018 16:00,47,69.1,65,64.5,112,66.4,2,0,0
1/07/2018 16:05,50,69.3,66,64.7,116,66.6,2,0,0
1/07/2018 16:10,45,68.4,63,63.7,108,65.6,2,0,0
1/07/2018 16:15,56,68,73,63.2,129,65.3,2,0,0
1/07/2018 16:20,48,68.1,65,63.4,113,65.4,2,0,0
1/07/2018 16:25,57,69,74,64.4,131,66.4,2,0,0
1/07/2018 16:30,46,69.2,63,64.5,109,66.5,2,0,0
1/07/2018 16:35,48,68.7,65,64.1,113,66.1,2,0,0
1/07/2018 16:40,49,68.5,67,63.8,116,65.8,2,0,0
1/07/2018 16:45,48,68.2,66,63.5,114,65.5,2,0,0
1/07/2018 16:50,50,67.5,67,62.8,117,64.8,2,0,0
1/07/2018 16:55,57,67.8,75,63,132,65.1,2,0,0
1/07/2018 17:00,58,68.2,77,63.5,135,65.5,2,0,0
1/07/2018 17:05,46,69,63,64.4,109,66.4,2,0,0
1/07/2018 17:10,45,69.2,62,64.6,107,66.6,2,0,0
1/07/2018 17:15,48,69.3,65,64.7,113,66.6,2,0,0
1/07/2018 17:20,55,68.7,73,64,128,66,2,0,0
1/07/2018 17:25,48,68.5,66,63.8,114,65.8,2,0,0
1/07/2018 17:30,50,68.6,66,63.8,116,65.9,2,0,0
1/07/2018 17:35,61,68.1,79,63.4,140,65.5,2,0,0
1/07/2018 17:40,51,68.1,68,63.4,119,65.4,2,0,0
1/07/2018 17:45,52,68.5,70,63.8,122,65.8,2,0,0
1/07/2018 17:50,47,69,64,64.4,111,66.4,2,0,0
1/07/2018 17:55,47,68.7,65,64,112,65.9,2,0,0
1/07/2018 18:00,43,68.5,60,63.8,103,65.7,2,0,0
1/07/2018 18:05,35,69.1,52,64.4,87,66.3,2,0,0
1/07/2018 18:10,47,69.1,64,64.5,111,66.5,2,0,0
1/07/2018 18:15,43,69.4,61,64.8,104,66.7,2,0,0
1/07/2018 18:20,49,69.2,67,64.6,116,66.6,2,0,0
1/07/2018 18:25,43,69.3,60,64.7,103,66.6,2,0,0
1/07/2018 18:30,36,69.4,52,64.8,88,66.7,2,0,0
1/07/2018 18:35,50,68.8,67,64.2,117,66.2,2,0,0
1/07/2018 18:40,47,69.2,64,64.6,111,66.6,2,0,0
1/07/2018 18:45,43,69.3,60,64.7,103,66.6,2,0,0
1/07/2018 18:50,45,69.2,62,64.6,107,66.6,2,0,0
1/07/2018 18:55,42,69.4,59,64.8,101,66.7,2,0,0
1/07/2018 19:00,34,69.8,51,65.3,85,67.1,2,0,0
1/07/2018 19:05,36,69.7,53,65.1,89,66.9,2,0,0
1/07/2018 19:10,32,69.3,48,64.6,80,66.5,2,0,0
1/07/2018 19:15,41,70.1,58,65.6,99,67.5,2,0,0
1/07/2018 19:20,42,69.7,59,65.1,101,67,2,0,0
1/07/2018 19:25,37,69.3,53,64.7,90,66.6,2,0,0
1/07/2018 19:30,30,69.2,46,64.5,76,66.3,2,0,0
1/07/2018 19:35,34,69.4,50,64.8,84,66.6,2,0,0
1/07/2018 19:40,30,69.3,46,64.7,76,66.5,2,0,0
1/07/2018 19:45,33,69.2,49,64.6,82,66.5,2,0,0
1/07/2018 19:50,33,68.8,49,64.2,82,66.1,2,0,0
1/07/2018 19:55,33,68.8,50,64.1,83,66,2,0,0
1/07/2018 20:00,30,69.3,47,64.7,77,66.5,2,0,0
1/07/2018 20:05,28,69,44,64.3,72,66.1,2,0,0
1/07/2018 20:10,34,68.5,51,63.8,85,65.7,2,0,0
1/07/2018 20:15,26,68.9,42,64.2,68,66,2,0,0
1/07/2018 20:20,28,68.7,44,64,72,65.8,2,0,0
1/07/2018 20:25,27,69.1,43,64.5,70,66.3,2,0,0
1/07/2018 20:30,23,68.9,39,64.2,62,66,2,0,0
1/07/2018 20:35,27,68.1,43,63.4,70,65.3,2,0,0
1/07/2018 20:40,29,68.6,44,64,73,65.8,2,0,0
1/07/2018 20:45,26,69,42,64.4,68,66.1,2,0,0
1/07/2018 20:50,30,69,46,64.4,76,66.2,2,0,0
1/07/2018 20:55,20,69.3,36,64.7,56,66.3,2,0,0
1/07/2018 21:00,26,69.2,43,64.5,69,66.3,2,0,0
1/07/2018 21:05,27,69,42,64.4,69,66.2,2,0,0
1/07/2018 21:10,28,68.8,44,64.2,72,66,2,0,0
1/07/2018 21:15,23,69.1,39,64.4,62,66.2,2,0,0
1/07/2018 21:20,28,68.9,45,64.2,73,66,2,0,0
1/07/2018 21:25,24,69.4,40,64.8,64,66.5,2,0,0
1/07/2018 21:30,22,69.4,38,64.8,60,66.5,2,0,0
1/07/2018 21:35,25,69.4,42,64.8,67,66.5,2,0,0
1/07/2018 21:40,21,68.7,37,64.1,58,65.8,2,0,0
1/07/2018 21:45,22,69,38,64.3,60,66,2,0,0
1/07/2018 21:50,25,69.2,41,64.6,66,66.4,2,0,0
1/07/2018 21:55,21,69.4,36,64.8,57,66.5,2,0,0
1/07/2018 22:00,24,68.9,40,64.3,64,66,2,0,0
1/07/2018 22:05,20,69,36,64.4,56,66,2,0,0
1/07/2018 22:10,19,69.1,35,64.4,54,66.1,2,0,0
1/07/2018 22:15,16,69.2,32,64.5,48,66.1,2,0,0
1/07/2018 22:20,16,69.2,31,64.5,47,66.1,2,0,0
1/07/2018 22:25,18,68.8,34,64.2,52,65.8,2,0,0
1/07/2018 22:30,18,69.1,34,64.5,52,66.1,2,0,0
1/07/2018 22:35,18,69.1,34,64.5,52,66.1,2,0,0
1/07/2018 22:40,16,69.4,32,64.8,48,66.3,2,0,0
1/07/2018 22:45,17,69.4,33,64.8,50,66.4,2,0,0
1/07/2018 22:50,14,69.4,30,64.8,44,66.2,2,0,0
1/07/2018 22:55,16,69.2,32,64.6,48,66.2,2,0,0
1/07/2018 23:00,19,69.3,35,64.7,54,66.3,2,0,0
1/07/2018 23:05,13,69.3,28,64.7,41,66.1,2,0,0
1/07/2018 23:10,20,69.2,35,64.6,55,66.3,2,0,0
1/07/2018 23:15,14,69.4,30,64.8,44,66.2,2,0,0
1/07/2018 23:20,15,69.4,31,64.8,46,66.3,2,0,0
1/07/2018 23:25,18,69.3,33,64.7,51,66.3,2,0,0
1/07/2018 23:30,12,69.3,27,64.7,39,66.2,2,0,0
1/07/2018 23:35,15,69.3,30,64.7,45,66.3,2,0,0
1/07/2018 23:40,14,69.3,29,64.7,43,66.2,2,0,0
1/07/2018 23:45,9,69.3,25,64.7,34,65.9,2,0,0
1/07/2018 23:50,11,69.3,26,64.7,37,66.1,2,0,0
1/07/2018 23:55,9,69.3,24,64.7,33,66,2,0,0
