5 Minutes,Lane 1 Flow (Veh/5 Minutes),Lane 1 Speed (mph),Lane 2 Flow (Veh/5 Minutes),Lane 2 Speed (mph),Flow (Veh/5 Minutes),Speed (mph),# Lane Points,% Observed,Holiday
1/08/2018 0:00,7,69.3,22,64.7,29,65.8,2,0,0
1/08/2018 0:05,13,68.9,28,64.3,41,65.7,2,0,0
1/08/2018 0:10,9,69.1,25,64.5,34,65.7,2,0,0
1/08/2018 0:15,11,69.2,27,64.6,38,65.9,2,0,0
1/08/2018 0:20,9,69.3,24,64.7,33,65.9,2,0,0
1/08/2018 0:25,9,69.2,24,64.6,33,65.9,2,0,0
1/08/2018 0:30,9,69.1,24,64.5,33,65.8,2,0,0
1/08/2018 0:35,8,69.3,23,64.7,31,65.8,2,0,0
1/08/2018 0:40,10,69.1,25,64.5,35,65.8,2,0,0
1/08/2018 0:45,8,69.2,23,64.5,31,65.7,2,0,0
1/08/2018 0:50,9,69.2,25,64.6,34,65.8,2,0,0
1/08/2018 0:55,7,69.1,23,64.5,30,65.6,2,0,0
1/08/2018 1:00,5,69.2,20,64.6,25,65.5,2,0,0
1/08/2018 1:05,8,69.2,24,64.6,32,65.8,2,0,0
1/08/2018 1:10,8,69.2,23,64.6,31,65.8,2,0,0
1/08/2018 1:15,8,69.2,23,64.6,31,65.8,2,0,0
1/08/2018 1:20,7,69.2,22,64.6,29,65.7,2,0,0
1/08/2018 1:25,10,69.2,20,64.6,30,66.2,2,0,0
1/08/2018 1:30,6,69.2,21,64.6,27,65.6,2,0,0
1/08/2018 1:35,6,69.3,21,64.7,27,65.7,2,0,0
1/08/2018 1:40,7,68.8,22,64.1,29,65.2,2,0,0
1/08/2018 1:45,6,68.8,21,64.2,27,65.2,2,0,0
1/08/2018 1:50,5,69,20,64.4,25,65.3,2,0,0
1/08/2018 1:55,13,69.2,21,64.5,34,66.3,2,0,0
1/08/2018 2:00,5,69.1,20,64.5,25,65.4,2,0,0
1/08/2018 2:05,11,69.2,21,64.6,32,66.2,2,0,0
1/08/2018 2:10,8,69.2,24,64.6,32,65.7,2,0,0
1/08/2018 2:15,6,69.2,21,64.6,27,65.6,2,0,0
1/08/2018 2:20,6,69.2,21,64.6,27,65.6,2,0,0
1/08/2018 2:25,8,68.7,23,64,31,65.2,2,0,0
1/08/2018 2:30,6,68.9,21,64.2,27,65.2,2,0,0
1/08/2018 2:35,6,69,22,64.4,28,65.3,2,0,0
1/08/2018 2:40,10,68.9,26,64.3,36,65.6,2,0,0
1/08/2018 2:45,10,68.9,26,64.2,36,65.5,2,0,0
1/08/2018 2:50,12,69.1,21,64.4,33,66.1,2,0,0
1/08/2018 2:55,10,69.1,25,64.5,35,65.8,2,0,0
1/08/2018 3:00,10,68.4,25,63.7,35,65,2,0,0
1/08/2018 3:05,13,68.7,29,64.1,42,65.5,2,0,0
1/08/2018 3:10,8,68.9,24,64.2,32,65.4,2,0,0
1/08/2018 3:15,9,69,24,64.4,33,65.6,2,0,0
1/08/2018 3:20,10,69.2,25,64.5,35,65.9,2,0,0
1/08/2018 3:25,6,69.2,21,64.6,27,65.6,2,0,0
1/08/2018 3:30,11,69.1,27,64.5,38,65.9,2,0,0
1/08/2018 3:35,13,69.1,29,64.4,42,65.9,2,0,0
1/08/2018 3:40,14,69,30,64.3,44,65.8,2,0,0
1/08/2018 3:45,15,68.8,30,64.1,45,65.7,2,0,0
1/08/2018 3:50,19,68.8,35,64.2,54,65.8,2,0,0
1/08/2018 3:55,12,69,27,64.3,39,65.7,2,0,0
1/08/2018 4:00,16,68.4,32,63.7,48,65.3,2,0,0
1/08/2018 4:05,15,68.3,31,63.6,46,65.1,2,0,0
1/08/2018 4:10,19,68.4,35,63.7,54,65.3,2,0,0
1/08/2018 4:15,20,67.9,36,63.1,56,64.8,2,0,0
1/08/2018 4:20,22,67.8,38,63.1,60,64.8,2,0,0
1/08/2018 4:25,24,67.1,40,62.2,64,64,2,0,0
1/08/2018 4:30,26,64.6,42,59.6,68,61.5,2,0,0
1/08/2018 4:35,29,64.4,45,59.3,74,61.3,2,0,0
1/08/2018 4:40,33,64.7,49,59.6,82,61.7,2,0,0
1/08/2018 4:45,42,60,58,54.2,100,56.6,2,0,0
1/08/2018 4:50,36,59.6,51,53.9,87,56.3,2,0,0
1/08/2018 4:55,36,57.9,52,52,88,54.4,2,0,0
1/08/2018 5:00,39,57.1,56,51.1,95,53.6,2,0,0
1/08/2018 5:05,33,55.3,49,49.2,82,51.6,2,0,0
1/08/2018 5:10,49,54.6,66,48.4,115,51.1,2,0,0
1/08/2018 5:15,31,58.6,47,52.9,78,55.1,2,0,0
1/08/2018 5:20,27,61.5,43,56.1,70,58.2,2,0,0
1/08/2018 5:25,30,62.4,45,57.2,75,59.3,2,0,0
1/08/2018 5:30,27,64.2,44,59.1,71,61,2,0,0
1/08/2018 5:35,23,65.4,39,60.4,62,62.2,2,0,0
1/08/2018 5:40,26,66.5,42,61.6,68,63.4,2,0,0
1/08/2018 5:45,32,65.5,50,60.5,82,62.5,2,0,0
1/08/2018 5:50,32,65,49,59.9,81,61.9,2,0,0
1/08/2018 5:55,37,59.3,54,53.6,91,55.9,2,0,0
1/08/2018 6:00,25,62.7,41,57.4,66,59.4,2,0,0
1/08/2018 6:05,29,64.4,45,59.3,74,61.3,2,0,0
1/08/2018 6:10,38,63.3,55,58.1,93,60.2,2,0,0
1/08/2018 6:15,33,62.8,50,57.6,83,59.7,2,0,0
1/08/2018 6:20,27,63.7,43,58.5,70,60.5,2,0,0
1/08/2018 6:25,32,63.3,48,58.1,80,60.2,2,0,0
1/08/2018 6:30,32,63.8,50,58.6,82,60.7,2,0,0
1/08/2018 6:35,37,63.2,54,57.9,91,60.1,2,0,0
1/08/2018 6:40,37,63.1,55,57.9,92,60,2,0,0
1/08/2018 6:45,43,62.3,61,56.9,104,59.1,2,0,0
1/08/2018 6:50,64,61.2,85,55.7,149,58,2,0,0
1/08/2018 6:55,65,60.7,85,55.1,150,57.5,2,0,0
1/08/2018 7:00,73,59.1,95,53.4,168,55.9,2,0,0
1/08/2018 7:05,75,59.2,98,53.5,173,56,2,0,0
1/08/2018 7:10,61,59.3,81,53.6,142,56,2,0,0
1/08/2018 7:15,74,59,96,53.2,170,55.7,2,0,0
1/08/2018 7:20,79,59,102,53.2,181,55.7,2,0,0
1/08/2018 7:25,72,58.3,95,52.5,167,55,2,0,0
1/08/2018 7:30,72,59.2,94,53.5,166,56,2,0,0
1/08/2018 7:35,81,59.2,104,53.4,185,55.9,2,0,0
1/08/2018 7:40,93,58.6,117,52.8,210,55.4,2,0,0
1/08/2018 7:45,80,58.2,103,52.4,183,54.9,2,0,0
1/08/2018 7:50,85,58.7,108,52.9,193,55.4,2,0,0
1/08/2018 7:55,69,59.9,90,54.3,159,56.7,2,0,0
1/08/2018 8:00,69,60.9,91,55.4,160,57.8,2,0,0
1/08/2018 8:05,58,61.1,79,55.6,137,57.9,2,0,0
1/08/2018 8:10,76,60.6,99,55,175,57.4,2,0,0
1/08/2018 8:15,73,59.9,93,54.3,166,56.8,2,0,0
1/08/2018 8:20,72,59.5,95,53.8,167,56.3,2,0,0
1/08/2018 8:25,71,59.6,93,53.9,164,56.4,2,0,0
1/08/2018 8:30,66,59.1,87,53.4,153,55.9,2,0,0
1/08/2018 8:35,75,58.2,97,52.4,172,54.9,2,0,0
1/08/2018 8:40,74,58.2,95,52.3,169,54.9,2,0,0
1/08/2018 8:45,74,59.2,95,53.5,169,56,2,0,0
1/08/2018 8:50,73,59.4,94,53.7,167,56.2,2,0,0
1/08/2018 8:55,75,59.4,96,53.7,171,56.2,2,0,0
1/08/2018 9:00,66,59.9,87,54.2,153,56.7,2,0,0
1/08/2018 9:05,71,60.1,92,54.4,163,56.9,2,0,0
1/08/2018 9:10,58,59.8,79,54.1,137,56.5,2,0,0
1/08/2018 9:15,64,61.1,84,55.5,148,57.9,2,0,0
1/08/2018 9:20,67,60.6,88,54.9,155,57.4,2,0,0
1/08/2018 9:25,62,59.7,82,54,144,56.5,2,0,0
1/08/2018 9:30,63,60.7,83,55.2,146,57.6,2,0,0
1/08/2018 9:35,62,61.5,83,56,145,58.3,2,0,0
1/08/2018 9:40,65,61.7,86,56.3,151,58.6,2,0,0
1/08/2018 9:45,60,61.3,79,55.8,139,58.2,2,0,0
1/08/2018 9:50,71,61.7,91,56.3,162,58.7,2,0,0
1/08/2018 9:55,77,61.4,98,56,175,58.4,2,0,0
1/08/2018 10:00,69,60.7,89,55.2,158,57.6,2,0,0
1/08/2018 10:05,63,60.1,82,54.5,145,56.9,2,0,0
1/08/2018 10:10,78,59.7,98,54.1,176,56.6,2,0,0
1/08/2018 10:15,64,60.3,83,54.7,147,57.2,2,0,0
1/08/2018 10:20,57,60.8,75,55.3,132,57.7,2,0,0
1/08/2018 10:25,51,62.3,69,57,120,59.2,2,0,0
1/08/2018 10:30,48,61.3,65,55.9,113,58.2,2,0,0
1/08/2018 10:35,55,61.2,74,55.8,129,58.1,2,0,0
1/08/2018 10:40,43,61.1,60,55.7,103,58,2,0,0
1/08/2018 10:45,43,60.7,60,55.3,103,57.6,2,0,0
1/08/2018 10:50,47,61.6,65,56.2,112,58.4,2,0,0
1/08/2018 10:55,45,61.5,62,56.1,107,58.4,2,0,0
1/08/2018 11:00,38,61.8,55,56.4,93,58.6,2,0,0
1/08/2018 11:05,34,62.9,51,57.6,85,59.7,2,0,0
1/08/2018 11:10,48,61,65,55.4,113,57.8,2,0,0
1/08/2018 11:15,42,60.7,58,55.3,100,57.6,2,0,0
1/08/2018 11:20,40,61.1,57,55.7,97,57.9,2,0,0
1/08/2018 11:25,43,60.3,61,54.7,104,57,2,0,0
1/08/2018 11:30,40,60.7,57,55.3,97,57.5,2,0,0
1/08/2018 11:35,41,59.3,59,53.7,100,56,2,0,0
1/08/2018 11:40,45,60.1,62,54.5,107,56.9,2,0,0
1/08/2018 11:45,45,60.4,62,54.8,107,57.2,2,0,0
1/08/2018 11:50,42,61.3,58,55.8,100,58.1,2,0,0
1/08/2018 11:55,42,61.5,58,56.1,100,58.4,2,0,0
1/08/2018 12:00,41,61,58,55.5,99,57.8,2,0,0
1/08/2018 12:05,38,61.1,55,55.7,93,57.9,2,0,0
1/08/2018 12:10,42,60.8,59,55.4,101,57.6,2,0,0
1/08/2018 12:15,42,60.3,58,54.8,100,57.1,2,0,0
1/08/2018 12:20,41,60.6,58,55.1,99,57.4,2,0,0
1/08/2018 12:25,44,61.2,61,55.8,105,58.1,2,0,0
1/08/2018 12:30,32,62.9,48,57.7,80,59.8,2,0,0
1/08/2018 12:35,34,63.2,50,58.1,84,60.2,2,0,0
1/08/2018 12:40,36,63.5,52,58.3,88,60.4,2,0,0
1/08/2018 12:45,37,63.4,54,58.2,91,60.3,2,0,0
1/08/2018 12:50,41,61.2,57,55.9,98,58.2,2,0,0
1/08/2018 12:55,46,61.8,63,56.5,109,58.7,2,0,0
1/08/2018 13:00,38,62.1,54,56.9,92,59,2,0,0
1/08/2018 13:05,43,61.3,58,56,101,58.3,2,0,0
1/08/2018 13:10,45,62,61,56.7,106,58.9,2,0,0
1/08/2018 13:15,39,60.8,56,55.4,95,57.6,2,0,0
1/08/2018 13:20,42,59.9,59,54.3,101,56.6,2,0,0
1/08/2018 13:25,39,60.5,55,55.1,94,57.3,2,0,0
1/08/2018 13:30,39,61.4,56,56,95,58.2,2,0,0
1/08/2018 13:35,37,60.5,54,55,91,57.3,2,0,0
1/08/2018 13:40,29,63.4,44,58.2,73,60.3,2,0,0
1/08/2018 13:45,28,64.1,44,59,72,61,2,0,0
1/08/2018 13:50,39,63.1,56,57.9,95,60.1,2,0,0
1/08/2018 13:55,34,63.5,50,58.4,84,60.5,2,0,0
1/08/2018 14:00,41,62.4,58,57,99,59.3,2,0,0
1/08/2018 14:05,39,62.5,54,57.3,93,59.5,2,0,0
1/08/2018 14:10,30,62.6,46,57.5,76,59.5,2,0,0
1/08/2018 14:15,43,61.8,59,56.5,102,58.7,2,0,0
1/08/2018 14:20,35,62.8,51,57.7,86,59.8,2,0,0
1/08/2018 14:25,36,62.9,53,57.7,89,59.8,2,0,0
1/08/2018 14:30,40,63.4,56,58.2,96,60.4,2,0,0
1/08/2018 14:35,39,62.9,55,57.7,94,59.8,2,0,0
1/08/2018 14:40,48,62.8,64,57.6,112,59.8,2,0,0
1/08/2018 14:45,44,62.5,61,57.2,105,59.4,2,0,0
1/08/2018 14:50,43,62.6,60,57.4,103,59.5,2,0,0
1/08/2018 14:55,43,63,59,57.8,102,60,2,0,0
1/08/2018 15:00,41,63.8,57,58.7,98,60.9,2,0,0
1/08/2018 15:05,47,62.9,63,57.8,110,60,2,0,0
1/08/2018 15:10,42,63.8,59,58.6,101,60.8,2,0,0
1/08/2018 15:15,40,63.7,58,58.5,98,60.6,2,0,0
1/08/2018 15:20,50,62.7,67,57.4,117,59.7,2,0,0
1/08/2018 15:25,46,62.7,64,57.3,110,59.6,2,0,0
1/08/2018 15:30,43,63.9,60,58.7,103,60.9,2,0,0
1/08/2018 15:35,49,63.9,68,58.8,117,60.9,2,0,0
1/08/2018 15:40,45,63.7,62,58.5,107,60.7,2,0,0
1/08/2018 15:45,52,64,69,58.8,121,61,2,0,0
1/08/2018 15:50,41,63.6,59,58.3,100,60.5,2,0,0
1/08/2018 15:55,46,63.6,64,58.4,110,60.6,2,0,0
1/08/2018 16:00,47,62.6,63,57.3,110,59.6,2,0,0
1/08/2018 16:05,43,63,59,57.8,102,60,2,0,0
1/08/2018 16:10,52,62.3,70,57,122,59.3,2,0,0
1/08/2018 16:15,45,63.4,61,58.1,106,60.4,2,0,0
1/08/2018 16:20,52,63.8,69,58.6,121,60.8,2,0,0
1/08/2018 16:25,45,63,62,57.7,107,59.9,2,0,0
1/08/2018 16:30,53,62.8,71,57.5,124,59.8,2,0,0
1/08/2018 16:35,52,63.1,68,57.8,120,60.1,2,0,0
1/08/2018 16:40,53,63.2,70,57.9,123,60.2,2,0,0
1/08/2018 16:45,43,63.5,61,58.4,104,60.5,2,0,0
1/08/2018 16:50,48,64.4,65,59.3,113,61.5,2,0,0
1/08/2018 16:55,52,63.3,69,58.2,121,60.4,2,0,0
1/08/2018 17:00,57,64.2,75,59.1,132,61.3,2,0,0
1/08/2018 17:05,57,65.2,75,60.2,132,62.3,2,0,0
1/08/2018 17:10,52,64.3,69,59.2,121,61.4,2,0,0
1/08/2018 17:15,59,60.3,77,54.8,136,57.2,2,0,0
1/08/2018 17:20,53,55.4,72,49.2,125,51.9,2,0,0
1/08/2018 17:25,53,48.6,72,41.7,125,44.6,2,0,0
1/08/2018 17:30,49,44.5,68,37.2,117,40.3,2,0,0
1/08/2018 17:35,41,47.7,58,40.6,99,43.5,2,0,0
1/08/2018 17:40,45,53.5,64,47.1,109,49.7,2,0,0
1/08/2018 17:45,48,56.4,66,50.3,114,52.9,2,0,0
1/08/2018 17:50,47,56.9,64,50.9,111,53.5,2,0,0
1/08/2018 17:55,42,57.9,60,52.1,102,54.5,2,0,0
1/08/2018 18:00,52,57.7,71,51.8,123,54.3,2,0,0
1/08/2018 18:05,43,55.3,60,49.1,103,51.7,2,0,0
1/08/2018 18:10,47,50.5,65,43.9,112,46.7,2,0,0
1/08/2018 18:15,41,45.1,59,37.9,100,40.9,2,0,0
1/08/2018 18:20,38,45.2,56,38,94,40.9,2,0,0
1/08/2018 18:25,35,52.5,52,46.1,87,48.7,2,0,0
1/08/2018 18:30,31,58.1,48,52.3,79,54.6,2,0,0
1/08/2018 18:35,27,61.9,43,56.6,70,58.6,2,0,0
1/08/2018 18:40,41,60.6,58,55,99,57.3,2,0,0
1/08/2018 18:45,36,61.1,53,55.5,89,57.8,2,0,0
1/08/2018 18:50,31,63.1,48,57.8,79,59.9,2,0,0
1/08/2018 18:55,28,62.6,44,57.4,72,59.4,2,0,0
1/08/2018 19:00,32,62.5,48,57.3,80,59.4,2,0,0
1/08/2018 19:05,19,64,34,58.9,53,60.7,2,0,0
1/08/2018 19:10,39,60.5,55,55.1,94,57.3,2,0,0
1/08/2018 19:15,20,63.3,36,58.2,56,60,2,0,0
1/08/2018 19:20,21,62.9,38,57.6,59,59.5,2,0,0
1/08/2018 19:25,7,64.7,19,59.6,26,61,2,0,0
1/08/2018 19:30,40,60.3,57,54.6,97,56.9,2,0,0
1/08/2018 19:35,49,57.8,67,51.8,116,54.3,2,0,0
1/08/2018 19:40,24,62,39,56.6,63,58.7,2,0,0
1/08/2018 19:45,24,64,40,58.9,64,60.8,2,0,0
1/08/2018 19:50,25,64.1,41,59.1,66,61,2,0,0
1/08/2018 19:55,25,65.1,40,60.1,65,62,2,0,0
1/08/2018 20:00,23,66,39,61.1,62,62.9,2,0,0
1/08/2018 20:05,29,65.2,45,60.3,74,62.2,2,0,0
1/08/2018 20:10,23,65.8,39,60.9,62,62.7,2,0,0
1/08/2018 20:15,27,66.3,43,61.4,70,63.3,2,0,0
1/08/2018 20:20,26,65.2,41,60.3,67,62.2,2,0,0
1/08/2018 20:25,21,66.2,36,61.4,57,63.2,2,0,0
1/08/2018 20:30,26,66.2,42,61.3,68,63.2,2,0,0
1/08/2018 20:35,25,66.3,41,61.5,66,63.3,2,0,0
1/08/2018 20:40,27,66.5,43,61.7,70,63.5,2,0,0
1/08/2018 20:45,20,66.7,35,61.9,55,63.6,2,0,0
1/08/2018 20:50,18,67.3,34,62.5,52,64.1,2,0,0
1/08/2018 20:55,29,66.1,45,61.2,74,63.1,2,0,0
1/08/2018 21:00,25,65,40,60.1,65,62,2,0,0
1/08/2018 21:05,15,67,30,62.3,45,63.8,2,0,0
1/08/2018 21:10,22,66.5,38,61.7,60,63.5,2,0,0
1/08/2018 21:15,19,67.1,34,62.3,53,64,2,0,0
1/08/2018 21:20,25,66.5,41,61.6,66,63.5,2,0,0
1/08/2018 21:25,25,65.6,41,60.6,66,62.5,2,0,0
1/08/2018 21:30,25,65.6,41,60.7,66,62.5,2,0,0
1/08/2018 21:35,20,66.7,35,61.9,55,63.7,2,0,0
1/08/2018 21:40,21,66.8,37,62,58,63.7,2,0,0
1/08/2018 21:45,22,66.8,38,62,60,63.8,2,0,0
1/08/2018 21:50,18,67.3,33,62.5,51,64.2,2,0,0
1/08/2018 21:55,20,65.7,35,60.9,55,62.7,2,0,0
1/08/2018 22:00,18,66.4,34,61.6,52,63.3,2,0,0
1/08/2018 22:05,17,67,32,62.2,49,63.8,2,0,0
1/08/2018 22:10,16,67.3,31,62.6,47,64.2,2,0,0
1/08/2018 22:15,20,65.9,36,61.1,56,62.8,2,0,0
1/08/2018 22:20,15,66.9,30,62.2,45,63.8,2,0,0
1/08/2018 22:25,17,67.5,32,62.8,49,64.4,2,0,0
1/08/2018 22:30,17,67.5,33,62.7,50,64.3,2,0,0
1/08/2018 22:35,15,67.9,30,63.2,45,64.8,2,0,0
1/08/2018 22:40,16,67.7,32,63,48,64.6,2,0,0
1/08/2018 22:45,16,67.8,31,63.1,47,64.7,2,0,0
1/08/2018 22:50,14,68.1,29,63.4,43,65,2,0,0
1/08/2018 22:55,19,66.3,34,61.5,53,63.2,2,0,0
1/08/2018 23:00,14,67.7,29,63,43,64.5,2,0,0
1/08/2018 23:05,11,68.3,27,63.6,38,65,2,0,0
1/08/2018 23:10,15,68.2,31,63.5,46,65.1,2,0,0
1/08/2018 23:15,12,68.2,28,63.5,40,64.9,2,0,0
1/08/2018 23:20,12,68.1,27,63.4,39,64.8,2,0,0
1/08/2018 23:25,14,67.5,29,62.8,43,64.3,2,0,0
1/08/2018 23:30,10,68.1,25,63.4,35,64.8,2,0,0
1/08/2018 23:35,12,68.1,27,63.4,39,64.9,2,0,0
1/08/2018 23:40,13,68.3,28,63.6,41,65.1,2,0,0
1/08/2018 23:45,14,68.1,29,63.4,43,64.9,2,0,0
1/08/2018 23:50,13,68.3,29,63.7,42,65.1,2,0,0
1/08/2018 23:55,10,68.5,25,63.8,35,65.1,2,0,0
1/09/2018 0:00,9,69.3,24,64.7,33,66,2,0,0
1/09/2018 0:05,20,69.2,25,64.6,45,66.7,2,0,0
1/09/2018 0:10,9,69,24,64.4,33,65.6,2,0,0
1/09/2018 0:15,10,69,25,64.3,35,65.6,2,0,0
1/09/2018 0:20,17,68.7,23,64,40,66,2,0,0
1/09/2018 0:25,19,68.2,24,63.5,43,65.6,2,0,0
1/09/2018 0:30,9,68.1,24,63.4,33,64.7,2,0,0
1/09/2018 0:35,8,68.6,24,63.9,32,65.1,2,0,0
1/09/2018 0:40,11,68.9,21,64.3,32,65.9,2,0,0
1/09/2018 0:45,8,69.2,23,64.5,31,65.7,2,0,0
1/09/2018 0:50,8,68.9,24,64.3,32,65.4,2,0,0
1/09/2018 0:55,13,69.1,21,64.5,34,66.2,2,0,0
1/09/2018 1:00,7,69.1,22,64.5,29,65.6,2,0,0
1/09/2018 1:05,5,69.3,21,64.7,26,65.5,2,0,0
1/09/2018 1:10,14,69.3,22,64.7,36,66.5,2,0,0
1/09/2018 1:15,7,69.3,22,64.7,29,65.8,2,0,0
1/09/2018 1:20,7,69.2,22,64.6,29,65.7,2,0,0
1/09/2018 1:25,5,69.3,21,64.7,26,65.5,2,0,0
1/09/2018 1:30,6,69.2,21,64.6,27,65.6,2,0,0
1/09/2018 1:35,9,69.1,24,64.4,33,65.7,2,0,0
1/09/2018 1:40,7,69.1,22,64.5,29,65.6,2,0,0
1/09/2018 1:45,5,69.2,20,64.6,25,65.5,2,0,0
1/09/2018 1:50,7,69.1,22,64.5,29,65.6,2,0,0
1/09/2018 1:55,8,69.2,23,64.5,31,65.7,2,0,0
1/09/2018 2:00,6,69.2,21,64.6,27,65.6,2,0,0
1/09/2018 2:05,10,69.2,20,64.6,30,66.1,2,0,0
1/09/2018 2:10,8,69.2,24,64.5,32,65.7,2,0,0
1/09/2018 2:15,9,69.1,24,64.4,33,65.7,2,0,0
1/09/2018 2:20,6,69.1,21,64.5,27,65.5,2,0,0
1/09/2018 2:25,7,69.1,22,64.5,29,65.6,2,0,0
1/09/2018 2:30,11,69.1,21,64.5,32,66.1,2,0,0
1/09/2018 2:35,10,69.1,20,64.5,30,66.1,2,0,0
1/09/2018 2:40,5,69.2,21,64.6,26,65.5,2,0,0
1/09/2018 2:45,10,69.2,25,64.6,35,65.9,2,0,0
1/09/2018 2:50,15,68,30,63.3,45,64.9,2,0,0
1/09/2018 2:55,7,68.7,22,64,29,65.1,2,0,0
1/09/2018 3:00,7,68.9,22,64.2,29,65.4,2,0,0
1/09/2018 3:05,11,68.2,27,63.5,38,64.8,2,0,0
1/09/2018 3:10,14,67,29,62.2,43,63.8,2,0,0
1/09/2018 3:15,10,68.1,26,63.4,36,64.7,2,0,0
1/09/2018 3:20,15,68.1,22,63.4,37,65.3,2,0,0
1/09/2018 3:25,11,68.7,26,64,37,65.4,2,0,0
1/09/2018 3:30,10,69,25,64.4,35,65.7,2,0,0
1/09/2018 3:35,11,68.8,27,64.1,38,65.5,2,0,0
1/09/2018 3:40,14,69.1,30,64.4,44,65.9,2,0,0
1/09/2018 3:45,13,69.2,28,64.6,41,66,2,0,0
1/09/2018 3:50,13,69.2,28,64.5,41,66,2,0,0
1/09/2018 3:55,15,69.1,30,64.5,45,66,2,0,0
1/09/2018 4:00,17,69.1,32,64.4,49,66,2,0,0
1/09/2018 4:05,16,68.6,32,63.9,48,65.5,2,0,0
1/09/2018 4:10,18,68.7,34,64,52,65.7,2,0,0
1/09/2018 4:15,23,69.2,39,64.6,62,66.3,2,0,0
1/09/2018 4:20,27,68.8,43,64.2,70,66,2,0,0
1/09/2018 4:25,26,68.6,42,63.9,68,65.7,2,0,0
1/09/2018 4:30,24,68.6,41,63.9,65,65.7,2,0,0
1/09/2018 4:35,28,68.8,46,64.1,74,65.9,2,0,0
1/09/2018 4:40,33,66.9,50,62.1,83,64,2,0,0
1/09/2018 4:45,36,67.6,54,62.8,90,64.7,2,0,0
1/09/2018 4:50,43,67.8,61,63,104,65,2,0,0
1/09/2018 4:55,31,68.5,48,63.8,79,65.7,2,0,0
1/09/2018 5:00,34,68.4,51,63.6,85,65.5,2,0,0
1/09/2018 5:05,42,68.3,60,63.6,102,65.5,2,0,0
1/09/2018 5:10,35,67.4,53,62.6,88,64.5,2,0,0
1/09/2018 5:15,50,66.3,69,61.3,119,63.4,2,0,0
1/09/2018 5:20,48,67.2,68,62.3,116,64.3,2,0,0
1/09/2018 5:25,49,67.6,67,62.8,116,64.8,2,0,0
1/09/2018 5:30,60,66.3,80,61.3,140,63.4,2,0,0
1/09/2018 5:35,52,67.7,72,62.9,124,64.9,2,0,0
1/09/2018 5:40,64,67.9,85,63,149,65.1,2,0,0
1/09/2018 5:45,60,66.6,81,61.7,141,63.8,2,0,0
1/09/2018 5:50,75,67.1,98,62.2,173,64.3,2,0,0
1/09/2018 5:55,54,67.9,74,63,128,65.1,2,0,0
1/09/2018 6:00,58,68,79,63.2,137,65.2,2,0,0
1/09/2018 6:05,61,67.6,83,62.8,144,64.8,2,0,0
1/09/2018 6:10,66,67,88,62.1,154,64.2,2,0,0
1/09/2018 6:15,59,66.3,79,61.3,138,63.4,2,0,0
1/09/2018 6:20,55,67.1,74,62.2,129,64.3,2,0,0
1/09/2018 6:25,68,67.3,90,62.5,158,64.6,2,0,0
1/09/2018 6:30,58,67.3,79,62.4,137,64.5,2,0,0
1/09/2018 6:35,66,67.2,88,62.4,154,64.4,2,0,0
1/09/2018 6:40,62,66.6,84,61.7,146,63.8,2,0,0
1/09/2018 6:45,67,65.7,89,60.6,156,62.8,2,0,0
1/09/2018 6:50,73,66.8,96,61.9,169,64,2,0,0
1/09/2018 6:55,68,67.3,90,62.4,158,64.5,2,0,0
1/09/2018 7:00,62,67.5,83,62.6,145,64.7,2,0,0
1/09/2018 7:05,72,67.6,93,62.7,165,64.8,2,0,0
1/09/2018 7:10,76,67.8,100,63,176,65.1,2,0,0
1/09/2018 7:15,75,68.1,97,63.3,172,65.4,2,0,0
1/09/2018 7:20,84,67.2,108,62.3,192,64.4,2,0,0
1/09/2018 7:25,70,66.1,92,61.1,162,63.3,2,0,0
1/09/2018 7:30,75,66.5,97,61.5,172,63.7,2,0,0
1/09/2018 7:35,90,65.9,115,60.9,205,63.1,2,0,0
1/09/2018 7:40,91,66.1,114,61.2,205,63.4,2,0,0
1/09/2018 7:45,84,65.7,108,60.7,192,62.9,2,0,0
1/09/2018 7:50,83,66.5,105,61.6,188,63.8,2,0,0
1/09/2018 7:55,73,67.8,95,63,168,65.1,2,0,0
1/09/2018 8:00,73,68.1,95,63.3,168,65.4,2,0,0
1/09/2018 8:05,76,67.6,98,62.9,174,65,2,0,0
1/09/2018 8:10,91,67.4,114,62.6,205,64.8,2,0,0
1/09/2018 8:15,88,66.7,111,61.8,199,63.9,2,0,0
1/09/2018 8:20,95,66.9,118,62,213,64.2,2,0,0
1/09/2018 8:25,84,66.9,107,62,191,64.1,2,0,0
1/09/2018 8:30,78,67,100,62.1,178,64.2,2,0,0
1/09/2018 8:35,87,65.7,110,60.7,197,62.9,2,0,0
1/09/2018 8:40,84,65.2,107,60.2,191,62.4,2,0,0
1/09/2018 8:45,81,65.6,104,60.6,185,62.8,2,0,0
1/09/2018 8:50,72,65.6,95,60.6,167,62.7,2,0,0
1/09/2018 8:55,73,65.2,94,60.2,167,62.4,2,0,0
1/09/2018 9:00,69,65.4,90,60.4,159,62.6,2,0,0
1/09/2018 9:05,78,66.7,101,61.8,179,63.9,2,0,0
1/09/2018 9:10,67,67.6,88,62.7,155,64.8,2,0,0
1/09/2018 9:15,65,68,86,63.2,151,65.3,2,0,0
1/09/2018 9:20,63,67.5,84,62.7,147,64.7,2,0,0
1/09/2018 9:25,61,67.7,80,62.9,141,65,2,0,0
1/09/2018 9:30,56,68.8,76,64.1,132,66.1,2,0,0
1/09/2018 9:35,64,68,84,63.3,148,65.3,2,0,0
1/09/2018 9:40,58,67.5,78,62.7,136,64.7,2,0,0
1/09/2018 9:45,65,67.8,85,63,150,65.1,2,0,0
1/09/2018 9:50,63,68,83,63.3,146,65.3,2,0,0
1/09/2018 9:55,57,67.6,75,62.9,132,64.9,2,0,0
1/09/2018 10:00,55,67.7,74,63,129,65,2,0,0
1/09/2018 10:05,63,68.6,82,63.9,145,66,2,0,0
1/09/2018 10:10,53,68.4,72,63.6,125,65.6,2,0,0
1/09/2018 10:15,64,69,83,64.3,147,66.4,2,0,0
1/09/2018 10:20,61,69.5,79,64.9,140,66.9,2,0,0
1/09/2018 10:25,60,68.7,79,64,139,66,2,0,0
1/09/2018 10:30,60,68.4,78,63.7,138,65.7,2,0,0
1/09/2018 10:35,58,69.1,77,64.4,135,66.4,2,0,0
1/09/2018 10:40,53,69.2,72,64.6,125,66.5,2,0,0
1/09/2018 10:45,50,69.7,67,65.1,117,67.1,2,0,0
1/09/2018 10:50,50,69.1,68,64.4,118,66.4,2,0,0
1/09/2018 10:55,63,67.9,81,63.2,144,65.2,2,0,0
1/09/2018 11:00,55,68.7,73,64,128,66,2,0,0
1/09/2018 11:05,60,67.2,78,62.3,138,64.4,2,0,0
1/09/2018 11:10,58,67.6,77,62.8,135,64.9,2,0,0
1/09/2018 11:15,59,68.7,78,64,137,66,2,0,0
1/09/2018 11:20,51,69,70,64.4,121,66.3,2,0,0
1/09/2018 11:25,48,68.4,65,63.7,113,65.7,2,0,0
1/09/2018 11:30,58,68.9,77,64.2,135,66.2,2,0,0
1/09/2018 11:35,43,69.4,60,64.8,103,66.7,2,0,0
1/09/2018 11:40,52,69.5,70,65,122,66.9,2,0,0
1/09/2018 11:45,52,68.6,70,64,122,65.9,2,0,0
1/09/2018 11:50,48,68.5,66,63.8,114,65.8,2,0,0
1/09/2018 11:55,51,69,69,64.4,120,66.4,2,0,0
1/09/2018 12:00,48,68.3,66,63.6,114,65.6,2,0,0
1/09/2018 12:05,44,68,61,63.3,105,65.3,2,0,0
1/09/2018 12:10,45,69.1,63,64.5,108,66.4,2,0,0
1/09/2018 12:15,41,69.2,59,64.6,100,66.5,2,0,0
1/09/2018 12:20,47,68.6,65,63.9,112,65.9,2,0,0
1/09/2018 12:25,51,68.6,68,63.9,119,65.9,2,0,0
1/09/2018 12:30,44,68.2,62,63.6,106,65.5,2,0,0
1/09/2018 12:35,56,67.4,74,62.7,130,64.7,2,0,0
1/09/2018 12:40,48,67.8,65,63,113,65,2,0,0
1/09/2018 12:45,45,68.3,62,63.6,107,65.5,2,0,0
1/09/2018 12:50,46,68.5,64,63.9,110,65.8,2,0,0
1/09/2018 12:55,46,69.1,63,64.5,109,66.5,2,0,0
1/09/2018 13:00,38,69.2,54,64.6,92,66.5,2,0,0
1/09/2018 13:05,38,67.7,55,62.9,93,64.9,2,0,0
1/09/2018 13:10,46,66.6,64,61.7,110,63.8,2,0,0
1/09/2018 13:15,48,67.9,66,63.2,114,65.2,2,0,0
1/09/2018 13:20,43,68.2,61,63.4,104,65.4,2,0,0
1/09/2018 13:25,43,68.5,60,63.9,103,65.8,2,0,0
1/09/2018 13:30,43,68.2,60,63.5,103,65.5,2,0,0
1/09/2018 13:35,48,68.7,65,64.1,113,66,2,0,0
1/09/2018 13:40,44,68.8,61,64.2,105,66.1,2,0,0
1/09/2018 13:45,50,69,67,64.3,117,66.3,2,0,0
1/09/2018 13:50,41,67.1,58,62.3,99,64.3,2,0,0
1/09/2018 13:55,41,67.7,58,63,99,65,2,0,0
1/09/2018 14:00,43,68.3,60,63.6,103,65.5,2,0,0
1/09/2018 14:05,39,67.8,55,63.1,94,65,2,0,0
1/09/2018 14:10,45,66.9,62,62,107,64.1,2,0,0
1/09/2018 14:15,44,68,63,63.2,107,65.2,2,0,0
1/09/2018 14:20,43,67.7,60,62.9,103,64.9,2,0,0
1/09/2018 14:25,44,67.4,61,62.6,105,64.6,2,0,0
1/09/2018 14:30,44,67.2,62,62.5,106,64.4,2,0,0
1/09/2018 14:35,46,67.2,63,62.4,109,64.5,2,0,0
1/09/2018 14:40,45,68,62,63.3,107,65.3,2,0,0
1/09/2018 14:45,44,67.4,62,62.7,106,64.7,2,0,0
1/09/2018 14:50,53,66.8,71,62,124,64,2,0,0
1/09/2018 14:55,50,66.8,69,62,119,64,2,0,0
1/09/2018 15:00,51,66.6,69,61.8,120,63.8,2,0,0
1/09/2018 15:05,48,67.2,66,62.5,114,64.5,2,0,0
1/09/2018 15:10,41,68.5,57,63.8,98,65.8,2,0,0
1/09/2018 15:15,53,69.6,70,65,123,67,2,0,0
1/09/2018 15:20,47,69.7,65,65.1,112,67,2,0,0
1/09/2018 15:25,51,69,69,64.3,120,66.3,2,0,0
1/09/2018 15:30,56,67.2,75,62.4,131,64.5,2,0,0
1/09/2018 15:35,49,67.7,66,63,115,65,2,0,0
1/09/2018 15:40,49,66.8,67,61.9,116,64,2,0,0
1/09/2018 15:45,55,66.8,74,61.8,129,63.9,2,0,0
1/09/2018 15:50,49,67.2,67,62.3,116,64.4,2,0,0
1/09/2018 15:55,52,66.5,71,61.6,123,63.6,2,0,0
1/09/2018 16:00,47,67.7,65,62.9,112,64.9,2,0,0
1/09/2018 16:05,44,69.5,62,64.9,106,66.8,2,0,0
1/09/2018 16:10,49,69.5,67,64.9,116,66.9,2,0,0
1/09/2018 16:15,41,69.5,58,64.9,99,66.8,2,0,0
1/09/2018 16:20,57,68.5,76,63.8,133,65.8,2,0,0
1/09/2018 16:25,47,69.2,66,64.6,113,66.5,2,0,0
1/09/2018 16:30,51,68.5,68,63.8,119,65.8,2,0,0
1/09/2018 16:35,48,69.8,65,65.2,113,67.2,2,0,0
1/09/2018 16:40,52,69.1,70,64.4,122,66.4,2,0,0
1/09/2018 16:45,48,69.1,65,64.5,113,66.4,2,0,0
1/09/2018 16:50,48,68.2,66,63.3,114,65.3,2,0,0
1/09/2018 16:55,40,68.9,57,64.1,97,66.1,2,0,0
1/09/2018 17:00,51,68.3,69,63.5,120,65.5,2,0,0
1/09/2018 17:05,43,69.2,60,64.5,103,66.5,2,0,0
1/09/2018 17:10,37,68.4,55,63.7,92,65.6,2,0,0
1/09/2018 17:15,50,69.8,68,65.3,118,67.2,2,0,0
1/09/2018 17:20,51,69.3,70,64.7,121,66.6,2,0,0
1/09/2018 17:25,47,68.3,65,63.6,112,65.5,2,0,0
1/09/2018 17:30,57,67,75,62.2,132,64.3,2,0,0
1/09/2018 17:35,40,67.8,57,63,97,65,2,0,0
1/09/2018 17:40,46,67.9,64,63.1,110,65.1,2,0,0
1/09/2018 17:45,41,67.8,59,63,100,64.9,2,0,0
1/09/2018 17:50,42,68.5,59,63.8,101,65.7,2,0,0
1/09/2018 17:55,40,67.3,58,62.5,98,64.5,2,0,0
1/09/2018 18:00,46,67.7,64,62.9,110,64.9,2,0,0
1/09/2018 18:05,43,67,61,62.1,104,64.1,2,0,0
1/09/2018 18:10,38,66.7,55,61.8,93,63.8,2,0,0
1/09/2018 18:15,34,67.5,51,62.6,85,64.6,2,0,0
1/09/2018 18:20,44,68,61,63.2,105,65.2,2,0,0
1/09/2018 18:25,48,68.6,67,63.8,115,65.8,2,0,0
1/09/2018 18:30,45,69.4,63,64.7,108,66.6,2,0,0
1/09/2018 18:35,43,69.8,61,65.2,104,67.1,2,0,0
1/09/2018 18:40,47,68.6,65,63.9,112,65.9,2,0,0
1/09/2018 18:45,42,68.6,59,63.8,101,65.8,2,0,0
1/09/2018 18:50,34,68.9,50,64.2,84,66.1,2,0,0
1/09/2018 18:55,34,69,51,64.3,85,66.2,2,0,0
1/09/2018 19:00,36,67.6,53,62.8,89,64.7,2,0,0
1/09/2018 19:05,30,68.2,46,63.4,76,65.3,2,0,0
1/09/2018 19:10,43,68,60,63.3,103,65.3,2,0,0
1/09/2018 19:15,37,69,53,64.4,90,66.3,2,0,0
1/09/2018 19:20,36,67.7,53,63,89,64.9,2,0,0
1/09/2018 19:25,44,66.6,62,61.6,106,63.7,2,0,0
1/09/2018 19:30,36,67.2,53,62.3,89,64.3,2,0,0
1/09/2018 19:35,38,67.5,55,62.7,93,64.6,2,0,0
1/09/2018 19:40,32,67.5,49,62.7,81,64.6,2,0,0
1/09/2018 19:45,32,68.2,49,63.6,81,65.4,2,0,0
1/09/2018 19:50,36,69.1,52,64.5,88,66.4,2,0,0
1/09/2018 19:55,28,69,44,64.4,72,66.2,2,0,0
1/09/2018 20:00,32,69,48,64.4,80,66.2,2,0,0
1/09/2018 20:05,28,67.7,45,63,73,64.8,2,0,0
1/09/2018 20:10,31,67.9,47,63.1,78,65,2,0,0
1/09/2018 20:15,27,68.8,43,64.1,70,65.9,2,0,0
1/09/2018 20:20,31,69.1,47,64.5,78,66.3,2,0,0
1/09/2018 20:25,37,69.2,54,64.6,91,66.5,2,0,0
1/09/2018 20:30,27,69,43,64.3,70,66.1,2,0,0
1/09/2018 20:35,24,69.3,41,64.7,65,66.4,2,0,0
1/09/2018 20:40,26,68.8,42,64.2,68,66,2,0,0
1/09/2018 20:45,25,69.2,41,64.6,66,66.3,2,0,0
1/09/2018 20:50,26,69.4,42,64.7,68,66.5,2,0,0
1/09/2018 20:55,25,68.1,42,63.5,67,65.2,2,0,0
1/09/2018 21:00,25,68.6,41,64,66,65.7,2,0,0
1/09/2018 21:05,27,69.4,43,64.8,70,66.6,2,0,0
1/09/2018 21:10,26,68.4,43,63.7,69,65.5,2,0,0
1/09/2018 21:15,26,68.5,42,63.8,68,65.6,2,0,0
1/09/2018 21:20,24,69.1,40,64.4,64,66.2,2,0,0
1/09/2018 21:25,19,68.9,34,64.2,53,65.9,2,0,0
1/09/2018 21:30,21,69,37,64.4,58,66,2,0,0
1/09/2018 21:35,16,69.1,31,64.5,47,66,2,0,0
1/09/2018 21:40,19,68.9,35,64.2,54,65.9,2,0,0
1/09/2018 21:45,17,69.1,33,64.4,50,66,2,0,0
1/09/2018 21:50,24,69.5,40,64.9,64,66.6,2,0,0
1/09/2018 21:55,21,69.4,37,64.8,58,66.5,2,0,0
1/09/2018 22:00,17,69.3,33,64.7,50,66.2,2,0,0
1/09/2018 22:05,13,69.3,29,64.7,42,66.1,2,0,0
1/09/2018 22:10,15,69.4,31,64.7,46,66.2,2,0,0
1/09/2018 22:15,18,69.4,33,64.8,51,66.4,2,0,0
1/09/2018 22:20,20,69.3,35,64.7,55,66.4,2,0,0
1/09/2018 22:25,17,69.4,33,64.8,50,66.4,2,0,0
1/09/2018 22:30,13,69.3,29,64.7,42,66.2,2,0,0
1/09/2018 22:35,19,69.3,35,64.7,54,66.3,2,0,0
1/09/2018 22:40,16,68.8,32,64.1,48,65.7,2,0,0
1/09/2018 22:45,19,69.4,35,64.7,54,66.4,2,0,0
1/09/2018 22:50,16,69.5,32,64.9,48,66.4,2,0,0
1/09/2018 22:55,16,69.3,31,64.6,47,66.2,2,0,0
1/09/2018 23:00,12,69.1,28,64.5,40,65.9,2,0,0
1/09/2018 23:05,12,69.3,28,64.7,40,66.1,2,0,0
1/09/2018 23:10,18,69.4,33,64.8,51,66.5,2,0,0
1/09/2018 23:15,12,69.6,28,65,40,66.4,2,0,0
1/09/2018 23:20,10,69.6,26,65,36,66.3,2,0,0
1/09/2018 23:25,11,69.5,26,64.9,37,66.3,2,0,0
1/09/2018 23:30,15,69.3,31,64.7,46,66.2,2,0,0
1/09/2018 23:35,12,69.4,27,64.8,39,66.2,2,0,0
1/09/2018 23:40,11,69.4,27,64.8,38,66.1,2,0,0
1/09/2018 23:45,10,69.4,26,64.8,36,66.1,2,0,0
1/09/2018 23:50,13,69.4,28,64.8,41,66.2,2,0,0
1/09/2018 23:55,8,69.2,24,64.6,32,65.7,2,0,0
1/10/2018 0:00,7,69.3,22,64.7,29,65.8,2,0,0
1/10/2018 0:05,11,69.4,27,64.8,38,66.2,2,0,0
1/10/2018 0:10,10,69.4,25,64.8,35,66.2,2,0,0
1/10/2018 0:15,14,69.4,30,64.8,44,66.2,2,0,0
1/10/2018 0:20,11,69.4,26,64.8,37,66.2,2,0,0
1/10/2018 0:25,6,69.4,22,64.8,28,65.8,2,0,0
1/10/2018 0:30,5,69.4,21,64.8,26,65.7,2,0,0
1/10/2018 0:35,8,69.2,23,64.5,31,65.7,2,0,0
1/10/2018 0:40,8,69.2,24,64.6,32,65.7,2,0,0
1/10/2018 0:45,8,69.3,24,64.7,32,65.8,2,0,0
1/10/2018 0:50,6,69.3,22,64.7,28,65.7,2,0,0
1/10/2018 0:55,7,69.3,23,64.7,30,65.8,2,0,0
1/10/2018 1:00,5,69.2,21,64.6,26,65.5,2,0,0
1/10/2018 1:05,5,69.1,21,64.5,26,65.4,2,0,0
1/10/2018 1:10,7,69.3,22,64.7,29,65.8,2,0,0
1/10/2018 1:15,9,69.3,19,64.7,28,66.2,2,0,0
1/10/2018 1:20,7,69.1,22,64.5,29,65.6,2,0,0
1/10/2018 1:25,7,69,22,64.4,29,65.5,2,0,0
1/10/2018 1:30,6,69.2,22,64.6,28,65.6,2,0,0
1/10/2018 1:35,9,69.3,24,64.7,33,65.9,2,0,0
1/10/2018 1:40,6,69.2,22,64.6,28,65.6,2,0,0
1/10/2018 1:45,7,69.4,22,64.8,29,66,2,0,0
1/10/2018 1:50,7,69.3,22,64.7,29,65.8,2,0,0
1/10/2018 1:55,9,69.3,24,64.7,33,66,2,0,0
1/10/2018 2:00,10,69.4,20,64.8,30,66.3,2,0,0
1/10/2018 2:05,7,69.2,22,64.6,29,65.7,2,0,0
1/10/2018 2:10,5,69.3,20,64.7,25,65.7,2,0,0
1/10/2018 2:15,7,68.9,23,64.2,30,65.3,2,0,0
1/10/2018 2:20,5,69.1,20,64.5,25,65.4,2,0,0
1/10/2018 2:25,7,69.1,22,64.5,29,65.6,2,0,0
1/10/2018 2:30,7,69.2,22,64.5,29,65.7,2,0,0
1/10/2018 2:35,10,69.2,25,64.6,35,65.9,2,0,0
1/10/2018 2:40,7,69.3,23,64.7,30,65.8,2,0,0
1/10/2018 2:45,8,69.4,23,64.8,31,66,2,0,0
1/10/2018 2:50,10,69.4,25,64.8,35,66.1,2,0,0
1/10/2018 2:55,14,69.3,29,64.7,43,66.2,2,0,0
1/10/2018 3:00,8,68.8,23,64.2,31,65.4,2,0,0
1/10/2018 3:05,9,68.9,25,64.2,34,65.5,2,0,0
1/10/2018 3:10,10,69.1,25,64.5,35,65.8,2,0,0
1/10/2018 3:15,10,69.2,25,64.6,35,65.9,2,0,0
1/10/2018 3:20,9,69.2,24,64.6,33,65.8,2,0,0
1/10/2018 3:25,7,69.2,23,64.5,30,65.6,2,0,0
1/10/2018 3:30,10,69,26,64.4,36,65.6,2,0,0
1/10/2018 3:35,15,69.1,30,64.5,45,66,2,0,0
1/10/2018 3:40,10,69.1,26,64.4,36,65.7,2,0,0
1/10/2018 3:45,15,69,31,64.4,46,65.9,2,0,0
1/10/2018 3:50,17,69.1,33,64.4,50,66,2,0,0
1/10/2018 3:55,18,69.4,34,64.8,52,66.4,2,0,0
1/10/2018 4:00,16,69.3,31,64.7,47,66.3,2,0,0
1/10/2018 4:05,15,69.1,32,64.5,47,65.9,2,0,0
1/10/2018 4:10,20,68.8,37,64.2,57,65.8,2,0,0
1/10/2018 4:15,19,69,35,64.4,54,66,2,0,0
1/10/2018 4:20,21,69.4,37,64.8,58,66.4,2,0,0
1/10/2018 4:25,20,69.4,37,64.8,57,66.4,2,0,0
1/10/2018 4:30,27,69.1,44,64.5,71,66.3,2,0,0
1/10/2018 4:35,29,69.4,46,64.8,75,66.6,2,0,0
1/10/2018 4:40,34,69,51,64.3,85,66.2,2,0,0
1/10/2018 4:45,36,69.6,54,65,90,66.8,2,0,0
1/10/2018 4:50,34,68.4,51,63.7,85,65.6,2,0,0
1/10/2018 4:55,38,68.4,56,63.8,94,65.6,2,0,0
1/10/2018 5:00,37,69.4,55,64.8,92,66.7,2,0,0
1/10/2018 5:05,36,70.2,54,65.7,90,67.5,2,0,0
1/10/2018 5:10,43,69.4,62,64.8,105,66.7,2,0,0
1/10/2018 5:15,45,68.6,64,63.9,109,65.8,2,0,0
1/10/2018 5:20,45,68.8,65,64.2,110,66.1,2,0,0
1/10/2018 5:25,58,69,79,64.4,137,66.4,2,0,0
1/10/2018 5:30,57,68.4,78,63.8,135,65.7,2,0,0
1/10/2018 5:35,61,67.4,83,62.6,144,64.7,2,0,0
1/10/2018 5:40,71,66,94,61.1,165,63.2,2,0,0
1/10/2018 5:45,67,67.5,87,62.7,154,64.8,2,0,0
1/10/2018 5:50,62,67.4,84,62.6,146,64.7,2,0,0
1/10/2018 5:55,69,67.6,91,62.8,160,64.9,2,0,0
1/10/2018 6:00,56,67,76,62.1,132,64.2,2,0,0
1/10/2018 6:05,65,67.7,86,62.9,151,65,2,0,0
1/10/2018 6:10,66,67.3,88,62.5,154,64.6,2,0,0
1/10/2018 6:15,71,66.7,93,61.8,164,63.9,2,0,0
1/10/2018 6:20,63,67.4,84,62.6,147,64.7,2,0,0
1/10/2018 6:25,75,67.7,98,62.8,173,64.9,2,0,0
1/10/2018 6:30,70,67.7,91,62.9,161,65,2,0,0
1/10/2018 6:35,68,68.2,90,63.4,158,65.4,2,0,0
1/10/2018 6:40,69,68.6,91,63.9,160,65.9,2,0,0
1/10/2018 6:45,71,69.2,93,64.5,164,66.5,2,0,0
1/10/2018 6:50,73,68.4,96,63.6,169,65.6,2,0,0
1/10/2018 6:55,74,68.6,96,63.9,170,65.9,2,0,0
1/10/2018 7:00,70,68.4,91,63.6,161,65.7,2,0,0
1/10/2018 7:05,66,67.6,87,62.8,153,64.9,2,0,0
1/10/2018 7:10,67,67.6,88,62.8,155,64.8,2,0,0
1/10/2018 7:15,79,67.2,103,62.4,182,64.5,2,0,0
1/10/2018 7:20,75,67.5,97,62.7,172,64.8,2,0,0
1/10/2018 7:25,75,67.1,98,62.2,173,64.3,2,0,0
1/10/2018 7:30,89,67.1,113,62.3,202,64.4,2,0,0
1/10/2018 7:35,100,67.7,125,62.9,225,65,2,0,0
1/10/2018 7:40,80,68.5,104,63.8,184,65.9,2,0,0
1/10/2018 7:45,92,68.4,115,63.7,207,65.8,2,0,0
1/10/2018 7:50,81,68.6,103,63.8,184,65.9,2,0,0
1/10/2018 7:55,86,68.9,109,64.3,195,66.3,2,0,0
1/10/2018 8:00,86,68.2,108,63.4,194,65.6,2,0,0
1/10/2018 8:05,79,66.5,101,61.5,180,63.7,2,0,0
1/10/2018 8:10,84,66.3,107,61.3,191,63.5,2,0,0
1/10/2018 8:15,84,67.7,108,62.8,192,65,2,0,0
1/10/2018 8:20,86,68.5,110,63.7,196,65.8,2,0,0
1/10/2018 8:25,76,68.8,98,64.1,174,66.1,2,0,0
1/10/2018 8:30,76,68.2,98,63.5,174,65.6,2,0,0
1/10/2018 8:35,86,66.4,109,61.4,195,63.6,2,0,0
1/10/2018 8:40,79,66.1,100,61.2,179,63.4,2,0,0
1/10/2018 8:45,78,65,101,60,179,62.2,2,0,0
1/10/2018 8:50,73,64.5,96,59.5,169,61.7,2,0,0
1/10/2018 8:55,70,65.3,92,60.4,162,62.5,2,0,0
1/10/2018 9:00,76,65.9,98,60.9,174,63.1,2,0,0
1/10/2018 9:05,69,66.2,90,61.2,159,63.4,2,0,0
1/10/2018 9:10,68,61.3,88,55.7,156,58.1,2,0,0
1/10/2018 9:15,51,45.5,68,38.2,119,41.3,2,0,0
1/10/2018 9:20,78,39.9,99,32,177,35.5,2,0,0
1/10/2018 9:25,55,49.6,75,42.8,130,45.7,2,0,0
1/10/2018 9:30,61,58.6,81,52.8,142,55.3,2,0,0
1/10/2018 9:35,62,62.9,82,57.6,144,59.8,2,0,0
1/10/2018 9:40,49,65.7,68,60.7,117,62.8,2,0,0
1/10/2018 9:45,62,67.4,82,62.6,144,64.6,2,0,0
1/10/2018 9:50,67,68.7,87,63.9,154,66,2,0,0
1/10/2018 9:55,62,68.1,82,63.4,144,65.5,2,0,0
1/10/2018 10:00,53,68.5,71,63.8,124,65.8,2,0,0
1/10/2018 10:05,55,68.1,73,63.4,128,65.4,2,0,0
1/10/2018 10:10,64,65.9,83,61,147,63.2,2,0,0
1/10/2018 10:15,60,66.4,80,61.6,140,63.7,2,0,0
1/10/2018 10:20,61,66.8,80,62.1,141,64.1,2,0,0
1/10/2018 10:25,54,66.8,72,62,126,64.1,2,0,0
1/10/2018 10:30,56,67.9,75,63.3,131,65.2,2,0,0
1/10/2018 10:35,57,67.1,76,62.4,133,64.4,2,0,0
1/10/2018 10:40,60,67.1,78,62.4,138,64.4,2,0,0
1/10/2018 10:45,59,67.6,78,62.9,137,64.9,2,0,0
1/10/2018 10:50,56,67.2,75,62.5,131,64.5,2,0,0
1/10/2018 10:55,57,68.1,75,63.4,132,65.5,2,0,0
1/10/2018 11:00,50,68.5,67,63.9,117,65.9,2,0,0
1/10/2018 11:05,53,68.2,72,63.6,125,65.6,2,0,0
1/10/2018 11:10,53,67.4,71,62.7,124,64.7,2,0,0
1/10/2018 11:15,50,67.6,68,62.9,118,64.9,2,0,0
1/10/2018 11:20,50,68.4,67,63.8,117,65.8,2,0,0
1/10/2018 11:25,39,67.8,57,63.1,96,65,2,0,0
1/10/2018 11:30,45,67.5,62,62.8,107,64.8,2,0,0
1/10/2018 11:35,39,67.2,56,62.5,95,64.5,2,0,0
1/10/2018 11:40,47,68.7,65,64.1,112,66,2,0,0
1/10/2018 11:45,42,68.2,59,63.6,101,65.5,2,0,0
1/10/2018 11:50,44,67.9,61,63.2,105,65.2,2,0,0
1/10/2018 11:55,43,67.8,60,63.1,103,65.1,2,0,0
1/10/2018 12:00,37,69.3,53,64.7,90,66.6,2,0,0
1/10/2018 12:05,35,67.9,51,63.1,86,65.1,2,0,0
1/10/2018 12:10,39,68,55,63.3,94,65.3,2,0,0
1/10/2018 12:15,45,68.8,62,64.1,107,66.1,2,0,0
1/10/2018 12:20,46,69.3,62,64.6,108,66.6,2,0,0
1/10/2018 12:25,46,69.8,63,65.2,109,67.2,2,0,0
1/10/2018 12:30,51,68.3,69,63.7,120,65.6,2,0,0
1/10/2018 12:35,40,67.7,58,63,98,64.9,2,0,0
1/10/2018 12:40,47,67.4,65,62.6,112,64.6,2,0,0
1/10/2018 12:45,48,66.3,65,61.4,113,63.5,2,0,0
1/10/2018 12:50,44,65,62,60,106,62.1,2,0,0
1/10/2018 12:55,42,66,59,61.2,101,63.2,2,0,0
1/10/2018 13:00,43,67.1,60,62.3,103,64.3,2,0,0
1/10/2018 13:05,49,65.6,67,60.7,116,62.8,2,0,0
1/10/2018 13:10,48,66.8,66,61.9,114,63.9,2,0,0
1/10/2018 13:15,43,66.7,61,61.8,104,63.9,2,0,0
1/10/2018 13:20,43,67.4,60,62.6,103,64.6,2,0,0
1/10/2018 13:25,44,68.6,61,63.9,105,65.9,2,0,0
1/10/2018 13:30,46,67.8,63,63.1,109,65.1,2,0,0
1/10/2018 13:35,50,66.7,68,61.9,118,63.9,2,0,0
1/10/2018 13:40,44,66,61,61,105,63.1,2,0,0
1/10/2018 13:45,49,65.4,67,60.4,116,62.5,2,0,0
1/10/2018 13:50,41,65.6,59,60.5,100,62.6,2,0,0
1/10/2018 13:55,42,66.7,60,61.8,102,63.8,2,0,0
1/10/2018 14:00,45,67.5,61,62.7,106,64.7,2,0,0
1/10/2018 14:05,45,68.3,62,63.5,107,65.5,2,0,0
1/10/2018 14:10,41,68.4,57,63.7,98,65.7,2,0,0
1/10/2018 14:15,47,67.8,64,63,111,65,2,0,0
1/10/2018 14:20,39,69.1,55,64.4,94,66.4,2,0,0
1/10/2018 14:25,50,66.9,68,62,118,64.1,2,0,0
1/10/2018 14:30,43,67.2,60,62.4,103,64.4,2,0,0
1/10/2018 14:35,47,67.7,63,62.9,110,65,2,0,0
1/10/2018 14:40,46,67.5,64,62.8,110,64.8,2,0,0
1/10/2018 14:45,48,67.7,66,63,114,65,2,0,0
1/10/2018 14:50,37,68.2,54,63.5,91,65.4,2,0,0
1/10/2018 14:55,49,68.1,66,63.3,115,65.3,2,0,0
1/10/2018 15:00,48,67.9,66,63.1,114,65.1,2,0,0
1/10/2018 15:05,54,67.5,72,62.7,126,64.8,2,0,0
1/10/2018 15:10,46,66.7,63,61.9,109,63.9,2,0,0
1/10/2018 15:15,51,68.2,68,63.5,119,65.5,2,0,0
1/10/2018 15:20,53,68.8,71,64.2,124,66.1,2,0,0
1/10/2018 15:25,48,68.3,66,63.6,114,65.6,2,0,0
1/10/2018 15:30,55,68,73,63.3,128,65.3,2,0,0
1/10/2018 15:35,54,68.6,72,63.9,126,65.9,2,0,0
1/10/2018 15:40,54,68.8,72,64.1,126,66.1,2,0,0
1/10/2018 15:45,51,68.6,69,63.8,120,65.8,2,0,0
1/10/2018 15:50,57,69.2,75,64.6,132,66.6,2,0,0
1/10/2018 15:55,59,68.9,77,64.2,136,66.2,2,0,0
1/10/2018 16:00,57,68.7,75,63.9,132,65.9,2,0,0
1/10/2018 16:05,51,68.5,69,63.7,120,65.8,2,0,0
1/10/2018 16:10,58,69.1,77,64.4,135,66.4,2,0,0
1/10/2018 16:15,53,69.9,71,65.3,124,67.2,2,0,0
1/10/2018 16:20,61,68.5,79,63.9,140,65.9,2,0,0
1/10/2018 16:25,58,67.5,77,62.7,135,64.7,2,0,0
1/10/2018 16:30,60,67.9,80,63.1,140,65.2,2,0,0
1/10/2018 16:35,60,69.3,79,64.6,139,66.6,2,0,0
1/10/2018 16:40,60,69.9,79,65.3,139,67.3,2,0,0
1/10/2018 16:45,59,69.5,78,64.9,137,66.9,2,0,0
1/10/2018 16:50,56,68.6,74,63.8,130,65.9,2,0,0
1/10/2018 16:55,54,67.9,73,63.2,127,65.2,2,0,0
1/10/2018 17:00,53,68.5,71,63.8,124,65.8,2,0,0
1/10/2018 17:05,54,68.8,72,64.2,126,66.2,2,0,0
1/10/2018 17:10,54,68.9,72,64.3,126,66.3,2,0,0
1/10/2018 17:15,49,67.7,67,62.9,116,64.9,2,0,0
1/10/2018 17:20,47,67.7,65,62.8,112,64.9,2,0,0
1/10/2018 17:25,56,61.9,75,56.4,131,58.8,2,0,0
1/10/2018 17:30,48,56.5,65,50.4,113,53,2,0,0
1/10/2018 17:35,40,52.5,58,45.9,98,48.6,2,0,0
1/10/2018 17:40,42,49.9,60,43,102,45.8,2,0,0
1/10/2018 17:45,47,54,65,47.6,112,50.3,2,0,0
1/10/2018 17:50,45,51.6,64,45,109,47.7,2,0,0
1/10/2018 17:55,45,55.4,63,49.1,108,51.7,2,0,0
1/10/2018 18:00,50,57.1,68,51,118,53.6,2,0,0
1/10/2018 18:05,54,59.3,71,53.5,125,56,2,0,0
1/10/2018 18:10,58,57.8,77,51.9,135,54.4,2,0,0
1/10/2018 18:15,44,51.2,63,44.5,107,47.3,2,0,0
1/10/2018 18:20,49,47,68,39.7,117,42.8,2,0,0
1/10/2018 18:25,54,51.2,74,44.4,128,47.3,2,0,0
1/10/2018 18:30,49,56.7,68,50.6,117,53.2,2,0,0
1/10/2018 18:35,53,59.7,72,53.9,125,56.3,2,0,0
1/10/2018 18:40,42,64,60,58.7,102,60.9,2,0,0
1/10/2018 18:45,39,66.4,57,61.5,96,63.5,2,0,0
1/10/2018 18:50,38,67.8,54,63,92,65,2,0,0
1/10/2018 18:55,45,68.2,62,63.5,107,65.5,2,0,0
1/10/2018 19:00,46,68.8,64,64.2,110,66.1,2,0,0
1/10/2018 19:05,35,69.6,51,65,86,66.8,2,0,0
1/10/2018 19:10,37,69.5,54,64.9,91,66.8,2,0,0
1/10/2018 19:15,37,67.8,54,63.1,91,65,2,0,0
1/10/2018 19:20,39,69.2,56,64.5,95,66.4,2,0,0
1/10/2018 19:25,40,67.6,57,62.8,97,64.8,2,0,0
1/10/2018 19:30,33,67.5,49,62.7,82,64.6,2,0,0
1/10/2018 19:35,31,68.4,48,63.7,79,65.5,2,0,0
1/10/2018 19:40,41,69.2,58,64.6,99,66.5,2,0,0
1/10/2018 19:45,35,68.7,51,64,86,65.9,2,0,0
1/10/2018 19:50,31,69.3,48,64.7,79,66.5,2,0,0
1/10/2018 19:55,31,69,47,64.4,78,66.2,2,0,0
1/10/2018 20:00,30,68.8,46,64.1,76,66,2,0,0
1/10/2018 20:05,34,68.9,51,64.2,85,66.1,2,0,0
1/10/2018 20:10,28,68.5,44,63.9,72,65.7,2,0,0
1/10/2018 20:15,34,67.7,50,62.9,84,64.9,2,0,0
1/10/2018 20:20,30,68.9,46,64.2,76,66.1,2,0,0
1/10/2018 20:25,30,67.8,46,63.1,76,64.9,2,0,0
1/10/2018 20:30,23,68.4,39,63.7,62,65.4,2,0,0
1/10/2018 20:35,25,68.9,42,64.3,67,66,2,0,0
1/10/2018 20:40,24,69.2,39,64.5,63,66.3,2,0,0
1/10/2018 20:45,23,68.5,39,63.9,62,65.6,2,0,0
1/10/2018 20:50,31,68.6,47,63.9,78,65.8,2,0,0
1/10/2018 20:55,30,68.2,46,63.6,76,65.4,2,0,0
1/10/2018 21:00,25,68.9,41,64.2,66,66,2,0,0
1/10/2018 21:05,29,69.4,45,64.8,74,66.6,2,0,0
1/10/2018 21:10,26,69.3,42,64.7,68,66.4,2,0,0
1/10/2018 21:15,25,69.3,41,64.7,66,66.4,2,0,0
1/10/2018 21:20,29,69.2,46,64.5,75,66.3,2,0,0
1/10/2018 21:25,28,68.2,44,63.5,72,65.3,2,0,0
1/10/2018 21:30,26,69,42,64.4,68,66.2,2,0,0
1/10/2018 21:35,26,69.1,41,64.5,67,66.3,2,0,0
1/10/2018 21:40,30,69.3,46,64.7,76,66.5,2,0,0
1/10/2018 21:45,24,69.2,40,64.6,64,66.4,2,0,0
1/10/2018 21:50,23,69,40,64.4,63,66.1,2,0,0
1/10/2018 21:55,26,68.6,41,64,67,65.8,2,0,0
1/10/2018 22:00,25,68.7,41,64,66,65.8,2,0,0
1/10/2018 22:05,18,69.1,33,64.5,51,66.1,2,0,0
1/10/2018 22:10,20,69.2,36,64.6,56,66.3,2,0,0
1/10/2018 22:15,18,67.6,34,62.9,52,64.5,2,0,0
1/10/2018 22:20,20,68.4,35,63.7,55,65.5,2,0,0
1/10/2018 22:25,24,68.8,40,64.2,64,65.9,2,0,0
1/10/2018 22:30,22,69.3,37,64.7,59,66.5,2,0,0
1/10/2018 22:35,23,68.7,39,64,62,65.7,2,0,0
1/10/2018 22:40,19,68.8,35,64.2,54,65.8,2,0,0
1/10/2018 22:45,15,69.1,30,64.5,45,66,2,0,0
1/10/2018 22:50,18,69.2,33,64.6,51,66.3,2,0,0
1/10/2018 22:55,19,69.3,34,64.7,53,66.3,2,0,0
1/10/2018 23:00,17,69,33,64.4,50,66,2,0,0
1/10/2018 23:05,16,69.2,32,64.5,48,66.1,2,0,0
1/10/2018 23:10,15,68.9,30,64.3,45,65.8,2,0,0
1/10/2018 23:15,16,69,32,64.4,48,65.9,2,0,0
1/10/2018 23:20,14,68.9,30,64.2,44,65.7,2,0,0
1/10/2018 23:25,12,69.1,28,64.5,40,65.9,2,0,0
1/10/2018 23:30,16,69.4,31,64.8,47,66.4,2,0,0
1/10/2018 23:35,15,69.2,30,64.6,45,66.2,2,0,0
1/10/2018 23:40,14,69.4,30,64.8,44,66.3,2,0,0
1/10/2018 23:45,11,69.3,27,64.7,38,66.1,2,0,0
1/10/2018 23:50,11,69.4,27,64.8,38,66.1,2,0,0
1/10/2018 23:55,13,69.2,29,64.6,42,66,2,0,0
1/11/2018 0:00,9,69.3,25,64.7,34,66,2,0,0
1/11/2018 0:05,7,69.3,23,64.7,30,65.8,2,0,0
1/11/2018 0:10,13,69,28,64.4,41,65.9,2,0,0
1/11/2018 0:15,11,69.2,26,64.5,37,65.9,2,0,0
1/11/2018 0:20,11,69,26,64.4,37,65.8,2,0,0
1/11/2018 0:25,9,69,24,64.4,33,65.6,2,0,0
1/11/2018 0:30,9,69,24,64.4,33,65.7,2,0,0
1/11/2018 0:35,7,69.2,22,64.5,29,65.7,2,0,0
1/11/2018 0:40,7,69.2,23,64.6,30,65.7,2,0,0
1/11/2018 0:45,8,69.3,24,64.7,32,65.8,2,0,0
1/11/2018 0:50,7,69.3,22,64.7,29,65.8,2,0,0
1/11/2018 0:55,10,69.3,20,64.7,30,66.2,2,0,0
1/11/2018 1:00,6,69.3,21,64.7,27,65.7,2,0,0
1/11/2018 1:05,21,69.2,25,64.5,46,66.6,2,0,0
1/11/2018 1:10,14,69.2,22,64.6,36,66.4,2,0,0
1/11/2018 1:15,8,69.2,23,64.5,31,65.7,2,0,0
1/11/2018 1:20,7,69.3,22,64.7,29,65.8,2,0,0
1/11/2018 1:25,6,69.3,21,64.7,27,65.7,2,0,0
1/11/2018 1:30,8,69.3,23,64.7,31,65.9,2,0,0
1/11/2018 1:35,8,69.3,24,64.7,32,65.9,2,0,0
1/11/2018 1:40,7,69.3,22,64.7,29,65.8,2,0,0
1/11/2018 1:45,7,69.4,23,64.8,30,65.8,2,0,0
1/11/2018 1:50,5,69.4,21,64.8,26,65.7,2,0,0
1/11/2018 1:55,7,69.4,22,64.8,29,65.9,2,0,0
1/11/2018 2:00,8,69.1,23,64.5,31,65.7,2,0,0
1/11/2018 2:05,7,69.1,22,64.5,29,65.6,2,0,0
1/11/2018 2:10,8,69.3,24,64.7,32,65.9,2,0,0
1/11/2018 2:15,5,69.3,21,64.7,26,65.6,2,0,0
1/11/2018 2:20,7,69.3,23,64.6,30,65.7,2,0,0
1/11/2018 2:25,7,69.3,23,64.7,30,65.8,2,0,0
1/11/2018 2:30,6,69.4,22,64.8,28,65.8,2,0,0
1/11/2018 2:35,8,69.4,23,64.8,31,66,2,0,0
1/11/2018 2:40,8,69.2,24,64.6,32,65.7,2,0,0
1/11/2018 2:45,9,69.3,24,64.7,33,65.9,2,0,0
1/11/2018 2:50,8,69.3,23,64.7,31,65.9,2,0,0
1/11/2018 2:55,12,69.3,27,64.7,39,66.1,2,0,0
1/11/2018 3:00,11,69.1,27,64.5,38,65.8,2,0,0
1/11/2018 3:05,10,69,25,64.4,35,65.7,2,0,0
1/11/2018 3:10,9,69,24,64.3,33,65.6,2,0,0
1/11/2018 3:15,11,69.3,27,64.7,38,66,2,0,0
1/11/2018 3:20,10,69.3,26,64.7,36,66,2,0,0
1/11/2018 3:25,12,69.2,27,64.6,39,66,2,0,0
1/11/2018 3:30,11,69.4,27,64.8,38,66.1,2,0,0
1/11/2018 3:35,11,69.4,26,64.8,37,66.2,2,0,0
1/11/2018 3:40,10,69.4,26,64.8,36,66.1,2,0,0
1/11/2018 3:45,13,69.2,28,64.5,41,66,2,0,0
1/11/2018 3:50,13,69.3,28,64.7,41,66.2,2,0,0
1/11/2018 3:55,19,68.9,35,64.2,54,65.9,2,0,0
1/11/2018 4:00,13,68.9,28,64.2,41,65.7,2,0,0
1/11/2018 4:05,15,69.2,31,64.5,46,66,2,0,0
1/11/2018 4:10,14,69.2,29,64.6,43,66.1,2,0,0
1/11/2018 4:15,26,69.5,44,64.9,70,66.6,2,0,0
1/11/2018 4:20,31,69,48,64.4,79,66.2,2,0,0
1/11/2018 4:25,24,68.8,40,64.1,64,65.9,2,0,0
1/11/2018 4:30,25,69.1,42,64.5,67,66.2,2,0,0
1/11/2018 4:35,30,69.9,47,65.3,77,67.1,2,0,0
1/11/2018 4:40,34,69.8,52,65.3,86,67.1,2,0,0
1/11/2018 4:45,32,69.6,50,65,82,66.8,2,0,0
1/11/2018 4:50,27,69.3,45,64.7,72,66.4,2,0,0
1/11/2018 4:55,34,70,52,65.4,86,67.2,2,0,0
1/11/2018 5:00,37,69.6,55,65,92,66.8,2,0,0
1/11/2018 5:05,34,68.9,52,64.2,86,66,2,0,0
1/11/2018 5:10,35,69.1,54,64.4,89,66.2,2,0,0
1/11/2018 5:15,50,69.7,70,65.1,120,67,2,0,0
1/11/2018 5:20,45,69.5,64,64.8,109,66.7,2,0,0
1/11/2018 5:25,55,69.1,76,64.4,131,66.4,2,0,0
1/11/2018 5:30,53,68.8,73,64.1,126,66.1,2,0,0
1/11/2018 5:35,53,67.9,74,63.1,127,65.1,2,0,0
1/11/2018 5:40,61,68.3,82,63.5,143,65.5,2,0,0
1/11/2018 5:45,68,68,89,63.1,157,65.2,2,0,0
1/11/2018 5:50,66,67.9,88,63.1,154,65.1,2,0,0
1/11/2018 5:55,56,67.8,77,63,133,65,2,0,0
1/11/2018 6:00,61,67.7,82,62.9,143,65,2,0,0
1/11/2018 6:05,62,68,84,63.2,146,65.3,2,0,0
1/11/2018 6:10,64,68.4,85,63.6,149,65.7,2,0,0
1/11/2018 6:15,57,68,78,63.3,135,65.3,2,0,0
1/11/2018 6:20,67,67.4,89,62.6,156,64.7,2,0,0
1/11/2018 6:25,64,67.8,87,62.9,151,65,2,0,0
1/11/2018 6:30,64,67.3,86,62.4,150,64.5,2,0,0
1/11/2018 6:35,61,67.2,83,62.3,144,64.4,2,0,0
1/11/2018 6:40,63,66.9,84,62,147,64.1,2,0,0
1/11/2018 6:45,74,66.5,97,61.5,171,63.7,2,0,0
1/11/2018 6:50,68,67.5,89,62.7,157,64.8,2,0,0
1/11/2018 6:55,64,67.8,86,63,150,65.1,2,0,0
1/11/2018 7:00,60,67.8,81,63,141,65.1,2,0,0
1/11/2018 7:05,66,68,88,63.1,154,65.2,2,0,0
1/11/2018 7:10,73,66.8,95,61.9,168,64.1,2,0,0
1/11/2018 7:15,78,65.8,101,60.9,179,63,2,0,0
1/11/2018 7:20,70,66.4,92,61.5,162,63.6,2,0,0
1/11/2018 7:25,72,67.4,94,62.6,166,64.7,2,0,0
1/11/2018 7:30,82,67.8,105,63,187,65.1,2,0,0
1/11/2018 7:35,82,67.9,105,63.1,187,65.2,2,0,0
1/11/2018 7:40,76,68.4,99,63.6,175,65.7,2,0,0
1/11/2018 7:45,94,66.8,118,61.9,212,64,2,0,0
1/11/2018 7:50,85,67.5,108,62.6,193,64.8,2,0,0
1/11/2018 7:55,81,68,104,63.2,185,65.3,2,0,0
1/11/2018 8:00,74,68.8,96,64,170,66.1,2,0,0
1/11/2018 8:05,80,68.8,104,64,184,66.1,2,0,0
1/11/2018 8:10,83,68.5,106,63.6,189,65.8,2,0,0
1/11/2018 8:15,91,68.4,114,63.6,205,65.7,2,0,0
1/11/2018 8:20,78,67.7,100,62.9,178,65,2,0,0
1/11/2018 8:25,80,68.1,103,63.3,183,65.4,2,0,0
1/11/2018 8:30,78,68.5,101,63.7,179,65.8,2,0,0
1/11/2018 8:35,83,67.8,105,63,188,65.1,2,0,0
1/11/2018 8:40,81,67.5,103,62.7,184,64.8,2,0,0
1/11/2018 8:45,86,67.6,109,62.8,195,64.9,2,0,0
1/11/2018 8:50,86,67.2,109,62.3,195,64.5,2,0,0
1/11/2018 8:55,73,67.3,96,62.5,169,64.5,2,0,0
1/11/2018 9:00,66,67.7,88,62.9,154,64.9,2,0,0
1/11/2018 9:05,79,68.1,101,63.4,180,65.5,2,0,0
1/11/2018 9:10,78,67.4,101,62.6,179,64.7,2,0,0
1/11/2018 9:15,70,67.9,91,63.2,161,65.2,2,0,0
1/11/2018 9:20,79,68.3,100,63.6,179,65.7,2,0,0
1/11/2018 9:25,80,67.1,103,62.3,183,64.4,2,0,0
1/11/2018 9:30,76,68.4,98,63.8,174,65.8,2,0,0
1/11/2018 9:35,70,68.1,90,63.4,160,65.5,2,0,0
1/11/2018 9:40,79,68.6,101,63.9,180,65.9,2,0,0
1/11/2018 9:45,66,68.5,86,63.8,152,65.9,2,0,0
1/11/2018 9:50,61,68.2,81,63.5,142,65.5,2,0,0
1/11/2018 9:55,59,68.5,78,63.8,137,65.8,2,0,0
1/11/2018 10:00,67,67.3,88,62.7,155,64.7,2,0,0
1/11/2018 10:05,56,67,75,62.2,131,64.2,2,0,0
1/11/2018 10:10,54,67,74,62.2,128,64.3,2,0,0
1/11/2018 10:15,56,67.6,75,62.9,131,64.9,2,0,0
1/11/2018 10:20,58,68.4,78,63.7,136,65.7,2,0,0
1/11/2018 10:25,65,68,84,63.3,149,65.4,2,0,0
1/11/2018 10:30,59,69,78,64.4,137,66.3,2,0,0
1/11/2018 10:35,60,70.1,79,65.6,139,67.5,2,0,0
1/11/2018 10:40,74,69.6,93,65,167,67,2,0,0
1/11/2018 10:45,62,67.5,80,62.8,142,64.9,2,0,0
1/11/2018 10:50,67,68.2,86,63.5,153,65.6,2,0,0
1/11/2018 10:55,64,68,84,63.3,148,65.3,2,0,0
1/11/2018 11:00,55,67.7,73,63,128,65,2,0,0
1/11/2018 11:05,62,68.7,81,64.1,143,66.1,2,0,0
1/11/2018 11:10,53,68.7,71,64.1,124,66.1,2,0,0
1/11/2018 11:15,56,68.1,75,63.5,131,65.5,2,0,0
1/11/2018 11:20,54,67.4,73,62.9,127,64.8,2,0,0
1/11/2018 11:25,51,68,68,63.4,119,65.4,2,0,0
1/11/2018 11:30,60,67.2,78,62.5,138,64.5,2,0,0
1/11/2018 11:35,64,67,83,62.2,147,64.3,2,0,0
1/11/2018 11:40,64,66.9,83,62.1,147,64.2,2,0,0
1/11/2018 11:45,56,67.9,75,63.2,131,65.2,2,0,0
1/11/2018 11:50,55,67.1,73,62.3,128,64.4,2,0,0
1/11/2018 11:55,58,67.7,78,63,136,65.1,2,0,0
1/11/2018 12:00,54,68.4,72,63.8,126,65.7,2,0,0
1/11/2018 12:05,52,67.4,70,62.7,122,64.7,2,0,0
1/11/2018 12:10,54,68.6,72,63.9,126,65.9,2,0,0
1/11/2018 12:15,53,66.8,70,62,123,64.1,2,0,0
1/11/2018 12:20,51,68.2,69,63.5,120,65.5,2,0,0
1/11/2018 12:25,55,67.8,74,63.1,129,65.1,2,0,0
1/11/2018 12:30,46,68.6,63,63.9,109,65.9,2,0,0
1/11/2018 12:35,54,67.6,72,62.8,126,64.9,2,0,0
1/11/2018 12:40,45,68.9,62,64.2,107,66.2,2,0,0
1/11/2018 12:45,57,68.9,76,64.3,133,66.3,2,0,0
1/11/2018 12:50,44,69.1,61,64.4,105,66.4,2,0,0
1/11/2018 12:55,45,68.8,62,64.2,107,66.2,2,0,0
1/11/2018 13:00,49,69.2,66,64.6,115,66.5,2,0,0
1/11/2018 13:05,43,69.5,60,64.9,103,66.8,2,0,0
1/11/2018 13:10,47,69.5,64,65,111,66.9,2,0,0
1/11/2018 13:15,45,69.2,63,64.6,108,66.5,2,0,0
1/11/2018 13:20,45,68.9,63,64.3,108,66.2,2,0,0
1/11/2018 13:25,54,68.4,73,63.7,127,65.7,2,0,0
1/11/2018 13:30,47,69.5,64,64.8,111,66.8,2,0,0
1/11/2018 13:35,55,68.6,74,63.9,129,65.9,2,0,0
1/11/2018 13:40,52,69.7,70,65.1,122,67.1,2,0,0
1/11/2018 13:45,48,67.7,66,63,114,65,2,0,0
1/11/2018 13:50,50,69.2,68,64.6,118,66.5,2,0,0
1/11/2018 13:55,47,70.1,65,65.6,112,67.5,2,0,0
1/11/2018 14:00,45,69.9,63,65.4,108,67.3,2,0,0
1/11/2018 14:05,47,70,64,65.4,111,67.3,2,0,0
1/11/2018 14:10,44,68.9,61,64.2,105,66.2,2,0,0
1/11/2018 14:15,39,69.2,57,64.6,96,66.4,2,0,0
1/11/2018 14:20,52,66.5,71,61.7,123,63.7,2,0,0
1/11/2018 14:25,54,66.8,72,61.9,126,64,2,0,0
1/11/2018 14:30,48,67.9,65,63.2,113,65.2,2,0,0
1/11/2018 14:35,48,67.2,65,62.5,113,64.5,2,0,0
1/11/2018 14:40,51,67.8,69,63.1,120,65.1,2,0,0
1/11/2018 14:45,50,69.2,67,64.7,117,66.6,2,0,0
1/11/2018 14:50,53,69.9,71,65.4,124,67.3,2,0,0
1/11/2018 14:55,44,70.3,61,65.8,105,67.7,2,0,0
1/11/2018 15:00,51,69.4,70,64.8,121,66.7,2,0,0
1/11/2018 15:05,63,67.9,81,63.2,144,65.3,2,0,0
1/11/2018 15:10,51,67.4,69,62.5,120,64.6,2,0,0
1/11/2018 15:15,61,67.1,80,62.3,141,64.4,2,0,0
1/11/2018 15:20,48,67.7,66,62.9,114,64.9,2,0,0
1/11/2018 15:25,60,68.1,79,63.5,139,65.5,2,0,0
1/11/2018 15:30,51,68.8,69,64.2,120,66.1,2,0,0
1/11/2018 15:35,45,70.4,62,65.8,107,67.7,2,0,0
1/11/2018 15:40,75,68,95,63.3,170,65.3,2,0,0
1/11/2018 15:45,65,68.7,84,64.1,149,66.1,2,0,0
1/11/2018 15:50,56,69.9,74,65.3,130,67.3,2,0,0
1/11/2018 15:55,50,68.5,69,63.9,119,65.8,2,0,0
1/11/2018 16:00,48,69.3,64,64.8,112,66.7,2,0,0
1/11/2018 16:05,61,68.9,80,64.3,141,66.3,2,0,0
1/11/2018 16:10,64,68.9,82,64.2,146,66.3,2,0,0
1/11/2018 16:15,60,69.1,79,64.5,139,66.5,2,0,0
1/11/2018 16:20,57,70,76,65.5,133,67.4,2,0,0
1/11/2018 16:25,53,69.2,70,64.6,123,66.6,2,0,0
1/11/2018 16:30,47,69,65,64.4,112,66.3,2,0,0
1/11/2018 16:35,37,69.4,54,64.8,91,66.7,2,0,0
1/11/2018 16:40,59,68.4,77,63.7,136,65.7,2,0,0
1/11/2018 16:45,50,69,68,64.4,118,66.3,2,0,0
1/11/2018 16:50,56,69.1,74,64.4,130,66.5,2,0,0
1/11/2018 16:55,44,69.7,62,65.1,106,67,2,0,0
1/11/2018 17:00,38,69,54,64.3,92,66.2,2,0,0
1/11/2018 17:05,55,67.8,74,63.1,129,65.1,2,0,0
1/11/2018 17:10,49,68.7,67,64,116,66,2,0,0
1/11/2018 17:15,56,69,75,64.2,131,66.2,2,0,0
1/11/2018 17:20,58,69.1,77,64.4,135,66.4,2,0,0
1/11/2018 17:25,60,69.8,78,65.2,138,67.2,2,0,0
1/11/2018 17:30,56,69.2,74,64.5,130,66.5,2,0,0
1/11/2018 17:35,48,68.5,66,63.8,114,65.8,2,0,0
1/11/2018 17:40,48,67.1,67,62.2,115,64.3,2,0,0
1/11/2018 17:45,49,66,67,61,116,63.1,2,0,0
1/11/2018 17:50,51,66.3,69,61.3,120,63.4,2,0,0
1/11/2018 17:55,47,66.2,65,61.3,112,63.4,2,0,0
1/11/2018 18:00,41,68,58,63.3,99,65.3,2,0,0
1/11/2018 18:05,47,68,64,63.2,111,65.2,2,0,0
1/11/2018 18:10,50,67.9,67,63.1,117,65.1,2,0,0
1/11/2018 18:15,55,68.1,72,63.4,127,65.5,2,0,0
1/11/2018 18:20,48,67.5,66,62.7,114,64.7,2,0,0
1/11/2018 18:25,48,67.7,65,62.9,113,64.9,2,0,0
1/11/2018 18:30,48,68.9,65,64.2,113,66.2,2,0,0
1/11/2018 18:35,51,67.9,68,63.1,119,65.1,2,0,0
1/11/2018 18:40,44,68.8,62,64.2,106,66.1,2,0,0
1/11/2018 18:45,36,69.6,53,65,89,66.9,2,0,0
1/11/2018 18:50,42,69.9,58,65.3,100,67.2,2,0,0
1/11/2018 18:55,36,69,53,64.3,89,66.2,2,0,0
1/11/2018 19:00,38,68.4,54,63.7,92,65.6,2,0,0
1/11/2018 19:05,36,68.5,53,63.9,89,65.8,2,0,0
1/11/2018 19:10,43,68.9,61,64.2,104,66.2,2,0,0
1/11/2018 19:15,38,68.7,55,64,93,66,2,0,0
1/11/2018 19:20,37,68.4,55,63.7,92,65.6,2,0,0
1/11/2018 19:25,44,66.4,62,61.5,106,63.5,2,0,0
1/11/2018 19:30,40,67.5,57,62.7,97,64.7,2,0,0
1/11/2018 19:35,40,66.8,57,61.9,97,63.9,2,0,0
1/11/2018 19:40,32,68.1,48,63.3,80,65.2,2,0,0
1/11/2018 19:45,39,67.9,56,63.2,95,65.1,2,0,0
1/11/2018 19:50,40,68.3,56,63.5,96,65.5,2,0,0
1/11/2018 19:55,31,69,47,64.4,78,66.2,2,0,0
1/11/2018 20:00,33,67.4,49,62.7,82,64.6,2,0,0
1/11/2018 20:05,31,67.8,48,63,79,64.9,2,0,0
1/11/2018 20:10,31,67.9,47,63.2,78,65,2,0,0
1/11/2018 20:15,34,67.9,51,63.1,85,65,2,0,0
1/11/2018 20:20,30,68.3,46,63.6,76,65.4,2,0,0
1/11/2018 20:25,37,68.9,53,64.2,90,66.1,2,0,0
1/11/2018 20:30,27,69.2,43,64.6,70,66.4,2,0,0
1/11/2018 20:35,34,68.9,50,64.2,84,66.1,2,0,0
1/11/2018 20:40,34,68.5,50,63.8,84,65.7,2,0,0
1/11/2018 20:45,29,68.6,45,63.9,74,65.7,2,0,0
1/11/2018 20:50,29,69.1,45,64.5,74,66.3,2,0,0
1/11/2018 20:55,36,68.4,53,63.7,89,65.6,2,0,0
1/11/2018 21:00,34,68.9,50,64.2,84,66.1,2,0,0
1/11/2018 21:05,28,69,45,64.3,73,66.1,2,0,0
1/11/2018 21:10,33,68,50,63.3,83,65.1,2,0,0
1/11/2018 21:15,29,68.1,46,63.4,75,65.2,2,0,0
1/11/2018 21:20,20,67.7,36,63,56,64.7,2,0,0
1/11/2018 21:25,28,69.1,44,64.5,72,66.3,2,0,0
1/11/2018 21:30,25,68.3,41,63.7,66,65.4,2,0,0
1/11/2018 21:35,26,68.4,42,63.7,68,65.5,2,0,0
1/11/2018 21:40,24,69.1,40,64.5,64,66.2,2,0,0
1/11/2018 21:45,28,69.3,44,64.7,72,66.5,2,0,0
1/11/2018 21:50,28,69.4,44,64.8,72,66.6,2,0,0
1/11/2018 21:55,22,69.2,38,64.6,60,66.3,2,0,0
1/11/2018 22:00,24,69.3,40,64.7,64,66.5,2,0,0
1/11/2018 22:05,21,69.5,36,64.9,57,66.6,2,0,0
1/11/2018 22:10,26,69.4,41,64.8,67,66.6,2,0,0
1/11/2018 22:15,18,69.4,34,64.8,52,66.4,2,0,0
1/11/2018 22:20,21,69.6,37,65,58,66.7,2,0,0
1/11/2018 22:25,19,69.7,35,65.1,54,66.7,2,0,0
1/11/2018 22:30,22,69.7,38,65.2,60,66.8,2,0,0
1/11/2018 22:35,22,69.6,38,65,60,66.7,2,0,0
1/11/2018 22:40,19,69.5,34,64.9,53,66.6,2,0,0
1/11/2018 22:45,21,69.7,37,65.1,58,66.8,2,0,0
1/11/2018 22:50,17,69.5,33,65,50,66.5,2,0,0
1/11/2018 22:55,16,69.6,31,65,47,66.6,2,0,0
1/11/2018 23:00,17,69.5,33,64.9,50,66.4,2,0,0
1/11/2018 23:05,17,69.5,32,64.9,49,66.5,2,0,0
1/11/2018 23:10,14,69.5,29,64.9,43,66.4,2,0,0
1/11/2018 23:15,14,69.5,30,64.9,44,66.4,2,0,0
1/11/2018 23:20,13,69.4,29,64.8,42,66.2,2,0,0
1/11/2018 23:25,12,69.4,27,64.8,39,66.2,2,0,0
1/11/2018 23:30,16,69.2,32,64.5,48,66.1,2,0,0
1/11/2018 23:35,14,69.3,29,64.7,43,66.2,2,0,0
1/11/2018 23:40,13,69.3,29,64.7,42,66.2,2,0,0
1/11/2018 23:45,17,69.4,32,64.8,49,66.4,2,0,0
1/11/2018 23:50,15,69.5,31,64.9,46,66.4,2,0,0
1/11/2018 23:55,13,69.5,29,64.9,42,66.3,2,0,0
1/12/2018 0:00,13,69.3,28,64.7,41,66.2,2,0,0
1/12/2018 0:05,8,69.4,24,64.8,32,65.9,2,0,0
1/12/2018 0:10,10,69.2,25,64.6,35,65.9,2,0,0
1/12/2018 0:15,8,69.2,23,64.5,31,65.7,2,0,0
1/12/2018 0:20,5,69.2,21,64.6,26,65.5,2,0,0
1/12/2018 0:25,12,69.4,27,64.8,39,66.2,2,0,0
1/12/2018 0:30,6,69.4,21,64.8,27,65.8,2,0,0
1/12/2018 0:35,9,69.2,24,64.6,33,65.9,2,0,0
1/12/2018 0:40,9,69.4,24,64.8,33,66.1,2,0,0
1/12/2018 0:45,15,69.3,22,64.7,37,66.6,2,0,0
1/12/2018 0:50,7,69.4,22,64.8,29,65.9,2,0,0
1/12/2018 0:55,14,69.4,22,64.8,36,66.6,2,0,0
1/12/2018 1:00,5,69.5,20,64.9,25,65.8,2,0,0
1/12/2018 1:05,6,69.4,21,64.8,27,65.9,2,0,0
1/12/2018 1:10,7,69.5,22,64.9,29,66,2,0,0
1/12/2018 1:15,7,69.5,22,64.9,29,66,2,0,0
1/12/2018 1:20,9,69.5,24,64.9,33,66.1,2,0,0
1/12/2018 1:25,13,69.4,21,64.8,34,66.6,2,0,0
1/12/2018 1:30,9,69.4,24,64.8,33,66,2,0,0
1/12/2018 1:35,7,69.4,23,64.8,30,65.9,2,0,0
1/12/2018 1:40,8,69.4,23,64.8,31,66,2,0,0
1/12/2018 1:45,7,69.5,22,64.9,29,66,2,0,0
1/12/2018 1:50,6,69.4,22,64.8,28,65.8,2,0,0
1/12/2018 1:55,10,69.4,25,64.8,35,66.1,2,0,0
1/12/2018 2:00,8,69.3,24,64.7,32,65.9,2,0,0
1/12/2018 2:05,8,69.3,23,64.7,31,65.9,2,0,0
1/12/2018 2:10,8,69.2,23,64.6,31,65.8,2,0,0
1/12/2018 2:15,5,69.3,21,64.7,26,65.5,2,0,0
1/12/2018 2:20,8,69.3,23,64.7,31,65.9,2,0,0
1/12/2018 2:25,6,69.1,21,64.5,27,65.5,2,0,0
1/12/2018 2:30,7,69.2,22,64.6,29,65.7,2,0,0
1/12/2018 2:35,7,69.3,23,64.7,30,65.8,2,0,0
1/12/2018 2:40,8,69.2,24,64.6,32,65.7,2,0,0
1/12/2018 2:45,8,69.2,24,64.5,32,65.7,2,0,0
1/12/2018 2:50,9,69.3,24,64.7,33,66,2,0,0
1/12/2018 2:55,6,69.3,21,64.7,27,65.7,2,0,0
1/12/2018 3:00,8,69.3,23,64.7,31,65.9,2,0,0
1/12/2018 3:05,11,69.3,27,64.7,38,66.1,2,0,0
1/12/2018 3:10,9,69.3,24,64.7,33,66,2,0,0
1/12/2018 3:15,13,69.1,29,64.4,42,65.9,2,0,0
1/12/2018 3:20,10,69.2,25,64.5,35,65.9,2,0,0
1/12/2018 3:25,12,69,28,64.4,40,65.7,2,0,0
1/12/2018 3:30,11,69,27,64.3,38,65.7,2,0,0
1/12/2018 3:35,14,68.9,30,64.2,44,65.7,2,0,0
1/12/2018 3:40,10,69.1,26,64.4,36,65.7,2,0,0
1/12/2018 3:45,15,69.1,30,64.5,45,66,2,0,0
1/12/2018 3:50,17,68.8,34,64.1,51,65.7,2,0,0
1/12/2018 3:55,15,68.9,30,64.3,45,65.8,2,0,0
1/12/2018 4:00,17,69.1,33,64.5,50,66.1,2,0,0
1/12/2018 4:05,14,69.1,31,64.5,45,65.9,2,0,0
1/12/2018 4:10,14,69.2,29,64.6,43,66.1,2,0,0
1/12/2018 4:15,20,69.3,36,64.7,56,66.4,2,0,0
1/12/2018 4:20,22,69.4,37,64.8,59,66.5,2,0,0
1/12/2018 4:25,17,69.4,33,64.8,50,66.3,2,0,0
1/12/2018 4:30,28,68.8,45,64.2,73,66,2,0,0
1/12/2018 4:35,24,68.6,41,64,65,65.7,2,0,0
1/12/2018 4:40,24,68.9,40,64.3,64,66,2,0,0
1/12/2018 4:45,35,69.8,53,65.3,88,67.1,2,0,0
1/12/2018 4:50,27,69.8,45,65.2,72,66.9,2,0,0
1/12/2018 4:55,28,68.4,44,63.8,72,65.6,2,0,0
1/12/2018 5:00,26,69.2,43,64.6,69,66.3,2,0,0
1/12/2018 5:05,31,70,48,65.5,79,67.3,2,0,0
1/12/2018 5:10,29,69.2,46,64.5,75,66.3,2,0,0
1/12/2018 5:15,39,69,57,64.4,96,66.3,2,0,0
1/12/2018 5:20,35,69.5,53,65,88,66.8,2,0,0
1/12/2018 5:25,50,69.2,69,64.5,119,66.5,2,0,0
1/12/2018 5:30,44,68,63,63.2,107,65.1,2,0,0
1/12/2018 5:35,55,68.5,75,63.8,130,65.8,2,0,0
1/12/2018 5:40,61,68.1,81,63.4,142,65.4,2,0,0
1/12/2018 5:45,67,67.9,88,63.1,155,65.2,2,0,0
1/12/2018 5:50,54,68.8,74,64.1,128,66.1,2,0,0
1/12/2018 5:55,55,68.7,75,64,130,66,2,0,0
1/12/2018 6:00,58,66.3,78,61.3,136,63.4,2,0,0
1/12/2018 6:05,58,67.3,79,62.5,137,64.5,2,0,0
1/12/2018 6:10,49,66.1,69,61.2,118,63.2,2,0,0
1/12/2018 6:15,69,66.2,91,61.4,160,63.5,2,0,0
1/12/2018 6:20,59,66.8,79,61.9,138,64,2,0,0
1/12/2018 6:25,63,68,84,63.2,147,65.3,2,0,0
1/12/2018 6:30,69,68,91,63.2,160,65.2,2,0,0
1/12/2018 6:35,63,67.1,85,62.2,148,64.3,2,0,0
1/12/2018 6:40,70,67.3,91,62.4,161,64.5,2,0,0
1/12/2018 6:45,65,67.1,87,62.2,152,64.3,2,0,0
1/12/2018 6:50,69,67.9,91,63.1,160,65.2,2,0,0
1/12/2018 6:55,63,67,84,62.2,147,64.3,2,0,0
1/12/2018 7:00,72,68.4,94,63.6,166,65.7,2,0,0
1/12/2018 7:05,62,68.9,83,64.1,145,66.1,2,0,0
1/12/2018 7:10,64,68.2,85,63.5,149,65.5,2,0,0
1/12/2018 7:15,81,68.5,104,63.8,185,65.9,2,0,0
1/12/2018 7:20,76,67.3,100,62.5,176,64.6,2,0,0
1/12/2018 7:25,79,67.8,101,63,180,65.1,2,0,0
1/12/2018 7:30,76,68.8,98,64.1,174,66.2,2,0,0
1/12/2018 7:35,79,68.3,101,63.5,180,65.6,2,0,0
1/12/2018 7:40,86,68.3,110,63.5,196,65.6,2,0,0
1/12/2018 7:45,86,67.1,110,62.2,196,64.3,2,0,0
1/12/2018 7:50,81,67.2,104,62.3,185,64.5,2,0,0
1/12/2018 7:55,80,67,102,62.1,182,64.3,2,0,0
1/12/2018 8:00,76,67.1,97,62.2,173,64.4,2,0,0
1/12/2018 8:05,80,67,103,62.1,183,64.2,2,0,0
1/12/2018 8:10,82,67.1,105,62.3,187,64.4,2,0,0
1/12/2018 8:15,92,66.9,117,62,209,64.2,2,0,0
1/12/2018 8:20,77,68,100,63.3,177,65.3,2,0,0
1/12/2018 8:25,78,68.5,100,63.7,178,65.8,2,0,0
1/12/2018 8:30,73,67.5,95,62.6,168,64.7,2,0,0
1/12/2018 8:35,81,67,104,62.1,185,64.3,2,0,0
1/12/2018 8:40,86,67.3,108,62.5,194,64.6,2,0,0
1/12/2018 8:45,91,65.8,115,60.9,206,63.1,2,0,0
1/12/2018 8:50,86,66,109,61.1,195,63.3,2,0,0
1/12/2018 8:55,84,66.3,107,61.3,191,63.5,2,0,0
1/12/2018 9:00,78,68.3,101,63.4,179,65.6,2,0,0
1/12/2018 9:05,69,69.1,90,64.4,159,66.4,2,0,0
1/12/2018 9:10,75,67.4,97,62.6,172,64.7,2,0,0
1/12/2018 9:15,73,67.6,94,62.8,167,64.9,2,0,0
1/12/2018 9:20,82,67.4,104,62.6,186,64.7,2,0,0
1/12/2018 9:25,60,68,78,63.2,138,65.3,2,0,0
1/12/2018 9:30,61,69,80,64.3,141,66.3,2,0,0
1/12/2018 9:35,55,68.5,74,63.8,129,65.8,2,0,0
1/12/2018 9:40,72,68.8,93,64.1,165,66.1,2,0,0
1/12/2018 9:45,75,68.6,95,63.9,170,66,2,0,0
1/12/2018 9:50,71,68.5,92,63.8,163,65.8,2,0,0
1/12/2018 9:55,58,68.3,76,63.7,134,65.7,2,0,0
1/12/2018 10:00,70,67.9,90,63.2,160,65.3,2,0,0
1/12/2018 10:05,63,67.7,82,63,145,65,2,0,0
1/12/2018 10:10,66,69.2,85,64.6,151,66.6,2,0,0
1/12/2018 10:15,59,69.2,77,64.7,136,66.7,2,0,0
1/12/2018 10:20,68,68.1,88,63.5,156,65.5,2,0,0
1/12/2018 10:25,55,68.3,73,63.7,128,65.7,2,0,0
1/12/2018 10:30,73,68,92,63.4,165,65.4,2,0,0
1/12/2018 10:35,66,67.5,85,62.9,151,64.9,2,0,0
1/12/2018 10:40,69,67,88,62.3,157,64.3,2,0,0
1/12/2018 10:45,59,68.2,77,63.6,136,65.6,2,0,0
1/12/2018 10:50,56,68.3,74,63.7,130,65.7,2,0,0
1/12/2018 10:55,62,66.9,81,62.1,143,64.2,2,0,0
1/12/2018 11:00,59,67,78,62.3,137,64.3,2,0,0
1/12/2018 11:05,57,67.8,76,63.1,133,65.1,2,0,0
1/12/2018 11:10,60,66.5,79,61.7,139,63.8,2,0,0
1/12/2018 11:15,52,67.8,70,63,122,65.1,2,0,0
1/12/2018 11:20,62,68.6,81,63.9,143,65.9,2,0,0
1/12/2018 11:25,64,67.6,83,62.9,147,65,2,0,0
1/12/2018 11:30,62,67.8,80,63,142,65.1,2,0,0
1/12/2018 11:35,66,67.7,85,63,151,65.1,2,0,0
1/12/2018 11:40,61,67.4,80,62.6,141,64.7,2,0,0
1/12/2018 11:45,61,66.7,80,61.8,141,63.9,2,0,0
1/12/2018 11:50,60,67.8,79,63,139,65,2,0,0
1/12/2018 11:55,65,68,83,63.3,148,65.4,2,0,0
1/12/2018 12:00,57,69.4,76,64.7,133,66.7,2,0,0
1/12/2018 12:05,62,69.6,81,64.9,143,66.9,2,0,0
1/12/2018 12:10,50,70,67,65.4,117,67.3,2,0,0
1/12/2018 12:15,61,68.9,80,64.2,141,66.2,2,0,0
1/12/2018 12:20,60,68.7,78,64,138,66,2,0,0
1/12/2018 12:25,58,69.3,76,64.7,134,66.7,2,0,0
1/12/2018 12:30,57,69.1,75,64.5,132,66.5,2,0,0
1/12/2018 12:35,58,68.8,76,64.1,134,66.1,2,0,0
1/12/2018 12:40,59,68.5,77,63.9,136,65.9,2,0,0
1/12/2018 12:45,47,69.4,64,64.9,111,66.8,2,0,0
1/12/2018 12:50,51,68.9,69,64.2,120,66.2,2,0,0
1/12/2018 12:55,53,69.1,71,64.5,124,66.4,2,0,0
1/12/2018 13:00,44,69.8,62,65.3,106,67.1,2,0,0
1/12/2018 13:05,51,68.8,69,64.1,120,66.1,2,0,0
1/12/2018 13:10,48,69.1,65,64.5,113,66.4,2,0,0
1/12/2018 13:15,48,69.6,65,65,113,66.9,2,0,0
1/12/2018 13:20,48,69.6,65,65.1,113,67,2,0,0
1/12/2018 13:25,52,69.1,70,64.4,122,66.4,2,0,0
1/12/2018 13:30,53,69.5,71,64.9,124,66.8,2,0,0
1/12/2018 13:35,55,69.5,74,64.8,129,66.8,2,0,0
1/12/2018 13:40,51,68.5,69,63.7,120,65.7,2,0,0
1/12/2018 13:45,57,69.3,75,64.7,132,66.7,2,0,0
1/12/2018 13:50,56,69.3,73,64.6,129,66.6,2,0,0
1/12/2018 13:55,45,69.4,63,64.8,108,66.7,2,0,0
1/12/2018 14:00,46,67.2,64,62.4,110,64.4,2,0,0
1/12/2018 14:05,48,66.4,65,61.4,113,63.5,2,0,0
1/12/2018 14:10,51,67.5,69,62.7,120,64.7,2,0,0
1/12/2018 14:15,42,69.1,59,64.4,101,66.4,2,0,0
1/12/2018 14:20,48,69.9,66,65.3,114,67.3,2,0,0
1/12/2018 14:25,38,68.5,55,63.9,93,65.7,2,0,0
1/12/2018 14:30,47,69.6,64,65,111,67,2,0,0
1/12/2018 14:35,55,68.4,74,63.7,129,65.7,2,0,0
1/12/2018 14:40,57,69.6,75,65,132,67,2,0,0
1/12/2018 14:45,56,69.6,74,65.1,130,67,2,0,0
1/12/2018 14:50,47,69.6,64,65,111,66.9,2,0,0
1/12/2018 14:55,53,68.7,72,64,125,66,2,0,0
1/12/2018 15:00,63,68.8,81,64.1,144,66.1,2,0,0
1/12/2018 15:05,54,67.8,72,63.1,126,65.1,2,0,0
1/12/2018 15:10,48,68.1,65,63.3,113,65.3,2,0,0
1/12/2018 15:15,45,68.3,64,63.7,109,65.6,2,0,0
1/12/2018 15:20,50,68.1,69,63.5,119,65.4,2,0,0
1/12/2018 15:25,60,69.6,79,65,139,67,2,0,0
1/12/2018 15:30,57,69.7,75,65.1,132,67.1,2,0,0
1/12/2018 15:35,53,69.8,71,65.3,124,67.2,2,0,0
1/12/2018 15:40,54,68.9,72,64.2,126,66.2,2,0,0
1/12/2018 15:45,66,68.3,84,63.5,150,65.6,2,0,0
1/12/2018 15:50,51,68.6,70,63.9,121,65.9,2,0,0
1/12/2018 15:55,50,69.1,68,64.4,118,66.4,2,0,0
1/12/2018 16:00,59,68.5,78,63.8,137,65.8,2,0,0
1/12/2018 16:05,49,67.3,68,62.6,117,64.6,2,0,0
1/12/2018 16:10,53,67.9,72,63.2,125,65.2,2,0,0
1/12/2018 16:15,58,67.4,77,62.6,135,64.7,2,0,0
1/12/2018 16:20,55,67.3,73,62.5,128,64.5,2,0,0
1/12/2018 16:25,58,68.3,76,63.5,134,65.6,2,0,0
1/12/2018 16:30,55,68.8,73,64.1,128,66.1,2,0,0
1/12/2018 16:35,64,67.7,84,62.8,148,64.9,2,0,0
1/12/2018 16:40,54,67.9,72,63,126,65.1,2,0,0
1/12/2018 16:45,61,68,80,63.3,141,65.3,2,0,0
1/12/2018 16:50,63,68.3,81,63.6,144,65.7,2,0,0
1/12/2018 16:55,61,67.6,80,62.8,141,64.9,2,0,0
1/12/2018 17:00,57,67.1,76,62.2,133,64.3,2,0,0
1/12/2018 17:05,56,68,74,63.3,130,65.4,2,0,0
1/12/2018 17:10,59,68.4,78,63.7,137,65.7,2,0,0
1/12/2018 17:15,54,68.4,71,63.8,125,65.8,2,0,0
1/12/2018 17:20,62,69.1,82,64.5,144,66.5,2,0,0
1/12/2018 17:25,63,67.1,83,62.3,146,64.4,2,0,0
1/12/2018 17:30,56,68.2,74,63.5,130,65.6,2,0,0
1/12/2018 17:35,52,69,69,64.3,121,66.3,2,0,0
1/12/2018 17:40,50,68.1,68,63.3,118,65.4,2,0,0
1/12/2018 17:45,47,68,65,63.2,112,65.3,2,0,0
1/12/2018 17:50,48,69.2,66,64.5,114,66.5,2,0,0
1/12/2018 17:55,36,68,53,63.3,89,65.2,2,0,0
1/12/2018 18:00,44,68.2,61,63.6,105,65.5,2,0,0
1/12/2018 18:05,43,67.2,61,62.4,104,64.4,2,0,0
1/12/2018 18:10,49,66.8,67,61.9,116,64,2,0,0
1/12/2018 18:15,45,66.2,63,61.2,108,63.3,2,0,0
1/12/2018 18:20,48,67.9,66,63.2,114,65.2,2,0,0
1/12/2018 18:25,50,68,66,63.3,116,65.4,2,0,0
1/12/2018 18:30,43,68.4,60,63.6,103,65.6,2,0,0
1/12/2018 18:35,58,69,76,64.3,134,66.3,2,0,0
1/12/2018 18:40,52,68.8,70,64.1,122,66.1,2,0,0
1/12/2018 18:45,50,69.3,68,64.7,118,66.7,2,0,0
1/12/2018 18:50,47,69.2,64,64.5,111,66.5,2,0,0
1/12/2018 18:55,42,69.5,58,64.9,100,66.8,2,0,0
1/12/2018 19:00,48,69.2,66,64.6,114,66.5,2,0,0
1/12/2018 19:05,40,69.1,58,64.4,98,66.3,2,0,0
1/12/2018 19:10,52,69.2,71,64.6,123,66.5,2,0,0
1/12/2018 19:15,50,69.4,68,64.8,118,66.8,2,0,0
1/12/2018 19:20,40,70.1,57,65.5,97,67.4,2,0,0
1/12/2018 19:25,50,67.5,68,62.7,118,64.7,2,0,0
1/12/2018 19:30,39,67.8,56,63.1,95,65,2,0,0
1/12/2018 19:35,39,68.5,56,63.9,95,65.8,2,0,0
1/12/2018 19:40,43,68.3,60,63.6,103,65.6,2,0,0
1/12/2018 19:45,35,68.6,52,64,87,65.9,2,0,0
1/12/2018 19:50,51,69.8,68,65.3,119,67.2,2,0,0
1/12/2018 19:55,43,69.1,61,64.4,104,66.4,2,0,0
1/12/2018 20:00,39,69.4,56,64.8,95,66.7,2,0,0
1/12/2018 20:05,37,69.3,54,64.7,91,66.6,2,0,0
1/12/2018 20:10,35,68.8,51,64.2,86,66.1,2,0,0
1/12/2018 20:15,33,69.3,50,64.7,83,66.5,2,0,0
1/12/2018 20:20,33,68.8,49,64.2,82,66,2,0,0
1/12/2018 20:25,34,68.2,51,63.5,85,65.3,2,0,0
1/12/2018 20:30,26,68.7,42,64.1,68,65.9,2,0,0
1/12/2018 20:35,28,68.6,44,63.9,72,65.7,2,0,0
1/12/2018 20:40,44,69,60,64.4,104,66.4,2,0,0
1/12/2018 20:45,32,69.5,47,64.9,79,66.8,2,0,0
1/12/2018 20:50,27,69.7,43,65.1,70,66.9,2,0,0
1/12/2018 20:55,38,68.1,55,63.5,93,65.4,2,0,0
1/12/2018 21:00,28,67.7,44,63,72,64.9,2,0,0
1/12/2018 21:05,32,68.2,49,63.5,81,65.4,2,0,0
1/12/2018 21:10,30,69.1,46,64.5,76,66.3,2,0,0
1/12/2018 21:15,33,69.1,49,64.5,82,66.3,2,0,0
1/12/2018 21:20,29,69.2,45,64.6,74,66.4,2,0,0
1/12/2018 21:25,34,69.8,51,65.2,85,67,2,0,0
1/12/2018 21:30,29,68.7,46,64.1,75,65.9,2,0,0
1/12/2018 21:35,30,68.8,46,64.1,76,66,2,0,0
1/12/2018 21:40,31,68.6,48,63.9,79,65.7,2,0,0
1/12/2018 21:45,29,68.5,45,63.8,74,65.6,2,0,0
1/12/2018 21:50,33,69.1,49,64.5,82,66.4,2,0,0
1/12/2018 21:55,26,69,43,64.4,69,66.1,2,0,0
1/12/2018 22:00,23,68.9,39,64.3,62,66,2,0,0
1/12/2018 22:05,31,69,48,64.4,79,66.2,2,0,0
1/12/2018 22:10,26,69,42,64.4,68,66.2,2,0,0
1/12/2018 22:15,26,69.1,41,64.5,67,66.3,2,0,0
1/12/2018 22:20,28,69.3,43,64.7,71,66.5,2,0,0
1/12/2018 22:25,23,67.7,39,63,62,64.7,2,0,0
1/12/2018 22:30,27,68.2,42,63.4,69,65.3,2,0,0
1/12/2018 22:35,33,68.6,49,63.9,82,65.8,2,0,0
1/12/2018 22:40,22,69,38,64.3,60,66,2,0,0
1/12/2018 22:45,24,69.1,39,64.5,63,66.3,2,0,0
1/12/2018 22:50,23,69.1,39,64.5,62,66.2,2,0,0
1/12/2018 22:55,24,69.1,40,64.5,64,66.2,2,0,0
1/12/2018 23:00,18,69.2,33,64.6,51,66.2,2,0,0
1/12/2018 23:05,21,69.4,36,64.8,57,66.5,2,0,0
1/12/2018 23:10,20,69.2,35,64.6,55,66.3,2,0,0
1/12/2018 23:15,16,69.2,31,64.5,47,66.1,2,0,0
1/12/2018 23:20,19,68.9,34,64.2,53,65.9,2,0,0
1/12/2018 23:25,20,69,35,64.4,55,66.1,2,0,0
1/12/2018 23:30,22,69.2,37,64.6,59,66.3,2,0,0
1/12/2018 23:35,20,69.3,36,64.7,56,66.3,2,0,0
1/12/2018 23:40,19,68.9,34,64.2,53,65.9,2,0,0
1/12/2018 23:45,18,69.2,34,64.5,52,66.1,2,0,0
1/12/2018 23:50,19,68.8,34,64.2,53,65.8,2,0,0
1/12/2018 23:55,14,69.2,29,64.6,43,66.1,2,0,0
1/13/2018 0:00,13,69.3,29,64.7,42,66.2,2,0,0
1/13/2018 0:05,8,69.3,24,64.7,32,65.9,2,0,0
1/13/2018 0:10,12,69.3,27,64.7,39,66.1,2,0,0
1/13/2018 0:15,14,69.3,29,64.7,43,66.2,2,0,0
1/13/2018 0:20,14,69.2,29,64.6,43,66.1,2,0,0
1/13/2018 0:25,12,69.2,27,64.6,39,66,2,0,0
1/13/2018 0:30,11,69.3,26,64.7,37,66,2,0,0
1/13/2018 0:35,14,69.2,29,64.6,43,66.1,2,0,0
1/13/2018 0:40,10,69.3,25,64.7,35,66,2,0,0
1/13/2018 0:45,13,69.3,29,64.7,42,66.1,2,0,0
1/13/2018 0:50,10,69.3,25,64.7,35,66,2,0,0
1/13/2018 0:55,9,69.3,24,64.7,33,66,2,0,0
1/13/2018 1:00,8,69.4,23,64.8,31,66,2,0,0
1/13/2018 1:05,9,69.3,24,64.7,33,66,2,0,0
1/13/2018 1:10,11,69.1,26,64.5,37,65.9,2,0,0
1/13/2018 1:15,12,68.9,27,64.3,39,65.7,2,0,0
1/13/2018 1:20,9,68.9,24,64.3,33,65.6,2,0,0
1/13/2018 1:25,8,69.1,24,64.5,32,65.7,2,0,0
1/13/2018 1:30,8,69.3,23,64.7,31,65.8,2,0,0
1/13/2018 1:35,11,69.3,26,64.7,37,66,2,0,0
1/13/2018 1:40,10,69.3,25,64.7,35,66,2,0,0
1/13/2018 1:45,10,69.3,25,64.7,35,66,2,0,0
1/13/2018 1:50,11,68.9,26,64.3,37,65.7,2,0,0
1/13/2018 1:55,8,69,23,64.3,31,65.5,2,0,0
1/13/2018 2:00,5,69.2,20,64.5,25,65.5,2,0,0
1/13/2018 2:05,8,69,23,64.4,31,65.5,2,0,0
1/13/2018 2:10,10,68.8,25,64.2,35,65.5,2,0,0
1/13/2018 2:15,6,69,21,64.3,27,65.3,2,0,0
1/13/2018 2:20,9,69,24,64.3,33,65.6,2,0,0
1/13/2018 2:25,8,69,23,64.4,31,65.6,2,0,0
1/13/2018 2:30,9,69,24,64.4,33,65.7,2,0,0
1/13/2018 2:35,7,69,22,64.4,29,65.5,2,0,0
1/13/2018 2:40,11,69.1,27,64.4,38,65.8,2,0,0
1/13/2018 2:45,8,69,23,64.4,31,65.6,2,0,0
1/13/2018 2:50,8,69.1,23,64.5,31,65.7,2,0,0
1/13/2018 2:55,9,69.1,25,64.4,34,65.7,2,0,0
1/13/2018 3:00,8,68.8,24,64.2,32,65.4,2,0,0
1/13/2018 3:05,7,69,23,64.4,30,65.4,2,0,0
1/13/2018 3:10,8,69.2,23,64.5,31,65.7,2,0,0
1/13/2018 3:15,9,69.2,24,64.5,33,65.8,2,0,0
1/13/2018 3:20,9,69.2,24,64.5,33,65.8,2,0,0
1/13/2018 3:25,9,69.2,24,64.6,33,65.9,2,0,0
1/13/2018 3:30,6,69,22,64.4,28,65.4,2,0,0
1/13/2018 3:35,6,68.9,21,64.3,27,65.3,2,0,0
1/13/2018 3:40,8,69.1,24,64.5,32,65.7,2,0,0
1/13/2018 3:45,10,69.3,26,64.7,36,65.9,2,0,0
1/13/2018 3:50,7,69.2,22,64.6,29,65.7,2,0,0
1/13/2018 3:55,11,69.3,27,64.7,38,66,2,0,0
1/13/2018 4:00,9,69.3,24,64.7,33,65.9,2,0,0
1/13/2018 4:05,10,69.2,25,64.6,35,65.9,2,0,0
1/13/2018 4:10,7,69.3,22,64.7,29,65.8,2,0,0
1/13/2018 4:15,13,69.1,28,64.5,41,66,2,0,0
1/13/2018 4:20,10,69.1,26,64.5,36,65.8,2,0,0
1/13/2018 4:25,15,69.1,30,64.5,45,66,2,0,0
1/13/2018 4:30,15,69.1,30,64.5,45,66,2,0,0
1/13/2018 4:35,16,69.1,32,64.5,48,66,2,0,0
1/13/2018 4:40,18,69.4,34,64.8,52,66.4,2,0,0
1/13/2018 4:45,13,69.3,29,64.7,42,66.1,2,0,0
1/13/2018 4:50,14,69.1,30,64.5,44,66,2,0,0
1/13/2018 4:55,14,69.1,29,64.5,43,66,2,0,0
1/13/2018 5:00,12,69.2,28,64.5,40,65.9,2,0,0
1/13/2018 5:05,16,69.1,31,64.5,47,66.1,2,0,0
1/13/2018 5:10,16,69.2,32,64.6,48,66.2,2,0,0
1/13/2018 5:15,16,69.2,32,64.6,48,66.1,2,0,0
1/13/2018 5:20,16,69,32,64.4,48,65.9,2,0,0
1/13/2018 5:25,18,68.1,34,63.4,52,65.1,2,0,0
1/13/2018 5:30,21,67.1,37,62.4,58,64.1,2,0,0
1/13/2018 5:35,19,68.2,35,63.5,54,65.1,2,0,0
1/13/2018 5:40,19,68.8,35,64.2,54,65.8,2,0,0
1/13/2018 5:45,25,69.4,41,64.8,66,66.5,2,0,0
1/13/2018 5:50,24,69.7,40,65.1,64,66.8,2,0,0
1/13/2018 5:55,20,69.5,36,64.9,56,66.6,2,0,0
1/13/2018 6:00,17,69.2,33,64.6,50,66.2,2,0,0
1/13/2018 6:05,23,69.7,38,65.2,61,66.9,2,0,0
1/13/2018 6:10,14,68.9,30,64.3,44,65.8,2,0,0
1/13/2018 6:15,30,68.2,47,63.6,77,65.4,2,0,0
1/13/2018 6:20,19,68.9,35,64.3,54,65.9,2,0,0
1/13/2018 6:25,27,68.5,44,63.8,71,65.6,2,0,0
1/13/2018 6:30,21,68.9,36,64.2,57,66,2,0,0
1/13/2018 6:35,29,69.2,47,64.5,76,66.3,2,0,0
1/13/2018 6:40,24,69.5,40,64.9,64,66.6,2,0,0
1/13/2018 6:45,29,69.5,45,64.9,74,66.7,2,0,0
1/13/2018 6:50,23,69.4,39,64.8,62,66.5,2,0,0
1/13/2018 6:55,23,68.8,39,64.2,62,65.9,2,0,0
1/13/2018 7:00,21,69.1,37,64.5,58,66.2,2,0,0
1/13/2018 7:05,21,68.9,38,64.3,59,66,2,0,0
1/13/2018 7:10,21,69.2,37,64.5,58,66.2,2,0,0
1/13/2018 7:15,29,69.5,45,64.9,74,66.7,2,0,0
1/13/2018 7:20,34,68.3,51,63.6,85,65.5,2,0,0
1/13/2018 7:25,31,68.7,47,64,78,65.9,2,0,0
1/13/2018 7:30,30,68.6,47,63.9,77,65.7,2,0,0
1/13/2018 7:35,36,69.2,52,64.6,88,66.5,2,0,0
1/13/2018 7:40,41,69.3,59,64.7,100,66.6,2,0,0
1/13/2018 7:45,38,68.8,55,64.1,93,66,2,0,0
1/13/2018 7:50,35,69.1,51,64.5,86,66.4,2,0,0
1/13/2018 7:55,36,69,53,64.4,89,66.3,2,0,0
1/13/2018 8:00,43,68.5,61,63.8,104,65.8,2,0,0
1/13/2018 8:05,31,69,48,64.3,79,66.1,2,0,0
1/13/2018 8:10,34,69.2,51,64.6,85,66.4,2,0,0
1/13/2018 8:15,37,69.5,54,64.8,91,66.7,2,0,0
1/13/2018 8:20,41,68.4,58,63.8,99,65.7,2,0,0
1/13/2018 8:25,28,69.2,45,64.5,73,66.3,2,0,0
1/13/2018 8:30,40,69,58,64.4,98,66.2,2,0,0
1/13/2018 8:35,43,70,61,65.4,104,67.3,2,0,0
1/13/2018 8:40,50,70,68,65.4,118,67.4,2,0,0
1/13/2018 8:45,51,70.5,68,65.9,119,67.9,2,0,0
1/13/2018 8:50,50,70.4,67,65.9,117,67.8,2,0,0
1/13/2018 8:55,50,69.8,68,65.3,118,67.2,2,0,0
1/13/2018 9:00,44,70.1,61,65.6,105,67.5,2,0,0
1/13/2018 9:05,48,69.3,65,64.7,113,66.7,2,0,0
1/13/2018 9:10,44,68.9,62,64.2,106,66.2,2,0,0
1/13/2018 9:15,55,69,73,64.4,128,66.4,2,0,0
1/13/2018 9:20,49,68.9,67,64.2,116,66.2,2,0,0
1/13/2018 9:25,57,68.4,75,63.6,132,65.7,2,0,0
1/13/2018 9:30,56,68.6,76,63.9,132,65.9,2,0,0
1/13/2018 9:35,52,68.9,69,64.3,121,66.3,2,0,0
1/13/2018 9:40,55,68.5,73,63.7,128,65.8,2,0,0
1/13/2018 9:45,67,68.7,85,64,152,66.1,2,0,0
1/13/2018 9:50,64,68.4,83,63.6,147,65.7,2,0,0
1/13/2018 9:55,63,69,80,64.4,143,66.4,2,0,0
1/13/2018 10:00,57,68.9,76,64.2,133,66.2,2,0,0
1/13/2018 10:05,51,69.3,69,64.7,120,66.7,2,0,0
1/13/2018 10:10,55,68.9,73,64.3,128,66.3,2,0,0
1/13/2018 10:15,62,68.9,80,64.2,142,66.3,2,0,0
1/13/2018 10:20,68,69.1,89,64.4,157,66.4,2,0,0
1/13/2018 10:25,55,68.5,73,63.8,128,65.8,2,0,0
1/13/2018 10:30,55,69,74,64.4,129,66.3,2,0,0
1/13/2018 10:35,61,69.4,79,64.7,140,66.7,2,0,0
1/13/2018 10:40,63,69.6,81,65,144,67,2,0,0
1/13/2018 10:45,60,69,78,64.3,138,66.3,2,0,0
1/13/2018 10:50,59,69,78,64.4,137,66.4,2,0,0
1/13/2018 10:55,58,69.1,76,64.5,134,66.5,2,0,0
1/13/2018 11:00,58,68.8,77,64.2,135,66.2,2,0,0
1/13/2018 11:05,55,68.4,73,63.6,128,65.7,2,0,0
1/13/2018 11:10,55,67.9,73,63.2,128,65.2,2,0,0
1/13/2018 11:15,60,68.5,77,63.8,137,65.8,2,0,0
1/13/2018 11:20,66,68.2,85,63.5,151,65.5,2,0,0
1/13/2018 11:25,56,68.4,74,63.7,130,65.8,2,0,0
1/13/2018 11:30,66,68.6,84,63.9,150,65.9,2,0,0
1/13/2018 11:35,63,68.5,82,63.9,145,65.9,2,0,0
1/13/2018 11:40,61,68.9,79,64.2,140,66.3,2,0,0
1/13/2018 11:45,67,68.8,86,64.2,153,66.2,2,0,0
1/13/2018 11:50,67,68.3,87,63.6,154,65.7,2,0,0
1/13/2018 11:55,71,68.7,90,64,161,66.1,2,0,0
1/13/2018 12:00,61,68.6,78,63.9,139,66,2,0,0
1/13/2018 12:05,73,68.6,91,63.9,164,66,2,0,0
1/13/2018 12:10,65,68.4,84,63.7,149,65.7,2,0,0
1/13/2018 12:15,61,68.5,80,63.9,141,65.9,2,0,0
1/13/2018 12:20,73,69,93,64.4,166,66.5,2,0,0
1/13/2018 12:25,74,68.7,93,64,167,66.1,2,0,0
1/13/2018 12:30,67,68.7,85,64,152,66.1,2,0,0
1/13/2018 12:35,76,68.1,96,63.3,172,65.5,2,0,0
1/13/2018 12:40,75,68.1,96,63.4,171,65.5,2,0,0
1/13/2018 12:45,79,67.8,99,63,178,65.1,2,0,0
1/13/2018 12:50,73,68.2,93,63.5,166,65.5,2,0,0
1/13/2018 12:55,64,67.9,83,63.2,147,65.2,2,0,0
1/13/2018 13:00,65,67.8,83,63,148,65.1,2,0,0
1/13/2018 13:05,77,67.6,98,62.8,175,64.9,2,0,0
1/13/2018 13:10,71,68,91,63.2,162,65.3,2,0,0
1/13/2018 13:15,70,68.5,90,63.8,160,65.8,2,0,0
1/13/2018 13:20,65,69.3,83,64.7,148,66.7,2,0,0
1/13/2018 13:25,73,68.5,93,63.8,166,65.9,2,0,0
1/13/2018 13:30,62,69,80,64.3,142,66.4,2,0,0
1/13/2018 13:35,58,68.5,76,63.8,134,65.8,2,0,0
1/13/2018 13:40,63,69,82,64.3,145,66.3,2,0,0
1/13/2018 13:45,67,68.9,87,64.2,154,66.2,2,0,0
1/13/2018 13:50,58,68.4,75,63.6,133,65.7,2,0,0
1/13/2018 13:55,59,68.9,78,64.2,137,66.2,2,0,0
1/13/2018 14:00,61,69.4,80,64.8,141,66.8,2,0,0
1/13/2018 14:05,61,68.5,80,63.8,141,65.8,2,0,0
1/13/2018 14:10,59,68.2,78,63.5,137,65.5,2,0,0
1/13/2018 14:15,56,68.1,73,63.3,129,65.4,2,0,0
1/13/2018 14:20,62,68.7,80,64,142,66,2,0,0
1/13/2018 14:25,58,68.3,76,63.6,134,65.6,2,0,0
1/13/2018 14:30,52,68.5,69,63.9,121,65.9,2,0,0
1/13/2018 14:35,56,68.9,74,64.3,130,66.3,2,0,0
1/13/2018 14:40,61,69,80,64.4,141,66.4,2,0,0
1/13/2018 14:45,61,68.3,80,63.6,141,65.6,2,0,0
1/13/2018 14:50,62,68.1,81,63.4,143,65.4,2,0,0
1/13/2018 14:55,65,69.2,83,64.6,148,66.6,2,0,0
1/13/2018 15:00,65,69.9,84,65.5,149,67.4,2,0,0
1/13/2018 15:05,57,69.7,75,65.2,132,67.1,2,0,0
1/13/2018 15:10,55,68.8,74,64.1,129,66.1,2,0,0
1/13/2018 15:15,62,69.5,81,64.9,143,66.9,2,0,0
1/13/2018 15:20,53,68.5,71,63.8,124,65.8,2,0,0
1/13/2018 15:25,59,69.1,77,64.4,136,66.5,2,0,0
1/13/2018 15:30,59,69.5,77,64.9,136,66.9,2,0,0
1/13/2018 15:35,57,69.3,75,64.8,132,66.7,2,0,0
1/13/2018 15:40,60,68.8,79,64.2,139,66.2,2,0,0
1/13/2018 15:45,64,69.2,83,64.6,147,66.6,2,0,0
1/13/2018 15:50,57,69,75,64.4,132,66.4,2,0,0
1/13/2018 15:55,57,68.6,75,63.9,132,65.9,2,0,0
1/13/2018 16:00,62,68.2,80,63.5,142,65.5,2,0,0
1/13/2018 16:05,61,68.1,78,63.4,139,65.5,2,0,0
1/13/2018 16:10,68,67.9,87,63.2,155,65.2,2,0,0
1/13/2018 16:15,67,68.7,86,64.1,153,66.1,2,0,0
1/13/2018 16:20,64,68.5,83,63.9,147,65.9,2,0,0
1/13/2018 16:25,58,68.7,76,64,134,66,2,0,0
1/13/2018 16:30,64,68.9,83,64.3,147,66.3,2,0,0
1/13/2018 16:35,53,69.4,71,64.8,124,66.8,2,0,0
1/13/2018 16:40,56,68.7,74,64.1,130,66.1,2,0,0
1/13/2018 16:45,58,69.3,76,64.7,134,66.7,2,0,0
1/13/2018 16:50,55,69,72,64.4,127,66.4,2,0,0
1/13/2018 16:55,62,68,81,63.2,143,65.3,2,0,0
1/13/2018 17:00,60,68.6,79,64,139,66,2,0,0
1/13/2018 17:05,54,68.9,72,64.3,126,66.3,2,0,0
1/13/2018 17:10,48,69.5,66,64.9,114,66.8,2,0,0
1/13/2018 17:15,64,69.2,83,64.6,147,66.6,2,0,0
1/13/2018 17:20,66,69.3,85,64.7,151,66.7,2,0,0
1/13/2018 17:25,60,68.8,79,64.1,139,66.1,2,0,0
1/13/2018 17:30,68,68.5,88,63.8,156,65.8,2,0,0
1/13/2018 17:35,66,68.2,85,63.5,151,65.6,2,0,0
1/13/2018 17:40,62,67.9,80,63.1,142,65.2,2,0,0
1/13/2018 17:45,62,68.6,80,64,142,66,2,0,0
1/13/2018 17:50,69,67.6,88,62.9,157,65,2,0,0
1/13/2018 17:55,51,67.9,68,63.2,119,65.2,2,0,0
1/13/2018 18:00,43,67.5,60,62.7,103,64.7,2,0,0
1/13/2018 18:05,49,67.2,67,62.4,116,64.4,2,0,0
1/13/2018 18:10,43,67.8,61,63,104,65,2,0,0
1/13/2018 18:15,37,68.2,54,63.4,91,65.3,2,0,0
1/13/2018 18:20,38,67.7,55,63,93,64.9,2,0,0
1/13/2018 18:25,37,68.3,53,63.6,90,65.5,2,0,0
1/13/2018 18:30,28,68.5,45,63.8,73,65.6,2,0,0
1/13/2018 18:35,26,68.3,43,63.5,69,65.3,2,0,0
1/13/2018 18:40,29,68.4,45,63.7,74,65.5,2,0,0
1/13/2018 18:45,30,68.7,46,64.1,76,65.9,2,0,0
1/13/2018 18:50,27,69.2,43,64.5,70,66.3,2,0,0
1/13/2018 18:55,28,69.1,44,64.5,72,66.3,2,0,0
1/13/2018 19:00,29,69,46,64.4,75,66.2,2,0,0
1/13/2018 19:05,26,69.2,43,64.5,69,66.3,2,0,0
1/13/2018 19:10,33,69,49,64.4,82,66.2,2,0,0
1/13/2018 19:15,35,68.8,52,64.1,87,66,2,0,0
1/13/2018 19:20,28,69,44,64.3,72,66.1,2,0,0
1/13/2018 19:25,30,69.2,45,64.5,75,66.4,2,0,0
1/13/2018 19:30,38,69.1,54,64.4,92,66.3,2,0,0
1/13/2018 19:35,40,69.4,56,64.7,96,66.7,2,0,0
1/13/2018 19:40,39,69.3,55,64.7,94,66.6,2,0,0
1/13/2018 19:45,37,67.8,54,63.1,91,65,2,0,0
1/13/2018 19:50,38,68.2,55,63.4,93,65.4,2,0,0
1/13/2018 19:55,36,68.2,52,63.5,88,65.5,2,0,0
1/13/2018 20:00,37,68.5,54,63.9,91,65.8,2,0,0
1/13/2018 20:05,33,68.8,49,64.2,82,66,2,0,0
1/13/2018 20:10,31,68.9,48,64.3,79,66.1,2,0,0
1/13/2018 20:15,30,68.3,46,63.6,76,65.5,2,0,0
1/13/2018 20:20,33,69.4,49,64.8,82,66.6,2,0,0
1/13/2018 20:25,39,69.4,56,64.8,95,66.7,2,0,0
1/13/2018 20:30,35,70,51,65.5,86,67.3,2,0,0
1/13/2018 20:35,23,69.8,38,65.2,61,66.9,2,0,0
1/13/2018 20:40,25,69.4,42,64.8,67,66.5,2,0,0
1/13/2018 20:45,33,68.7,49,64,82,65.9,2,0,0
1/13/2018 20:50,26,68.8,41,64.2,67,66,2,0,0
1/13/2018 20:55,26,68.9,42,64.2,68,66,2,0,0
1/13/2018 21:00,33,69,49,64.4,82,66.2,2,0,0
1/13/2018 21:05,30,68.5,46,63.8,76,65.7,2,0,0
1/13/2018 21:10,37,68.6,53,63.9,90,65.8,2,0,0
1/13/2018 21:15,32,69.1,48,64.5,80,66.3,2,0,0
1/13/2018 21:20,31,69.1,48,64.5,79,66.3,2,0,0
1/13/2018 21:25,32,69.3,48,64.7,80,66.5,2,0,0
1/13/2018 21:30,37,68.6,53,63.9,90,65.8,2,0,0
1/13/2018 21:35,33,68.4,49,63.7,82,65.6,2,0,0
1/13/2018 21:40,30,68.5,47,63.8,77,65.6,2,0,0
1/13/2018 21:45,30,69.2,46,64.5,76,66.4,2,0,0
1/13/2018 21:50,33,69.3,49,64.7,82,66.6,2,0,0
1/13/2018 21:55,21,69.4,37,64.8,58,66.5,2,0,0
1/13/2018 22:00,24,69.2,39,64.5,63,66.3,2,0,0
1/13/2018 22:05,26,69.3,41,64.7,67,66.5,2,0,0
1/13/2018 22:10,30,69.3,46,64.6,76,66.5,2,0,0
1/13/2018 22:15,29,69.2,45,64.5,74,66.3,2,0,0
1/13/2018 22:20,30,68.9,45,64.2,75,66.1,2,0,0
1/13/2018 22:25,30,69.3,46,64.6,76,66.5,2,0,0
1/13/2018 22:30,32,69,48,64.4,80,66.2,2,0,0
1/13/2018 22:35,28,69,45,64.3,73,66.1,2,0,0
1/13/2018 22:40,25,68.8,41,64.1,66,65.9,2,0,0
1/13/2018 22:45,30,68.6,46,64,76,65.8,2,0,0
1/13/2018 22:50,23,69,39,64.3,62,66,2,0,0
1/13/2018 22:55,22,69.2,37,64.6,59,66.3,2,0,0
1/13/2018 23:00,22,68.6,38,63.9,60,65.6,2,0,0
1/13/2018 23:05,25,69,41,64.4,66,66.1,2,0,0
1/13/2018 23:10,18,69,33,64.4,51,66,2,0,0
1/13/2018 23:15,21,69.1,37,64.5,58,66.1,2,0,0
1/13/2018 23:20,18,69.2,33,64.6,51,66.2,2,0,0
1/13/2018 23:25,18,69.2,34,64.6,52,66.2,2,0,0
1/13/2018 23:30,15,69.2,30,64.6,45,66.2,2,0,0
1/13/2018 23:35,19,69.2,34,64.5,53,66.2,2,0,0
1/13/2018 23:40,21,69.2,36,64.5,57,66.3,2,0,0
1/13/2018 23:45,20,69.1,35,64.5,55,66.2,2,0,0
1/13/2018 23:50,19,69.3,35,64.7,54,66.4,2,0,0
1/13/2018 23:55,20,69.4,35,64.8,55,66.5,2,0,0
1/14/2018 0:00,20,69.3,35,64.7,55,66.4,2,0,0
1/14/2018 0:05,19,69.2,34,64.6,53,66.3,2,0,0
1/14/2018 0:10,17,69.2,32,64.6,49,66.2,2,0,0
1/14/2018 0:15,14,69.3,29,64.7,43,66.2,2,0,0
1/14/2018 0:20,19,69.1,35,64.5,54,66.1,2,0,0
1/14/2018 0:25,16,69.1,32,64.5,48,66,2,0,0
1/14/2018 0:30,16,69.2,31,64.6,47,66.2,2,0,0
1/14/2018 0:35,11,69.3,27,64.7,38,66,2,0,0
1/14/2018 0:40,11,69.2,26,64.6,37,66,2,0,0
1/14/2018 0:45,11,69.3,27,64.7,38,66.1,2,0,0
1/14/2018 0:50,13,69.4,28,64.8,41,66.3,2,0,0
1/14/2018 0:55,11,69.2,27,64.6,38,65.9,2,0,0
1/14/2018 1:00,9,69.2,24,64.6,33,65.9,2,0,0
1/14/2018 1:05,12,69.2,27,64.6,39,66,2,0,0
1/14/2018 1:10,10,69.2,25,64.6,35,65.9,2,0,0
1/14/2018 1:15,12,69.3,27,64.7,39,66.1,2,0,0
1/14/2018 1:20,9,69.3,25,64.7,34,65.9,2,0,0
1/14/2018 1:25,8,69.3,23,64.7,31,65.9,2,0,0
1/14/2018 1:30,9,69.3,24,64.7,33,66,2,0,0
1/14/2018 1:35,10,69.3,25,64.7,35,66.1,2,0,0
1/14/2018 1:40,8,69.3,23,64.7,31,65.9,2,0,0
1/14/2018 1:45,9,69.3,24,64.7,33,66,2,0,0
1/14/2018 1:50,8,69.3,23,64.7,31,65.8,2,0,0
1/14/2018 1:55,9,69.3,24,64.7,33,65.9,2,0,0
1/14/2018 2:00,16,69.3,23,64.7,39,66.6,2,0,0
1/14/2018 2:05,7,69.3,22,64.7,29,65.8,2,0,0
1/14/2018 2:10,9,69.2,24,64.6,33,65.9,2,0,0
1/14/2018 2:15,8,69.3,23,64.7,31,65.9,2,0,0
1/14/2018 2:20,5,69.3,21,64.7,26,65.6,2,0,0
1/14/2018 2:25,9,69.3,24,64.7,33,66,2,0,0
1/14/2018 2:30,9,69.3,24,64.7,33,65.9,2,0,0
1/14/2018 2:35,8,69.2,23,64.6,31,65.8,2,0,0
1/14/2018 2:40,13,69.3,21,64.7,34,66.5,2,0,0
1/14/2018 2:45,6,69.3,21,64.7,27,65.7,2,0,0
1/14/2018 2:50,10,69.3,25,64.7,35,66,2,0,0
1/14/2018 2:55,6,69.2,21,64.6,27,65.6,2,0,0
1/14/2018 3:00,7,69.3,22,64.7,29,65.8,2,0,0
1/14/2018 3:05,9,69.4,24,64.8,33,66.1,2,0,0
1/14/2018 3:10,5,69.4,20,64.8,25,65.7,2,0,0
1/14/2018 3:15,6,69.3,21,64.7,27,65.8,2,0,0
1/14/2018 3:20,6,69.3,22,64.7,28,65.7,2,0,0
1/14/2018 3:25,7,69.3,22,64.7,29,65.8,2,0,0
1/14/2018 3:30,9,69.3,24,64.7,33,66,2,0,0
1/14/2018 3:35,8,69.3,24,64.7,32,65.9,2,0,0
1/14/2018 3:40,5,69.3,21,64.7,26,65.6,2,0,0
1/14/2018 3:45,8,69.3,24,64.7,32,65.9,2,0,0
1/14/2018 3:50,6,69.4,21,64.8,27,65.8,2,0,0
1/14/2018 3:55,6,69.4,22,64.8,28,65.8,2,0,0
1/14/2018 4:00,7,69.2,22,64.6,29,65.7,2,0,0
1/14/2018 4:05,6,69.3,21,64.7,27,65.7,2,0,0
1/14/2018 4:10,10,69.3,25,64.7,35,66,2,0,0
1/14/2018 4:15,10,69.3,25,64.7,35,66,2,0,0
1/14/2018 4:20,8,69.3,24,64.7,32,65.9,2,0,0
1/14/2018 4:25,9,69.3,24,64.7,33,66,2,0,0
1/14/2018 4:30,7,69.4,22,64.8,29,65.9,2,0,0
1/14/2018 4:35,9,69.4,24,64.8,33,66,2,0,0
1/14/2018 4:40,10,69.3,26,64.7,36,66,2,0,0
1/14/2018 4:45,8,69.3,24,64.7,32,65.8,2,0,0
1/14/2018 4:50,9,69.3,24,64.7,33,66,2,0,0
1/14/2018 4:55,10,68.9,25,64.2,35,65.6,2,0,0
1/14/2018 5:00,9,69,25,64.3,34,65.5,2,0,0
1/14/2018 5:05,7,69.1,22,64.5,29,65.6,2,0,0
1/14/2018 5:10,8,69.1,23,64.5,31,65.7,2,0,0
1/14/2018 5:15,9,69.1,24,64.5,33,65.8,2,0,0
1/14/2018 5:20,13,69.2,28,64.6,41,66.1,2,0,0
1/14/2018 5:25,15,69.1,30,64.5,45,66,2,0,0
1/14/2018 5:30,14,69.3,29,64.6,43,66.1,2,0,0
1/14/2018 5:35,13,69.4,29,64.7,42,66.2,2,0,0
1/14/2018 5:40,18,69.3,34,64.7,52,66.3,2,0,0
1/14/2018 5:45,16,69.4,31,64.8,47,66.3,2,0,0
1/14/2018 5:50,12,69.3,27,64.7,39,66.2,2,0,0
1/14/2018 5:55,14,69.4,30,64.8,44,66.2,2,0,0
1/14/2018 6:00,13,69.3,29,64.7,42,66.1,2,0,0
1/14/2018 6:05,17,69.2,33,64.6,50,66.2,2,0,0
1/14/2018 6:10,15,69.2,31,64.6,46,66.1,2,0,0
1/14/2018 6:15,15,69.2,31,64.6,46,66.1,2,0,0
1/14/2018 6:20,16,69.3,32,64.7,48,66.2,2,0,0
1/14/2018 6:25,11,69.3,27,64.7,38,66,2,0,0
1/14/2018 6:30,18,69.2,34,64.6,52,66.2,2,0,0
1/14/2018 6:35,20,69.2,36,64.6,56,66.2,2,0,0
1/14/2018 6:40,22,69.2,38,64.6,60,66.3,2,0,0
1/14/2018 6:45,19,69.3,35,64.7,54,66.3,2,0,0
1/14/2018 6:50,15,69.2,30,64.5,45,66.1,2,0,0
1/14/2018 6:55,16,69.2,31,64.6,47,66.2,2,0,0
1/14/2018 7:00,16,69.2,32,64.6,48,66.1,2,0,0
1/14/2018 7:05,17,69.3,32,64.7,49,66.3,2,0,0
1/14/2018 7:10,18,69.2,33,64.6,51,66.2,2,0,0
1/14/2018 7:15,19,69.4,35,64.8,54,66.4,2,0,0
1/14/2018 7:20,22,69.3,38,64.7,60,66.3,2,0,0
1/14/2018 7:25,18,69.3,34,64.7,52,66.3,2,0,0
1/14/2018 7:30,21,69.2,37,64.6,58,66.3,2,0,0
1/14/2018 7:35,22,69.4,38,64.8,60,66.5,2,0,0
1/14/2018 7:40,26,69.5,42,65,68,66.7,2,0,0
1/14/2018 7:45,21,69.6,37,65.1,58,66.7,2,0,0
1/14/2018 7:50,25,69.3,42,64.7,67,66.4,2,0,0
1/14/2018 7:55,23,69.2,40,64.7,63,66.3,2,0,0
1/14/2018 8:00,24,69.3,40,64.7,64,66.4,2,0,0
1/14/2018 8:05,21,69.3,37,64.7,58,66.4,2,0,0
1/14/2018 8:10,27,69.4,42,64.8,69,66.6,2,0,0
1/14/2018 8:15,30,69.2,46,64.6,76,66.4,2,0,0
1/14/2018 8:20,27,69.3,43,64.7,70,66.4,2,0,0
1/14/2018 8:25,27,69.1,43,64.5,70,66.3,2,0,0
1/14/2018 8:30,25,69.2,41,64.6,66,66.3,2,0,0
1/14/2018 8:35,24,69.2,40,64.5,64,66.3,2,0,0
1/14/2018 8:40,26,69.4,42,64.7,68,66.5,2,0,0
1/14/2018 8:45,34,69.4,50,64.8,84,66.6,2,0,0
1/14/2018 8:50,35,69,51,64.4,86,66.3,2,0,0
1/14/2018 8:55,34,69,51,64.4,85,66.2,2,0,0
1/14/2018 9:00,29,69.3,46,64.7,75,66.5,2,0,0
1/14/2018 9:05,30,69,46,64.3,76,66.2,2,0,0
1/14/2018 9:10,33,69.1,49,64.5,82,66.3,2,0,0
1/14/2018 9:15,37,69.1,54,64.5,91,66.4,2,0,0
1/14/2018 9:20,36,69.1,53,64.5,89,66.4,2,0,0
1/14/2018 9:25,47,68.6,64,64,111,65.9,2,0,0
1/14/2018 9:30,37,69.2,54,64.6,91,66.5,2,0,0
1/14/2018 9:35,40,68.7,57,64,97,65.9,2,0,0
1/14/2018 9:40,47,68.6,65,63.9,112,65.9,2,0,0
1/14/2018 9:45,60,68.7,79,64,139,66,2,0,0
1/14/2018 9:50,41,68.5,58,63.8,99,65.7,2,0,0
1/14/2018 9:55,55,68.7,73,64.1,128,66.1,2,0,0
1/14/2018 10:00,49,68.2,65,63.5,114,65.5,2,0,0
1/14/2018 10:05,53,68.5,70,63.8,123,65.9,2,0,0
1/14/2018 10:10,52,68.3,70,63.5,122,65.5,2,0,0
1/14/2018 10:15,45,67.8,62,63.1,107,65.1,2,0,0
1/14/2018 10:20,51,68.6,67,63.9,118,65.9,2,0,0
1/14/2018 10:25,45,68,62,63.2,107,65.2,2,0,0
1/14/2018 10:30,48,67.9,66,63.1,114,65.1,2,0,0
1/14/2018 10:35,44,68.4,62,63.7,106,65.6,2,0,0
1/14/2018 10:40,42,68.1,59,63.4,101,65.4,2,0,0
1/14/2018 10:45,47,68.2,65,63.4,112,65.4,2,0,0
1/14/2018 10:50,54,68.5,71,63.8,125,65.8,2,0,0
1/14/2018 10:55,46,68.8,64,64.1,110,66.1,2,0,0
1/14/2018 11:00,44,69.8,61,65.2,105,67.1,2,0,0
1/14/2018 11:05,50,68.9,68,64.2,118,66.2,2,0,0
1/14/2018 11:10,41,68.7,58,64,99,65.9,2,0,0
1/14/2018 11:15,53,68.6,71,64,124,66,2,0,0
1/14/2018 11:20,57,68.6,75,63.9,132,65.9,2,0,0
1/14/2018 11:25,52,68.1,70,63.3,122,65.3,2,0,0
1/14/2018 11:30,48,68,65,63.2,113,65.2,2,0,0
1/14/2018 11:35,48,68,66,63.2,114,65.2,2,0,0
1/14/2018 11:40,74,68.2,93,63.4,167,65.5,2,0,0
1/14/2018 11:45,52,67.9,69,63.1,121,65.2,2,0,0
1/14/2018 11:50,63,68.5,82,63.7,145,65.8,2,0,0
1/14/2018 11:55,51,68.7,69,64,120,66,2,0,0
1/14/2018 12:00,50,68.9,67,64.2,117,66.2,2,0,0
1/14/2018 12:05,51,69.2,69,64.5,120,66.5,2,0,0
1/14/2018 12:10,49,68.5,66,63.8,115,65.8,2,0,0
1/14/2018 12:15,47,68.1,65,63.3,112,65.3,2,0,0
1/14/2018 12:20,52,68.2,70,63.5,122,65.5,2,0,0
1/14/2018 12:25,52,68,68,63.3,120,65.4,2,0,0
1/14/2018 12:30,50,68.6,67,63.9,117,65.9,2,0,0
1/14/2018 12:35,52,68.1,70,63.3,122,65.4,2,0,0
1/14/2018 12:40,58,68.7,75,64,133,66,2,0,0
1/14/2018 12:45,53,69.2,71,64.6,124,66.5,2,0,0
1/14/2018 12:50,60,68.7,78,64.1,138,66.1,2,0,0
1/14/2018 12:55,55,68.6,72,63.9,127,65.9,2,0,0
1/14/2018 13:00,44,68.2,61,63.5,105,65.4,2,0,0
1/14/2018 13:05,49,68.2,67,63.5,116,65.5,2,0,0
1/14/2018 13:10,49,68.7,66,64,115,66,2,0,0
1/14/2018 13:15,62,68.5,81,63.8,143,65.8,2,0,0
1/14/2018 13:20,50,68.6,68,63.9,118,65.9,2,0,0
1/14/2018 13:25,55,68.6,74,63.9,129,65.9,2,0,0
1/14/2018 13:30,47,68.7,64,64,111,66,2,0,0
1/14/2018 13:35,53,68.6,71,64,124,66,2,0,0
1/14/2018 13:40,58,67.5,77,62.7,135,64.7,2,0,0
1/14/2018 13:45,63,68.2,81,63.4,144,65.5,2,0,0
1/14/2018 13:50,57,68.5,75,63.9,132,65.9,2,0,0
1/14/2018 13:55,55,68,73,63.2,128,65.3,2,0,0
1/14/2018 14:00,51,67.8,67,63,118,65.1,2,0,0
1/14/2018 14:05,57,67.7,75,62.9,132,65,2,0,0
1/14/2018 14:10,53,68.5,70,63.9,123,65.9,2,0,0
1/14/2018 14:15,52,68.2,69,63.4,121,65.5,2,0,0
1/14/2018 14:20,58,68.5,76,63.9,134,65.9,2,0,0
1/14/2018 14:25,59,68.6,77,63.9,136,65.9,2,0,0
1/14/2018 14:30,61,68.5,80,63.8,141,65.8,2,0,0
1/14/2018 14:35,60,67.6,78,62.9,138,64.9,2,0,0
1/14/2018 14:40,53,68.2,70,63.5,123,65.5,2,0,0
1/14/2018 14:45,67,67.5,86,62.7,153,64.8,2,0,0
1/14/2018 14:50,60,67.7,78,62.9,138,65,2,0,0
1/14/2018 14:55,58,68.3,75,63.6,133,65.7,2,0,0
1/14/2018 15:00,47,68.7,64,64,111,66,2,0,0
1/14/2018 15:05,46,68.5,64,63.8,110,65.7,2,0,0
1/14/2018 15:10,54,68.5,71,63.8,125,65.8,2,0,0
1/14/2018 15:15,56,67.7,75,62.9,131,65,2,0,0
1/14/2018 15:20,59,67.9,78,63.1,137,65.2,2,0,0
1/14/2018 15:25,51,67.4,69,62.6,120,64.7,2,0,0
1/14/2018 15:30,59,67.4,78,62.5,137,64.6,2,0,0
1/14/2018 15:35,54,67.4,72,62.6,126,64.7,2,0,0
1/14/2018 15:40,62,67.1,80,62.2,142,64.3,2,0,0
1/14/2018 15:45,53,67.1,71,62.2,124,64.3,2,0,0
1/14/2018 15:50,50,66.9,68,62.1,118,64.1,2,0,0
1/14/2018 15:55,42,67.3,59,62.5,101,64.5,2,0,0
1/14/2018 16:00,42,68,58,63.2,100,65.2,2,0,0
1/14/2018 16:05,43,67.8,61,63,104,65,2,0,0
1/14/2018 16:10,44,68.6,61,63.9,105,65.9,2,0,0
1/14/2018 16:15,46,68.6,63,63.9,109,65.9,2,0,0
1/14/2018 16:20,45,68.1,62,63.3,107,65.3,2,0,0
1/14/2018 16:25,51,68.8,68,64.2,119,66.1,2,0,0
1/14/2018 16:30,41,68.1,58,63.4,99,65.3,2,0,0
1/14/2018 16:35,54,68,72,63.2,126,65.3,2,0,0
1/14/2018 16:40,50,68.6,67,63.9,117,65.9,2,0,0
1/14/2018 16:45,53,68.3,70,63.6,123,65.6,2,0,0
1/14/2018 16:50,60,68,78,63.2,138,65.3,2,0,0
1/14/2018 16:55,49,68.8,67,64.2,116,66.1,2,0,0
1/14/2018 17:00,45,68.5,62,63.9,107,65.8,2,0,0
1/14/2018 17:05,59,68.7,77,64.1,136,66.1,2,0,0
1/14/2018 17:10,57,68.3,75,63.5,132,65.6,2,0,0
1/14/2018 17:15,65,67.9,83,63.1,148,65.2,2,0,0
1/14/2018 17:20,52,68.4,68,63.7,120,65.7,2,0,0
1/14/2018 17:25,51,69,69,64.3,120,66.3,2,0,0
1/14/2018 17:30,57,69,75,64.3,132,66.3,2,0,0
1/14/2018 17:35,42,68.9,59,64.3,101,66.2,2,0,0
1/14/2018 17:40,52,68.9,71,64.3,123,66.2,2,0,0
1/14/2018 17:45,52,67.4,70,62.6,122,64.6,2,0,0
1/14/2018 17:50,55,67,74,62.2,129,64.2,2,0,0
1/14/2018 17:55,49,67.6,67,62.8,116,64.8,2,0,0
1/14/2018 18:00,52,67.2,70,62.4,122,64.5,2,0,0
1/14/2018 18:05,51,66.7,69,61.8,120,63.9,2,0,0
1/14/2018 18:10,57,68,74,63.3,131,65.4,2,0,0
1/14/2018 18:15,53,67.7,70,63,123,65,2,0,0
1/14/2018 18:20,55,68.2,72,63.5,127,65.5,2,0,0
1/14/2018 18:25,52,67.5,69,62.7,121,64.8,2,0,0
1/14/2018 18:30,40,68.3,57,63.5,97,65.5,2,0,0
1/14/2018 18:35,54,66.7,71,61.8,125,63.9,2,0,0
1/14/2018 18:40,55,67,73,62.2,128,64.2,2,0,0
1/14/2018 18:45,46,67.2,63,62.5,109,64.5,2,0,0
1/14/2018 18:50,44,67.2,62,62.4,106,64.4,2,0,0
1/14/2018 18:55,43,68.1,59,63.4,102,65.4,2,0,0
1/14/2018 19:00,39,68.1,56,63.4,95,65.3,2,0,0
1/14/2018 19:05,42,68.6,58,63.9,100,65.9,2,0,0
1/14/2018 19:10,50,68.3,68,63.6,118,65.6,2,0,0
1/14/2018 19:15,39,68.8,56,64.2,95,66.1,2,0,0
1/14/2018 19:20,39,69,56,64.4,95,66.3,2,0,0
1/14/2018 19:25,35,68.3,51,63.6,86,65.5,2,0,0
1/14/2018 19:30,29,68.6,45,63.9,74,65.8,2,0,0
1/14/2018 19:35,44,67.7,61,62.9,105,64.9,2,0,0
1/14/2018 19:40,42,68.1,59,63.4,101,65.3,2,0,0
1/14/2018 19:45,35,68.6,51,64,86,65.8,2,0,0
1/14/2018 19:50,31,68.7,47,64,78,65.9,2,0,0
1/14/2018 19:55,40,68.4,57,63.7,97,65.6,2,0,0
1/14/2018 20:00,30,68.9,47,64.2,77,66.1,2,0,0
1/14/2018 20:05,33,68.9,49,64.2,82,66.1,2,0,0
1/14/2018 20:10,33,69.3,50,64.7,83,66.6,2,0,0
1/14/2018 20:15,31,69.5,46,64.9,77,66.8,2,0,0
1/14/2018 20:20,29,69.3,45,64.7,74,66.5,2,0,0
1/14/2018 20:25,32,69.4,47,64.8,79,66.7,2,0,0
1/14/2018 20:30,38,68.1,54,63.4,92,65.4,2,0,0
1/14/2018 20:35,26,68.6,42,63.9,68,65.7,2,0,0
1/14/2018 20:40,36,68.7,52,64.1,88,66,2,0,0
1/14/2018 20:45,35,69.2,51,64.5,86,66.4,2,0,0
1/14/2018 20:50,24,68.9,40,64.3,64,66,2,0,0
1/14/2018 20:55,31,68.9,47,64.2,78,66.1,2,0,0
1/14/2018 21:00,32,68.7,48,64.1,80,65.9,2,0,0
1/14/2018 21:05,28,68.9,44,64.3,72,66.1,2,0,0
1/14/2018 21:10,29,69.1,45,64.5,74,66.3,2,0,0
1/14/2018 21:15,23,69.4,39,64.8,62,66.5,2,0,0
1/14/2018 21:20,26,69.5,42,65,68,66.7,2,0,0
1/14/2018 21:25,26,68.7,42,64.1,68,65.9,2,0,0
1/14/2018 21:30,25,69,41,64.4,66,66.1,2,0,0
1/14/2018 21:35,37,69.3,53,64.7,90,66.6,2,0,0
1/14/2018 21:40,29,68.9,45,64.3,74,66.1,2,0,0
1/14/2018 21:45,23,68.9,39,64.3,62,66,2,0,0
1/14/2018 21:50,30,69,47,64.3,77,66.1,2,0,0
1/14/2018 21:55,30,69.2,46,64.6,76,66.4,2,0,0
1/14/2018 22:00,33,69.6,50,65,83,66.8,2,0,0
1/14/2018 22:05,29,69.5,45,64.9,74,66.7,2,0,0
1/14/2018 22:10,26,68.2,42,63.5,68,65.3,2,0,0
1/14/2018 22:15,24,68.7,39,64,63,65.8,2,0,0
1/14/2018 22:20,20,69.1,35,64.4,55,66.1,2,0,0
1/14/2018 22:25,20,69.3,35,64.7,55,66.4,2,0,0
1/14/2018 22:30,20,69.4,35,64.8,55,66.5,2,0,0
1/14/2018 22:35,27,69.6,42,65,69,66.8,2,0,0
1/14/2018 22:40,26,69.8,41,65.2,67,67,2,0,0
1/14/2018 22:45,19,69.5,34,64.9,53,66.5,2,0,0
1/14/2018 22:50,19,69.6,34,65,53,66.6,2,0,0
1/14/2018 22:55,21,69.3,37,64.7,58,66.4,2,0,0
1/14/2018 23:00,17,69.4,33,64.8,50,66.3,2,0,0
1/14/2018 23:05,17,69.4,33,64.8,50,66.4,2,0,0
1/14/2018 23:10,15,69.4,31,64.8,46,66.3,2,0,0
1/14/2018 23:15,16,69,32,64.4,48,65.9,2,0,0
1/14/2018 23:20,17,69.2,32,64.5,49,66.1,2,0,0
1/14/2018 23:25,16,69.2,31,64.6,47,66.2,2,0,0
1/14/2018 23:30,12,69.3,27,64.7,39,66.1,2,0,0
1/14/2018 23:35,19,69.4,34,64.8,53,66.5,2,0,0
1/14/2018 23:40,14,69.3,29,64.7,43,66.2,2,0,0
1/14/2018 23:45,19,69.5,34,64.9,53,66.5,2,0,0
1/14/2018 23:50,17,69.4,33,64.7,50,66.3,2,0,0
1/14/2018 23:55,11,69.3,27,64.7,38,66,2,0,0
