5 Minutes,Lane 1 Flow (Veh/5 Minutes),Lane 1 Speed (mph),Lane 2 Flow (Veh/5 Minutes),Lane 2 Speed (mph),Flow (Veh/5 Minutes),Speed (mph),# Lane Points,% Observed,Holiday
1/15/2018 0:00,16,69.3,32,64.7,48,66.3,2,0,1
1/15/2018 0:05,12,69.2,27,64.6,39,66,2,0,1
1/15/2018 0:10,12,69.1,27,64.5,39,65.9,2,0,1
1/15/2018 0:15,10,69.2,25,64.6,35,65.9,2,0,1
1/15/2018 0:20,12,69.3,27,64.7,39,66.1,2,0,1
1/15/2018 0:25,9,69.3,24,64.7,33,65.9,2,0,1
1/15/2018 0:30,9,69.3,24,64.7,33,66,2,0,1
1/15/2018 0:35,10,69.2,25,64.5,35,65.9,2,0,1
1/15/2018 0:40,11,69.2,26,64.6,37,66,2,0,1
1/15/2018 0:45,9,69.3,24,64.7,33,66,2,0,1
1/15/2018 0:50,11,69.3,26,64.7,37,66,2,0,1
1/15/2018 0:55,8,69.3,24,64.7,32,65.8,2,0,1
1/15/2018 1:00,8,69.3,23,64.7,31,65.9,2,0,1
1/15/2018 1:05,6,69.4,21,64.8,27,65.8,2,0,1
1/15/2018 1:10,7,69.4,23,64.8,30,65.9,2,0,1
1/15/2018 1:15,6,69.2,21,64.6,27,65.6,2,0,1
1/15/2018 1:20,7,69.2,23,64.6,30,65.7,2,0,1
1/15/2018 1:25,7,69.3,22,64.7,29,65.8,2,0,1
1/15/2018 1:30,10,69.3,20,64.7,30,66.2,2,0,1
1/15/2018 1:35,7,69.3,22,64.7,29,65.8,2,0,1
1/15/2018 1:40,9,69.4,24,64.8,33,66,2,0,1
1/15/2018 1:45,8,69.2,23,64.6,31,65.8,2,0,1
1/15/2018 1:50,5,69.2,21,64.6,26,65.5,2,0,1
1/15/2018 1:55,7,69.2,22,64.5,29,65.7,2,0,1
1/15/2018 2:00,6,69.2,21,64.6,27,65.6,2,0,1
1/15/2018 2:05,5,69.2,20,64.6,25,65.5,2,0,1
1/15/2018 2:10,6,69.3,21,64.7,27,65.7,2,0,1
1/15/2018 2:15,8,69.2,23,64.6,31,65.8,2,0,1
1/15/2018 2:20,4,69.3,19,64.7,23,65.5,2,0,1
1/15/2018 2:25,7,69.3,22,64.7,29,65.8,2,0,1
1/15/2018 2:30,5,69.3,21,64.7,26,65.5,2,0,1
1/15/2018 2:35,6,69.2,22,64.6,28,65.6,2,0,1
1/15/2018 2:40,6,69.2,22,64.5,28,65.5,2,0,1
1/15/2018 2:45,7,69.1,22,64.5,29,65.6,2,0,1
1/15/2018 2:50,7,69.2,22,64.6,29,65.7,2,0,1
1/15/2018 2:55,13,68.5,28,63.9,41,65.4,2,0,1
1/15/2018 3:00,10,68.9,26,64.3,36,65.6,2,0,1
1/15/2018 3:05,8,68.9,23,64.3,31,65.5,2,0,1
1/15/2018 3:10,7,69.1,22,64.5,29,65.6,2,0,1
1/15/2018 3:15,7,69.3,22,64.7,29,65.8,2,0,1
1/15/2018 3:20,9,69.3,25,64.7,34,65.9,2,0,1
1/15/2018 3:25,9,69.3,25,64.7,34,65.9,2,0,1
1/15/2018 3:30,9,69.3,24,64.7,33,66,2,0,1
1/15/2018 3:35,13,69.3,28,64.7,41,66.2,2,0,1
1/15/2018 3:40,8,69.3,24,64.7,32,65.9,2,0,1
1/15/2018 3:45,8,69.1,23,64.5,31,65.7,2,0,1
1/15/2018 3:50,12,69.2,27,64.6,39,66,2,0,1
1/15/2018 3:55,13,68.7,28,64,41,65.5,2,0,1
1/15/2018 4:00,10,68.5,26,63.8,36,65.1,2,0,1
1/15/2018 4:05,14,68.4,30,63.8,44,65.3,2,0,1
1/15/2018 4:10,17,68.8,33,64.2,50,65.7,2,0,1
1/15/2018 4:15,16,69,32,64.4,48,65.9,2,0,1
1/15/2018 4:20,21,69,37,64.4,58,66,2,0,1
1/15/2018 4:25,19,69,35,64.4,54,66,2,0,1
1/15/2018 4:30,25,69.1,41,64.5,66,66.3,2,0,1
1/15/2018 4:35,20,69.2,36,64.6,56,66.2,2,0,1
1/15/2018 4:40,30,68.4,47,63.7,77,65.6,2,0,1
1/15/2018 4:45,28,68.9,46,64.2,74,66,2,0,1
1/15/2018 4:50,22,69.1,38,64.5,60,66.2,2,0,1
1/15/2018 4:55,22,68.6,39,63.9,61,65.6,2,0,1
1/15/2018 5:00,26,68.6,43,63.9,69,65.7,2,0,1
1/15/2018 5:05,28,67.5,44,62.8,72,64.6,2,0,1
1/15/2018 5:10,29,68,47,63.3,76,65.1,2,0,1
1/15/2018 5:15,30,67.7,48,63,78,64.8,2,0,1
1/15/2018 5:20,37,68.5,55,63.9,92,65.7,2,0,1
1/15/2018 5:25,28,68.7,46,64.1,74,65.9,2,0,1
1/15/2018 5:30,38,68.9,57,64.2,95,66.1,2,0,1
1/15/2018 5:35,39,69.7,57,65.1,96,67,2,0,1
1/15/2018 5:40,40,68.5,58,63.8,98,65.7,2,0,1
1/15/2018 5:45,42,67.5,61,62.7,103,64.6,2,0,1
1/15/2018 5:50,47,68.6,65,63.9,112,65.9,2,0,1
1/15/2018 5:55,36,68.9,54,64.2,90,66.1,2,0,1
1/15/2018 6:00,34,68.3,52,63.6,86,65.4,2,0,1
1/15/2018 6:05,40,65.4,58,60.5,98,62.5,2,0,1
1/15/2018 6:10,42,65.4,61,60.4,103,62.5,2,0,1
1/15/2018 6:15,42,65.3,61,60.3,103,62.3,2,0,1
1/15/2018 6:20,50,66.4,70,61.5,120,63.6,2,0,1
1/15/2018 6:25,44,65.9,63,61,107,63,2,0,1
1/15/2018 6:30,43,66.4,61,61.6,104,63.6,2,0,1
1/15/2018 6:35,38,67.2,57,62.4,95,64.3,2,0,1
1/15/2018 6:40,41,67,60,62.2,101,64.2,2,0,1
1/15/2018 6:45,55,66.8,75,62,130,64,2,0,1
1/15/2018 6:50,40,66.8,58,62,98,63.9,2,0,1
1/15/2018 6:55,43,67,61,62.2,104,64.2,2,0,1
1/15/2018 7:00,40,67.6,59,62.8,99,64.7,2,0,1
1/15/2018 7:05,49,66.5,69,61.6,118,63.7,2,0,1
1/15/2018 7:10,38,67.4,56,62.6,94,64.6,2,0,1
1/15/2018 7:15,44,66.8,63,62,107,64,2,0,1
1/15/2018 7:20,46,66.1,65,61.2,111,63.2,2,0,1
1/15/2018 7:25,52,65.6,71,60.6,123,62.7,2,0,1
1/15/2018 7:30,56,66.4,75,61.5,131,63.6,2,0,1
1/15/2018 7:35,49,66.9,68,62.1,117,64.1,2,0,1
1/15/2018 7:40,58,67.6,77,62.9,135,64.9,2,0,1
1/15/2018 7:45,54,68.5,74,63.9,128,65.8,2,0,1
1/15/2018 7:50,53,68.1,72,63.4,125,65.4,2,0,1
1/15/2018 7:55,49,67.2,67,62.5,116,64.5,2,0,1
1/15/2018 8:00,54,67.2,72,62.4,126,64.5,2,0,1
1/15/2018 8:05,50,67.2,70,62.3,120,64.3,2,0,1
1/15/2018 8:10,41,68.3,58,63.6,99,65.6,2,0,1
1/15/2018 8:15,65,67.1,85,62.3,150,64.4,2,0,1
1/15/2018 8:20,58,67.8,77,63.1,135,65.1,2,0,1
1/15/2018 8:25,58,67.4,77,62.5,135,64.6,2,0,1
1/15/2018 8:30,61,67.7,82,62.9,143,64.9,2,0,1
1/15/2018 8:35,46,67.9,64,63.2,110,65.2,2,0,1
1/15/2018 8:40,55,68.5,73,63.9,128,65.9,2,0,1
1/15/2018 8:45,58,68.3,78,63.7,136,65.7,2,0,1
1/15/2018 8:50,50,67.6,68,62.9,118,64.9,2,0,1
1/15/2018 8:55,55,67.5,73,62.8,128,64.8,2,0,1
1/15/2018 9:00,51,67.9,69,63.3,120,65.3,2,0,1
1/15/2018 9:05,55,67.9,75,63.2,130,65.2,2,0,1
1/15/2018 9:10,44,67.3,62,62.5,106,64.5,2,0,1
1/15/2018 9:15,46,67.1,63,62.3,109,64.4,2,0,1
1/15/2018 9:20,47,68.3,64,63.6,111,65.6,2,0,1
1/15/2018 9:25,43,68.9,61,64.2,104,66.1,2,0,1
1/15/2018 9:30,50,67.9,68,63.2,118,65.2,2,0,1
1/15/2018 9:35,54,65.8,72,60.9,126,63,2,0,1
1/15/2018 9:40,52,65.1,70,60.1,122,62.3,2,0,1
1/15/2018 9:45,49,65,68,60,117,62.1,2,0,1
1/15/2018 9:50,58,64.9,77,59.9,135,62,2,0,1
1/15/2018 9:55,48,66.4,66,61.5,114,63.5,2,0,1
1/15/2018 10:00,60,66.6,78,61.8,138,63.9,2,0,1
1/15/2018 10:05,55,67.2,72,62.4,127,64.5,2,0,1
1/15/2018 10:10,54,67.9,72,63.2,126,65.2,2,0,1
1/15/2018 10:15,53,66.9,71,62,124,64.1,2,0,1
1/15/2018 10:20,53,66.8,72,62,125,64.1,2,0,1
1/15/2018 10:25,57,66,75,61.2,132,63.3,2,0,1
1/15/2018 10:30,61,65.9,79,61,140,63.1,2,0,1
1/15/2018 10:35,49,66,67,61.2,116,63.2,2,0,1
1/15/2018 10:40,66,65.2,85,60.2,151,62.4,2,0,1
1/15/2018 10:45,51,64.7,69,59.7,120,61.8,2,0,1
1/15/2018 10:50,58,65.8,75,60.9,133,63,2,0,1
1/15/2018 10:55,59,66.3,77,61.5,136,63.6,2,0,1
1/15/2018 11:00,43,65.3,60,60.5,103,62.5,2,0,1
1/15/2018 11:05,47,66.2,64,61.3,111,63.4,2,0,1
1/15/2018 11:10,50,65.3,68,60.4,118,62.5,2,0,1
1/15/2018 11:15,45,65.8,62,60.9,107,62.9,2,0,1
1/15/2018 11:20,61,65.6,78,60.6,139,62.8,2,0,1
1/15/2018 11:25,56,65.4,73,60.5,129,62.6,2,0,1
1/15/2018 11:30,56,65.6,74,60.7,130,62.8,2,0,1
1/15/2018 11:35,58,65,76,60.1,134,62.2,2,0,1
1/15/2018 11:40,58,65.5,76,60.5,134,62.7,2,0,1
1/15/2018 11:45,52,65.3,70,60.3,122,62.4,2,0,1
1/15/2018 11:50,51,66.5,68,61.7,119,63.7,2,0,1
1/15/2018 11:55,50,66.6,67,61.8,117,63.8,2,0,1
1/15/2018 12:00,59,66.2,76,61.2,135,63.4,2,0,1
1/15/2018 12:05,56,66.2,74,61.3,130,63.4,2,0,1
1/15/2018 12:10,58,64.9,78,59.9,136,62,2,0,1
1/15/2018 12:15,47,64.9,65,59.8,112,61.9,2,0,1
1/15/2018 12:20,61,64.1,80,59.1,141,61.3,2,0,1
1/15/2018 12:25,61,64.1,81,59.1,142,61.2,2,0,1
1/15/2018 12:30,53,64.7,71,59.7,124,61.8,2,0,1
1/15/2018 12:35,54,65,72,60.1,126,62.2,2,0,1
1/15/2018 12:40,54,64.8,72,59.8,126,61.9,2,0,1
1/15/2018 12:45,56,65.1,74,60.2,130,62.3,2,0,1
1/15/2018 12:50,59,66.6,76,61.8,135,63.9,2,0,1
1/15/2018 12:55,63,66.4,83,61.5,146,63.6,2,0,1
1/15/2018 13:00,54,66.7,72,61.9,126,63.9,2,0,1
1/15/2018 13:05,50,66.7,67,61.9,117,64,2,0,1
1/15/2018 13:10,53,67.5,71,62.7,124,64.8,2,0,1
1/15/2018 13:15,47,67.4,65,62.6,112,64.6,2,0,1
1/15/2018 13:20,55,67.1,73,62.3,128,64.3,2,0,1
1/15/2018 13:25,48,65.5,66,60.5,114,62.6,2,0,1
1/15/2018 13:30,51,66.2,68,61.3,119,63.4,2,0,1
1/15/2018 13:35,49,65.2,67,60.2,116,62.3,2,0,1
1/15/2018 13:40,47,65.4,64,60.5,111,62.6,2,0,1
1/15/2018 13:45,45,66.9,61,62.1,106,64.1,2,0,1
1/15/2018 13:50,56,66.8,74,62,130,64,2,0,1
1/15/2018 13:55,45,66.6,62,61.7,107,63.8,2,0,1
1/15/2018 14:00,48,65.8,66,60.9,114,62.9,2,0,1
1/15/2018 14:05,46,66,64,61.1,110,63.1,2,0,1
1/15/2018 14:10,62,65.9,80,61,142,63.2,2,0,1
1/15/2018 14:15,42,66.8,60,62,102,63.9,2,0,1
1/15/2018 14:20,47,65.8,65,60.9,112,63,2,0,1
1/15/2018 14:25,52,65.4,71,60.4,123,62.5,2,0,1
1/15/2018 14:30,46,66.6,64,61.8,110,63.8,2,0,1
1/15/2018 14:35,34,66.6,50,61.8,84,63.7,2,0,1
1/15/2018 14:40,50,64.8,68,59.8,118,62,2,0,1
1/15/2018 14:45,40,66.2,56,61.3,96,63.4,2,0,1
1/15/2018 14:50,42,66.1,59,61.3,101,63.3,2,0,1
1/15/2018 14:55,45,67,61,62.2,106,64.3,2,0,1
1/15/2018 15:00,45,67.1,63,62.3,108,64.3,2,0,1
1/15/2018 15:05,61,67.3,79,62.6,140,64.7,2,0,1
1/15/2018 15:10,51,68.4,68,63.8,119,65.7,2,0,1
1/15/2018 15:15,47,68.1,65,63.5,112,65.4,2,0,1
1/15/2018 15:20,50,67.2,66,62.5,116,64.5,2,0,1
1/15/2018 15:25,50,67.8,67,63.1,117,65.1,2,0,1
1/15/2018 15:30,57,67.8,75,63.1,132,65.1,2,0,1
1/15/2018 15:35,57,66.6,75,61.8,132,63.9,2,0,1
1/15/2018 15:40,59,66.9,78,62.2,137,64.2,2,0,1
1/15/2018 15:45,44,67.3,61,62.6,105,64.6,2,0,1
1/15/2018 15:50,60,66.6,78,61.8,138,63.9,2,0,1
1/15/2018 15:55,43,67,61,62.1,104,64.1,2,0,1
1/15/2018 16:00,57,66.9,76,62.1,133,64.1,2,0,1
1/15/2018 16:05,46,67,65,62.2,111,64.2,2,0,1
1/15/2018 16:10,63,67.3,82,62.5,145,64.6,2,0,1
1/15/2018 16:15,61,67.6,77,62.8,138,64.9,2,0,1
1/15/2018 16:20,66,67.4,85,62.7,151,64.7,2,0,1
1/15/2018 16:25,51,68.1,68,63.4,119,65.4,2,0,1
1/15/2018 16:30,52,67.6,70,62.9,122,64.9,2,0,1
1/15/2018 16:35,54,66.1,73,61.1,127,63.2,2,0,1
1/15/2018 16:40,58,66.8,76,61.9,134,64,2,0,1
1/15/2018 16:45,52,67,70,62.2,122,64.3,2,0,1
1/15/2018 16:50,53,66.3,71,61.3,124,63.5,2,0,1
1/15/2018 16:55,54,66.8,72,61.9,126,64,2,0,1
1/15/2018 17:00,53,68,72,63.3,125,65.3,2,0,1
1/15/2018 17:05,50,68.5,68,63.8,118,65.8,2,0,1
1/15/2018 17:10,59,68.4,78,63.7,137,65.7,2,0,1
1/15/2018 17:15,54,69,72,64.4,126,66.4,2,0,1
1/15/2018 17:20,45,68.2,62,63.5,107,65.5,2,0,1
1/15/2018 17:25,54,67.8,73,63.1,127,65.1,2,0,1
1/15/2018 17:30,57,67.2,76,62.4,133,64.4,2,0,1
1/15/2018 17:35,41,67.6,59,62.8,100,64.8,2,0,1
1/15/2018 17:40,48,67.9,64,63.2,112,65.2,2,0,1
1/15/2018 17:45,49,67.4,67,62.6,116,64.7,2,0,1
1/15/2018 17:50,56,66.9,73,62,129,64.1,2,0,1
1/15/2018 17:55,53,66.4,70,61.5,123,63.6,2,0,1
1/15/2018 18:00,51,66.9,68,62.1,119,64.2,2,0,1
1/15/2018 18:05,49,67,67,62.1,116,64.2,2,0,1
1/15/2018 18:10,55,67.5,74,62.7,129,64.8,2,0,1
1/15/2018 18:15,48,68.1,65,63.3,113,65.3,2,0,1
1/15/2018 18:20,43,69.3,61,64.6,104,66.5,2,0,1
1/15/2018 18:25,43,68.7,60,64.1,103,66,2,0,1
1/15/2018 18:30,40,68.1,57,63.4,97,65.4,2,0,1
1/15/2018 18:35,45,67.6,63,62.8,108,64.8,2,0,1
1/15/2018 18:40,47,68.1,63,63.3,110,65.4,2,0,1
1/15/2018 18:45,41,68.9,58,64.3,99,66.2,2,0,1
1/15/2018 18:50,43,68.7,59,64,102,66,2,0,1
1/15/2018 18:55,40,68.7,56,64.1,96,66,2,0,1
1/15/2018 19:00,45,67.7,62,62.9,107,64.9,2,0,1
1/15/2018 19:05,38,68,55,63.3,93,65.2,2,0,1
1/15/2018 19:10,38,68.2,55,63.4,93,65.4,2,0,1
1/15/2018 19:15,39,68.6,56,63.9,95,65.8,2,0,1
1/15/2018 19:20,42,68.2,59,63.5,101,65.4,2,0,1
1/15/2018 19:25,36,68.5,52,63.8,88,65.7,2,0,1
1/15/2018 19:30,33,68.8,49,64.1,82,66,2,0,1
1/15/2018 19:35,36,68.3,53,63.7,89,65.6,2,0,1
1/15/2018 19:40,42,67.9,59,63.2,101,65.1,2,0,1
1/15/2018 19:45,39,67.6,56,62.8,95,64.8,2,0,1
1/15/2018 19:50,35,68.1,51,63.4,86,65.3,2,0,1
1/15/2018 19:55,33,68.7,49,64,82,65.9,2,0,1
1/15/2018 20:00,31,69.2,47,64.5,78,66.4,2,0,1
1/15/2018 20:05,34,69.5,50,64.9,84,66.8,2,0,1
1/15/2018 20:10,37,68.9,53,64.2,90,66.2,2,0,1
1/15/2018 20:15,28,68.9,45,64.2,73,66,2,0,1
1/15/2018 20:20,28,69,45,64.4,73,66.2,2,0,1
1/15/2018 20:25,29,69.3,45,64.7,74,66.5,2,0,1
1/15/2018 20:30,37,68.5,54,63.9,91,65.8,2,0,1
1/15/2018 20:35,36,68.2,53,63.5,89,65.4,2,0,1
1/15/2018 20:40,31,68.5,46,63.8,77,65.7,2,0,1
1/15/2018 20:45,29,68.6,45,63.9,74,65.7,2,0,1
1/15/2018 20:50,31,69.1,48,64.5,79,66.3,2,0,1
1/15/2018 20:55,28,68.9,45,64.2,73,66,2,0,1
1/15/2018 21:00,30,67.5,46,62.8,76,64.7,2,0,1
1/15/2018 21:05,28,68.4,44,63.7,72,65.5,2,0,1
1/15/2018 21:10,33,69.4,49,64.8,82,66.7,2,0,1
1/15/2018 21:15,21,69.6,37,65,58,66.7,2,0,1
1/15/2018 21:20,29,69.4,45,64.8,74,66.6,2,0,1
1/15/2018 21:25,25,69.6,41,65,66,66.7,2,0,1
1/15/2018 21:30,35,69,52,64.4,87,66.2,2,0,1
1/15/2018 21:35,23,69.1,39,64.5,62,66.2,2,0,1
1/15/2018 21:40,26,69.3,42,64.6,68,66.4,2,0,1
1/15/2018 21:45,29,69.3,46,64.7,75,66.5,2,0,1
1/15/2018 21:50,29,69.7,45,65.1,74,66.9,2,0,1
1/15/2018 21:55,22,69.3,37,64.7,59,66.5,2,0,1
1/15/2018 22:00,25,69.1,42,64.5,67,66.2,2,0,1
1/15/2018 22:05,20,69.1,36,64.5,56,66.1,2,0,1
1/15/2018 22:10,20,69.1,36,64.4,56,66.1,2,0,1
1/15/2018 22:15,24,69,40,64.4,64,66.1,2,0,1
1/15/2018 22:20,22,69.3,37,64.7,59,66.4,2,0,1
1/15/2018 22:25,14,69.1,30,64.5,44,65.9,2,0,1
1/15/2018 22:30,21,69.2,37,64.5,58,66.2,2,0,1
1/15/2018 22:35,19,69.3,34,64.7,53,66.4,2,0,1
1/15/2018 22:40,23,69.4,39,64.8,62,66.5,2,0,1
1/15/2018 22:45,20,69.6,36,65,56,66.6,2,0,1
1/15/2018 22:50,16,69.4,32,64.8,48,66.3,2,0,1
1/15/2018 22:55,11,69.3,27,64.7,38,66,2,0,1
1/15/2018 23:00,15,69.5,31,64.9,46,66.4,2,0,1
1/15/2018 23:05,15,69.4,31,64.8,46,66.3,2,0,1
1/15/2018 23:10,14,69.4,30,64.8,44,66.2,2,0,1
1/15/2018 23:15,17,68.9,34,64.3,51,65.9,2,0,1
1/15/2018 23:20,14,69.1,30,64.5,44,66,2,0,1
1/15/2018 23:25,19,69.3,24,64.7,43,66.7,2,0,1
1/15/2018 23:30,11,69.3,26,64.7,37,66,2,0,1
1/15/2018 23:35,11,69.4,26,64.8,37,66.1,2,0,1
1/15/2018 23:40,9,69.3,25,64.7,34,66,2,0,1
1/15/2018 23:45,17,69.4,33,64.8,50,66.4,2,0,1
1/15/2018 23:50,11,69.3,27,64.7,38,66.1,2,0,1
1/15/2018 23:55,10,69.2,25,64.5,35,65.9,2,0,1
1/16/2018 0:00,11,69.3,27,64.7,38,66.1,2,0,0
1/16/2018 0:05,11,69.2,26,64.6,37,66,2,0,0
1/16/2018 0:10,13,69.1,29,64.5,42,65.9,2,0,0
1/16/2018 0:15,7,69.2,22,64.6,29,65.7,2,0,0
1/16/2018 0:20,7,68.9,22,64.3,29,65.4,2,0,0
1/16/2018 0:25,6,69.1,21,64.5,27,65.5,2,0,0
1/16/2018 0:30,8,69.1,23,64.5,31,65.7,2,0,0
1/16/2018 0:35,9,69.3,24,64.7,33,65.9,2,0,0
1/16/2018 0:40,9,69.4,24,64.8,33,66,2,0,0
1/16/2018 0:45,7,69.3,22,64.7,29,65.8,2,0,0
1/16/2018 0:50,7,69.3,22,64.7,29,65.8,2,0,0
1/16/2018 0:55,7,69.2,22,64.6,29,65.7,2,0,0
1/16/2018 1:00,8,69.2,23,64.6,31,65.8,2,0,0
1/16/2018 1:05,5,69.2,21,64.6,26,65.5,2,0,0
1/16/2018 1:10,7,69.2,22,64.6,29,65.7,2,0,0
1/16/2018 1:15,10,69.3,20,64.7,30,66.2,2,0,0
1/16/2018 1:20,11,69.2,21,64.6,32,66.2,2,0,0
1/16/2018 1:25,8,69.3,19,64.7,27,66.1,2,0,0
1/16/2018 1:30,13,69.3,21,64.7,34,66.4,2,0,0
1/16/2018 1:35,7,69.2,22,64.6,29,65.7,2,0,0
1/16/2018 1:40,6,69.3,21,64.7,27,65.7,2,0,0
1/16/2018 1:45,7,69.3,23,64.7,30,65.7,2,0,0
1/16/2018 1:50,5,69.3,20,64.7,25,65.7,2,0,0
1/16/2018 1:55,10,69.4,20,64.8,30,66.3,2,0,0
1/16/2018 2:00,10,69.3,20,64.7,30,66.3,2,0,0
1/16/2018 2:05,5,69.4,20,64.8,25,65.7,2,0,0
1/16/2018 2:10,7,69.2,22,64.6,29,65.7,2,0,0
1/16/2018 2:15,8,69.1,19,64.5,27,65.9,2,0,0
1/16/2018 2:20,5,69.2,21,64.6,26,65.5,2,0,0
1/16/2018 2:25,8,69.3,23,64.7,31,65.8,2,0,0
1/16/2018 2:30,7,69.2,22,64.6,29,65.7,2,0,0
1/16/2018 2:35,9,69.3,24,64.7,33,65.9,2,0,0
1/16/2018 2:40,5,69.3,21,64.7,26,65.6,2,0,0
1/16/2018 2:45,8,68.8,23,64.2,31,65.4,2,0,0
1/16/2018 2:50,6,69.1,21,64.5,27,65.5,2,0,0
1/16/2018 2:55,11,69,26,64.4,37,65.8,2,0,0
1/16/2018 3:00,12,69.1,28,64.5,40,65.9,2,0,0
1/16/2018 3:05,11,69.3,27,64.7,38,66.1,2,0,0
1/16/2018 3:10,8,69.4,23,64.8,31,66,2,0,0
1/16/2018 3:15,12,69.3,27,64.7,39,66.1,2,0,0
1/16/2018 3:20,13,69,28,64.4,41,65.9,2,0,0
1/16/2018 3:25,11,69.1,27,64.5,38,65.8,2,0,0
1/16/2018 3:30,9,69.1,24,64.5,33,65.7,2,0,0
1/16/2018 3:35,9,69.3,25,64.7,34,65.9,2,0,0
1/16/2018 3:40,8,69.3,24,64.7,32,65.8,2,0,0
1/16/2018 3:45,12,69.5,28,64.9,40,66.3,2,0,0
1/16/2018 3:50,20,69.6,36,65,56,66.7,2,0,0
1/16/2018 3:55,10,69.6,26,65,36,66.3,2,0,0
1/16/2018 4:00,16,69.6,32,65,48,66.6,2,0,0
1/16/2018 4:05,18,69.2,35,64.5,53,66.1,2,0,0
1/16/2018 4:10,18,69.2,34,64.5,52,66.1,2,0,0
1/16/2018 4:15,21,69.3,38,64.7,59,66.4,2,0,0
1/16/2018 4:20,22,69.4,39,64.8,61,66.5,2,0,0
1/16/2018 4:25,25,69.3,42,64.7,67,66.4,2,0,0
1/16/2018 4:30,29,69.4,46,64.8,75,66.6,2,0,0
1/16/2018 4:35,24,69.7,42,65.1,66,66.8,2,0,0
1/16/2018 4:40,35,68.4,52,63.7,87,65.6,2,0,0
1/16/2018 4:45,36,69.9,54,65.4,90,67.2,2,0,0
1/16/2018 4:50,37,69.9,54,65.3,91,67.2,2,0,0
1/16/2018 4:55,31,70.7,47,66.2,78,68,2,0,0
1/16/2018 5:00,34,70.4,51,65.9,85,67.7,2,0,0
1/16/2018 5:05,43,69,62,64.3,105,66.2,2,0,0
1/16/2018 5:10,38,69.2,56,64.6,94,66.4,2,0,0
1/16/2018 5:15,37,68.6,56,63.9,93,65.8,2,0,0
1/16/2018 5:20,40,69.6,60,65,100,66.9,2,0,0
1/16/2018 5:25,55,69.7,75,65,130,67,2,0,0
1/16/2018 5:30,30,69.4,48,64.7,78,66.5,2,0,0
1/16/2018 5:35,56,68,78,63.1,134,65.2,2,0,0
1/16/2018 5:40,66,68.1,88,63.2,154,65.3,2,0,0
1/16/2018 5:45,57,69.2,77,64.5,134,66.5,2,0,0
1/16/2018 5:50,53,68.9,73,64.2,126,66.1,2,0,0
1/16/2018 5:55,68,66.5,90,61.6,158,63.7,2,0,0
1/16/2018 6:00,58,67.4,77,62.6,135,64.7,2,0,0
1/16/2018 6:05,67,67.9,88,63.2,155,65.2,2,0,0
1/16/2018 6:10,57,67,77,62.1,134,64.2,2,0,0
1/16/2018 6:15,63,66.7,85,61.9,148,64,2,0,0
1/16/2018 6:20,62,69.2,84,64.5,146,66.5,2,0,0
1/16/2018 6:25,66,68.3,88,63.5,154,65.6,2,0,0
1/16/2018 6:30,50,67.2,70,62.3,120,64.3,2,0,0
1/16/2018 6:35,73,67.4,96,62.5,169,64.6,2,0,0
1/16/2018 6:40,39,67.6,58,62.9,97,64.8,2,0,0
1/16/2018 6:45,83,67.5,108,62.7,191,64.8,2,0,0
1/16/2018 6:50,50,66.9,70,62.1,120,64.1,2,0,0
1/16/2018 6:55,72,66.5,94,61.7,166,63.8,2,0,0
1/16/2018 7:00,62,67.2,83,62.4,145,64.5,2,0,0
1/16/2018 7:05,69,67.9,91,63.1,160,65.2,2,0,0
1/16/2018 7:10,71,66.8,94,62,165,64,2,0,0
1/16/2018 7:15,79,67.9,102,63.2,181,65.2,2,0,0
1/16/2018 7:20,64,67.5,86,62.7,150,64.8,2,0,0
1/16/2018 7:25,86,68.3,109,63.6,195,65.7,2,0,0
1/16/2018 7:30,75,68.9,98,64.2,173,66.2,2,0,0
1/16/2018 7:35,84,68.3,108,63.5,192,65.6,2,0,0
1/16/2018 7:40,52,67.5,72,62.6,124,64.7,2,0,0
1/16/2018 7:45,72,67,93,62.1,165,64.2,2,0,0
1/16/2018 7:50,71,67.5,92,62.6,163,64.7,2,0,0
1/16/2018 7:55,86,67.5,109,62.7,195,64.8,2,0,0
1/16/2018 8:00,80,66.8,103,61.9,183,64,2,0,0
1/16/2018 8:05,92,66,116,61.1,208,63.3,2,0,0
1/16/2018 8:10,92,66,118,61.1,210,63.3,2,0,0
1/16/2018 8:15,89,66.6,112,61.7,201,63.8,2,0,0
1/16/2018 8:20,81,67.4,104,62.6,185,64.7,2,0,0
1/16/2018 8:25,78,67.1,101,62.3,179,64.4,2,0,0
1/16/2018 8:30,53,67.7,73,62.9,126,64.9,2,0,0
1/16/2018 8:35,80,67.6,102,62.8,182,64.9,2,0,0
1/16/2018 8:40,54,66.8,73,62,127,64,2,0,0
1/16/2018 8:45,43,67.9,63,63.1,106,65.1,2,0,0
1/16/2018 8:50,66,67.3,87,62.5,153,64.6,2,0,0
1/16/2018 8:55,98,67.1,123,62.3,221,64.4,2,0,0
1/16/2018 9:00,67,67,88,62.2,155,64.3,2,0,0
1/16/2018 9:05,78,68.7,100,64,178,66,2,0,0
1/16/2018 9:10,60,68.4,80,63.7,140,65.7,2,0,0
1/16/2018 9:15,89,67.3,112,62.4,201,64.5,2,0,0
1/16/2018 9:20,56,67.1,76,62.3,132,64.3,2,0,0
1/16/2018 9:25,73,67.8,94,63.1,167,65.2,2,0,0
1/16/2018 9:30,56,67.9,76,63.2,132,65.2,2,0,0
1/16/2018 9:35,67,66.6,87,61.8,154,63.9,2,0,0
1/16/2018 9:40,76,66.3,98,61.4,174,63.5,2,0,0
1/16/2018 9:45,76,66.9,98,62.1,174,64.2,2,0,0
1/16/2018 9:50,61,66.7,81,61.9,142,64,2,0,0
1/16/2018 9:55,74,67.1,95,62.2,169,64.3,2,0,0
1/16/2018 10:00,73,67.6,94,62.8,167,64.9,2,0,0
1/16/2018 10:05,72,66.9,92,62.1,164,64.2,2,0,0
1/16/2018 10:10,66,67.9,85,63.1,151,65.2,2,0,0
1/16/2018 10:15,52,67.7,71,62.9,123,65,2,0,0
1/16/2018 10:20,54,67.5,72,62.7,126,64.7,2,0,0
1/16/2018 10:25,55,69.1,74,64.4,129,66.4,2,0,0
1/16/2018 10:30,66,68.5,86,63.8,152,65.8,2,0,0
1/16/2018 10:35,63,67.7,81,63,144,65.1,2,0,0
1/16/2018 10:40,48,66.6,66,61.8,114,63.8,2,0,0
1/16/2018 10:45,79,68.8,98,64.2,177,66.2,2,0,0
1/16/2018 10:50,67,68.3,86,63.8,153,65.8,2,0,0
1/16/2018 10:55,60,68.2,79,63.6,139,65.6,2,0,0
1/16/2018 11:00,57,68.7,75,64.1,132,66.1,2,0,0
1/16/2018 11:05,56,67.6,74,63,130,65,2,0,0
1/16/2018 11:10,42,68,60,63.3,102,65.3,2,0,0
1/16/2018 11:15,39,68.8,56,64.2,95,66.1,2,0,0
1/16/2018 11:20,51,67.3,69,62.5,120,64.6,2,0,0
1/16/2018 11:25,56,68.4,74,63.6,130,65.7,2,0,0
1/16/2018 11:30,40,69.8,57,65.2,97,67.1,2,0,0
1/16/2018 11:35,50,69.1,68,64.4,118,66.4,2,0,0
1/16/2018 11:40,47,68.9,64,64.3,111,66.3,2,0,0
1/16/2018 11:45,46,68.6,63,64,109,66,2,0,0
1/16/2018 11:50,48,68.5,66,63.9,114,65.9,2,0,0
1/16/2018 11:55,44,69.3,61,64.7,105,66.6,2,0,0
1/16/2018 12:00,30,68.7,46,64,76,65.8,2,0,0
1/16/2018 12:05,42,68,60,63.3,102,65.2,2,0,0
1/16/2018 12:10,27,67.8,43,63.1,70,64.9,2,0,0
1/16/2018 12:15,38,66.9,55,62.2,93,64.1,2,0,0
1/16/2018 12:20,33,67.9,50,63.2,83,65.1,2,0,0
1/16/2018 12:25,39,67.8,56,63.1,95,65,2,0,0
1/16/2018 12:30,38,65.5,55,60.5,93,62.5,2,0,0
1/16/2018 12:35,55,65.6,72,60.6,127,62.7,2,0,0
1/16/2018 12:40,40,66.6,58,61.7,98,63.7,2,0,0
1/16/2018 12:45,41,66.4,59,61.6,100,63.6,2,0,0
1/16/2018 12:50,39,67,55,62.2,94,64.2,2,0,0
1/16/2018 12:55,43,67.4,59,62.6,102,64.6,2,0,0
1/16/2018 13:00,42,67.8,59,63.1,101,65,2,0,0
1/16/2018 13:05,30,68.4,46,63.7,76,65.5,2,0,0
1/16/2018 13:10,33,67.8,50,63.1,83,65,2,0,0
1/16/2018 13:15,37,67.1,54,62.3,91,64.3,2,0,0
1/16/2018 13:20,29,68.2,45,63.6,74,65.4,2,0,0
1/16/2018 13:25,38,67.6,55,62.9,93,64.8,2,0,0
1/16/2018 13:30,27,66.8,44,62,71,63.8,2,0,0
1/16/2018 13:35,37,66.7,54,61.8,91,63.8,2,0,0
1/16/2018 13:40,33,66.4,50,61.5,83,63.5,2,0,0
1/16/2018 13:45,41,66.3,58,61.5,99,63.5,2,0,0
1/16/2018 13:50,36,68.1,53,63.4,89,65.3,2,0,0
1/16/2018 13:55,36,68.7,52,64,88,65.9,2,0,0
1/16/2018 14:00,34,68.6,51,63.9,85,65.8,2,0,0
1/16/2018 14:05,34,66.4,50,61.6,84,63.6,2,0,0
1/16/2018 14:10,24,68.9,39,64.3,63,66,2,0,0
1/16/2018 14:15,37,68.6,54,64,91,65.9,2,0,0
1/16/2018 14:20,40,67.7,56,63,96,65,2,0,0
1/16/2018 14:25,51,67.7,69,62.9,120,65,2,0,0
1/16/2018 14:30,40,67,58,62.3,98,64.2,2,0,0
1/16/2018 14:35,47,67,65,62.3,112,64.3,2,0,0
1/16/2018 14:40,51,68.5,69,63.9,120,65.9,2,0,0
1/16/2018 14:45,46,68.1,63,63.5,109,65.4,2,0,0
1/16/2018 14:50,42,69,59,64.4,101,66.3,2,0,0
1/16/2018 14:55,53,68.5,71,63.8,124,65.8,2,0,0
1/16/2018 15:00,29,68.4,46,63.7,75,65.5,2,0,0
1/16/2018 15:05,60,67.6,79,62.8,139,64.9,2,0,0
1/16/2018 15:10,55,67.2,73,62.4,128,64.5,2,0,0
1/16/2018 15:15,57,68.1,76,63.5,133,65.5,2,0,0
1/16/2018 15:20,50,67,68,62.2,118,64.2,2,0,0
1/16/2018 15:25,58,68.7,76,64,134,66,2,0,0
1/16/2018 15:30,48,69.2,66,64.6,114,66.5,2,0,0
1/16/2018 15:35,51,69.5,68,64.8,119,66.8,2,0,0
1/16/2018 15:40,58,70.1,77,65.5,135,67.5,2,0,0
1/16/2018 15:45,62,69.2,81,64.6,143,66.6,2,0,0
1/16/2018 15:50,45,69,62,64.4,107,66.4,2,0,0
1/16/2018 15:55,48,69.3,66,64.7,114,66.6,2,0,0
1/16/2018 16:00,60,69.5,78,64.9,138,66.9,2,0,0
1/16/2018 16:05,60,68.7,79,64,139,66,2,0,0
1/16/2018 16:10,38,68.8,56,64,94,65.9,2,0,0
1/16/2018 16:15,60,67.4,78,62.5,138,64.7,2,0,0
1/16/2018 16:20,45,69,62,64.3,107,66.2,2,0,0
1/16/2018 16:25,43,69.2,61,64.6,104,66.5,2,0,0
1/16/2018 16:30,48,68.2,66,63.5,114,65.5,2,0,0
1/16/2018 16:35,49,69.2,67,64.6,116,66.5,2,0,0
1/16/2018 16:40,54,69.3,72,64.7,126,66.7,2,0,0
1/16/2018 16:45,56,70.1,74,65.6,130,67.5,2,0,0
1/16/2018 16:50,44,69.4,61,64.8,105,66.7,2,0,0
1/16/2018 16:55,57,69.5,76,64.8,133,66.8,2,0,0
1/16/2018 17:00,53,69.9,71,65.3,124,67.3,2,0,0
1/16/2018 17:05,48,69.3,66,64.7,114,66.6,2,0,0
1/16/2018 17:10,48,69.7,66,65.1,114,67,2,0,0
1/16/2018 17:15,53,69.2,72,64.5,125,66.5,2,0,0
1/16/2018 17:20,50,68.8,68,64,118,66,2,0,0
1/16/2018 17:25,64,66.5,83,61.6,147,63.8,2,0,0
1/16/2018 17:30,45,67.3,63,62.4,108,64.4,2,0,0
1/16/2018 17:35,48,67.5,66,62.7,114,64.8,2,0,0
1/16/2018 17:40,36,67.6,53,62.8,89,64.7,2,0,0
1/16/2018 17:45,39,67.7,56,62.9,95,64.9,2,0,0
1/16/2018 17:50,47,68.7,66,63.9,113,65.9,2,0,0
1/16/2018 17:55,38,68.7,55,64,93,65.9,2,0,0
1/16/2018 18:00,43,68.1,62,63.4,105,65.3,2,0,0
1/16/2018 18:05,48,68.5,66,63.9,114,65.9,2,0,0
1/16/2018 18:10,45,68.5,63,63.9,108,65.8,2,0,0
1/16/2018 18:15,46,68.4,64,63.9,110,65.8,2,0,0
1/16/2018 18:20,45,68.8,62,64.1,107,66.1,2,0,0
1/16/2018 18:25,43,68.7,60,64,103,66,2,0,0
1/16/2018 18:30,38,69,55,64.4,93,66.3,2,0,0
1/16/2018 18:35,44,69.8,62,65.3,106,67.2,2,0,0
1/16/2018 18:40,37,70.1,54,65.6,91,67.4,2,0,0
1/16/2018 18:45,48,69.6,66,65.1,114,67,2,0,0
1/16/2018 18:50,38,69.7,55,65.2,93,67,2,0,0
1/16/2018 18:55,40,69.1,57,64.5,97,66.4,2,0,0
1/16/2018 19:00,27,69.3,44,64.7,71,66.4,2,0,0
1/16/2018 19:05,35,68.3,52,63.6,87,65.4,2,0,0
1/16/2018 19:10,46,67.5,63,62.7,109,64.7,2,0,0
1/16/2018 19:15,33,68.1,49,63.4,82,65.3,2,0,0
1/16/2018 19:20,36,67.1,52,62.3,88,64.3,2,0,0
1/16/2018 19:25,39,67.9,56,63.2,95,65.2,2,0,0
1/16/2018 19:30,31,68.3,48,63.7,79,65.5,2,0,0
1/16/2018 19:35,35,68.8,50,64.2,85,66.1,2,0,0
1/16/2018 19:40,33,68.6,50,64,83,65.8,2,0,0
1/16/2018 19:45,45,68,62,63.3,107,65.2,2,0,0
1/16/2018 19:50,34,68.8,51,64.2,85,66.1,2,0,0
1/16/2018 19:55,30,68.7,46,64.1,76,65.9,2,0,0
1/16/2018 20:00,30,69.1,46,64.5,76,66.4,2,0,0
1/16/2018 20:05,22,69.2,38,64.6,60,66.3,2,0,0
1/16/2018 20:10,36,69.3,53,64.8,89,66.6,2,0,0
1/16/2018 20:15,20,69.4,35,64.8,55,66.5,2,0,0
1/16/2018 20:20,26,69.7,42,65.1,68,66.9,2,0,0
1/16/2018 20:25,23,69.7,39,65.1,62,66.8,2,0,0
1/16/2018 20:30,32,68.8,49,64.1,81,66,2,0,0
1/16/2018 20:35,31,69,46,64.3,77,66.2,2,0,0
1/16/2018 20:40,22,68.4,38,63.7,60,65.5,2,0,0
1/16/2018 20:45,25,68.8,41,64.2,66,65.9,2,0,0
1/16/2018 20:50,25,68.8,41,64.2,66,66,2,0,0
1/16/2018 20:55,20,68.4,36,63.7,56,65.4,2,0,0
1/16/2018 21:00,25,68.8,40,64.2,65,65.9,2,0,0
1/16/2018 21:05,21,69.1,37,64.4,58,66.1,2,0,0
1/16/2018 21:10,24,69,41,64.4,65,66.1,2,0,0
1/16/2018 21:15,25,69.2,41,64.6,66,66.4,2,0,0
1/16/2018 21:20,28,69.5,45,64.9,73,66.7,2,0,0
1/16/2018 21:25,28,69.3,44,64.7,72,66.5,2,0,0
1/16/2018 21:30,25,69.1,41,64.4,66,66.2,2,0,0
1/16/2018 21:35,24,69.8,40,65.2,64,66.9,2,0,0
1/16/2018 21:40,22,69.5,38,64.9,60,66.6,2,0,0
1/16/2018 21:45,24,69.7,40,65.1,64,66.8,2,0,0
1/16/2018 21:50,27,69.6,43,65,70,66.8,2,0,0
1/16/2018 21:55,19,69.2,34,64.5,53,66.2,2,0,0
1/16/2018 22:00,25,69.4,42,64.8,67,66.5,2,0,0
1/16/2018 22:05,24,69.2,40,64.6,64,66.3,2,0,0
1/16/2018 22:10,23,69.3,40,64.7,63,66.3,2,0,0
1/16/2018 22:15,20,69,36,64.4,56,66,2,0,0
1/16/2018 22:20,22,69.2,37,64.6,59,66.3,2,0,0
1/16/2018 22:25,17,69.4,33,64.8,50,66.3,2,0,0
1/16/2018 22:30,14,69.4,30,64.8,44,66.3,2,0,0
1/16/2018 22:35,19,69.3,35,64.7,54,66.4,2,0,0
1/16/2018 22:40,23,69.3,40,64.7,63,66.4,2,0,0
1/16/2018 22:45,22,69.4,38,64.8,60,66.5,2,0,0
1/16/2018 22:50,17,68.9,33,64.3,50,65.9,2,0,0
1/16/2018 22:55,17,69.2,33,64.6,50,66.1,2,0,0
1/16/2018 23:00,17,69.2,33,64.6,50,66.2,2,0,0
1/16/2018 23:05,19,69.2,34,64.5,53,66.2,2,0,0
1/16/2018 23:10,13,69.3,28,64.7,41,66.2,2,0,0
1/16/2018 23:15,10,69.4,25,64.8,35,66.1,2,0,0
1/16/2018 23:20,13,69.1,28,64.5,41,65.9,2,0,0
1/16/2018 23:25,11,69.3,27,64.7,38,66,2,0,0
1/16/2018 23:30,13,69.4,29,64.8,42,66.2,2,0,0
1/16/2018 23:35,13,69.3,28,64.7,41,66.2,2,0,0
1/16/2018 23:40,11,69.4,26,64.8,37,66.2,2,0,0
1/16/2018 23:45,13,69.5,28,64.9,41,66.4,2,0,0
1/16/2018 23:50,16,69.2,31,64.6,47,66.2,2,0,0
1/16/2018 23:55,9,69.3,24,64.7,33,65.9,2,0,0
1/17/2018 0:00,7,69.3,22,64.7,29,65.8,2,0,0
1/17/2018 0:05,10,69.1,26,64.5,36,65.8,2,0,0
1/17/2018 0:10,14,68.7,30,64,44,65.5,2,0,0
1/17/2018 0:15,11,69,26,64.4,37,65.8,2,0,0
1/17/2018 0:20,8,68.8,24,64.2,32,65.4,2,0,0
1/17/2018 0:25,10,69,25,64.4,35,65.7,2,0,0
1/17/2018 0:30,7,69.1,22,64.4,29,65.5,2,0,0
1/17/2018 0:35,7,69.2,22,64.5,29,65.7,2,0,0
1/17/2018 0:40,6,69.2,22,64.6,28,65.6,2,0,0
1/17/2018 0:45,6,69.3,21,64.7,27,65.7,2,0,0
1/17/2018 0:50,9,69.3,24,64.7,33,66,2,0,0
1/17/2018 0:55,5,69.4,21,64.8,26,65.7,2,0,0
1/17/2018 1:00,16,69.4,23,64.8,39,66.7,2,0,0
1/17/2018 1:05,5,69.4,20,64.8,25,65.7,2,0,0
1/17/2018 1:10,5,69.4,21,64.8,26,65.7,2,0,0
1/17/2018 1:15,6,69.3,21,64.7,27,65.7,2,0,0
1/17/2018 1:20,10,69.3,20,64.7,30,66.2,2,0,0
1/17/2018 1:25,6,69.3,21,64.7,27,65.7,2,0,0
1/17/2018 1:30,7,69.3,22,64.7,29,65.8,2,0,0
1/17/2018 1:35,9,69.1,25,64.5,34,65.7,2,0,0
1/17/2018 1:40,9,69.3,24,64.7,33,65.9,2,0,0
1/17/2018 1:45,7,69.4,23,64.8,30,65.8,2,0,0
1/17/2018 1:50,6,69.2,21,64.6,27,65.6,2,0,0
1/17/2018 1:55,7,69.3,22,64.7,29,65.8,2,0,0
1/17/2018 2:00,10,69.3,20,64.7,30,66.2,2,0,0
1/17/2018 2:05,16,69.3,23,64.7,39,66.6,2,0,0
1/17/2018 2:10,9,69.3,24,64.7,33,66,2,0,0
1/17/2018 2:15,7,69.1,23,64.4,30,65.5,2,0,0
1/17/2018 2:20,7,69.1,22,64.4,29,65.5,2,0,0
1/17/2018 2:25,8,69.2,23,64.5,31,65.7,2,0,0
1/17/2018 2:30,9,69.2,24,64.6,33,65.9,2,0,0
1/17/2018 2:35,7,69.3,22,64.7,29,65.8,2,0,0
1/17/2018 2:40,7,69.3,22,64.7,29,65.8,2,0,0
1/17/2018 2:45,11,69.2,26,64.6,37,66,2,0,0
1/17/2018 2:50,8,69.3,24,64.7,32,65.8,2,0,0
1/17/2018 2:55,10,69.2,26,64.6,36,65.9,2,0,0
1/17/2018 3:00,12,69.2,28,64.6,40,66,2,0,0
1/17/2018 3:05,8,69.3,24,64.7,32,65.8,2,0,0
1/17/2018 3:10,9,69.3,25,64.7,34,66,2,0,0
1/17/2018 3:15,10,69.4,26,64.8,36,66,2,0,0
1/17/2018 3:20,9,69.3,25,64.7,34,66,2,0,0
1/17/2018 3:25,9,69.4,25,64.8,34,66,2,0,0
1/17/2018 3:30,13,69.5,28,65,41,66.4,2,0,0
1/17/2018 3:35,12,69.3,28,64.7,40,66.1,2,0,0
1/17/2018 3:40,12,68.8,27,64.2,39,65.6,2,0,0
1/17/2018 3:45,13,69,29,64.4,42,65.8,2,0,0
1/17/2018 3:50,11,68.9,26,64.3,37,65.7,2,0,0
1/17/2018 3:55,14,69.3,30,64.7,44,66.2,2,0,0
1/17/2018 4:00,14,69.1,30,64.5,44,66,2,0,0
1/17/2018 4:05,16,69.3,32,64.7,48,66.2,2,0,0
1/17/2018 4:10,19,68.9,36,64.2,55,65.9,2,0,0
1/17/2018 4:15,20,69.1,36,64.5,56,66.1,2,0,0
1/17/2018 4:20,19,69.4,36,64.8,55,66.4,2,0,0
1/17/2018 4:25,24,69.1,40,64.4,64,66.2,2,0,0
1/17/2018 4:30,24,68.6,41,63.9,65,65.7,2,0,0
1/17/2018 4:35,29,67.4,46,62.7,75,64.5,2,0,0
1/17/2018 4:40,31,68.8,48,64.2,79,66,2,0,0
1/17/2018 4:45,38,68.7,56,64,94,65.9,2,0,0
1/17/2018 4:50,38,69.6,55,65.1,93,66.9,2,0,0
1/17/2018 4:55,35,68.6,54,63.9,89,65.7,2,0,0
1/17/2018 5:00,45,69.7,64,65.1,109,67,2,0,0
1/17/2018 5:05,43,69.6,62,65,105,66.9,2,0,0
1/17/2018 5:10,41,70.4,60,65.9,101,67.7,2,0,0
1/17/2018 5:15,43,69.9,61,65.4,104,67.3,2,0,0
1/17/2018 5:20,51,68.7,71,64.1,122,66,2,0,0
1/17/2018 5:25,49,68.5,70,63.8,119,65.8,2,0,0
1/17/2018 5:30,50,68.3,69,63.6,119,65.6,2,0,0
1/17/2018 5:35,60,68.6,81,64,141,65.9,2,0,0
1/17/2018 5:40,62,68.8,83,64.2,145,66.2,2,0,0
1/17/2018 5:45,60,69.6,81,65,141,67,2,0,0
1/17/2018 5:50,75,68.8,97,64.1,172,66.2,2,0,0
1/17/2018 5:55,71,68.6,92,63.9,163,66,2,0,0
1/17/2018 6:00,50,69.2,70,64.5,120,66.5,2,0,0
1/17/2018 6:05,59,68.7,80,64,139,66,2,0,0
1/17/2018 6:10,56,67.5,77,62.8,133,64.8,2,0,0
1/17/2018 6:15,65,67.6,85,62.8,150,64.9,2,0,0
1/17/2018 6:20,65,67.8,88,63,153,65,2,0,0
1/17/2018 6:25,64,68.3,85,63.6,149,65.6,2,0,0
1/17/2018 6:30,65,68.9,87,64.1,152,66.2,2,0,0
1/17/2018 6:35,68,69.3,90,64.6,158,66.7,2,0,0
1/17/2018 6:40,71,68.6,93,63.8,164,65.9,2,0,0
1/17/2018 6:45,82,68.1,105,63.3,187,65.4,2,0,0
1/17/2018 6:50,80,68.2,103,63.5,183,65.5,2,0,0
1/17/2018 6:55,64,69.6,84,64.9,148,66.9,2,0,0
1/17/2018 7:00,68,69.2,90,64.6,158,66.6,2,0,0
1/17/2018 7:05,75,69.8,97,65.2,172,67.2,2,0,0
1/17/2018 7:10,85,69.2,109,64.5,194,66.6,2,0,0
1/17/2018 7:15,78,69.6,100,64.9,178,67,2,0,0
1/17/2018 7:20,76,68.4,100,63.5,176,65.6,2,0,0
1/17/2018 7:25,80,67.8,104,62.9,184,65,2,0,0
1/17/2018 7:30,94,68.4,118,63.7,212,65.8,2,0,0
1/17/2018 7:35,85,68.4,109,63.7,194,65.7,2,0,0
1/17/2018 7:40,76,68.8,99,64.1,175,66.1,2,0,0
1/17/2018 7:45,95,68,119,63.2,214,65.3,2,0,0
1/17/2018 7:50,87,68.1,110,63.3,197,65.5,2,0,0
1/17/2018 7:55,86,68.1,110,63.3,196,65.4,2,0,0
1/17/2018 8:00,80,69.2,102,64.5,182,66.5,2,0,0
1/17/2018 8:05,71,68.6,92,63.8,163,65.9,2,0,0
1/17/2018 8:10,87,67.9,110,63,197,65.2,2,0,0
1/17/2018 8:15,76,68,98,63.2,174,65.3,2,0,0
1/17/2018 8:20,87,68.3,110,63.5,197,65.6,2,0,0
1/17/2018 8:25,88,68.3,110,63.5,198,65.7,2,0,0
1/17/2018 8:30,85,68.4,108,63.6,193,65.7,2,0,0
1/17/2018 8:35,84,68.9,106,64.2,190,66.3,2,0,0
1/17/2018 8:40,90,68.4,114,63.7,204,65.8,2,0,0
1/17/2018 8:45,95,68.3,119,63.6,214,65.7,2,0,0
1/17/2018 8:50,82,67.9,105,63.2,187,65.3,2,0,0
1/17/2018 8:55,80,67.5,102,62.7,182,64.8,2,0,0
1/17/2018 9:00,87,67.8,109,63,196,65.1,2,0,0
1/17/2018 9:05,81,67.4,102,62.6,183,64.7,2,0,0
1/17/2018 9:10,85,67.8,108,63,193,65.1,2,0,0
1/17/2018 9:15,83,66.7,105,61.8,188,63.9,2,0,0
1/17/2018 9:20,74,67.5,95,62.7,169,64.8,2,0,0
1/17/2018 9:25,73,68.3,95,63.6,168,65.6,2,0,0
1/17/2018 9:30,82,67.3,103,62.5,185,64.6,2,0,0
1/17/2018 9:35,71,67.1,93,62.3,164,64.4,2,0,0
1/17/2018 9:40,77,68.5,99,63.9,176,65.9,2,0,0
1/17/2018 9:45,68,69.7,88,65.1,156,67.1,2,0,0
1/17/2018 9:50,80,68.6,101,63.9,181,66,2,0,0
1/17/2018 9:55,65,67.6,86,62.9,151,64.9,2,0,0
1/17/2018 10:00,60,68.4,79,63.7,139,65.8,2,0,0
1/17/2018 10:05,68,69.8,88,65.2,156,67.2,2,0,0
1/17/2018 10:10,57,69.4,76,64.8,133,66.8,2,0,0
1/17/2018 10:15,68,68.2,88,63.5,156,65.5,2,0,0
1/17/2018 10:20,55,67.8,73,63.1,128,65.1,2,0,0
1/17/2018 10:25,64,68,83,63.3,147,65.4,2,0,0
1/17/2018 10:30,63,69,81,64.3,144,66.4,2,0,0
1/17/2018 10:35,53,69.1,71,64.5,124,66.5,2,0,0
1/17/2018 10:40,62,68.7,81,64.1,143,66.1,2,0,0
1/17/2018 10:45,58,69,77,64.3,135,66.3,2,0,0
1/17/2018 10:50,66,67.7,85,63,151,65.1,2,0,0
1/17/2018 10:55,47,68.8,64,64.1,111,66,2,0,0
1/17/2018 11:00,55,69,74,64.4,129,66.4,2,0,0
1/17/2018 11:05,46,68.4,63,63.7,109,65.7,2,0,0
1/17/2018 11:10,59,67.7,77,63,136,65,2,0,0
1/17/2018 11:15,53,70,71,65.4,124,67.4,2,0,0
1/17/2018 11:20,54,70.5,72,66,126,68,2,0,0
1/17/2018 11:25,59,70.4,77,65.9,136,67.8,2,0,0
1/17/2018 11:30,48,69.5,66,64.9,114,66.9,2,0,0
1/17/2018 11:35,55,70.5,73,66,128,67.9,2,0,0
1/17/2018 11:40,53,70.4,71,66,124,67.9,2,0,0
1/17/2018 11:45,51,70.1,70,65.7,121,67.6,2,0,0
1/17/2018 11:50,46,70.2,65,65.8,111,67.6,2,0,0
1/17/2018 11:55,54,70,72,65.6,126,67.5,2,0,0
1/17/2018 12:00,58,69.5,77,64.9,135,66.9,2,0,0
1/17/2018 12:05,45,68.5,62,63.9,107,65.8,2,0,0
1/17/2018 12:10,50,69.4,68,64.8,118,66.7,2,0,0
1/17/2018 12:15,52,69.3,70,64.7,122,66.6,2,0,0
1/17/2018 12:20,54,69.2,73,64.6,127,66.5,2,0,0
1/17/2018 12:25,53,69.4,71,64.8,124,66.7,2,0,0
1/17/2018 12:30,46,69.9,64,65.3,110,67.2,2,0,0
1/17/2018 12:35,47,69,64,64.4,111,66.3,2,0,0
1/17/2018 12:40,49,69.7,67,65.1,116,67.1,2,0,0
1/17/2018 12:45,56,68.8,74,64.2,130,66.2,2,0,0
1/17/2018 12:50,43,69.1,59,64.5,102,66.5,2,0,0
1/17/2018 12:55,45,69,63,64.4,108,66.3,2,0,0
1/17/2018 13:00,49,68.7,66,64,115,66,2,0,0
1/17/2018 13:05,44,69.6,62,65,106,66.9,2,0,0
1/17/2018 13:10,51,67.7,68,63,119,65,2,0,0
1/17/2018 13:15,46,69,63,64.3,109,66.3,2,0,0
1/17/2018 13:20,54,68.6,71,63.9,125,66,2,0,0
1/17/2018 13:25,45,68.7,62,64.1,107,66.1,2,0,0
1/17/2018 13:30,53,69.4,71,64.9,124,66.8,2,0,0
1/17/2018 13:35,37,68.9,54,64.3,91,66.2,2,0,0
1/17/2018 13:40,49,68.8,67,64.1,116,66.1,2,0,0
1/17/2018 13:45,38,69.5,55,64.9,93,66.8,2,0,0
1/17/2018 13:50,9,69.5,25,65,34,66.2,2,0,0
1/17/2018 13:55,8,69.4,24,64.8,32,65.9,2,0,0
1/17/2018 14:00,6,69.4,18,64.8,24,65.9,2,0,0
1/17/2018 14:05,68,68,61,62.2,129,65.3,2,0,0
1/17/2018 14:10,71,67.9,63,62.1,134,65.2,2,0,0
1/17/2018 14:15,74,67.9,67,62.1,141,65.1,2,0,0
1/17/2018 14:20,74,67.9,67,62.1,141,65.1,2,0,0
1/17/2018 14:25,73,67.8,66,62,139,65,2,0,0
1/17/2018 14:30,75,67.7,68,61.9,143,64.9,2,0,0
1/17/2018 14:35,77,67.7,69,61.9,146,65,2,0,0
1/17/2018 14:40,78,68,70,62.2,148,65.3,2,0,0
1/17/2018 14:45,79,68.1,71,62.3,150,65.4,2,0,0
1/17/2018 14:50,80,68.2,71,62.4,151,65.5,2,0,0
1/17/2018 14:55,76,68.1,69,62.3,145,65.3,2,0,0
1/17/2018 15:00,76,67.7,69,61.9,145,64.9,2,0,0
1/17/2018 15:05,77,67.5,70,61.7,147,64.7,2,0,0
1/17/2018 15:10,81,67.4,72,61.6,153,64.7,2,0,0
1/17/2018 15:15,82,67.4,74,61.6,156,64.6,2,0,0
1/17/2018 15:20,82,67.4,73,61.6,155,64.7,2,0,0
1/17/2018 15:25,80,67.5,72,61.7,152,64.8,2,0,0
1/17/2018 15:30,81,67.5,73,61.7,154,64.8,2,0,0
1/17/2018 15:35,83,67.5,75,61.7,158,64.7,2,0,0
1/17/2018 15:40,85,67.5,76,61.7,161,64.8,2,0,0
1/17/2018 15:45,86,67.5,78,61.7,164,64.7,2,0,0
1/17/2018 15:50,83,67.6,75,61.8,158,64.8,2,0,0
1/17/2018 15:55,82,67.7,73,61.9,155,65,2,0,0
1/17/2018 16:00,77,67.7,70,61.9,147,64.9,2,0,0
1/17/2018 16:05,81,67.5,72,61.7,153,64.8,2,0,0
1/17/2018 16:10,85,67.5,76,61.7,161,64.8,2,0,0
1/17/2018 16:15,86,67.3,78,61.5,164,64.5,2,0,0
1/17/2018 16:20,85,67.5,76,61.7,161,64.8,2,0,0
1/17/2018 16:25,82,67.6,74,61.8,156,64.8,2,0,0
1/17/2018 16:30,84,67.8,75,62,159,65.1,2,0,0
1/17/2018 16:35,86,67.8,77,62,163,65.1,2,0,0
1/17/2018 16:40,89,67.7,79,61.9,168,65,2,0,0
1/17/2018 16:45,89,67.5,80,61.7,169,64.8,2,0,0
1/17/2018 16:50,88,67.4,79,61.6,167,64.7,2,0,0
1/17/2018 16:55,87,67.8,79,62,166,65,2,0,0
1/17/2018 17:00,87,67.7,79,61.9,166,64.9,2,0,0
1/17/2018 17:05,89,67.6,80,61.8,169,64.9,2,0,0
1/17/2018 17:10,95,67.6,86,61.8,181,64.8,2,0,0
1/17/2018 17:15,97,67.3,87,61.5,184,64.6,2,0,0
1/17/2018 17:20,95,67.1,86,61.3,181,64.3,2,0,0
1/17/2018 17:25,93,67,84,61.2,177,64.2,2,0,0
1/17/2018 17:30,91,66.7,82,60.9,173,63.9,2,0,0
1/17/2018 17:35,91,66.7,81,60.9,172,64,2,0,0
1/17/2018 17:40,92,66.3,83,60.7,175,63.6,2,0,0
1/17/2018 17:45,91,66.1,81,60.5,172,63.5,2,0,0
1/17/2018 17:50,88,66.3,79,60.7,167,63.7,2,0,0
1/17/2018 17:55,85,65.9,77,60.3,162,63.2,2,0,0
1/17/2018 18:00,83,66.4,74,60.8,157,63.8,2,0,0
1/17/2018 18:05,82,66.6,73,60.8,155,63.9,2,0,0
1/17/2018 18:10,85,66.8,76,61,161,64.1,2,0,0
1/17/2018 18:15,83,66.8,74,61,157,64.1,2,0,0
1/17/2018 18:20,83,67.1,74,61.3,157,64.4,2,0,0
1/17/2018 18:25,80,67.3,71,61.5,151,64.6,2,0,0
1/17/2018 18:30,78,67.6,70,61.8,148,64.9,2,0,0
1/17/2018 18:35,76,67.6,68,61.8,144,64.9,2,0,0
1/17/2018 18:40,76,67.9,68,62.1,144,65.2,2,0,0
1/17/2018 18:45,75,68,68,62.2,143,65.2,2,0,0
1/17/2018 18:50,72,68.2,64,62.4,136,65.5,2,0,0
1/17/2018 18:55,70,68.4,62,62.6,132,65.7,2,0,0
1/17/2018 19:00,65,68.7,58,62.9,123,66,2,0,0
1/17/2018 19:05,63,69.2,57,63.2,120,66.3,2,0,0
1/17/2018 19:10,65,69.1,58,63.1,123,66.3,2,0,0
1/17/2018 19:15,63,69.4,57,63.4,120,66.5,2,0,0
1/17/2018 19:20,61,69.5,55,63.5,116,66.7,2,0,0
1/17/2018 19:25,57,69.7,52,63.7,109,66.8,2,0,0
1/17/2018 19:30,54,69.9,48,63.9,102,67.1,2,0,0
1/17/2018 19:35,53,69.9,47,63.9,100,67.1,2,0,0
1/17/2018 19:40,51,70,46,64,97,67.2,2,0,0
1/17/2018 19:45,48,70.1,44,64.1,92,67.2,2,0,0
1/17/2018 19:50,46,70.2,42,64.2,88,67.3,2,0,0
1/17/2018 19:55,45,70.2,40,64.2,85,67.4,2,0,0
1/17/2018 20:00,43,70.1,38,64.1,81,67.3,2,0,0
1/17/2018 20:05,41,70.3,37,64.3,78,67.5,2,0,0
1/17/2018 20:10,43,70.2,39,64.2,82,67.3,2,0,0
1/17/2018 20:15,42,70.3,37,64.3,79,67.5,2,0,0
1/17/2018 20:20,41,70.3,37,64.3,78,67.5,2,0,0
1/17/2018 20:25,39,70.4,35,64.4,74,67.6,2,0,0
1/17/2018 20:30,38,70.4,35,64.4,73,67.5,2,0,0
1/17/2018 20:35,38,70.3,34,64.3,72,67.5,2,0,0
1/17/2018 20:40,38,70.3,35,64.3,73,67.4,2,0,0
1/17/2018 20:45,38,70.2,34,64.2,72,67.4,2,0,0
1/17/2018 20:50,38,70.3,35,64.3,73,67.4,2,0,0
1/17/2018 20:55,37,70.2,33,64.2,70,67.4,2,0,0
1/17/2018 21:00,35,70.1,32,64.1,67,67.2,2,0,0
1/17/2018 21:05,36,70.2,33,64.2,69,67.3,2,0,0
1/17/2018 21:10,37,70.2,33,64.2,70,67.4,2,0,0
1/17/2018 21:15,37,70.2,34,64.2,71,67.3,2,0,0
1/17/2018 21:20,36,70.1,32,64.1,68,67.3,2,0,0
1/17/2018 21:25,35,70.1,32,64.1,67,67.2,2,0,0
1/17/2018 21:30,36,70.2,32,64.2,68,67.4,2,0,0
1/17/2018 21:35,34,69.9,30,63.9,64,67.1,2,0,0
1/17/2018 21:40,34,70.2,30,64.2,64,67.4,2,0,0
1/17/2018 21:45,34,70.2,30,64.2,64,67.4,2,0,0
1/17/2018 21:50,32,70.2,28,64.2,60,67.4,2,0,0
1/17/2018 21:55,31,70.3,27,64.3,58,67.5,2,0,0
1/17/2018 22:00,28,70.3,26,64.3,54,67.4,2,0,0
1/17/2018 22:05,28,70.2,25,64.2,53,67.4,2,0,0
1/17/2018 22:10,27,70.1,25,64.1,52,67.2,2,0,0
1/17/2018 22:15,28,70.1,25,64.1,53,67.3,2,0,0
1/17/2018 22:20,26,70.2,24,64.2,50,67.3,2,0,0
1/17/2018 22:25,26,70.1,23,64.1,49,67.3,2,0,0
1/17/2018 22:30,24,70.1,21,64.1,45,67.3,2,0,0
1/17/2018 22:35,23,70,21,64,44,67.1,2,0,0
1/17/2018 22:40,23,70.1,20,64.1,43,67.3,2,0,0
1/17/2018 22:45,22,70,20,64,42,67.1,2,0,0
1/17/2018 22:50,21,70,19,64,40,67.2,2,0,0
1/17/2018 22:55,18,70.1,17,64.1,35,67.2,2,0,0
1/17/2018 23:00,18,70.1,16,64.1,34,67.3,2,0,0
1/17/2018 23:05,17,70.2,16,64.2,33,67.3,2,0,0
1/17/2018 23:10,17,70.1,15,64.1,32,67.3,2,0,0
1/17/2018 23:15,17,70.2,15,64.2,32,67.4,2,0,0
1/17/2018 23:20,16,70.1,14,64.1,30,67.3,2,0,0
1/17/2018 23:25,14,70.3,13,64.3,27,67.4,2,0,0
1/17/2018 23:30,14,70.1,12,64.1,26,67.3,2,0,0
1/17/2018 23:35,14,70.2,13,64.2,27,67.3,2,0,0
1/17/2018 23:40,13,70.1,12,64.1,25,67.2,2,0,0
1/17/2018 23:45,13,70.2,11,64.2,24,67.5,2,0,0
1/17/2018 23:50,12,70.1,11,64.1,23,67.2,2,0,0
1/17/2018 23:55,11,70,9,64,20,67.3,2,0,0
1/18/2018 0:00,10,70.4,9,64.4,19,67.6,2,0,0
1/18/2018 0:05,9,70.3,8,64.3,17,67.5,2,0,0
1/18/2018 0:10,10,70.2,9,64.2,19,67.4,2,0,0
1/18/2018 0:15,10,70.1,9,64.1,19,67.3,2,0,0
1/18/2018 0:20,10,70.1,9,64.1,19,67.3,2,0,0
1/18/2018 0:25,11,70,9,64,20,67.3,2,0,0
1/18/2018 0:30,10,70,9,64,19,67.2,2,0,0
1/18/2018 0:35,9,70,9,64,18,67,2,0,0
1/18/2018 0:40,9,70,8,64,17,67.2,2,0,0
1/18/2018 0:45,8,69.9,8,63.9,16,66.9,2,0,0
1/18/2018 0:50,8,69.9,7,63.9,15,67.1,2,0,0
1/18/2018 0:55,8,69.8,7,63.8,15,67,2,0,0
1/18/2018 1:00,7,69.9,6,63.9,13,67.1,2,0,0
1/18/2018 1:05,7,70,6,64,13,67.2,2,0,0
1/18/2018 1:10,7,70,6,64,13,67.2,2,0,0
1/18/2018 1:15,6,70,6,64,12,67,2,0,0
1/18/2018 1:20,6,70.2,6,64.2,12,67.2,2,0,0
1/18/2018 1:25,6,70,5,64,11,67.3,2,0,0
1/18/2018 1:30,6,70,5,64,11,67.3,2,0,0
1/18/2018 1:35,6,70.3,5,64.3,11,67.6,2,0,0
1/18/2018 1:40,6,70.1,6,64.1,12,67.1,2,0,0
1/18/2018 1:45,6,70,5,64,11,67.3,2,0,0
1/18/2018 1:50,5,70,5,64,10,67,2,0,0
1/18/2018 1:55,5,70,5,64,10,67,2,0,0
1/18/2018 2:00,5,70.1,5,64.1,10,67.1,2,0,0
1/18/2018 2:05,5,69.9,5,63.9,10,66.9,2,0,0
1/18/2018 2:10,5,70,5,64,10,67,2,0,0
1/18/2018 2:15,5,70.1,5,64.1,10,67.1,2,0,0
1/18/2018 2:20,5,70,4,64,9,67.3,2,0,0
1/18/2018 2:25,5,70,4,64,9,67.3,2,0,0
1/18/2018 2:30,5,70,4,64,9,67.3,2,0,0
1/18/2018 2:35,5,70,5,64,10,67,2,0,0
1/18/2018 2:40,5,70.1,4,64.1,9,67.4,2,0,0
1/18/2018 2:45,5,70,4,64,9,67.3,2,0,0
1/18/2018 2:50,5,70.1,4,64.1,9,67.4,2,0,0
1/18/2018 2:55,4,70,4,64,8,67,2,0,0
1/18/2018 3:00,4,70,4,64,8,67,2,0,0
1/18/2018 3:05,4,69.9,4,63.9,8,66.9,2,0,0
1/18/2018 3:10,4,69.9,4,63.9,8,66.9,2,0,0
1/18/2018 3:15,5,70,4,64,9,67.3,2,0,0
1/18/2018 3:20,5,69.9,5,63.9,10,66.9,2,0,0
1/18/2018 3:25,5,69.9,5,63.9,10,66.9,2,0,0
1/18/2018 3:30,5,69.9,5,63.9,10,66.9,2,0,0
1/18/2018 3:35,6,70,5,64,11,67.3,2,0,0
1/18/2018 3:40,6,69.9,6,63.9,12,66.9,2,0,0
1/18/2018 3:45,6,69.7,6,63.7,12,66.7,2,0,0
1/18/2018 3:50,6,70,6,64,12,67,2,0,0
1/18/2018 3:55,6,69.8,5,63.8,11,67.1,2,0,0
1/18/2018 4:00,6,69.9,5,63.9,11,67.2,2,0,0
1/18/2018 4:05,6,69.8,6,63.8,12,66.8,2,0,0
1/18/2018 4:10,6,69.7,6,63.7,12,66.7,2,0,0
1/18/2018 4:15,7,69.8,6,63.8,13,67,2,0,0
1/18/2018 4:20,7,69.9,7,63.9,14,66.9,2,0,0
1/18/2018 4:25,8,69.9,7,63.9,15,67.1,2,0,0
1/18/2018 4:30,8,69.7,7,63.7,15,66.9,2,0,0
1/18/2018 4:35,9,69.8,8,63.8,17,67,2,0,0
1/18/2018 4:40,11,69.7,9,63.7,20,67,2,0,0
1/18/2018 4:45,11,69.8,10,63.8,21,66.9,2,0,0
1/18/2018 4:50,11,69.7,10,63.7,21,66.8,2,0,0
1/18/2018 4:55,12,69.7,10,63.7,22,67,2,0,0
1/18/2018 5:00,11,69.6,10,63.6,21,66.7,2,0,0
1/18/2018 5:05,12,69.4,10,63.4,22,66.7,2,0,0
1/18/2018 5:10,13,69.5,12,63.5,25,66.6,2,0,0
1/18/2018 5:15,16,69.6,14,63.6,30,66.8,2,0,0
1/18/2018 5:20,16,69.4,15,63.4,31,66.5,2,0,0
1/18/2018 5:25,17,69.4,16,63.4,33,66.5,2,0,0
1/18/2018 5:30,18,69.4,16,63.4,34,66.6,2,0,0
1/18/2018 5:35,20,69.4,18,63.4,38,66.6,2,0,0
1/18/2018 5:40,23,69.4,20,63.4,43,66.6,2,0,0
1/18/2018 5:45,24,69.2,22,63.2,46,66.3,2,0,0
1/18/2018 5:50,25,69.2,22,63.2,47,66.4,2,0,0
1/18/2018 5:55,26,69.2,23,63.2,49,66.4,2,0,0
1/18/2018 6:00,24,69.1,22,63.1,46,66.2,2,0,0
1/18/2018 6:05,26,69,23,63,49,66.2,2,0,0
1/18/2018 6:10,28,69,25,63,53,66.2,2,0,0
1/18/2018 6:15,32,68.9,28,62.9,60,66.1,2,0,0
1/18/2018 6:20,34,68.5,30,62.7,64,65.8,2,0,0
1/18/2018 6:25,36,68.2,32,62.4,68,65.5,2,0,0
1/18/2018 6:30,37,68.3,33,62.5,70,65.6,2,0,0
1/18/2018 6:35,42,68.2,38,62.4,80,65.4,2,0,0
1/18/2018 6:40,45,68.1,41,62.3,86,65.3,2,0,0
1/18/2018 6:45,48,68,43,62.2,91,65.3,2,0,0
1/18/2018 6:50,50,68.1,44,62.3,94,65.4,2,0,0
1/18/2018 6:55,48,68,43,62.2,91,65.3,2,0,0
1/18/2018 7:00,50,68,45,62.2,95,65.3,2,0,0
1/18/2018 7:05,49,67.9,44,62.1,93,65.2,2,0,0
1/18/2018 7:10,53,67.8,48,62,101,65,2,0,0
1/18/2018 7:15,55,67.9,49,62.1,104,65.2,2,0,0
1/18/2018 7:20,58,67.9,53,62.1,111,65.1,2,0,0
1/18/2018 7:25,58,67.8,52,62,110,65.1,2,0,0
1/18/2018 7:30,61,67.9,55,62.1,116,65.2,2,0,0
1/18/2018 7:35,62,67.9,55,62.1,117,65.2,2,0,0
1/18/2018 7:40,64,67.8,57,62,121,65.1,2,0,0
1/18/2018 7:45,66,67.8,59,62,125,65.1,2,0,0
1/18/2018 7:50,67,67.9,60,62.1,127,65.2,2,0,0
1/18/2018 7:55,68,67.8,61,62,129,65.1,2,0,0
1/18/2018 8:00,65,67.5,58,61.7,123,64.8,2,0,0
1/18/2018 8:05,63,67.4,56,61.6,119,64.7,2,0,0
1/18/2018 8:10,63,67.4,57,61.6,120,64.6,2,0,0
1/18/2018 8:15,64,67.4,57,61.6,121,64.7,2,0,0
1/18/2018 8:20,64,67.5,58,61.7,122,64.7,2,0,0
1/18/2018 8:25,62,67.2,55,61.4,117,64.5,2,0,0
1/18/2018 8:30,61,67.3,55,61.5,116,64.5,2,0,0
1/18/2018 8:35,61,67.3,55,61.5,116,64.5,2,0,0
1/18/2018 8:40,60,67.4,53,61.6,113,64.7,2,0,0
1/18/2018 8:45,61,67.3,55,61.5,116,64.5,2,0,0
1/18/2018 8:50,59,67.3,53,61.5,112,64.6,2,0,0
1/18/2018 8:55,57,67.2,52,61.4,109,64.4,2,0,0
1/18/2018 9:00,56,67.4,50,61.6,106,64.7,2,0,0
1/18/2018 9:05,55,67.4,50,61.6,105,64.6,2,0,0
1/18/2018 9:10,53,67.3,48,61.5,101,64.5,2,0,0
1/18/2018 9:15,55,67.5,49,61.7,104,64.8,2,0,0
1/18/2018 9:20,53,67.4,47,61.6,100,64.7,2,0,0
1/18/2018 9:25,54,67.5,49,61.7,103,64.7,2,0,0
1/18/2018 9:30,53,67.5,47,61.7,100,64.8,2,0,0
1/18/2018 9:35,52,67.7,47,61.9,99,64.9,2,0,0
1/18/2018 9:40,53,67.7,47,61.9,100,65,2,0,0
1/18/2018 9:45,53,67.7,48,61.9,101,64.9,2,0,0
1/18/2018 9:50,54,67.7,49,61.9,103,64.9,2,0,0
1/18/2018 9:55,52,67.8,46,62,98,65.1,2,0,0
1/18/2018 10:00,50,67.8,45,62,95,65.1,2,0,0
1/18/2018 10:05,50,67.7,44,61.9,94,65,2,0,0
1/18/2018 10:10,49,67.7,44,61.9,93,65,2,0,0
1/18/2018 10:15,51,67.8,46,62,97,65,2,0,0
1/18/2018 10:20,52,67.8,47,62,99,65,2,0,0
1/18/2018 10:25,51,67.8,46,62,97,65,2,0,0
1/18/2018 10:30,49,67.8,44,62,93,65.1,2,0,0
1/18/2018 10:35,52,67.9,47,62.1,99,65.1,2,0,0
1/18/2018 10:40,53,67.9,47,62.1,100,65.2,2,0,0
1/18/2018 10:45,53,67.9,47,62.1,100,65.2,2,0,0
1/18/2018 10:50,53,67.9,48,62.1,101,65.1,2,0,0
1/18/2018 10:55,53,67.9,48,62.1,101,65.1,2,0,0
1/18/2018 11:00,51,67.7,46,61.9,97,64.9,2,0,0
1/18/2018 11:05,52,67.6,46,61.8,98,64.9,2,0,0
1/18/2018 11:10,54,67.6,48,61.8,102,64.9,2,0,0
1/18/2018 11:15,54,67.7,49,61.9,103,64.9,2,0,0
1/18/2018 11:20,55,67.7,50,61.9,105,64.9,2,0,0
1/18/2018 11:25,55,67.6,49,61.8,104,64.9,2,0,0
1/18/2018 11:30,55,67.8,49,62,104,65.1,2,0,0
1/18/2018 11:35,56,67.8,50,62,106,65.1,2,0,0
1/18/2018 11:40,55,67.7,50,61.9,105,64.9,2,0,0
1/18/2018 11:45,57,67.8,51,62,108,65.1,2,0,0
1/18/2018 11:50,58,67.8,52,62,110,65.1,2,0,0
1/18/2018 11:55,57,67.8,51,62,108,65.1,2,0,0
1/18/2018 12:00,56,67.8,50,62,106,65.1,2,0,0
1/18/2018 12:05,56,67.7,51,61.9,107,64.9,2,0,0
1/18/2018 12:10,57,67.8,52,62,109,65,2,0,0
1/18/2018 12:15,58,67.7,53,61.9,111,64.9,2,0,0
1/18/2018 12:20,58,67.8,52,62,110,65.1,2,0,0
1/18/2018 12:25,59,67.7,53,61.9,112,65,2,0,0
1/18/2018 12:30,60,67.9,53,62.1,113,65.2,2,0,0
1/18/2018 12:35,58,67.9,53,62.1,111,65.1,2,0,0
1/18/2018 12:40,58,68,53,62.2,111,65.2,2,0,0
1/18/2018 12:45,61,67.8,54,62,115,65.1,2,0,0
1/18/2018 12:50,60,67.9,53,62.1,113,65.2,2,0,0
1/18/2018 12:55,60,67.9,54,62.1,114,65.2,2,0,0
1/18/2018 13:00,59,67.9,53,62.1,112,65.2,2,0,0
1/18/2018 13:05,60,67.9,54,62.1,114,65.2,2,0,0
1/18/2018 13:10,60,67.9,53,62.1,113,65.2,2,0,0
1/18/2018 13:15,61,67.9,55,62.1,116,65.2,2,0,0
1/18/2018 13:20,60,67.9,54,62.1,114,65.2,2,0,0
1/18/2018 13:25,61,68,55,62.2,116,65.3,2,0,0
1/18/2018 13:30,62,68,55,62.2,117,65.3,2,0,0
1/18/2018 13:35,63,68,56,62.2,119,65.3,2,0,0
1/18/2018 13:40,64,67.8,58,62,122,65,2,0,0
1/18/2018 13:45,65,67.9,58,62.1,123,65.2,2,0,0
1/18/2018 13:50,65,67.9,58,62.1,123,65.2,2,0,0
1/18/2018 13:55,65,67.9,59,62.1,124,65.1,2,0,0
1/18/2018 14:00,62,68,56,62.2,118,65.2,2,0,0
1/18/2018 14:05,63,67.8,57,62,120,65,2,0,0
1/18/2018 14:10,67,67.6,60,61.8,127,64.9,2,0,0
1/18/2018 14:15,68,67.7,61,61.9,129,65,2,0,0
1/18/2018 14:20,68,67.9,61,62.1,129,65.2,2,0,0
1/18/2018 14:25,67,67.7,61,61.9,128,64.9,2,0,0
1/18/2018 14:30,70,67.6,62,61.8,132,64.9,2,0,0
1/18/2018 14:35,70,67.6,63,61.8,133,64.9,2,0,0
1/18/2018 14:40,71,67.7,64,61.9,135,65,2,0,0
1/18/2018 14:45,71,67.8,63,62,134,65.1,2,0,0
1/18/2018 14:50,72,67.9,64,62.1,136,65.2,2,0,0
1/18/2018 14:55,71,67.8,63,62,134,65.1,2,0,0
1/18/2018 15:00,70,67.9,62,62.1,132,65.2,2,0,0
1/18/2018 15:05,70,67.8,62,62,132,65.1,2,0,0
1/18/2018 15:10,71,67.8,63,62,134,65.1,2,0,0
1/18/2018 15:15,73,67.7,65,61.9,138,65,2,0,0
1/18/2018 15:20,73,67.7,66,61.9,139,64.9,2,0,0
1/18/2018 15:25,73,67.8,66,62,139,65,2,0,0
1/18/2018 15:30,75,67.8,67,62,142,65.1,2,0,0
1/18/2018 15:35,74,67.8,67,62,141,65,2,0,0
1/18/2018 15:40,76,67.7,68,61.9,144,65,2,0,0
1/18/2018 15:45,75,67.6,68,61.8,143,64.8,2,0,0
1/18/2018 15:50,76,67.6,68,61.8,144,64.9,2,0,0
1/18/2018 15:55,73,67.7,66,61.9,139,64.9,2,0,0
1/18/2018 16:00,72,67.9,64,62.1,136,65.2,2,0,0
1/18/2018 16:05,71,67.8,64,62,135,65.1,2,0,0
1/18/2018 16:10,74,67.8,67,62,141,65,2,0,0
1/18/2018 16:15,75,67.9,68,62.1,143,65.1,2,0,0
1/18/2018 16:20,76,67.9,69,62.1,145,65.1,2,0,0
1/18/2018 16:25,75,68,68,62.2,143,65.2,2,0,0
1/18/2018 16:30,72,68.1,65,62.3,137,65.3,2,0,0
1/18/2018 16:35,72,67.9,65,62.1,137,65.1,2,0,0
1/18/2018 16:40,76,68.1,69,62.3,145,65.3,2,0,0
1/18/2018 16:45,74,67.9,67,62.1,141,65.1,2,0,0
1/18/2018 16:50,76,67.7,69,61.9,145,64.9,2,0,0
1/18/2018 16:55,75,67.8,68,62,143,65,2,0,0
1/18/2018 17:00,74,68.3,67,62.5,141,65.5,2,0,0
1/18/2018 17:05,76,68.4,68,62.6,144,65.7,2,0,0
1/18/2018 17:10,77,68.3,69,62.5,146,65.6,2,0,0
1/18/2018 17:15,80,68.3,72,62.5,152,65.6,2,0,0
1/18/2018 17:20,80,68.3,72,62.5,152,65.6,2,0,0
1/18/2018 17:25,77,68.2,70,62.4,147,65.4,2,0,0
1/18/2018 17:30,77,68,69,62.2,146,65.3,2,0,0
1/18/2018 17:35,76,67.7,68,61.9,144,65,2,0,0
1/18/2018 17:40,76,67.4,69,61.6,145,64.6,2,0,0
1/18/2018 17:45,75,67.2,67,61.4,142,64.5,2,0,0
1/18/2018 17:50,74,67.1,66,61.3,140,64.4,2,0,0
1/18/2018 17:55,72,67.1,64,61.3,136,64.4,2,0,0
1/18/2018 18:00,70,67.4,63,61.6,133,64.7,2,0,0
1/18/2018 18:05,71,67.6,63,61.8,134,64.9,2,0,0
1/18/2018 18:10,71,67.5,64,61.7,135,64.8,2,0,0
1/18/2018 18:15,70,67.7,63,61.9,133,65,2,0,0
1/18/2018 18:20,67,67.8,60,62,127,65.1,2,0,0
1/18/2018 18:25,66,68,59,62.2,125,65.3,2,0,0
1/18/2018 18:30,65,68.2,58,62.4,123,65.5,2,0,0
1/18/2018 18:35,63,68.3,56,62.5,119,65.6,2,0,0
1/18/2018 18:40,64,68.3,57,62.5,121,65.6,2,0,0
1/18/2018 18:45,62,68.6,55,62.8,117,65.9,2,0,0
1/18/2018 18:50,60,68.5,53,62.7,113,65.8,2,0,0
1/18/2018 18:55,57,68.7,52,62.9,109,65.9,2,0,0
1/18/2018 19:00,56,69,50,63,106,66.2,2,0,0
1/18/2018 19:05,54,69.2,49,63.2,103,66.3,2,0,0
1/18/2018 19:10,55,69.3,50,63.3,105,66.4,2,0,0
1/18/2018 19:15,53,69.5,48,63.5,101,66.6,2,0,0
1/18/2018 19:20,52,69.5,46,63.5,98,66.7,2,0,0
1/18/2018 19:25,51,69.6,45,63.6,96,66.8,2,0,0
1/18/2018 19:30,47,69.8,43,63.8,90,66.9,2,0,0
1/18/2018 19:35,47,69.9,42,63.9,89,67.1,2,0,0
1/18/2018 19:40,46,70.1,41,64.1,87,67.3,2,0,0
1/18/2018 19:45,45,70.1,41,64.1,86,67.2,2,0,0
1/18/2018 19:50,44,70.2,40,64.2,84,67.3,2,0,0
1/18/2018 19:55,42,70.1,37,64.1,79,67.3,2,0,0
1/18/2018 20:00,42,70.2,37,64.2,79,67.4,2,0,0
1/18/2018 20:05,40,70.2,35,64.2,75,67.4,2,0,0
1/18/2018 20:10,41,70.2,37,64.2,78,67.4,2,0,0
1/18/2018 20:15,40,70.2,36,64.2,76,67.4,2,0,0
1/18/2018 20:20,41,70.2,36,64.2,77,67.4,2,0,0
1/18/2018 20:25,39,70.1,35,64.1,74,67.3,2,0,0
1/18/2018 20:30,38,70.1,35,64.1,73,67.2,2,0,0
1/18/2018 20:35,38,70.2,34,64.2,72,67.4,2,0,0
1/18/2018 20:40,36,70.4,32,64.4,68,67.6,2,0,0
1/18/2018 20:45,36,70.3,33,64.3,69,67.4,2,0,0
1/18/2018 20:50,36,70.3,33,64.3,69,67.4,2,0,0
1/18/2018 20:55,36,70.4,32,64.4,68,67.6,2,0,0
1/18/2018 21:00,35,70.3,31,64.3,66,67.5,2,0,0
1/18/2018 21:05,34,70.2,31,64.2,65,67.3,2,0,0
1/18/2018 21:10,36,70.3,33,64.3,69,67.4,2,0,0
1/18/2018 21:15,36,70.3,33,64.3,69,67.4,2,0,0
1/18/2018 21:20,36,70.2,32,64.2,68,67.4,2,0,0
1/18/2018 21:25,35,70.2,32,64.2,67,67.3,2,0,0
1/18/2018 21:30,34,70.3,31,64.3,65,67.4,2,0,0
1/18/2018 21:35,33,70.4,30,64.4,63,67.5,2,0,0
1/18/2018 21:40,32,70.3,29,64.3,61,67.4,2,0,0
1/18/2018 21:45,32,70.4,28,64.4,60,67.6,2,0,0
1/18/2018 21:50,31,70.5,27,64.5,58,67.7,2,0,0
1/18/2018 21:55,30,70.4,26,64.4,56,67.6,2,0,0
1/18/2018 22:00,28,70.4,26,64.4,54,67.5,2,0,0
1/18/2018 22:05,28,70.4,25,64.4,53,67.6,2,0,0
1/18/2018 22:10,28,70.5,25,64.5,53,67.7,2,0,0
1/18/2018 22:15,27,70.5,25,64.5,52,67.6,2,0,0
1/18/2018 22:20,27,70.3,24,64.3,51,67.5,2,0,0
1/18/2018 22:25,26,70.3,23,64.3,49,67.5,2,0,0
1/18/2018 22:30,25,70.3,22,64.3,47,67.5,2,0,0
1/18/2018 22:35,24,70.4,21,64.4,45,67.6,2,0,0
1/18/2018 22:40,24,70.4,21,64.4,45,67.6,2,0,0
1/18/2018 22:45,22,70.4,19,64.4,41,67.6,2,0,0
1/18/2018 22:50,21,70.5,19,64.5,40,67.7,2,0,0
1/18/2018 22:55,19,70.3,18,64.3,37,67.4,2,0,0
1/18/2018 23:00,18,70.4,16,64.4,34,67.6,2,0,0
1/18/2018 23:05,18,70.4,16,64.4,34,67.6,2,0,0
1/18/2018 23:10,18,70.3,17,64.3,35,67.4,2,0,0
1/18/2018 23:15,17,70.3,16,64.3,33,67.4,2,0,0
1/18/2018 23:20,17,70.3,15,64.3,32,67.5,2,0,0
1/18/2018 23:25,16,70.3,14,64.3,30,67.5,2,0,0
1/18/2018 23:30,16,70.3,14,64.3,30,67.5,2,0,0
1/18/2018 23:35,15,70.2,13,64.2,28,67.4,2,0,0
1/18/2018 23:40,15,70.4,13,64.4,28,67.6,2,0,0
1/18/2018 23:45,13,70.2,12,64.2,25,67.3,2,0,0
1/18/2018 23:50,12,70.2,11,64.2,23,67.3,2,0,0
1/18/2018 23:55,12,70.2,11,64.2,23,67.3,2,0,0
1/19/2018 0:00,12,69.3,27,64.7,39,66.2,2,0,0
1/19/2018 0:05,10,69,25,64.4,35,65.7,2,0,0
1/19/2018 0:10,8,69.2,24,64.5,32,65.7,2,0,0
1/19/2018 0:15,10,69.2,26,64.6,36,65.9,2,0,0
1/19/2018 0:20,10,69.2,26,64.5,36,65.8,2,0,0
1/19/2018 0:25,8,69,23,64.4,31,65.6,2,0,0
1/19/2018 0:30,10,69.1,26,64.5,36,65.8,2,0,0
1/19/2018 0:35,6,69.1,21,64.5,27,65.5,2,0,0
1/19/2018 0:40,10,69.3,25,64.7,35,66,2,0,0
1/19/2018 0:45,7,69.4,22,64.8,29,65.9,2,0,0
1/19/2018 0:50,7,69.1,23,64.5,30,65.5,2,0,0
1/19/2018 0:55,6,69.3,21,64.7,27,65.7,2,0,0
1/19/2018 1:00,6,69.3,21,64.7,27,65.8,2,0,0
1/19/2018 1:05,7,69.4,22,64.8,29,65.9,2,0,0
1/19/2018 1:10,8,69.4,24,64.8,32,66,2,0,0
1/19/2018 1:15,6,69.3,21,64.7,27,65.8,2,0,0
1/19/2018 1:20,10,69.3,20,64.7,30,66.3,2,0,0
1/19/2018 1:25,10,69.4,20,64.8,30,66.3,2,0,0
1/19/2018 1:30,9,69.4,24,64.8,33,66.1,2,0,0
1/19/2018 1:35,9,69.4,24,64.8,33,66.1,2,0,0
1/19/2018 1:40,7,69.4,22,64.8,29,65.9,2,0,0
1/19/2018 1:45,12,69.5,21,64.9,33,66.6,2,0,0
1/19/2018 1:50,7,69.4,22,64.8,29,66,2,0,0
1/19/2018 1:55,6,69.3,21,64.7,27,65.8,2,0,0
1/19/2018 2:00,6,69.3,21,64.7,27,65.7,2,0,0
1/19/2018 2:05,7,69.4,22,64.8,29,65.9,2,0,0
1/19/2018 2:10,6,69.3,21,64.7,27,65.8,2,0,0
1/19/2018 2:15,9,69.2,24,64.5,33,65.8,2,0,0
1/19/2018 2:20,7,69.3,22,64.7,29,65.8,2,0,0
1/19/2018 2:25,7,69.3,22,64.7,29,65.8,2,0,0
1/19/2018 2:30,9,69.3,24,64.7,33,66,2,0,0
1/19/2018 2:35,8,69.3,23,64.7,31,65.9,2,0,0
1/19/2018 2:40,8,69.3,23,64.7,31,65.8,2,0,0
1/19/2018 2:45,11,69.2,26,64.5,37,65.9,2,0,0
1/19/2018 2:50,8,69.2,24,64.6,32,65.7,2,0,0
1/19/2018 2:55,11,68.9,26,64.3,37,65.7,2,0,0
1/19/2018 3:00,9,69.1,25,64.5,34,65.7,2,0,0
1/19/2018 3:05,12,69.1,28,64.4,40,65.8,2,0,0
1/19/2018 3:10,9,68.9,24,64.2,33,65.5,2,0,0
1/19/2018 3:15,11,68.6,27,63.9,38,65.2,2,0,0
1/19/2018 3:20,9,68.8,25,64.2,34,65.4,2,0,0
1/19/2018 3:25,14,69.1,30,64.5,44,65.9,2,0,0
1/19/2018 3:30,9,69.3,25,64.7,34,65.9,2,0,0
1/19/2018 3:35,10,69.2,25,64.6,35,65.9,2,0,0
1/19/2018 3:40,18,69.4,34,64.8,52,66.4,2,0,0
1/19/2018 3:45,14,69.4,30,64.8,44,66.3,2,0,0
1/19/2018 3:50,13,69.3,29,64.6,42,66.1,2,0,0
1/19/2018 3:55,16,69.4,32,64.8,48,66.3,2,0,0
1/19/2018 4:00,13,68.9,29,64.2,42,65.6,2,0,0
1/19/2018 4:05,16,69.2,31,64.5,47,66.1,2,0,0
1/19/2018 4:10,22,68.9,38,64.3,60,66,2,0,0
1/19/2018 4:15,20,68.8,36,64.2,56,65.9,2,0,0
1/19/2018 4:20,24,68.8,41,64.2,65,65.9,2,0,0
1/19/2018 4:25,22,69.4,38,64.8,60,66.5,2,0,0
1/19/2018 4:30,27,69.7,44,65.2,71,66.9,2,0,0
1/19/2018 4:35,33,67.6,50,62.9,83,64.8,2,0,0
1/19/2018 4:40,32,68.3,50,63.6,82,65.4,2,0,0
1/19/2018 4:45,30,68.3,47,63.7,77,65.5,2,0,0
1/19/2018 4:50,33,70,49,65.4,82,67.3,2,0,0
1/19/2018 4:55,35,70.1,53,65.6,88,67.4,2,0,0
1/19/2018 5:00,36,69.8,54,65.3,90,67.1,2,0,0
1/19/2018 5:05,43,68.3,61,63.7,104,65.6,2,0,0
1/19/2018 5:10,33,68.3,50,63.6,83,65.5,2,0,0
1/19/2018 5:15,36,69.5,54,64.9,90,66.7,2,0,0
1/19/2018 5:20,46,70.2,64,65.7,110,67.6,2,0,0
1/19/2018 5:25,45,70.9,65,66.4,110,68.2,2,0,0
1/19/2018 5:30,37,70.4,55,65.9,92,67.7,2,0,0
1/19/2018 5:35,80,69.1,103,64.4,183,66.5,2,0,0
1/19/2018 5:40,52,69.2,72,64.5,124,66.5,2,0,0
1/19/2018 5:45,59,68.1,80,63.5,139,65.5,2,0,0
1/19/2018 5:50,61,68.7,81,64.1,142,66.1,2,0,0
1/19/2018 5:55,62,68.1,83,63.5,145,65.4,2,0,0
1/19/2018 6:00,56,68.2,75,63.5,131,65.5,2,0,0
1/19/2018 6:05,43,68,62,63.3,105,65.2,2,0,0
1/19/2018 6:10,51,69.2,72,64.6,123,66.5,2,0,0
1/19/2018 6:15,60,68.1,80,63.4,140,65.4,2,0,0
1/19/2018 6:20,74,67.5,97,62.7,171,64.8,2,0,0
1/19/2018 6:25,57,67.4,78,62.6,135,64.6,2,0,0
1/19/2018 6:30,71,67.5,94,62.8,165,64.8,2,0,0
1/19/2018 6:35,64,68,86,63.2,150,65.2,2,0,0
1/19/2018 6:40,58,69.1,80,64.4,138,66.3,2,0,0
1/19/2018 6:45,68,68.6,90,63.9,158,65.9,2,0,0
1/19/2018 6:50,65,68.3,87,63.6,152,65.6,2,0,0
1/19/2018 6:55,72,68.7,93,64,165,66,2,0,0
1/19/2018 7:00,69,67.3,91,62.5,160,64.6,2,0,0
1/19/2018 7:05,75,68.7,97,64,172,66.1,2,0,0
1/19/2018 7:10,54,68.5,75,63.8,129,65.7,2,0,0
1/19/2018 7:15,72,66.7,94,61.9,166,64,2,0,0
1/19/2018 7:20,75,66.3,98,61.4,173,63.5,2,0,0
1/19/2018 7:25,76,67.8,98,63,174,65.1,2,0,0
1/19/2018 7:30,69,67.7,90,62.9,159,65,2,0,0
1/19/2018 7:35,90,67.7,115,62.8,205,64.9,2,0,0
1/19/2018 7:40,87,68.2,112,63.4,199,65.5,2,0,0
1/19/2018 7:45,90,68.1,114,63.2,204,65.4,2,0,0
1/19/2018 7:50,77,68.8,100,64,177,66.1,2,0,0
1/19/2018 7:55,92,69,116,64.3,208,66.4,2,0,0
1/19/2018 8:00,69,68.4,90,63.6,159,65.7,2,0,0
1/19/2018 8:05,79,67.1,102,62.2,181,64.4,2,0,0
1/19/2018 8:10,67,68.1,90,63.4,157,65.4,2,0,0
1/19/2018 8:15,74,67.3,96,62.4,170,64.5,2,0,0
1/19/2018 8:20,81,67.7,103,62.8,184,64.9,2,0,0
1/19/2018 8:25,74,68.6,95,63.8,169,65.9,2,0,0
1/19/2018 8:30,85,68.2,107,63.5,192,65.6,2,0,0
1/19/2018 8:35,74,67.2,96,62.4,170,64.5,2,0,0
1/19/2018 8:40,84,68.4,108,63.7,192,65.7,2,0,0
1/19/2018 8:45,77,68.8,98,64.1,175,66.2,2,0,0
1/19/2018 8:50,80,68.2,102,63.5,182,65.6,2,0,0
1/19/2018 8:55,76,67.9,99,63.1,175,65.2,2,0,0
1/19/2018 9:00,90,67.9,112,63.1,202,65.2,2,0,0
1/19/2018 9:05,79,68,101,63.2,180,65.3,2,0,0
1/19/2018 9:10,81,67.3,101,62.4,182,64.6,2,0,0
1/19/2018 9:15,78,67.5,100,62.6,178,64.7,2,0,0
1/19/2018 9:20,66,67.4,88,62.5,154,64.6,2,0,0
1/19/2018 9:25,63,67.9,84,63.1,147,65.2,2,0,0
1/19/2018 9:30,68,68.5,88,63.8,156,65.9,2,0,0
1/19/2018 9:35,70,67.8,90,63.1,160,65.1,2,0,0
1/19/2018 9:40,66,68.9,85,64.2,151,66.3,2,0,0
1/19/2018 9:45,56,69.6,75,65,131,66.9,2,0,0
1/19/2018 9:50,67,68.3,87,63.6,154,65.7,2,0,0
1/19/2018 9:55,68,68.6,87,63.9,155,66,2,0,0
1/19/2018 10:00,59,67.8,78,63,137,65.1,2,0,0
1/19/2018 10:05,69,64.3,89,59.1,158,61.4,2,0,0
1/19/2018 10:10,44,63.6,62,58.5,106,60.6,2,0,0
1/19/2018 10:15,64,65.3,83,60.2,147,62.4,2,0,0
1/19/2018 10:20,63,66.2,83,61.3,146,63.4,2,0,0
1/19/2018 10:25,57,67.1,75,62.3,132,64.4,2,0,0
1/19/2018 10:30,51,65.8,68,60.8,119,63,2,0,0
1/19/2018 10:35,32,67,49,62.2,81,64.1,2,0,0
1/19/2018 10:40,16,68.4,32,63.7,48,65.3,2,0,0
1/19/2018 10:45,17,68.5,33,63.8,50,65.4,2,0,0
1/19/2018 10:50,60,68.7,80,64,140,66,2,0,0
1/19/2018 10:55,49,68.7,67,64,116,66,2,0,0
1/19/2018 11:00,53,68.8,72,64.1,125,66.1,2,0,0
1/19/2018 11:05,55,68.3,75,63.6,130,65.6,2,0,0
1/19/2018 11:10,63,68.4,82,63.7,145,65.7,2,0,0
1/19/2018 11:15,54,68.1,72,63.4,126,65.4,2,0,0
1/19/2018 11:20,60,68.7,79,64,139,66,2,0,0
1/19/2018 11:25,64,69.2,83,64.5,147,66.5,2,0,0
1/19/2018 11:30,52,68.2,70,63.5,122,65.5,2,0,0
1/19/2018 11:35,58,67.9,76,63.2,134,65.2,2,0,0
1/19/2018 11:40,55,68.7,73,64.1,128,66,2,0,0
1/19/2018 11:45,57,67.2,76,62.5,133,64.5,2,0,0
1/19/2018 11:50,56,69.1,75,64.5,131,66.4,2,0,0
1/19/2018 11:55,59,69.5,77,65,136,66.9,2,0,0
1/19/2018 12:00,50,69.9,67,65.3,117,67.3,2,0,0
1/19/2018 12:05,54,69.9,71,65.3,125,67.3,2,0,0
1/19/2018 12:10,55,70.4,72,65.9,127,67.9,2,0,0
1/19/2018 12:15,51,69.7,70,65.1,121,67,2,0,0
1/19/2018 12:20,54,69.7,72,65.1,126,67.1,2,0,0
1/19/2018 12:25,50,68.8,68,64.1,118,66.1,2,0,0
1/19/2018 12:30,52,67.9,70,63.2,122,65.2,2,0,0
1/19/2018 12:35,55,67.9,73,63.2,128,65.2,2,0,0
1/19/2018 12:40,57,68.4,76,63.7,133,65.7,2,0,0
1/19/2018 12:45,64,67.6,82,62.8,146,64.9,2,0,0
1/19/2018 12:50,48,67.5,66,62.7,114,64.7,2,0,0
1/19/2018 12:55,51,66.6,71,61.6,122,63.7,2,0,0
1/19/2018 13:00,46,67,64,62.2,110,64.2,2,0,0
1/19/2018 13:05,45,66.2,63,61.4,108,63.4,2,0,0
1/19/2018 13:10,53,67.4,70,62.6,123,64.7,2,0,0
1/19/2018 13:15,53,68.7,70,64,123,66,2,0,0
1/19/2018 13:20,55,67.2,73,62.4,128,64.4,2,0,0
1/19/2018 13:25,53,67.9,71,63.2,124,65.2,2,0,0
1/19/2018 13:30,39,68.5,56,63.9,95,65.8,2,0,0
1/19/2018 13:35,51,68,69,63.4,120,65.4,2,0,0
1/19/2018 13:40,47,68.4,64,63.7,111,65.7,2,0,0
1/19/2018 13:45,48,67.4,66,62.7,114,64.7,2,0,0
1/19/2018 13:50,49,67.2,67,62.4,116,64.5,2,0,0
1/19/2018 13:55,53,68,71,63.2,124,65.3,2,0,0
1/19/2018 14:00,51,67.5,69,62.7,120,64.8,2,0,0
1/19/2018 14:05,44,66.9,61,62.1,105,64.1,2,0,0
1/19/2018 14:10,55,67.6,74,62.8,129,64.9,2,0,0
1/19/2018 14:15,52,67.7,70,63,122,65,2,0,0
1/19/2018 14:20,49,66.9,66,62,115,64.1,2,0,0
1/19/2018 14:25,55,67.8,75,63,130,65,2,0,0
1/19/2018 14:30,51,67,69,62.2,120,64.2,2,0,0
1/19/2018 14:35,44,67.4,62,62.6,106,64.6,2,0,0
1/19/2018 14:40,61,68.3,79,63.6,140,65.6,2,0,0
1/19/2018 14:45,47,68.2,65,63.5,112,65.5,2,0,0
1/19/2018 14:50,61,68.8,79,64.2,140,66.2,2,0,0
1/19/2018 14:55,55,68.4,74,63.7,129,65.7,2,0,0
1/19/2018 15:00,55,69.6,73,65,128,67,2,0,0
1/19/2018 15:05,51,69.3,69,64.6,120,66.6,2,0,0
1/19/2018 15:10,47,68.4,64,63.7,111,65.7,2,0,0
1/19/2018 15:15,67,67.9,86,63.1,153,65.2,2,0,0
1/19/2018 15:20,56,69.5,74,64.9,130,66.8,2,0,0
1/19/2018 15:25,64,67.1,84,62.3,148,64.4,2,0,0
1/19/2018 15:30,57,68.3,74,63.7,131,65.7,2,0,0
1/19/2018 15:35,63,68.3,81,63.6,144,65.7,2,0,0
1/19/2018 15:40,60,69.4,78,64.8,138,66.8,2,0,0
1/19/2018 15:45,59,69.1,79,64.5,138,66.5,2,0,0
1/19/2018 15:50,54,68.5,73,63.9,127,65.8,2,0,0
1/19/2018 15:55,52,67.9,70,63.1,122,65.2,2,0,0
1/19/2018 16:00,58,68,76,63.3,134,65.3,2,0,0
1/19/2018 16:05,54,67.9,72,63.2,126,65.2,2,0,0
1/19/2018 16:10,51,67.7,71,63,122,65,2,0,0
1/19/2018 16:15,49,67.7,68,63,117,65,2,0,0
1/19/2018 16:20,53,68.9,70,64.3,123,66.3,2,0,0
1/19/2018 16:25,52,68,70,63.3,122,65.3,2,0,0
1/19/2018 16:30,53,66.4,71,61.6,124,63.7,2,0,0
1/19/2018 16:35,55,67.9,74,63.2,129,65.2,2,0,0
1/19/2018 16:40,55,68.8,73,64.1,128,66.1,2,0,0
1/19/2018 16:45,57,68.3,76,63.5,133,65.6,2,0,0
1/19/2018 16:50,52,68.5,70,63.8,122,65.8,2,0,0
1/19/2018 16:55,53,68.8,70,64.1,123,66.1,2,0,0
1/19/2018 17:00,49,69.7,65,65.1,114,67,2,0,0
1/19/2018 17:05,63,68.6,83,63.8,146,65.9,2,0,0
1/19/2018 17:10,59,67.7,78,63,137,65.1,2,0,0
1/19/2018 17:15,56,67.3,75,62.6,131,64.6,2,0,0
1/19/2018 17:20,57,67.3,75,62.5,132,64.6,2,0,0
1/19/2018 17:25,58,66.9,78,62.1,136,64.1,2,0,0
1/19/2018 17:30,55,68.1,73,63.3,128,65.4,2,0,0
1/19/2018 17:35,58,67.8,77,62.9,135,65,2,0,0
1/19/2018 17:40,42,68.3,59,63.6,101,65.5,2,0,0
1/19/2018 17:45,50,66.5,68,61.6,118,63.7,2,0,0
1/19/2018 17:50,39,68.5,56,63.8,95,65.7,2,0,0
1/19/2018 17:55,43,67.8,61,63,104,65,2,0,0
1/19/2018 18:00,45,68.4,62,63.6,107,65.6,2,0,0
1/19/2018 18:05,44,68.1,62,63.4,106,65.4,2,0,0
1/19/2018 18:10,48,69.1,66,64.4,114,66.4,2,0,0
1/19/2018 18:15,47,67.3,65,62.4,112,64.5,2,0,0
1/19/2018 18:20,43,68.5,61,63.7,104,65.7,2,0,0
1/19/2018 18:25,44,68.4,62,63.7,106,65.7,2,0,0
1/19/2018 18:30,50,68.9,67,64.3,117,66.3,2,0,0
1/19/2018 18:35,48,68.2,66,63.4,114,65.4,2,0,0
1/19/2018 18:40,50,68.7,67,64.1,117,66.1,2,0,0
1/19/2018 18:45,55,68.2,73,63.5,128,65.5,2,0,0
1/19/2018 18:50,43,67.6,61,62.8,104,64.8,2,0,0
1/19/2018 18:55,47,68.1,64,63.4,111,65.4,2,0,0
1/19/2018 19:00,48,68.5,65,63.7,113,65.7,2,0,0
1/19/2018 19:05,44,68.2,63,63.4,107,65.4,2,0,0
1/19/2018 19:10,49,68.6,68,63.8,117,65.8,2,0,0
1/19/2018 19:15,39,68.7,57,64,96,65.9,2,0,0
1/19/2018 19:20,47,68.4,64,63.8,111,65.8,2,0,0
1/19/2018 19:25,51,67.6,68,62.7,119,64.8,2,0,0
1/19/2018 19:30,52,67.2,69,62.4,121,64.4,2,0,0
1/19/2018 19:35,45,67.6,62,62.8,107,64.8,2,0,0
1/19/2018 19:40,47,67.5,65,62.7,112,64.7,2,0,0
1/19/2018 19:45,39,68.9,56,64.2,95,66.1,2,0,0
1/19/2018 19:50,39,69.4,56,64.8,95,66.7,2,0,0
1/19/2018 19:55,39,68.2,56,63.5,95,65.5,2,0,0
1/19/2018 20:00,39,69.1,56,64.4,95,66.4,2,0,0
1/19/2018 20:05,35,69.6,51,65,86,66.9,2,0,0
1/19/2018 20:10,41,69.4,59,64.7,100,66.6,2,0,0
1/19/2018 20:15,46,68.9,64,64.2,110,66.1,2,0,0
1/19/2018 20:20,30,68.6,46,63.9,76,65.8,2,0,0
1/19/2018 20:25,37,69.4,54,64.8,91,66.7,2,0,0
1/19/2018 20:30,34,69.9,50,65.3,84,67.2,2,0,0
1/19/2018 20:35,30,69,47,64.4,77,66.2,2,0,0
1/19/2018 20:40,40,69.4,57,64.8,97,66.7,2,0,0
1/19/2018 20:45,34,69.8,51,65.2,85,67,2,0,0
1/19/2018 20:50,34,69.5,51,64.9,85,66.7,2,0,0
1/19/2018 20:55,28,69.4,44,64.8,72,66.6,2,0,0
1/19/2018 21:00,28,69.3,44,64.7,72,66.5,2,0,0
1/19/2018 21:05,23,69.2,40,64.6,63,66.3,2,0,0
1/19/2018 21:10,32,68.6,48,64,80,65.8,2,0,0
1/19/2018 21:15,31,68.3,47,63.7,78,65.5,2,0,0
1/19/2018 21:20,28,69,44,64.3,72,66.1,2,0,0
1/19/2018 21:25,35,69.4,52,64.8,87,66.6,2,0,0
1/19/2018 21:30,29,69.5,45,64.9,74,66.7,2,0,0
1/19/2018 21:35,27,69.5,44,64.9,71,66.7,2,0,0
1/19/2018 21:40,28,68.9,44,64.2,72,66,2,0,0
1/19/2018 21:45,32,69.4,48,64.7,80,66.6,2,0,0
1/19/2018 21:50,34,69.6,51,65,85,66.9,2,0,0
1/19/2018 21:55,27,69.4,42,64.8,69,66.6,2,0,0
1/19/2018 22:00,30,69.7,46,65.1,76,66.9,2,0,0
1/19/2018 22:05,26,69.3,41,64.7,67,66.5,2,0,0
1/19/2018 22:10,28,69.3,43,64.7,71,66.5,2,0,0
1/19/2018 22:15,27,69.4,42,64.8,69,66.6,2,0,0
1/19/2018 22:20,30,69.2,46,64.5,76,66.4,2,0,0
1/19/2018 22:25,24,69.3,40,64.7,64,66.4,2,0,0
1/19/2018 22:30,27,69.3,43,64.7,70,66.5,2,0,0
1/19/2018 22:35,17,69.5,33,64.9,50,66.4,2,0,0
1/19/2018 22:40,25,69.4,41,64.8,66,66.6,2,0,0
1/19/2018 22:45,21,69.4,37,64.8,58,66.5,2,0,0
1/19/2018 22:50,21,69.4,37,64.8,58,66.4,2,0,0
1/19/2018 22:55,22,69.5,38,64.9,60,66.5,2,0,0
1/19/2018 23:00,27,69.8,42,65.2,69,67,2,0,0
1/19/2018 23:05,20,69.6,36,65,56,66.6,2,0,0
1/19/2018 23:10,20,69.7,36,65.1,56,66.7,2,0,0
1/19/2018 23:15,20,69.7,36,65,56,66.7,2,0,0
1/19/2018 23:20,18,69.3,34,64.7,52,66.3,2,0,0
1/19/2018 23:25,18,69.5,34,64.9,52,66.5,2,0,0
1/19/2018 23:30,24,69.6,40,65,64,66.7,2,0,0
1/19/2018 23:35,22,69.6,37,65,59,66.7,2,0,0
1/19/2018 23:40,17,69.6,33,65,50,66.6,2,0,0
1/19/2018 23:45,21,69,37,64.4,58,66.1,2,0,0
1/19/2018 23:50,19,69.4,34,64.8,53,66.4,2,0,0
1/19/2018 23:55,17,69.5,32,64.9,49,66.5,2,0,0
1/20/2018 0:00,17,69.3,32,64.7,49,66.3,2,0,0
1/20/2018 0:05,12,68.9,27,64.2,39,65.7,2,0,0
1/20/2018 0:10,19,69.2,35,64.6,54,66.2,2,0,0
1/20/2018 0:15,16,69.2,32,64.5,48,66.1,2,0,0
1/20/2018 0:20,15,69.1,30,64.5,45,66.1,2,0,0
1/20/2018 0:25,14,69.3,30,64.7,44,66.1,2,0,0
1/20/2018 0:30,12,69,27,64.4,39,65.8,2,0,0
1/20/2018 0:35,12,68.9,27,64.2,39,65.7,2,0,0
1/20/2018 0:40,14,68.9,30,64.2,44,65.7,2,0,0
1/20/2018 0:45,12,69.1,27,64.5,39,65.9,2,0,0
1/20/2018 0:50,10,69.2,25,64.6,35,65.9,2,0,0
1/20/2018 0:55,10,69.3,25,64.7,35,66,2,0,0
1/20/2018 1:00,6,69.3,21,64.7,27,65.7,2,0,0
1/20/2018 1:05,9,69.2,24,64.6,33,65.9,2,0,0
1/20/2018 1:10,18,69.3,23,64.7,41,66.8,2,0,0
1/20/2018 1:15,9,69.1,24,64.5,33,65.7,2,0,0
1/20/2018 1:20,10,69.2,25,64.6,35,65.9,2,0,0
1/20/2018 1:25,7,69.3,22,64.7,29,65.8,2,0,0
1/20/2018 1:30,9,69.3,24,64.7,33,66,2,0,0
1/20/2018 1:35,15,68.8,30,64.2,45,65.7,2,0,0
1/20/2018 1:40,10,69.1,25,64.5,35,65.8,2,0,0
1/20/2018 1:45,10,69.3,25,64.7,35,66,2,0,0
1/20/2018 1:50,6,69.2,21,64.6,27,65.6,2,0,0
1/20/2018 1:55,7,69.4,22,64.8,29,65.9,2,0,0
1/20/2018 2:00,9,69.4,25,64.8,34,66,2,0,0
1/20/2018 2:05,7,69.3,23,64.7,30,65.8,2,0,0
1/20/2018 2:10,10,69.4,26,64.8,36,66,2,0,0
1/20/2018 2:15,18,69.4,24,64.8,42,66.7,2,0,0
1/20/2018 2:20,8,69,23,64.4,31,65.6,2,0,0
1/20/2018 2:25,7,69.2,23,64.6,30,65.7,2,0,0
1/20/2018 2:30,7,69.3,23,64.7,30,65.8,2,0,0
1/20/2018 2:35,7,69.1,23,64.5,30,65.6,2,0,0
1/20/2018 2:40,9,69.2,25,64.5,34,65.8,2,0,0
1/20/2018 2:45,10,69.1,26,64.5,36,65.8,2,0,0
1/20/2018 2:50,5,69.3,21,64.7,26,65.5,2,0,0
1/20/2018 2:55,9,69.2,24,64.6,33,65.9,2,0,0
1/20/2018 3:00,7,69.3,23,64.7,30,65.7,2,0,0
1/20/2018 3:05,10,69.3,26,64.7,36,65.9,2,0,0
1/20/2018 3:10,14,69.3,22,64.7,36,66.5,2,0,0
1/20/2018 3:15,10,69.4,25,64.8,35,66.2,2,0,0
1/20/2018 3:20,6,69.2,22,64.5,28,65.5,2,0,0
1/20/2018 3:25,7,69.3,23,64.7,30,65.8,2,0,0
1/20/2018 3:30,12,69.4,27,64.8,39,66.2,2,0,0
1/20/2018 3:35,7,69.4,22,64.8,29,65.9,2,0,0
1/20/2018 3:40,9,68.5,25,63.9,34,65.1,2,0,0
1/20/2018 3:45,10,69,25,64.4,35,65.7,2,0,0
1/20/2018 3:50,6,69.3,21,64.7,27,65.7,2,0,0
1/20/2018 3:55,9,69.2,24,64.5,33,65.8,2,0,0
1/20/2018 4:00,9,69.3,24,64.7,33,65.9,2,0,0
1/20/2018 4:05,6,69.4,22,64.8,28,65.8,2,0,0
1/20/2018 4:10,12,69.5,28,64.9,40,66.3,2,0,0
1/20/2018 4:15,12,69.3,27,64.7,39,66.1,2,0,0
1/20/2018 4:20,11,69.3,27,64.7,38,66,2,0,0
1/20/2018 4:25,12,69.3,27,64.7,39,66.2,2,0,0
1/20/2018 4:30,15,69,31,64.4,46,65.9,2,0,0
1/20/2018 4:35,12,69.2,28,64.5,40,65.9,2,0,0
1/20/2018 4:40,16,69.3,32,64.7,48,66.2,2,0,0
1/20/2018 4:45,15,69.4,31,64.8,46,66.3,2,0,0
1/20/2018 4:50,14,69.1,30,64.5,44,66,2,0,0
1/20/2018 4:55,11,69.1,27,64.5,38,65.8,2,0,0
1/20/2018 5:00,17,69.2,33,64.6,50,66.2,2,0,0
1/20/2018 5:05,14,69,30,64.3,44,65.8,2,0,0
1/20/2018 5:10,14,69.3,30,64.7,44,66.1,2,0,0
1/20/2018 5:15,13,69.4,28,64.8,41,66.2,2,0,0
1/20/2018 5:20,15,69.4,30,64.8,45,66.3,2,0,0
1/20/2018 5:25,17,69.5,33,64.9,50,66.5,2,0,0
1/20/2018 5:30,17,69.5,34,64.9,51,66.4,2,0,0
1/20/2018 5:35,19,69.6,35,65,54,66.6,2,0,0
1/20/2018 5:40,19,69.3,34,64.7,53,66.3,2,0,0
1/20/2018 5:45,17,69.4,32,64.8,49,66.4,2,0,0
1/20/2018 5:50,21,69.6,38,65,59,66.6,2,0,0
1/20/2018 5:55,25,69.6,41,65.1,66,66.8,2,0,0
1/20/2018 6:00,19,69,35,64.4,54,66,2,0,0
1/20/2018 6:05,19,69.3,34,64.7,53,66.3,2,0,0
1/20/2018 6:10,26,69.4,43,64.8,69,66.5,2,0,0
1/20/2018 6:15,21,69.2,37,64.6,58,66.3,2,0,0
1/20/2018 6:20,28,69.4,44,64.7,72,66.5,2,0,0
1/20/2018 6:25,26,69.5,41,64.9,67,66.7,2,0,0
1/20/2018 6:30,19,69.6,35,65,54,66.6,2,0,0
1/20/2018 6:35,27,69.4,44,64.7,71,66.5,2,0,0
1/20/2018 6:40,27,69,44,64.4,71,66.1,2,0,0
1/20/2018 6:45,30,68.9,47,64.2,77,66,2,0,0
1/20/2018 6:50,29,68.9,46,64.2,75,66,2,0,0
1/20/2018 6:55,31,68.9,47,64.3,78,66.1,2,0,0
1/20/2018 7:00,25,68.6,41,64,66,65.7,2,0,0
1/20/2018 7:05,26,68.2,42,63.6,68,65.3,2,0,0
1/20/2018 7:10,24,68.5,39,63.8,63,65.6,2,0,0
1/20/2018 7:15,28,68.8,45,64.2,73,65.9,2,0,0
1/20/2018 7:20,26,68.4,43,63.7,69,65.5,2,0,0
1/20/2018 7:25,37,69.4,55,64.7,92,66.6,2,0,0
1/20/2018 7:30,33,70.1,49,65.5,82,67.4,2,0,0
1/20/2018 7:35,37,69.4,54,64.7,91,66.6,2,0,0
1/20/2018 7:40,42,70.3,60,65.8,102,67.7,2,0,0
1/20/2018 7:45,44,69.7,61,65.1,105,67,2,0,0
1/20/2018 7:50,46,69.6,63,65,109,66.9,2,0,0
1/20/2018 7:55,33,69.9,50,65.3,83,67.2,2,0,0
1/20/2018 8:00,40,69.9,56,65.3,96,67.2,2,0,0
1/20/2018 8:05,30,69.6,47,65,77,66.8,2,0,0
1/20/2018 8:10,41,68.4,59,63.7,100,65.6,2,0,0
1/20/2018 8:15,40,68.8,57,64.2,97,66.1,2,0,0
1/20/2018 8:20,36,69,53,64.4,89,66.3,2,0,0
1/20/2018 8:25,40,69.8,57,65.2,97,67.1,2,0,0
1/20/2018 8:30,46,69.8,63,65.3,109,67.2,2,0,0
1/20/2018 8:35,47,70,65,65.4,112,67.3,2,0,0
1/20/2018 8:40,44,70.3,62,65.8,106,67.7,2,0,0
1/20/2018 8:45,45,69.8,63,65.2,108,67.1,2,0,0
1/20/2018 8:50,48,70.3,65,65.8,113,67.7,2,0,0
1/20/2018 8:55,55,69.6,74,65.1,129,67,2,0,0
1/20/2018 9:00,41,70,58,65.5,99,67.4,2,0,0
1/20/2018 9:05,42,69.3,59,64.7,101,66.6,2,0,0
1/20/2018 9:10,50,68.5,67,63.9,117,65.8,2,0,0
1/20/2018 9:15,54,68.9,73,64.3,127,66.2,2,0,0
1/20/2018 9:20,54,68.3,73,63.6,127,65.6,2,0,0
1/20/2018 9:25,55,68.7,73,64,128,66,2,0,0
1/20/2018 9:30,50,69.1,67,64.4,117,66.4,2,0,0
1/20/2018 9:35,53,68.6,71,63.9,124,65.9,2,0,0
1/20/2018 9:40,60,68.2,80,63.5,140,65.5,2,0,0
1/20/2018 9:45,63,68.7,81,64,144,66,2,0,0
1/20/2018 9:50,60,68.7,77,64,137,66.1,2,0,0
1/20/2018 9:55,64,69.4,82,64.8,146,66.8,2,0,0
1/20/2018 10:00,56,69.3,74,64.6,130,66.6,2,0,0
1/20/2018 10:05,52,68.4,70,63.6,122,65.7,2,0,0
1/20/2018 10:10,59,68.5,77,63.9,136,65.9,2,0,0
1/20/2018 10:15,57,68,75,63.3,132,65.3,2,0,0
1/20/2018 10:20,71,68.5,91,63.8,162,65.9,2,0,0
1/20/2018 10:25,60,68.6,79,63.9,139,66,2,0,0
1/20/2018 10:30,53,68.6,70,63.8,123,65.9,2,0,0
1/20/2018 10:35,54,69.1,72,64.4,126,66.4,2,0,0
1/20/2018 10:40,63,67.6,82,62.7,145,64.8,2,0,0
1/20/2018 10:45,55,67.4,74,62.6,129,64.6,2,0,0
1/20/2018 10:50,67,67.7,85,63,152,65.1,2,0,0
1/20/2018 10:55,61,68.6,79,63.9,140,66,2,0,0
1/20/2018 11:00,61,69.1,80,64.4,141,66.4,2,0,0
1/20/2018 11:05,54,69.7,72,65.1,126,67.1,2,0,0
1/20/2018 11:10,65,68.7,83,63.9,148,66,2,0,0
1/20/2018 11:15,59,69,77,64.3,136,66.3,2,0,0
1/20/2018 11:20,69,68.9,88,64.2,157,66.2,2,0,0
1/20/2018 11:25,64,68.9,83,64.3,147,66.3,2,0,0
1/20/2018 11:30,63,69,82,64.4,145,66.4,2,0,0
1/20/2018 11:35,64,69.4,83,64.8,147,66.8,2,0,0
1/20/2018 11:40,60,69.5,79,64.9,139,66.9,2,0,0
1/20/2018 11:45,71,69.1,91,64.5,162,66.5,2,0,0
1/20/2018 11:50,70,69.4,89,64.8,159,66.9,2,0,0
1/20/2018 11:55,61,69.8,80,65.2,141,67.2,2,0,0
1/20/2018 12:00,72,68.4,92,63.7,164,65.8,2,0,0
1/20/2018 12:05,74,68.6,94,63.9,168,66,2,0,0
1/20/2018 12:10,59,68.9,78,64.3,137,66.3,2,0,0
1/20/2018 12:15,77,69,98,64.3,175,66.4,2,0,0
1/20/2018 12:20,64,69.3,83,64.7,147,66.7,2,0,0
1/20/2018 12:25,60,69,79,64.4,139,66.4,2,0,0
1/20/2018 12:30,68,69.1,86,64.5,154,66.5,2,0,0
1/20/2018 12:35,68,69.4,87,64.8,155,66.8,2,0,0
1/20/2018 12:40,70,68.3,89,63.6,159,65.7,2,0,0
1/20/2018 12:45,67,68,87,63.3,154,65.3,2,0,0
1/20/2018 12:50,67,67.9,87,63.2,154,65.3,2,0,0
1/20/2018 12:55,80,67.1,100,62.3,180,64.5,2,0,0
1/20/2018 13:00,61,68.2,78,63.5,139,65.6,2,0,0
1/20/2018 13:05,55,68.4,74,63.7,129,65.7,2,0,0
1/20/2018 13:10,70,68.5,90,63.8,160,65.9,2,0,0
1/20/2018 13:15,67,68.6,87,63.8,154,65.9,2,0,0
1/20/2018 13:20,72,69,91,64.4,163,66.4,2,0,0
1/20/2018 13:25,73,69,94,64.3,167,66.4,2,0,0
1/20/2018 13:30,66,67.6,85,62.7,151,64.9,2,0,0
1/20/2018 13:35,64,67.9,83,63.1,147,65.2,2,0,0
1/20/2018 13:40,56,68.3,73,63.6,129,65.6,2,0,0
1/20/2018 13:45,60,68.8,78,64.1,138,66.1,2,0,0
1/20/2018 13:50,52,68.7,70,64.1,122,66.1,2,0,0
1/20/2018 13:55,53,68.3,71,63.6,124,65.6,2,0,0
1/20/2018 14:00,56,69.2,76,64.5,132,66.5,2,0,0
1/20/2018 14:05,58,68.2,77,63.4,135,65.5,2,0,0
1/20/2018 14:10,47,68.5,64,63.8,111,65.8,2,0,0
1/20/2018 14:15,46,69.7,63,65.2,109,67.1,2,0,0
1/20/2018 14:20,40,69.6,57,65,97,66.9,2,0,0
1/20/2018 14:25,52,68.8,71,64.2,123,66.1,2,0,0
1/20/2018 14:30,56,69.2,75,64.5,131,66.5,2,0,0
1/20/2018 14:35,51,69.2,69,64.6,120,66.6,2,0,0
1/20/2018 14:40,59,68.3,77,63.6,136,65.7,2,0,0
1/20/2018 14:45,56,68.5,74,63.8,130,65.8,2,0,0
1/20/2018 14:50,62,69.6,80,65,142,67,2,0,0
1/20/2018 14:55,53,69.1,72,64.5,125,66.4,2,0,0
1/20/2018 15:00,54,69.3,72,64.7,126,66.7,2,0,0
1/20/2018 15:05,61,69,80,64.4,141,66.4,2,0,0
1/20/2018 15:10,56,68.7,73,64,129,66.1,2,0,0
1/20/2018 15:15,60,68.4,79,63.7,139,65.7,2,0,0
1/20/2018 15:20,54,68.6,72,63.8,126,65.9,2,0,0
1/20/2018 15:25,57,68.9,75,64.2,132,66.2,2,0,0
1/20/2018 15:30,66,68.3,84,63.5,150,65.6,2,0,0
1/20/2018 15:35,58,68.2,76,63.3,134,65.4,2,0,0
1/20/2018 15:40,72,68.1,90,63.3,162,65.4,2,0,0
1/20/2018 15:45,63,67.6,82,62.8,145,64.9,2,0,0
1/20/2018 15:50,59,68,77,63.2,136,65.3,2,0,0
1/20/2018 15:55,59,68.7,77,64,136,66,2,0,0
1/20/2018 16:00,60,68.1,79,63.4,139,65.4,2,0,0
1/20/2018 16:05,66,68.4,85,63.7,151,65.8,2,0,0
1/20/2018 16:10,56,68.6,74,64,130,66,2,0,0
1/20/2018 16:15,46,69.1,64,64.5,110,66.4,2,0,0
1/20/2018 16:20,54,68.5,72,63.8,126,65.8,2,0,0
1/20/2018 16:25,59,68.1,76,63.3,135,65.4,2,0,0
1/20/2018 16:30,43,68.6,60,64,103,65.9,2,0,0
1/20/2018 16:35,43,68.1,60,63.4,103,65.4,2,0,0
1/20/2018 16:40,47,68.4,64,63.7,111,65.7,2,0,0
1/20/2018 16:45,44,68.5,61,63.8,105,65.8,2,0,0
1/20/2018 16:50,43,68.5,60,63.8,103,65.8,2,0,0
1/20/2018 16:55,49,68.3,66,63.6,115,65.6,2,0,0
1/20/2018 17:00,48,69,65,64.3,113,66.3,2,0,0
1/20/2018 17:05,47,69.3,64,64.7,111,66.7,2,0,0
1/20/2018 17:10,50,68.9,67,64.2,117,66.2,2,0,0
1/20/2018 17:15,55,68.6,74,63.9,129,65.9,2,0,0
1/20/2018 17:20,60,68.1,79,63.4,139,65.4,2,0,0
1/20/2018 17:25,55,67.8,72,63,127,65,2,0,0
1/20/2018 17:30,67,68.5,85,63.8,152,65.9,2,0,0
1/20/2018 17:35,54,69.3,72,64.7,126,66.6,2,0,0
1/20/2018 17:40,58,67,76,62.1,134,64.2,2,0,0
1/20/2018 17:45,53,67.3,71,62.5,124,64.6,2,0,0
1/20/2018 17:50,60,67.1,79,62.2,139,64.3,2,0,0
1/20/2018 17:55,71,67.3,89,62.5,160,64.6,2,0,0
1/20/2018 18:00,60,68,79,63.2,139,65.3,2,0,0
1/20/2018 18:05,64,68.1,84,63.4,148,65.4,2,0,0
1/20/2018 18:10,54,68.2,73,63.4,127,65.4,2,0,0
1/20/2018 18:15,61,68.2,80,63.5,141,65.5,2,0,0
1/20/2018 18:20,56,67.5,75,62.7,131,64.8,2,0,0
1/20/2018 18:25,70,68.2,89,63.5,159,65.6,2,0,0
1/20/2018 18:30,62,68.7,79,64.1,141,66.1,2,0,0
1/20/2018 18:35,47,68.9,64,64.2,111,66.2,2,0,0
1/20/2018 18:40,47,69.5,65,64.9,112,66.8,2,0,0
1/20/2018 18:45,59,69.3,78,64.7,137,66.7,2,0,0
1/20/2018 18:50,51,69.8,69,65.2,120,67.1,2,0,0
1/20/2018 18:55,52,69.4,70,64.8,122,66.7,2,0,0
1/20/2018 19:00,46,69.6,63,65.1,109,67,2,0,0
1/20/2018 19:05,52,69.3,70,64.6,122,66.6,2,0,0
1/20/2018 19:10,46,69.3,63,64.7,109,66.7,2,0,0
1/20/2018 19:15,44,69.3,62,64.7,106,66.6,2,0,0
1/20/2018 19:20,46,69.4,63,64.8,109,66.7,2,0,0
1/20/2018 19:25,42,69.2,58,64.6,100,66.5,2,0,0
1/20/2018 19:30,33,69.1,50,64.4,83,66.3,2,0,0
1/20/2018 19:35,42,69.3,59,64.6,101,66.5,2,0,0
1/20/2018 19:40,41,69.1,58,64.4,99,66.4,2,0,0
1/20/2018 19:45,37,68.9,54,64.2,91,66.1,2,0,0
1/20/2018 19:50,44,68.7,60,64.1,104,66,2,0,0
1/20/2018 19:55,36,68.9,52,64.2,88,66.1,2,0,0
1/20/2018 20:00,35,69.1,52,64.5,87,66.3,2,0,0
1/20/2018 20:05,35,68.2,51,63.5,86,65.4,2,0,0
1/20/2018 20:10,35,68.9,51,64.2,86,66.1,2,0,0
1/20/2018 20:15,33,69.2,49,64.7,82,66.5,2,0,0
1/20/2018 20:20,32,69.3,48,64.7,80,66.5,2,0,0
1/20/2018 20:25,26,69.2,42,64.6,68,66.4,2,0,0
1/20/2018 20:30,26,69.5,41,64.9,67,66.7,2,0,0
1/20/2018 20:35,35,69.1,51,64.5,86,66.4,2,0,0
1/20/2018 20:40,42,69.3,58,64.6,100,66.6,2,0,0
1/20/2018 20:45,33,69.5,49,64.9,82,66.7,2,0,0
1/20/2018 20:50,35,69.2,51,64.7,86,66.5,2,0,0
1/20/2018 20:55,26,69,42,64.4,68,66.2,2,0,0
1/20/2018 21:00,33,68.4,49,63.7,82,65.6,2,0,0
1/20/2018 21:05,31,68.9,47,64.3,78,66.1,2,0,0
1/20/2018 21:10,32,69,49,64.4,81,66.2,2,0,0
1/20/2018 21:15,38,69.4,55,64.8,93,66.7,2,0,0
1/20/2018 21:20,34,69.3,51,64.7,85,66.5,2,0,0
1/20/2018 21:25,32,68.8,49,64.1,81,66,2,0,0
1/20/2018 21:30,34,69,50,64.4,84,66.3,2,0,0
1/20/2018 21:35,29,69.4,45,64.8,74,66.6,2,0,0
1/20/2018 21:40,37,69,53,64.4,90,66.3,2,0,0
1/20/2018 21:45,42,69.4,59,64.7,101,66.7,2,0,0
1/20/2018 21:50,34,68.8,51,64.2,85,66.1,2,0,0
1/20/2018 21:55,37,69.2,54,64.6,91,66.5,2,0,0
1/20/2018 22:00,39,69,56,64.4,95,66.3,2,0,0
1/20/2018 22:05,36,69.1,52,64.4,88,66.3,2,0,0
1/20/2018 22:10,38,68.5,54,63.8,92,65.7,2,0,0
1/20/2018 22:15,32,69,47,64.3,79,66.2,2,0,0
1/20/2018 22:20,29,69,45,64.3,74,66.1,2,0,0
1/20/2018 22:25,28,69.2,45,64.6,73,66.4,2,0,0
1/20/2018 22:30,25,69.2,41,64.6,66,66.4,2,0,0
1/20/2018 22:35,28,69.3,44,64.7,72,66.5,2,0,0
1/20/2018 22:40,22,69.2,38,64.6,60,66.3,2,0,0
1/20/2018 22:45,20,69.3,36,64.7,56,66.3,2,0,0
1/20/2018 22:50,23,69.5,39,64.9,62,66.6,2,0,0
1/20/2018 22:55,23,69.5,39,65,62,66.7,2,0,0
1/20/2018 23:00,18,69.2,34,64.6,52,66.2,2,0,0
1/20/2018 23:05,22,69.3,38,64.6,60,66.3,2,0,0
1/20/2018 23:10,20,69.3,35,64.7,55,66.4,2,0,0
1/20/2018 23:15,18,69.4,34,64.8,52,66.4,2,0,0
1/20/2018 23:20,18,69.4,33,64.8,51,66.4,2,0,0
1/20/2018 23:25,18,69.3,34,64.7,52,66.3,2,0,0
1/20/2018 23:30,23,69.4,39,64.7,62,66.5,2,0,0
1/20/2018 23:35,23,69.4,38,64.8,61,66.5,2,0,0
1/20/2018 23:40,18,69.3,33,64.7,51,66.3,2,0,0
1/20/2018 23:45,16,69.5,32,64.9,48,66.4,2,0,0
1/20/2018 23:50,18,69.4,33,64.8,51,66.4,2,0,0
1/20/2018 23:55,18,69.3,34,64.7,52,66.3,2,0,0
1/21/2018 0:00,15,69.3,31,64.7,46,66.2,2,0,0
1/21/2018 0:05,10,69.3,25,64.7,35,66,2,0,0
1/21/2018 0:10,12,69.4,27,64.8,39,66.2,2,0,0
1/21/2018 0:15,11,69.3,27,64.7,38,66,2,0,0
1/21/2018 0:20,10,69.3,25,64.6,35,65.9,2,0,0
1/21/2018 0:25,12,69.4,27,64.8,39,66.2,2,0,0
1/21/2018 0:30,10,69.3,25,64.7,35,66.1,2,0,0
1/21/2018 0:35,13,69.3,28,64.7,41,66.2,2,0,0
1/21/2018 0:40,9,69.2,24,64.5,33,65.8,2,0,0
1/21/2018 0:45,12,69.2,27,64.6,39,66,2,0,0
1/21/2018 0:50,11,69.1,26,64.5,37,65.9,2,0,0
1/21/2018 0:55,11,69.3,26,64.7,37,66,2,0,0
1/21/2018 1:00,11,69.2,27,64.5,38,65.9,2,0,0
1/21/2018 1:05,12,69.2,27,64.6,39,66,2,0,0
1/21/2018 1:10,10,69.3,25,64.7,35,66,2,0,0
1/21/2018 1:15,16,69.5,31,64.9,47,66.5,2,0,0
1/21/2018 1:20,10,69.4,25,64.8,35,66.2,2,0,0
1/21/2018 1:25,11,69.5,26,64.9,37,66.3,2,0,0
1/21/2018 1:30,14,69.4,22,64.8,36,66.6,2,0,0
1/21/2018 1:35,7,69.4,22,64.8,29,66,2,0,0
1/21/2018 1:40,10,69.3,26,64.7,36,66,2,0,0
1/21/2018 1:45,12,69.2,27,64.5,39,66,2,0,0
1/21/2018 1:50,8,69.3,24,64.7,32,65.8,2,0,0
1/21/2018 1:55,17,69.3,23,64.7,40,66.7,2,0,0
1/21/2018 2:00,10,69.3,20,64.7,30,66.2,2,0,0
1/21/2018 2:05,9,69.4,24,64.8,33,66,2,0,0
1/21/2018 2:10,8,69.4,23,64.8,31,66,2,0,0
1/21/2018 2:15,8,69.5,23,64.9,31,66.1,2,0,0
1/21/2018 2:20,9,69.4,24,64.8,33,66.1,2,0,0
1/21/2018 2:25,8,69.5,23,64.9,31,66.1,2,0,0
1/21/2018 2:30,9,69.3,24,64.7,33,66,2,0,0
1/21/2018 2:35,8,69.4,23,64.8,31,66,2,0,0
1/21/2018 2:40,7,69.5,22,64.9,29,66,2,0,0
1/21/2018 2:45,7,69.5,22,64.9,29,66,2,0,0
1/21/2018 2:50,8,69.5,19,64.9,27,66.2,2,0,0
1/21/2018 2:55,8,69.4,23,64.8,31,66,2,0,0
1/21/2018 3:00,14,69.3,22,64.7,36,66.5,2,0,0
1/21/2018 3:05,10,69,25,64.4,35,65.7,2,0,0
1/21/2018 3:10,17,69.2,23,64.5,40,66.5,2,0,0
1/21/2018 3:15,9,69.3,25,64.7,34,65.9,2,0,0
1/21/2018 3:20,8,69.3,23,64.7,31,65.9,2,0,0
1/21/2018 3:25,10,69.3,20,64.7,30,66.3,2,0,0
1/21/2018 3:30,7,69.3,23,64.7,30,65.7,2,0,0
1/21/2018 3:35,5,69.3,21,64.7,26,65.6,2,0,0
1/21/2018 3:40,7,69.4,22,64.8,29,65.9,2,0,0
1/21/2018 3:45,6,69.4,21,64.8,27,65.8,2,0,0
1/21/2018 3:50,10,69.4,20,64.8,30,66.3,2,0,0
1/21/2018 3:55,4,69.4,19,64.8,23,65.6,2,0,0
1/21/2018 4:00,7,69.3,23,64.7,30,65.8,2,0,0
1/21/2018 4:05,4,69.3,19,64.7,23,65.5,2,0,0
1/21/2018 4:10,5,69.3,20,64.7,25,65.7,2,0,0
1/21/2018 4:15,9,69.4,24,64.8,33,66,2,0,0
1/21/2018 4:20,7,69.4,23,64.8,30,65.8,2,0,0
1/21/2018 4:25,9,69.3,24,64.7,33,66,2,0,0
1/21/2018 4:30,9,69.4,25,64.8,34,66,2,0,0
1/21/2018 4:35,10,69.3,25,64.7,35,66,2,0,0
1/21/2018 4:40,11,69.3,26,64.7,37,66.1,2,0,0
1/21/2018 4:45,7,69.4,22,64.8,29,65.9,2,0,0
1/21/2018 4:50,10,69.3,26,64.7,36,65.9,2,0,0
1/21/2018 4:55,7,69.2,22,64.6,29,65.7,2,0,0
1/21/2018 5:00,6,69.2,22,64.6,28,65.6,2,0,0
1/21/2018 5:05,10,69.3,25,64.7,35,66,2,0,0
1/21/2018 5:10,11,69.1,26,64.5,37,65.9,2,0,0
1/21/2018 5:15,11,69.2,27,64.6,38,65.9,2,0,0
1/21/2018 5:20,11,69.2,26,64.6,37,66,2,0,0
1/21/2018 5:25,8,69.3,23,64.7,31,65.8,2,0,0
1/21/2018 5:30,16,69.4,31,64.8,47,66.4,2,0,0
1/21/2018 5:35,12,69.4,28,64.8,40,66.2,2,0,0
1/21/2018 5:40,15,69.2,31,64.6,46,66.1,2,0,0
1/21/2018 5:45,12,69.3,28,64.7,40,66.1,2,0,0
1/21/2018 5:50,11,69.4,27,64.8,38,66.1,2,0,0
1/21/2018 5:55,12,69.4,27,64.8,39,66.2,2,0,0
1/21/2018 6:00,13,69.4,29,64.8,42,66.2,2,0,0
1/21/2018 6:05,13,69,29,64.4,42,65.8,2,0,0
1/21/2018 6:10,11,69.1,27,64.5,38,65.8,2,0,0
1/21/2018 6:15,12,69.3,27,64.7,39,66.1,2,0,0
1/21/2018 6:20,15,69.2,31,64.6,46,66.1,2,0,0
1/21/2018 6:25,18,69.1,34,64.5,52,66.1,2,0,0
1/21/2018 6:30,14,69.1,29,64.5,43,66,2,0,0
1/21/2018 6:35,12,69.2,28,64.6,40,66,2,0,0
1/21/2018 6:40,18,69.4,34,64.8,52,66.4,2,0,0
1/21/2018 6:45,18,69.3,34,64.7,52,66.3,2,0,0
1/21/2018 6:50,16,69.4,32,64.8,48,66.4,2,0,0
1/21/2018 6:55,14,69.3,30,64.7,44,66.2,2,0,0
1/21/2018 7:00,15,69.3,30,64.7,45,66.3,2,0,0
1/21/2018 7:05,17,69.3,32,64.7,49,66.3,2,0,0
1/21/2018 7:10,17,69.3,32,64.7,49,66.3,2,0,0
1/21/2018 7:15,19,69.2,35,64.6,54,66.2,2,0,0
1/21/2018 7:20,17,69.3,33,64.7,50,66.3,2,0,0
1/21/2018 7:25,22,69.3,38,64.7,60,66.3,2,0,0
1/21/2018 7:30,26,69.5,42,64.9,68,66.6,2,0,0
1/21/2018 7:35,22,69.5,38,65,60,66.6,2,0,0
1/21/2018 7:40,29,69.4,44,64.8,73,66.6,2,0,0
1/21/2018 7:45,21,69.4,37,64.8,58,66.5,2,0,0
1/21/2018 7:50,23,69.7,39,65.1,62,66.8,2,0,0
1/21/2018 7:55,28,69.9,44,65.4,72,67.1,2,0,0
1/21/2018 8:00,19,69.5,35,65,54,66.6,2,0,0
1/21/2018 8:05,19,69.3,35,64.7,54,66.4,2,0,0
1/21/2018 8:10,29,69.2,45,64.6,74,66.4,2,0,0
1/21/2018 8:15,27,68.9,43,64.2,70,66,2,0,0
1/21/2018 8:20,31,68.6,47,63.9,78,65.8,2,0,0
1/21/2018 8:25,26,69.1,42,64.5,68,66.3,2,0,0
1/21/2018 8:30,28,69.2,44,64.6,72,66.4,2,0,0
1/21/2018 8:35,27,69.4,42,64.8,69,66.6,2,0,0
1/21/2018 8:40,29,68.9,45,64.3,74,66.1,2,0,0
1/21/2018 8:45,30,68.9,46,64.3,76,66.1,2,0,0
1/21/2018 8:50,34,69,50,64.4,84,66.2,2,0,0
1/21/2018 8:55,29,68.6,45,64,74,65.8,2,0,0
1/21/2018 9:00,34,68.4,51,63.7,85,65.5,2,0,0
1/21/2018 9:05,29,68.8,44,64.2,73,66,2,0,0
1/21/2018 9:10,27,68.7,43,64,70,65.8,2,0,0
1/21/2018 9:15,29,68.3,45,63.7,74,65.5,2,0,0
1/21/2018 9:20,40,68.7,56,64,96,65.9,2,0,0
1/21/2018 9:25,36,68.6,53,63.9,89,65.8,2,0,0
1/21/2018 9:30,39,69.4,56,64.7,95,66.6,2,0,0
1/21/2018 9:35,37,68.9,54,64.3,91,66.2,2,0,0
1/21/2018 9:40,47,69.3,64,64.7,111,66.6,2,0,0
1/21/2018 9:45,43,69.3,60,64.7,103,66.6,2,0,0
1/21/2018 9:50,50,69.5,67,65,117,66.9,2,0,0
1/21/2018 9:55,37,69.2,53,64.6,90,66.5,2,0,0
1/21/2018 10:00,42,69.3,59,64.7,101,66.6,2,0,0
1/21/2018 10:05,45,69.2,62,64.6,107,66.5,2,0,0
1/21/2018 10:10,48,69.7,65,65.1,113,67.1,2,0,0
1/21/2018 10:15,53,69.1,70,64.5,123,66.5,2,0,0
1/21/2018 10:20,44,68.8,61,64.1,105,66.1,2,0,0
1/21/2018 10:25,46,68.4,63,63.8,109,65.7,2,0,0
1/21/2018 10:30,52,69,70,64.3,122,66.3,2,0,0
1/21/2018 10:35,50,68.5,68,63.9,118,65.8,2,0,0
1/21/2018 10:40,46,69.2,64,64.7,110,66.6,2,0,0
1/21/2018 10:45,49,68.9,67,64.2,116,66.2,2,0,0
1/21/2018 10:50,58,69,76,64.3,134,66.3,2,0,0
1/21/2018 10:55,57,68.8,75,64.1,132,66.1,2,0,0
1/21/2018 11:00,50,68.9,67,64.3,117,66.3,2,0,0
1/21/2018 11:05,58,68.7,76,64,134,66.1,2,0,0
1/21/2018 11:10,61,69,79,64.4,140,66.4,2,0,0
1/21/2018 11:15,54,68.9,72,64.2,126,66.2,2,0,0
1/21/2018 11:20,59,68,77,63.2,136,65.3,2,0,0
1/21/2018 11:25,48,68.1,66,63.4,114,65.4,2,0,0
1/21/2018 11:30,52,66.9,70,62,122,64.1,2,0,0
1/21/2018 11:35,50,68,68,63.3,118,65.3,2,0,0
1/21/2018 11:40,53,68.5,72,63.8,125,65.8,2,0,0
1/21/2018 11:45,53,67.9,71,63.1,124,65.2,2,0,0
1/21/2018 11:50,57,69.1,75,64.4,132,66.4,2,0,0
1/21/2018 11:55,58,68.4,76,63.7,134,65.7,2,0,0
1/21/2018 12:00,52,68.2,69,63.5,121,65.5,2,0,0
1/21/2018 12:05,48,68.4,66,63.6,114,65.6,2,0,0
1/21/2018 12:10,54,68.2,70,63.5,124,65.5,2,0,0
1/21/2018 12:15,51,68.8,69,64.2,120,66.1,2,0,0
1/21/2018 12:20,58,68.8,76,64.1,134,66.1,2,0,0
1/21/2018 12:25,47,69.2,64,64.5,111,66.5,2,0,0
1/21/2018 12:30,60,68.8,79,64.2,139,66.2,2,0,0
1/21/2018 12:35,45,68.5,62,63.9,107,65.8,2,0,0
1/21/2018 12:40,51,68.2,69,63.5,120,65.5,2,0,0
1/21/2018 12:45,61,67.7,79,63,140,65.1,2,0,0
1/21/2018 12:50,52,68.3,70,63.7,122,65.7,2,0,0
1/21/2018 12:55,45,67.6,63,62.8,108,64.8,2,0,0
1/21/2018 13:00,49,68.1,67,63.3,116,65.3,2,0,0
1/21/2018 13:05,49,68.4,67,63.6,116,65.6,2,0,0
1/21/2018 13:10,48,68.8,66,64.2,114,66.1,2,0,0
1/21/2018 13:15,47,68.9,63,64.2,110,66.2,2,0,0
1/21/2018 13:20,58,68,75,63.1,133,65.2,2,0,0
1/21/2018 13:25,57,68.5,75,63.7,132,65.8,2,0,0
1/21/2018 13:30,56,68,73,63.3,129,65.3,2,0,0
1/21/2018 13:35,54,67.9,72,63.2,126,65.2,2,0,0
1/21/2018 13:40,57,67.6,75,62.8,132,64.9,2,0,0
1/21/2018 13:45,50,66.8,68,61.9,118,64,2,0,0
1/21/2018 13:50,55,67.2,74,62.3,129,64.4,2,0,0
1/21/2018 13:55,50,67.6,68,62.8,118,64.8,2,0,0
1/21/2018 14:00,48,67.5,65,62.7,113,64.7,2,0,0
1/21/2018 14:05,51,67.5,68,62.7,119,64.7,2,0,0
1/21/2018 14:10,54,66.5,72,61.6,126,63.7,2,0,0
1/21/2018 14:15,53,65.7,70,60.7,123,62.8,2,0,0
1/21/2018 14:20,54,66.6,71,61.7,125,63.8,2,0,0
1/21/2018 14:25,23,66.8,40,61.9,63,63.7,2,0,0
1/21/2018 14:30,85,64.9,107,59.8,192,62.1,2,0,0
1/21/2018 14:35,62,64.7,82,59.6,144,61.8,2,0,0
1/21/2018 14:40,62,63.7,82,58.4,144,60.7,2,0,0
1/21/2018 14:45,49,63.4,68,58.1,117,60.3,2,0,0
1/21/2018 14:50,59,63.5,79,58.1,138,60.4,2,0,0
1/21/2018 14:55,30,64.6,46,59.4,76,61.4,2,0,0
1/21/2018 15:00,77,63.6,98,58.3,175,60.7,2,0,0
1/21/2018 15:05,49,63.9,68,58.7,117,60.9,2,0,0
1/21/2018 15:10,55,63.2,74,57.9,129,60.1,2,0,0
1/21/2018 15:15,77,63.3,98,58,175,60.3,2,0,0
1/21/2018 15:20,54,63,74,57.6,128,59.9,2,0,0
1/21/2018 15:25,71,63.8,92,58.5,163,60.8,2,0,0
1/21/2018 15:30,51,63.1,70,57.8,121,60,2,0,0
1/21/2018 15:35,53,63.8,73,58.5,126,60.7,2,0,0
1/21/2018 15:40,46,61.9,64,56.4,110,58.7,2,0,0
1/21/2018 15:45,73,62.7,96,57.3,169,59.6,2,0,0
1/21/2018 15:50,33,62.5,50,57.1,83,59.2,2,0,0
1/21/2018 15:55,75,62.6,97,57.2,172,59.5,2,0,0
1/21/2018 16:00,53,61.8,73,56.4,126,58.7,2,0,0
1/21/2018 16:05,56,62.6,75,57.2,131,59.5,2,0,0
1/21/2018 16:10,34,65.5,52,60.5,86,62.5,2,0,0
1/21/2018 16:15,72,62.9,93,57.5,165,59.9,2,0,0
1/21/2018 16:20,51,61,70,55.4,121,57.8,2,0,0
1/21/2018 16:25,19,65,34,59.9,53,61.7,2,0,0
1/21/2018 16:30,63,63,84,57.6,147,59.9,2,0,0
1/21/2018 16:35,58,60.5,78,54.9,136,57.3,2,0,0
1/21/2018 16:40,14,64.9,30,59.7,44,61.4,2,0,0
1/21/2018 16:45,6,64.9,18,59.7,24,61,2,0,0
1/21/2018 16:50,27,64.3,45,59.2,72,61.1,2,0,0
1/21/2018 16:55,102,62.7,124,57.3,226,59.7,2,0,0
1/21/2018 17:00,48,65.5,66,60.5,114,62.6,2,0,0
1/21/2018 17:05,41,66.7,58,61.7,99,63.8,2,0,0
1/21/2018 17:10,56,67.3,75,62.4,131,64.5,2,0,0
1/21/2018 17:15,42,67.5,59,62.6,101,64.6,2,0,0
1/21/2018 17:20,58,67.1,76,62.2,134,64.4,2,0,0
1/21/2018 17:25,49,68.4,66,63.6,115,65.6,2,0,0
1/21/2018 17:30,56,66.8,73,62,129,64.1,2,0,0
1/21/2018 17:35,57,67.5,75,62.7,132,64.8,2,0,0
1/21/2018 17:40,53,67.4,71,62.6,124,64.6,2,0,0
1/21/2018 17:45,48,67,65,62.2,113,64.3,2,0,0
1/21/2018 17:50,52,66.5,70,61.6,122,63.7,2,0,0
1/21/2018 17:55,51,67.7,69,62.9,120,64.9,2,0,0
1/21/2018 18:00,54,68.1,72,63.3,126,65.4,2,0,0
1/21/2018 18:05,55,67.9,73,63.2,128,65.2,2,0,0
1/21/2018 18:10,57,67.7,75,62.9,132,65,2,0,0
1/21/2018 18:15,50,67.8,67,63.1,117,65.1,2,0,0
1/21/2018 18:20,57,67.7,75,62.9,132,65,2,0,0
1/21/2018 18:25,53,68.2,71,63.5,124,65.5,2,0,0
1/21/2018 18:30,50,67.9,67,63.2,117,65.2,2,0,0
1/21/2018 18:35,49,68,66,63.2,115,65.2,2,0,0
1/21/2018 18:40,46,67.7,63,62.9,109,65,2,0,0
1/21/2018 18:45,46,68.6,63,63.9,109,65.9,2,0,0
1/21/2018 18:50,47,68.7,66,64,113,65.9,2,0,0
1/21/2018 18:55,48,68.6,65,63.9,113,65.9,2,0,0
1/21/2018 19:00,41,68.4,57,63.7,98,65.6,2,0,0
1/21/2018 19:05,38,68.9,55,64.3,93,66.2,2,0,0
1/21/2018 19:10,38,68.3,55,63.5,93,65.4,2,0,0
1/21/2018 19:15,35,68.6,52,63.9,87,65.8,2,0,0
1/21/2018 19:20,36,68.9,53,64.2,89,66.1,2,0,0
1/21/2018 19:25,42,68.8,59,64.2,101,66.1,2,0,0
1/21/2018 19:30,34,68.4,51,63.6,85,65.5,2,0,0
1/21/2018 19:35,36,68,53,63.3,89,65.2,2,0,0
1/21/2018 19:40,36,68.5,52,63.8,88,65.7,2,0,0
1/21/2018 19:45,31,68.7,48,64,79,65.8,2,0,0
1/21/2018 19:50,31,68.1,48,63.4,79,65.2,2,0,0
1/21/2018 19:55,29,68.5,45,63.9,74,65.7,2,0,0
1/21/2018 20:00,22,68.9,37,64.2,59,66,2,0,0
1/21/2018 20:05,30,68.9,46,64.2,76,66.1,2,0,0
1/21/2018 20:10,35,69.1,51,64.5,86,66.4,2,0,0
1/21/2018 20:15,24,69.1,40,64.5,64,66.2,2,0,0
1/21/2018 20:20,29,68.5,44,63.9,73,65.7,2,0,0
1/21/2018 20:25,26,68.9,42,64.2,68,66,2,0,0
1/21/2018 20:30,29,68.3,45,63.7,74,65.5,2,0,0
1/21/2018 20:35,35,68.6,51,63.9,86,65.8,2,0,0
1/21/2018 20:40,26,68.5,42,63.8,68,65.6,2,0,0
1/21/2018 20:45,28,68.9,45,64.2,73,66,2,0,0
1/21/2018 20:50,32,69,48,64.4,80,66.2,2,0,0
1/21/2018 20:55,28,68.9,44,64.2,72,66.1,2,0,0
1/21/2018 21:00,26,68.9,42,64.3,68,66,2,0,0
1/21/2018 21:05,28,69.1,44,64.4,72,66.2,2,0,0
1/21/2018 21:10,28,69,44,64.3,72,66.1,2,0,0
1/21/2018 21:15,31,69.1,48,64.4,79,66.2,2,0,0
1/21/2018 21:20,25,69.1,41,64.5,66,66.2,2,0,0
1/21/2018 21:25,30,69,47,64.3,77,66.1,2,0,0
1/21/2018 21:30,30,69,46,64.3,76,66.2,2,0,0
1/21/2018 21:35,33,68.9,49,64.2,82,66.1,2,0,0
1/21/2018 21:40,33,69.4,49,64.8,82,66.6,2,0,0
1/21/2018 21:45,21,69.2,37,64.6,58,66.3,2,0,0
1/21/2018 21:50,22,69.3,38,64.7,60,66.4,2,0,0
1/21/2018 21:55,26,68.9,42,64.3,68,66.1,2,0,0
1/21/2018 22:00,23,69,39,64.3,62,66.1,2,0,0
1/21/2018 22:05,21,69,37,64.4,58,66.1,2,0,0
1/21/2018 22:10,19,69,35,64.4,54,66.1,2,0,0
1/21/2018 22:15,19,69.1,34,64.5,53,66.1,2,0,0
1/21/2018 22:20,19,69,35,64.4,54,66,2,0,0
1/21/2018 22:25,19,69.2,35,64.6,54,66.2,2,0,0
1/21/2018 22:30,19,69.2,35,64.5,54,66.2,2,0,0
1/21/2018 22:35,22,69.2,38,64.6,60,66.3,2,0,0
1/21/2018 22:40,17,69.1,33,64.5,50,66.1,2,0,0
1/21/2018 22:45,23,69.1,38,64.5,61,66.2,2,0,0
1/21/2018 22:50,20,69.2,36,64.6,56,66.3,2,0,0
1/21/2018 22:55,17,69.4,32,64.8,49,66.4,2,0,0
1/21/2018 23:00,18,69.2,33,64.6,51,66.2,2,0,0
1/21/2018 23:05,15,69.3,31,64.7,46,66.2,2,0,0
1/21/2018 23:10,15,69.3,31,64.7,46,66.2,2,0,0
1/21/2018 23:15,10,69.3,25,64.7,35,66,2,0,0
1/21/2018 23:20,15,69.3,31,64.7,46,66.2,2,0,0
1/21/2018 23:25,15,69.1,30,64.5,45,66,2,0,0
1/21/2018 23:30,15,69.1,30,64.5,45,66,2,0,0
1/21/2018 23:35,16,69.2,32,64.5,48,66.1,2,0,0
1/21/2018 23:40,14,69,29,64.4,43,65.9,2,0,0
1/21/2018 23:45,15,69.2,30,64.6,45,66.2,2,0,0
1/21/2018 23:50,11,69.2,26,64.6,37,66,2,0,0
1/21/2018 23:55,9,69.2,24,64.6,33,65.8,2,0,0
