5 Minutes,Lane 1 Flow (Veh/5 Minutes),Lane 1 Speed (mph),Lane 2 Flow (Veh/5 Minutes),Lane 2 Speed (mph),Flow (Veh/5 Minutes),Speed (mph),# Lane Points,% Observed,Holiday
1/22/2018 0:00,10,69.3,25,64.7,35,66.1,2,0,0
1/22/2018 0:05,10,69.2,25,64.5,35,65.9,2,0,0
1/22/2018 0:10,11,69.1,26,64.5,37,65.8,2,0,0
1/22/2018 0:15,13,69.2,28,64.6,41,66,2,0,0
1/22/2018 0:20,13,69.2,29,64.6,42,66,2,0,0
1/22/2018 0:25,9,69.2,24,64.5,33,65.8,2,0,0
1/22/2018 0:30,8,69.2,23,64.6,31,65.8,2,0,0
1/22/2018 0:35,7,69,22,64.4,29,65.5,2,0,0
1/22/2018 0:40,8,69.1,23,64.5,31,65.7,2,0,0
1/22/2018 0:45,8,69.1,24,64.5,32,65.7,2,0,0
1/22/2018 0:50,7,69.2,22,64.6,29,65.7,2,0,0
1/22/2018 0:55,9,69.2,24,64.5,33,65.8,2,0,0
1/22/2018 1:00,7,69.1,22,64.5,29,65.6,2,0,0
1/22/2018 1:05,13,69.1,21,64.5,34,66.2,2,0,0
1/22/2018 1:10,7,69.2,22,64.5,29,65.7,2,0,0
1/22/2018 1:15,5,69.2,21,64.5,26,65.4,2,0,0
1/22/2018 1:20,15,69.2,22,64.5,37,66.4,2,0,0
1/22/2018 1:25,10,69.2,20,64.6,30,66.1,2,0,0
1/22/2018 1:30,6,69.2,21,64.6,27,65.6,2,0,0
1/22/2018 1:35,9,68.9,24,64.3,33,65.5,2,0,0
1/22/2018 1:40,12,69,21,64.4,33,66.1,2,0,0
1/22/2018 1:45,5,69.2,21,64.5,26,65.4,2,0,0
1/22/2018 1:50,7,69.2,22,64.5,29,65.7,2,0,0
1/22/2018 1:55,7,69.3,22,64.7,29,65.8,2,0,0
1/22/2018 2:00,5,69.3,20,64.7,25,65.6,2,0,0
1/22/2018 2:05,11,69.3,21,64.7,32,66.3,2,0,0
1/22/2018 2:10,6,69.2,21,64.6,27,65.6,2,0,0
1/22/2018 2:15,6,69,22,64.4,28,65.4,2,0,0
1/22/2018 2:20,5,69.2,21,64.5,26,65.4,2,0,0
1/22/2018 2:25,5,69.3,20,64.7,25,65.6,2,0,0
1/22/2018 2:30,8,69.2,23,64.5,31,65.7,2,0,0
1/22/2018 2:35,9,69,24,64.4,33,65.7,2,0,0
1/22/2018 2:40,8,69.1,23,64.4,31,65.6,2,0,0
1/22/2018 2:45,25,68.4,27,63.8,52,66,2,0,0
1/22/2018 2:50,10,68.8,25,64.1,35,65.5,2,0,0
1/22/2018 2:55,9,68.8,24,64.2,33,65.4,2,0,0
1/22/2018 3:00,10,68.7,25,64,35,65.4,2,0,0
1/22/2018 3:05,11,68.9,27,64.3,38,65.6,2,0,0
1/22/2018 3:10,8,69,23,64.4,31,65.6,2,0,0
1/22/2018 3:15,7,68.9,22,64.3,29,65.4,2,0,0
1/22/2018 3:20,8,69.1,24,64.4,32,65.6,2,0,0
1/22/2018 3:25,7,69.2,22,64.6,29,65.7,2,0,0
1/22/2018 3:30,13,69,29,64.4,42,65.9,2,0,0
1/22/2018 3:35,13,69,28,64.4,41,65.9,2,0,0
1/22/2018 3:40,11,69.1,27,64.4,38,65.8,2,0,0
1/22/2018 3:45,12,69.2,27,64.5,39,66,2,0,0
1/22/2018 3:50,11,69.2,27,64.6,38,66,2,0,0
1/22/2018 3:55,12,69.3,27,64.7,39,66.1,2,0,0
1/22/2018 4:00,15,69.1,31,64.5,46,66,2,0,0
1/22/2018 4:05,18,68.8,33,64.1,51,65.8,2,0,0
1/22/2018 4:10,24,67.2,39,62.4,63,64.2,2,0,0
1/22/2018 4:15,17,67.6,33,62.9,50,64.5,2,0,0
1/22/2018 4:20,21,68,37,63.3,58,65,2,0,0
1/22/2018 4:25,24,68.1,41,63.4,65,65.1,2,0,0
1/22/2018 4:30,32,67.3,50,62.5,82,64.4,2,0,0
1/22/2018 4:35,26,66.9,42,62,68,63.9,2,0,0
1/22/2018 4:40,39,66.2,57,61.2,96,63.2,2,0,0
1/22/2018 4:45,34,66.8,51,61.9,85,63.9,2,0,0
1/22/2018 4:50,39,66.8,56,61.9,95,63.9,2,0,0
1/22/2018 4:55,34,67,52,62.1,86,64,2,0,0
1/22/2018 5:00,35,66.6,52,61.7,87,63.7,2,0,0
1/22/2018 5:05,43,64.8,61,59.7,104,61.8,2,0,0
1/22/2018 5:10,38,63.9,56,58.7,94,60.8,2,0,0
1/22/2018 5:15,43,63.2,61,57.8,104,60,2,0,0
1/22/2018 5:20,50,63.1,68,57.7,118,60,2,0,0
1/22/2018 5:25,50,62.1,69,56.7,119,59,2,0,0
1/22/2018 5:30,43,60.3,62,54.7,105,57,2,0,0
1/22/2018 5:35,51,61.8,71,56.3,122,58.6,2,0,0
1/22/2018 5:40,51,62.1,71,56.6,122,58.9,2,0,0
1/22/2018 5:45,60,61.3,81,55.8,141,58.1,2,0,0
1/22/2018 5:50,59,60.7,80,55.1,139,57.5,2,0,0
1/22/2018 5:55,58,61.4,77,55.8,135,58.2,2,0,0
1/22/2018 6:00,63,61.4,83,55.9,146,58.3,2,0,0
1/22/2018 6:05,62,60.9,82,55.3,144,57.7,2,0,0
1/22/2018 6:10,52,59.4,72,53.6,124,56,2,0,0
1/22/2018 6:15,64,60.1,84,54.4,148,56.9,2,0,0
1/22/2018 6:20,64,60.5,85,55,149,57.4,2,0,0
1/22/2018 6:25,59,61.3,79,55.7,138,58.1,2,0,0
1/22/2018 6:30,64,60.1,86,54.4,150,56.9,2,0,0
1/22/2018 6:35,56,59.3,76,53.5,132,56,2,0,0
1/22/2018 6:40,74,59.8,95,54.2,169,56.6,2,0,0
1/22/2018 6:45,62,61.1,83,55.6,145,57.9,2,0,0
1/22/2018 6:50,69,59.6,90,53.9,159,56.3,2,0,0
1/22/2018 6:55,64,59.1,84,53.3,148,55.8,2,0,0
1/22/2018 7:00,56,59.3,75,53.5,131,56,2,0,0
1/22/2018 7:05,70,60.1,92,54.3,162,56.8,2,0,0
1/22/2018 7:10,69,59.8,91,54,160,56.5,2,0,0
1/22/2018 7:15,72,59.4,95,53.7,167,56.1,2,0,0
1/22/2018 7:20,79,58.2,102,52.3,181,54.9,2,0,0
1/22/2018 7:25,61,60.1,81,54.4,142,56.9,2,0,0
1/22/2018 7:30,84,58.8,106,52.9,190,55.5,2,0,0
1/22/2018 7:35,76,51.7,97,45,173,47.9,2,0,0
1/22/2018 7:40,72,45.4,92,38,164,41.2,2,0,0
1/22/2018 7:45,68,40.4,87,32.4,155,35.9,2,0,0
1/22/2018 7:50,58,35.3,77,26.8,135,30.5,2,0,0
1/22/2018 7:55,62,32.3,81,23.6,143,27.4,2,0,0
1/22/2018 8:00,64,31.1,84,22.3,148,26.1,2,0,0
1/22/2018 8:05,69,31.1,88,22.3,157,26.2,2,0,0
1/22/2018 8:10,69,32.6,89,23.9,158,27.7,2,0,0
1/22/2018 8:15,69,46.1,91,38.9,160,42,2,0,0
1/22/2018 8:20,69,54.9,91,48.7,160,51.4,2,0,0
1/22/2018 8:25,76,59.3,98,53.6,174,56.1,2,0,0
1/22/2018 8:30,79,61,102,55.5,181,57.9,2,0,0
1/22/2018 8:35,84,62.9,108,57.7,192,60,2,0,0
1/22/2018 8:40,73,64.2,95,59.1,168,61.3,2,0,0
1/22/2018 8:45,72,65,95,59.9,167,62.1,2,0,0
1/22/2018 8:50,68,64.2,89,59.1,157,61.3,2,0,0
1/22/2018 8:55,67,65.4,87,60.4,154,62.6,2,0,0
1/22/2018 9:00,71,65.2,92,60.2,163,62.3,2,0,0
1/22/2018 9:05,63,64.9,85,59.8,148,62,2,0,0
1/22/2018 9:10,72,65.6,93,60.6,165,62.8,2,0,0
1/22/2018 9:15,62,66,82,61,144,63.2,2,0,0
1/22/2018 9:20,61,64.9,82,59.8,143,62,2,0,0
1/22/2018 9:25,62,65.2,82,60.2,144,62.3,2,0,0
1/22/2018 9:30,64,66,84,61,148,63.1,2,0,0
1/22/2018 9:35,65,65.6,85,60.7,150,62.8,2,0,0
1/22/2018 9:40,70,65,91,60,161,62.2,2,0,0
1/22/2018 9:45,62,65.5,82,60.5,144,62.7,2,0,0
1/22/2018 9:50,67,66.4,87,61.5,154,63.6,2,0,0
1/22/2018 9:55,60,65,79,60,139,62.2,2,0,0
1/22/2018 10:00,66,64.6,85,59.5,151,61.7,2,0,0
1/22/2018 10:05,66,63.9,86,58.9,152,61.1,2,0,0
1/22/2018 10:10,51,64.9,70,60,121,62.1,2,0,0
1/22/2018 10:15,60,64.1,80,59,140,61.2,2,0,0
1/22/2018 10:20,59,64.6,78,59.6,137,61.7,2,0,0
1/22/2018 10:25,64,65.2,83,60.2,147,62.4,2,0,0
1/22/2018 10:30,54,64.5,72,59.5,126,61.7,2,0,0
1/22/2018 10:35,55,64,74,59,129,61.1,2,0,0
1/22/2018 10:40,60,64.9,78,59.9,138,62,2,0,0
1/22/2018 10:45,52,66.1,70,61.2,122,63.3,2,0,0
1/22/2018 10:50,50,66.3,67,61.4,117,63.5,2,0,0
1/22/2018 10:55,46,66.3,63,61.4,109,63.5,2,0,0
1/22/2018 11:00,45,65.8,63,60.8,108,62.9,2,0,0
1/22/2018 11:05,55,65.3,75,60.3,130,62.5,2,0,0
1/22/2018 11:10,54,66.4,73,61.5,127,63.6,2,0,0
1/22/2018 11:15,54,66.5,72,61.6,126,63.7,2,0,0
1/22/2018 11:20,50,65.6,68,60.8,118,62.8,2,0,0
1/22/2018 11:25,53,65.3,70,60.4,123,62.5,2,0,0
1/22/2018 11:30,50,65.5,68,60.6,118,62.7,2,0,0
1/22/2018 11:35,49,66.1,67,61.2,116,63.3,2,0,0
1/22/2018 11:40,50,67,68,62.1,118,64.2,2,0,0
1/22/2018 11:45,53,65.6,71,60.6,124,62.7,2,0,0
1/22/2018 11:50,53,66.5,70,61.7,123,63.7,2,0,0
1/22/2018 11:55,56,65.5,74,60.5,130,62.7,2,0,0
1/22/2018 12:00,52,65.6,70,60.6,122,62.7,2,0,0
1/22/2018 12:05,42,65.1,59,60,101,62.1,2,0,0
1/22/2018 12:10,46,64.5,64,59.4,110,61.5,2,0,0
1/22/2018 12:15,44,65.5,61,60.4,105,62.6,2,0,0
1/22/2018 12:20,55,65.2,73,60.2,128,62.4,2,0,0
1/22/2018 12:25,54,66.2,72,61.3,126,63.4,2,0,0
1/22/2018 12:30,50,66.1,67,61.2,117,63.3,2,0,0
1/22/2018 12:35,28,66.6,44,61.8,72,63.6,2,0,0
1/22/2018 12:40,47,65.6,65,60.7,112,62.8,2,0,0
1/22/2018 12:45,48,66.3,65,61.4,113,63.5,2,0,0
1/22/2018 12:50,50,66.6,67,61.8,117,63.8,2,0,0
1/22/2018 12:55,48,65,66,60.1,114,62.2,2,0,0
1/22/2018 13:00,50,65.1,68,60.2,118,62.3,2,0,0
1/22/2018 13:05,50,65.7,67,60.8,117,62.9,2,0,0
1/22/2018 13:10,55,65.5,73,60.6,128,62.7,2,0,0
1/22/2018 13:15,45,65.5,61,60.6,106,62.6,2,0,0
1/22/2018 13:20,47,65.7,63,60.8,110,62.9,2,0,0
1/22/2018 13:25,50,65.5,68,60.6,118,62.7,2,0,0
1/22/2018 13:30,52,66,69,61.1,121,63.2,2,0,0
1/22/2018 13:35,40,67,58,62.3,98,64.2,2,0,0
1/22/2018 13:40,41,67.5,58,62.7,99,64.7,2,0,0
1/22/2018 13:45,50,66.9,68,62.1,118,64.1,2,0,0
1/22/2018 13:50,55,66.4,73,61.5,128,63.6,2,0,0
1/22/2018 13:55,44,65,61,60,105,62.1,2,0,0
1/22/2018 14:00,43,64.5,60,59.6,103,61.7,2,0,0
1/22/2018 14:05,50,64.4,68,59.4,118,61.5,2,0,0
1/22/2018 14:10,41,65.5,57,60.6,98,62.7,2,0,0
1/22/2018 14:15,53,65.9,70,61,123,63.1,2,0,0
1/22/2018 14:20,44,64.1,62,59,106,61.1,2,0,0
1/22/2018 14:25,51,64.8,68,59.9,119,62,2,0,0
1/22/2018 14:30,46,66.1,63,61.3,109,63.3,2,0,0
1/22/2018 14:35,47,65.7,64,60.8,111,62.9,2,0,0
1/22/2018 14:40,47,66.1,64,61.2,111,63.3,2,0,0
1/22/2018 14:45,48,66.9,66,62.1,114,64.1,2,0,0
1/22/2018 14:50,47,67.1,64,62.3,111,64.3,2,0,0
1/22/2018 14:55,42,67.7,60,62.9,102,64.9,2,0,0
1/22/2018 15:00,50,66.9,68,62.1,118,64.1,2,0,0
1/22/2018 15:05,46,66,64,61.1,110,63.1,2,0,0
1/22/2018 15:10,45,65.9,63,61,108,63,2,0,0
1/22/2018 15:15,46,66.6,63,61.8,109,63.8,2,0,0
1/22/2018 15:20,49,66.8,67,62,116,64,2,0,0
1/22/2018 15:25,55,66,73,61.2,128,63.2,2,0,0
1/22/2018 15:30,49,66.3,67,61.4,116,63.5,2,0,0
1/22/2018 15:35,45,66.2,63,61.3,108,63.3,2,0,0
1/22/2018 15:40,44,66.1,63,61.1,107,63.2,2,0,0
1/22/2018 15:45,52,66.7,70,61.8,122,63.8,2,0,0
1/22/2018 15:50,46,66.7,63,61.9,109,63.9,2,0,0
1/22/2018 15:55,53,66.8,71,62,124,64.1,2,0,0
1/22/2018 16:00,44,67.4,62,62.5,106,64.5,2,0,0
1/22/2018 16:05,45,66.7,62,61.8,107,63.9,2,0,0
1/22/2018 16:10,48,66.9,66,62,114,64.1,2,0,0
1/22/2018 16:15,57,67.2,76,62.4,133,64.5,2,0,0
1/22/2018 16:20,50,66.5,68,61.5,118,63.6,2,0,0
1/22/2018 16:25,55,66,73,61,128,63.1,2,0,0
1/22/2018 16:30,46,67.2,63,62.3,109,64.3,2,0,0
1/22/2018 16:35,43,67.1,60,62.3,103,64.3,2,0,0
1/22/2018 16:40,44,67.3,62,62.5,106,64.5,2,0,0
1/22/2018 16:45,51,67.7,68,62.9,119,64.9,2,0,0
1/22/2018 16:50,44,67.5,62,62.6,106,64.6,2,0,0
1/22/2018 16:55,49,66.8,67,61.9,116,64,2,0,0
1/22/2018 17:00,43,67.6,60,62.7,103,64.8,2,0,0
1/22/2018 17:05,44,67.3,62,62.5,106,64.5,2,0,0
1/22/2018 17:10,53,66.7,72,62,125,64,2,0,0
1/22/2018 17:15,42,67.9,59,63.2,101,65.1,2,0,0
1/22/2018 17:20,49,66.2,67,61.2,116,63.3,2,0,0
1/22/2018 17:25,48,66.8,65,61.9,113,63.9,2,0,0
1/22/2018 17:30,46,68,63,63.2,109,65.2,2,0,0
1/22/2018 17:35,40,66.3,57,61.4,97,63.4,2,0,0
1/22/2018 17:40,50,65.5,67,60.4,117,62.6,2,0,0
1/22/2018 17:45,43,67.4,61,62.5,104,64.5,2,0,0
1/22/2018 17:50,51,67.6,68,62.8,119,64.9,2,0,0
1/22/2018 17:55,54,67.8,72,63,126,65,2,0,0
1/22/2018 18:00,45,66.6,63,61.7,108,63.8,2,0,0
1/22/2018 18:05,43,67.3,60,62.4,103,64.4,2,0,0
1/22/2018 18:10,52,66.8,69,61.9,121,64,2,0,0
1/22/2018 18:15,48,66.5,67,61.6,115,63.6,2,0,0
1/22/2018 18:20,44,67.2,61,62.4,105,64.4,2,0,0
1/22/2018 18:25,38,67.6,55,62.8,93,64.7,2,0,0
1/22/2018 18:30,41,68,58,63.3,99,65.2,2,0,0
1/22/2018 18:35,36,68.5,53,63.8,89,65.7,2,0,0
1/22/2018 18:40,40,68.7,57,64,97,65.9,2,0,0
1/22/2018 18:45,38,67.9,55,63.2,93,65.1,2,0,0
1/22/2018 18:50,37,67.1,54,62.2,91,64.2,2,0,0
1/22/2018 18:55,42,67.5,59,62.7,101,64.7,2,0,0
1/22/2018 19:00,37,65.5,54,60.6,91,62.6,2,0,0
1/22/2018 19:05,40,66.5,57,61.6,97,63.7,2,0,0
1/22/2018 19:10,44,67.2,62,62.4,106,64.4,2,0,0
1/22/2018 19:15,39,67.9,55,63.2,94,65.2,2,0,0
1/22/2018 19:20,39,67.7,56,62.9,95,64.9,2,0,0
1/22/2018 19:25,38,67.8,55,63,93,65,2,0,0
1/22/2018 19:30,41,66.2,58,61.3,99,63.3,2,0,0
1/22/2018 19:35,31,68,49,63.3,80,65.1,2,0,0
1/22/2018 19:40,36,68.1,52,63.4,88,65.4,2,0,0
1/22/2018 19:45,36,68.3,52,63.6,88,65.5,2,0,0
1/22/2018 19:50,29,69.1,46,64.5,75,66.3,2,0,0
1/22/2018 19:55,38,68.7,54,64.1,92,66,2,0,0
1/22/2018 20:00,31,69.1,47,64.5,78,66.3,2,0,0
1/22/2018 20:05,29,68,44,63.4,73,65.2,2,0,0
1/22/2018 20:10,29,68.9,45,64.3,74,66.1,2,0,0
1/22/2018 20:15,26,69.4,42,64.8,68,66.6,2,0,0
1/22/2018 20:20,32,69.6,50,65.1,82,66.8,2,0,0
1/22/2018 20:25,28,69.3,44,64.7,72,66.5,2,0,0
1/22/2018 20:30,33,68.1,49,63.3,82,65.2,2,0,0
1/22/2018 20:35,27,68.3,43,63.6,70,65.4,2,0,0
1/22/2018 20:40,33,68.4,49,63.7,82,65.6,2,0,0
1/22/2018 20:45,27,67.8,44,63.1,71,64.9,2,0,0
1/22/2018 20:50,28,68.8,45,64.2,73,66,2,0,0
1/22/2018 20:55,30,69.2,46,64.6,76,66.4,2,0,0
1/22/2018 21:00,23,68.4,39,63.7,62,65.5,2,0,0
1/22/2018 21:05,26,68.7,42,64,68,65.8,2,0,0
1/22/2018 21:10,28,68.4,44,63.7,72,65.5,2,0,0
1/22/2018 21:15,26,68.2,42,63.5,68,65.3,2,0,0
1/22/2018 21:20,26,68.2,42,63.5,68,65.3,2,0,0
1/22/2018 21:25,21,68.8,37,64.2,58,65.9,2,0,0
1/22/2018 21:30,21,69.1,37,64.5,58,66.2,2,0,0
1/22/2018 21:35,23,69.3,39,64.7,62,66.4,2,0,0
1/22/2018 21:40,18,69,34,64.4,52,66,2,0,0
1/22/2018 21:45,22,69.3,38,64.7,60,66.4,2,0,0
1/22/2018 21:50,27,69.4,43,64.8,70,66.5,2,0,0
1/22/2018 21:55,20,69.1,36,64.5,56,66.2,2,0,0
1/22/2018 22:00,17,69.2,33,64.5,50,66.1,2,0,0
1/22/2018 22:05,22,69.2,38,64.6,60,66.3,2,0,0
1/22/2018 22:10,22,69.2,38,64.6,60,66.3,2,0,0
1/22/2018 22:15,22,69.1,39,64.5,61,66.1,2,0,0
1/22/2018 22:20,23,69.2,38,64.6,61,66.3,2,0,0
1/22/2018 22:25,19,69.3,34,64.7,53,66.3,2,0,0
1/22/2018 22:30,20,69.3,36,64.7,56,66.3,2,0,0
1/22/2018 22:35,20,69.1,36,64.5,56,66.1,2,0,0
1/22/2018 22:40,13,69.2,28,64.6,41,66.1,2,0,0
1/22/2018 22:45,17,68.7,32,64,49,65.7,2,0,0
1/22/2018 22:50,14,68.9,30,64.3,44,65.7,2,0,0
1/22/2018 22:55,16,69.3,32,64.7,48,66.2,2,0,0
1/22/2018 23:00,15,69.3,30,64.7,45,66.2,2,0,0
1/22/2018 23:05,10,69.3,25,64.7,35,66.1,2,0,0
1/22/2018 23:10,14,69.2,29,64.6,43,66.1,2,0,0
1/22/2018 23:15,14,68.9,29,64.2,43,65.7,2,0,0
1/22/2018 23:20,12,69.1,28,64.4,40,65.8,2,0,0
1/22/2018 23:25,14,68.8,30,64.1,44,65.6,2,0,0
1/22/2018 23:30,12,69,28,64.4,40,65.8,2,0,0
1/22/2018 23:35,16,69.3,32,64.7,48,66.2,2,0,0
1/22/2018 23:40,12,69.3,27,64.7,39,66.1,2,0,0
1/22/2018 23:45,10,69.3,26,64.7,36,66,2,0,0
1/22/2018 23:50,13,69.3,29,64.7,42,66.1,2,0,0
1/22/2018 23:55,12,69.3,28,64.7,40,66,2,0,0
1/23/2018 0:00,9,69.3,24,64.7,33,66,2,0,0
1/23/2018 0:05,9,69.3,24,64.7,33,65.9,2,0,0
1/23/2018 0:10,8,68.9,24,64.3,32,65.5,2,0,0
1/23/2018 0:15,10,69.2,25,64.5,35,65.9,2,0,0
1/23/2018 0:20,6,69.3,21,64.7,27,65.7,2,0,0
1/23/2018 0:25,9,69.2,24,64.5,33,65.8,2,0,0
1/23/2018 0:30,9,69.1,24,64.5,33,65.8,2,0,0
1/23/2018 0:35,7,69.2,22,64.6,29,65.7,2,0,0
1/23/2018 0:40,7,69.2,22,64.6,29,65.7,2,0,0
1/23/2018 0:45,7,69.1,22,64.4,29,65.6,2,0,0
1/23/2018 0:50,5,69.2,21,64.6,26,65.5,2,0,0
1/23/2018 0:55,5,69.3,21,64.7,26,65.5,2,0,0
1/23/2018 1:00,9,69.2,24,64.6,33,65.8,2,0,0
1/23/2018 1:05,6,69.3,21,64.7,27,65.7,2,0,0
1/23/2018 1:10,5,69.2,20,64.6,25,65.5,2,0,0
1/23/2018 1:15,4,69.3,19,64.7,23,65.5,2,0,0
1/23/2018 1:20,6,69.3,21,64.7,27,65.7,2,0,0
1/23/2018 1:25,5,69.1,21,64.5,26,65.4,2,0,0
1/23/2018 1:30,8,69.2,24,64.6,32,65.8,2,0,0
1/23/2018 1:35,11,69.3,27,64.7,38,66,2,0,0
1/23/2018 1:40,6,69,21,64.4,27,65.5,2,0,0
1/23/2018 1:45,6,69,21,64.4,27,65.4,2,0,0
1/23/2018 1:50,4,69.3,20,64.7,24,65.4,2,0,0
1/23/2018 1:55,8,69.1,23,64.5,31,65.7,2,0,0
1/23/2018 2:00,11,69.2,21,64.6,32,66.2,2,0,0
1/23/2018 2:05,8,69.3,24,64.7,32,65.8,2,0,0
1/23/2018 2:10,7,69.2,22,64.6,29,65.7,2,0,0
1/23/2018 2:15,5,69.2,20,64.6,25,65.5,2,0,0
1/23/2018 2:20,5,69.4,21,64.8,26,65.7,2,0,0
1/23/2018 2:25,7,69.4,22,64.8,29,65.9,2,0,0
1/23/2018 2:30,13,69.4,21,64.8,34,66.6,2,0,0
1/23/2018 2:35,6,69.3,21,64.7,27,65.8,2,0,0
1/23/2018 2:40,10,69.3,25,64.7,35,66.1,2,0,0
1/23/2018 2:45,10,69.1,25,64.4,35,65.8,2,0,0
1/23/2018 2:50,7,69,23,64.4,30,65.5,2,0,0
1/23/2018 2:55,7,69.3,22,64.7,29,65.8,2,0,0
1/23/2018 3:00,9,69.2,25,64.6,34,65.8,2,0,0
1/23/2018 3:05,10,69.1,25,64.4,35,65.8,2,0,0
1/23/2018 3:10,9,69.2,26,64.6,35,65.8,2,0,0
1/23/2018 3:15,11,69.3,27,64.7,38,66,2,0,0
1/23/2018 3:20,8,69.3,23,64.7,31,65.9,2,0,0
1/23/2018 3:25,12,69,28,64.4,40,65.8,2,0,0
1/23/2018 3:30,11,69.3,27,64.7,38,66,2,0,0
1/23/2018 3:35,15,69.3,30,64.7,45,66.2,2,0,0
1/23/2018 3:40,11,69.3,26,64.7,37,66.1,2,0,0
1/23/2018 3:45,13,69.5,29,64.9,42,66.3,2,0,0
1/23/2018 3:50,14,69.5,30,64.9,44,66.4,2,0,0
1/23/2018 3:55,14,69.4,30,64.8,44,66.3,2,0,0
1/23/2018 4:00,13,69.5,29,64.9,42,66.3,2,0,0
1/23/2018 4:05,20,69.5,36,64.9,56,66.5,2,0,0
1/23/2018 4:10,20,69.4,37,64.8,57,66.4,2,0,0
1/23/2018 4:15,19,69.5,35,64.9,54,66.5,2,0,0
1/23/2018 4:20,25,69.6,42,65,67,66.7,2,0,0
1/23/2018 4:25,28,69.9,45,65.3,73,67.1,2,0,0
1/23/2018 4:30,25,69.4,42,64.8,67,66.5,2,0,0
1/23/2018 4:35,32,68.7,50,64.1,82,65.9,2,0,0
1/23/2018 4:40,35,69.8,52,65.3,87,67.1,2,0,0
1/23/2018 4:45,36,69.1,55,64.5,91,66.3,2,0,0
1/23/2018 4:50,31,69.2,48,64.6,79,66.4,2,0,0
1/23/2018 4:55,41,69.7,59,65.1,100,67,2,0,0
1/23/2018 5:00,42,69.3,61,64.7,103,66.5,2,0,0
1/23/2018 5:05,40,69.6,59,65,99,66.8,2,0,0
1/23/2018 5:10,46,69.6,65,65,111,66.9,2,0,0
1/23/2018 5:15,43,70.5,62,65.9,105,67.8,2,0,0
1/23/2018 5:20,55,70.2,76,65.6,131,67.5,2,0,0
1/23/2018 5:25,47,68.8,67,64.1,114,66,2,0,0
1/23/2018 5:30,54,68.3,75,63.6,129,65.6,2,0,0
1/23/2018 5:35,60,68.5,82,63.9,142,65.9,2,0,0
1/23/2018 5:40,67,69.1,88,64.5,155,66.5,2,0,0
1/23/2018 5:45,56,69.6,77,65,133,67,2,0,0
1/23/2018 5:50,73,69.9,94,65.4,167,67.4,2,0,0
1/23/2018 5:55,57,69.1,78,64.5,135,66.5,2,0,0
1/23/2018 6:00,58,68.4,79,63.6,137,65.6,2,0,0
1/23/2018 6:05,43,69.2,63,64.6,106,66.4,2,0,0
1/23/2018 6:10,59,68.4,80,63.6,139,65.6,2,0,0
1/23/2018 6:15,55,68.2,76,63.4,131,65.4,2,0,0
1/23/2018 6:20,49,68.8,68,64.1,117,66.1,2,0,0
1/23/2018 6:25,48,69.2,68,64.5,116,66.4,2,0,0
1/23/2018 6:30,48,68.8,67,64,115,66,2,0,0
1/23/2018 6:35,42,68.8,61,64,103,66,2,0,0
1/23/2018 6:40,44,67.6,63,62.8,107,64.8,2,0,0
1/23/2018 6:45,50,68.4,70,63.7,120,65.7,2,0,0
1/23/2018 6:50,48,69.4,66,64.7,114,66.7,2,0,0
1/23/2018 6:55,46,69,66,64.3,112,66.3,2,0,0
1/23/2018 7:00,40,69.7,58,65.1,98,67,2,0,0
1/23/2018 7:05,48,69.6,68,64.9,116,66.8,2,0,0
1/23/2018 7:10,42,69.2,62,64.5,104,66.4,2,0,0
1/23/2018 7:15,55,67.5,75,62.7,130,64.7,2,0,0
1/23/2018 7:20,51,68.4,70,63.7,121,65.7,2,0,0
1/23/2018 7:25,46,68.7,64,63.9,110,65.9,2,0,0
1/23/2018 7:30,52,68.7,71,64,123,66,2,0,0
1/23/2018 7:35,58,69.7,78,65.1,136,67.1,2,0,0
1/23/2018 7:40,60,68.3,80,63.6,140,65.6,2,0,0
1/23/2018 7:45,80,68.8,102,64.1,182,66.2,2,0,0
1/23/2018 7:50,60,69.1,80,64.4,140,66.4,2,0,0
1/23/2018 7:55,71,70.3,93,65.7,164,67.7,2,0,0
1/23/2018 8:00,72,70.7,95,66.1,167,68.1,2,0,0
1/23/2018 8:05,81,68.4,104,63.6,185,65.7,2,0,0
1/23/2018 8:10,83,67.2,107,62.3,190,64.4,2,0,0
1/23/2018 8:15,79,67.4,101,62.5,180,64.7,2,0,0
1/23/2018 8:20,86,68.5,109,63.7,195,65.8,2,0,0
1/23/2018 8:25,72,69.2,94,64.4,166,66.5,2,0,0
1/23/2018 8:30,72,68.6,93,63.8,165,65.9,2,0,0
1/23/2018 8:35,80,67.7,102,62.9,182,65,2,0,0
1/23/2018 8:40,86,68.2,109,63.4,195,65.5,2,0,0
1/23/2018 8:45,85,69,107,64.3,192,66.4,2,0,0
1/23/2018 8:50,94,68,118,63.1,212,65.3,2,0,0
1/23/2018 8:55,91,67.2,115,62.3,206,64.4,2,0,0
1/23/2018 9:00,91,67.6,113,62.7,204,64.9,2,0,0
1/23/2018 9:05,91,66.6,113,61.7,204,63.8,2,0,0
1/23/2018 9:10,86,66.2,108,61.2,194,63.4,2,0,0
1/23/2018 9:15,79,66.2,99,61.2,178,63.5,2,0,0
1/23/2018 9:20,84,65.8,107,60.8,191,63,2,0,0
1/23/2018 9:25,85,65,106,60,191,62.2,2,0,0
1/23/2018 9:30,81,65.2,102,60.2,183,62.4,2,0,0
1/23/2018 9:35,77,64.6,98,59.5,175,61.8,2,0,0
1/23/2018 9:40,79,65,99,60,178,62.2,2,0,0
1/23/2018 9:45,73,65.2,94,60.3,167,62.5,2,0,0
1/23/2018 9:50,79,64.9,100,59.9,179,62.1,2,0,0
1/23/2018 9:55,74,65.4,95,60.5,169,62.7,2,0,0
1/23/2018 10:00,72,66.4,92,61.6,164,63.7,2,0,0
1/23/2018 10:05,67,66.3,87,61.4,154,63.5,2,0,0
1/23/2018 10:10,66,66.6,86,61.8,152,63.9,2,0,0
1/23/2018 10:15,66,66.9,86,62,152,64.1,2,0,0
1/23/2018 10:20,72,67,91,62.2,163,64.3,2,0,0
1/23/2018 10:25,67,68.1,87,63.4,154,65.5,2,0,0
1/23/2018 10:30,63,67.9,82,63.2,145,65.2,2,0,0
1/23/2018 10:35,62,67.2,81,62.4,143,64.5,2,0,0
1/23/2018 10:40,64,67.8,84,63,148,65.1,2,0,0
1/23/2018 10:45,68,66.7,88,61.9,156,64,2,0,0
1/23/2018 10:50,67,66.8,87,62,154,64.1,2,0,0
1/23/2018 10:55,60,66.6,78,61.9,138,63.9,2,0,0
1/23/2018 11:00,57,51.4,76,44.8,133,47.6,2,0,0
1/23/2018 11:05,54,43.9,72,36.6,126,39.7,2,0,0
1/23/2018 11:10,53,51,71,44.4,124,47.3,2,0,0
1/23/2018 11:15,50,58.7,68,53,118,55.4,2,0,0
1/23/2018 11:20,53,63.7,72,58.5,125,60.7,2,0,0
1/23/2018 11:25,48,66.6,66,61.6,114,63.7,2,0,0
1/23/2018 11:30,48,68.5,66,63.8,114,65.8,2,0,0
1/23/2018 11:35,50,68.8,68,64.1,118,66.1,2,0,0
1/23/2018 11:40,47,67.6,64,62.8,111,64.8,2,0,0
1/23/2018 11:45,48,67.9,66,63.2,114,65.1,2,0,0
1/23/2018 11:50,58,68.9,77,64.3,135,66.3,2,0,0
1/23/2018 11:55,53,69.3,70,64.7,123,66.7,2,0,0
1/23/2018 12:00,46,69.1,64,64.5,110,66.4,2,0,0
1/23/2018 12:05,47,69.5,64,64.9,111,66.9,2,0,0
1/23/2018 12:10,49,69.5,66,64.9,115,66.8,2,0,0
1/23/2018 12:15,49,68,66,63.3,115,65.3,2,0,0
1/23/2018 12:20,48,70,65,65.4,113,67.4,2,0,0
1/23/2018 12:25,51,69.8,69,65.2,120,67.1,2,0,0
1/23/2018 12:30,49,69.1,67,64.5,116,66.4,2,0,0
1/23/2018 12:35,46,66.2,64,61.4,110,63.4,2,0,0
1/23/2018 12:40,39,66.6,56,61.9,95,63.8,2,0,0
1/23/2018 12:45,47,67.3,64,62.6,111,64.6,2,0,0
1/23/2018 12:50,37,68.8,54,64.2,91,66,2,0,0
1/23/2018 12:55,49,68.2,66,63.5,115,65.5,2,0,0
1/23/2018 13:00,39,69.4,56,64.9,95,66.7,2,0,0
1/23/2018 13:05,43,70,60,65.5,103,67.4,2,0,0
1/23/2018 13:10,37,70.2,55,65.7,92,67.5,2,0,0
1/23/2018 13:15,42,70.3,60,65.8,102,67.7,2,0,0
1/23/2018 13:20,45,67.8,63,63.1,108,65.1,2,0,0
1/23/2018 13:25,43,68.7,60,64,103,66,2,0,0
1/23/2018 13:30,46,68.2,64,63.6,110,65.5,2,0,0
1/23/2018 13:35,49,68.5,67,63.8,116,65.8,2,0,0
1/23/2018 13:40,53,70.1,71,65.6,124,67.5,2,0,0
1/23/2018 13:45,49,70,67,65.6,116,67.5,2,0,0
1/23/2018 13:50,48,70,65,65.5,113,67.4,2,0,0
1/23/2018 13:55,50,69.2,68,64.7,118,66.6,2,0,0
1/23/2018 14:00,54,69.4,72,64.9,126,66.8,2,0,0
1/23/2018 14:05,49,69.6,66,65.1,115,67,2,0,0
1/23/2018 14:10,50,69,67,64.3,117,66.3,2,0,0
1/23/2018 14:15,45,69.7,62,65.2,107,67.1,2,0,0
1/23/2018 14:20,58,69.2,76,64.6,134,66.6,2,0,0
1/23/2018 14:25,60,69,78,64.3,138,66.3,2,0,0
1/23/2018 14:30,49,68.8,67,64.1,116,66.1,2,0,0
1/23/2018 14:35,44,68.3,62,63.6,106,65.6,2,0,0
1/23/2018 14:40,41,69.3,58,64.7,99,66.6,2,0,0
1/23/2018 14:45,54,69.5,72,65,126,66.9,2,0,0
1/23/2018 14:50,51,69.2,69,64.6,120,66.6,2,0,0
1/23/2018 14:55,50,68.9,68,64.1,118,66.1,2,0,0
1/23/2018 15:00,58,68.9,77,64.3,135,66.3,2,0,0
1/23/2018 15:05,42,69.3,60,64.8,102,66.6,2,0,0
1/23/2018 15:10,51,69.7,68,65.2,119,67.1,2,0,0
1/23/2018 15:15,55,69.5,74,65,129,66.9,2,0,0
1/23/2018 15:20,55,70.5,73,66.1,128,68,2,0,0
1/23/2018 15:25,45,70.6,63,66.2,108,68,2,0,0
1/23/2018 15:30,53,69,71,64.4,124,66.4,2,0,0
1/23/2018 15:35,55,69.1,73,64.5,128,66.4,2,0,0
1/23/2018 15:40,59,68.6,78,63.9,137,65.9,2,0,0
1/23/2018 15:45,59,69.4,77,64.8,136,66.8,2,0,0
1/23/2018 15:50,49,69,66,64.3,115,66.3,2,0,0
1/23/2018 15:55,55,69.4,74,64.8,129,66.8,2,0,0
1/23/2018 16:00,53,68.7,72,64.1,125,66,2,0,0
1/23/2018 16:05,54,69.9,72,65.4,126,67.3,2,0,0
1/23/2018 16:10,52,69.7,70,65.2,122,67.1,2,0,0
1/23/2018 16:15,61,69.2,80,64.7,141,66.6,2,0,0
1/23/2018 16:20,51,69.1,68,64.5,119,66.5,2,0,0
1/23/2018 16:25,54,69.4,73,64.8,127,66.7,2,0,0
1/23/2018 16:30,62,69.3,80,64.7,142,66.7,2,0,0
1/23/2018 16:35,56,69.6,75,65,131,67,2,0,0
1/23/2018 16:40,56,70.3,73,65.7,129,67.7,2,0,0
1/23/2018 16:45,54,69.9,71,65.3,125,67.3,2,0,0
1/23/2018 16:50,58,67.9,77,63.1,135,65.1,2,0,0
1/23/2018 16:55,55,68.2,73,63.3,128,65.4,2,0,0
1/23/2018 17:00,56,68.6,74,63.9,130,65.9,2,0,0
1/23/2018 17:05,47,69,64,64.3,111,66.3,2,0,0
1/23/2018 17:10,58,69.6,77,65,135,67,2,0,0
1/23/2018 17:15,54,70.2,73,65.7,127,67.6,2,0,0
1/23/2018 17:20,53,70,71,65.4,124,67.3,2,0,0
1/23/2018 17:25,47,70.3,65,65.7,112,67.6,2,0,0
1/23/2018 17:30,56,69.2,75,64.5,131,66.5,2,0,0
1/23/2018 17:35,59,67.4,78,62.5,137,64.7,2,0,0
1/23/2018 17:40,42,64.7,60,59.4,102,61.6,2,0,0
1/23/2018 17:45,52,65.8,70,60.6,122,62.8,2,0,0
1/23/2018 17:50,49,66.2,67,61.1,116,63.3,2,0,0
1/23/2018 17:55,59,66.4,79,61.4,138,63.5,2,0,0
1/23/2018 18:00,61,66.5,81,61.4,142,63.6,2,0,0
1/23/2018 18:05,53,67.2,72,62.3,125,64.4,2,0,0
1/23/2018 18:10,52,66.4,70,61.4,122,63.5,2,0,0
1/23/2018 18:15,62,66.6,80,61.6,142,63.8,2,0,0
1/23/2018 18:20,51,67,68,62.1,119,64.2,2,0,0
1/23/2018 18:25,54,66.5,72,61.6,126,63.7,2,0,0
1/23/2018 18:30,48,67.8,65,63,113,65,2,0,0
1/23/2018 18:35,52,67.3,70,62.4,122,64.5,2,0,0
1/23/2018 18:40,58,67.8,75,63,133,65.1,2,0,0
1/23/2018 18:45,55,67.8,73,63,128,65,2,0,0
1/23/2018 18:50,51,68.6,68,63.9,119,65.9,2,0,0
1/23/2018 18:55,47,70,64,65.4,111,67.3,2,0,0
1/23/2018 19:00,39,69,56,64.3,95,66.2,2,0,0
1/23/2018 19:05,44,68.6,61,63.8,105,65.8,2,0,0
1/23/2018 19:10,50,68.8,68,64.1,118,66.1,2,0,0
1/23/2018 19:15,46,68.7,64,64,110,66,2,0,0
1/23/2018 19:20,46,68.2,63,63.4,109,65.4,2,0,0
1/23/2018 19:25,43,68.4,60,63.6,103,65.6,2,0,0
1/23/2018 19:30,42,67.4,59,62.6,101,64.6,2,0,0
1/23/2018 19:35,39,67.5,56,62.7,95,64.7,2,0,0
1/23/2018 19:40,37,69.1,53,64.5,90,66.4,2,0,0
1/23/2018 19:45,30,69.2,45,64.5,75,66.3,2,0,0
1/23/2018 19:50,35,69.7,51,65,86,66.9,2,0,0
1/23/2018 19:55,37,69,54,64.3,91,66.2,2,0,0
1/23/2018 20:00,28,68.8,45,64.1,73,65.9,2,0,0
1/23/2018 20:05,33,68.8,50,64.1,83,66,2,0,0
1/23/2018 20:10,32,68.4,48,63.7,80,65.6,2,0,0
1/23/2018 20:15,30,68.7,46,64,76,65.8,2,0,0
1/23/2018 20:20,32,68.5,48,63.9,80,65.7,2,0,0
1/23/2018 20:25,31,68.4,48,63.7,79,65.6,2,0,0
1/23/2018 20:30,29,68.6,45,63.9,74,65.7,2,0,0
1/23/2018 20:35,30,69,46,64.4,76,66.2,2,0,0
1/23/2018 20:40,28,69.4,45,64.8,73,66.6,2,0,0
1/23/2018 20:45,29,69.3,45,64.7,74,66.5,2,0,0
1/23/2018 20:50,27,69.3,43,64.6,70,66.4,2,0,0
1/23/2018 20:55,29,69.4,45,64.8,74,66.6,2,0,0
1/23/2018 21:00,21,69.3,37,64.7,58,66.4,2,0,0
1/23/2018 21:05,28,69,44,64.3,72,66.1,2,0,0
1/23/2018 21:10,30,68.8,46,64.1,76,66,2,0,0
1/23/2018 21:15,33,68.8,49,64.2,82,66.1,2,0,0
1/23/2018 21:20,29,68.4,46,63.7,75,65.5,2,0,0
1/23/2018 21:25,28,69,44,64.4,72,66.2,2,0,0
1/23/2018 21:30,27,68.9,44,64.3,71,66,2,0,0
1/23/2018 21:35,27,68.9,43,64.2,70,66,2,0,0
1/23/2018 21:40,24,68.7,40,64.1,64,65.8,2,0,0
1/23/2018 21:45,28,68.6,44,64,72,65.8,2,0,0
1/23/2018 21:50,22,69.1,38,64.5,60,66.2,2,0,0
1/23/2018 21:55,30,68.7,47,64,77,65.8,2,0,0
1/23/2018 22:00,28,68.4,43,63.7,71,65.6,2,0,0
1/23/2018 22:05,20,68.8,35,64.2,55,65.9,2,0,0
1/23/2018 22:10,20,69.1,36,64.4,56,66.1,2,0,0
1/23/2018 22:15,24,69,40,64.4,64,66.1,2,0,0
1/23/2018 22:20,23,69,38,64.4,61,66.1,2,0,0
1/23/2018 22:25,19,69.2,35,64.6,54,66.2,2,0,0
1/23/2018 22:30,14,69.2,30,64.6,44,66.1,2,0,0
1/23/2018 22:35,21,69.4,37,64.7,58,66.4,2,0,0
1/23/2018 22:40,22,69.3,38,64.7,60,66.4,2,0,0
1/23/2018 22:45,18,69.2,34,64.5,52,66.2,2,0,0
1/23/2018 22:50,17,69,33,64.4,50,66,2,0,0
1/23/2018 22:55,15,69.2,31,64.5,46,66.1,2,0,0
1/23/2018 23:00,14,69.3,29,64.7,43,66.2,2,0,0
1/23/2018 23:05,17,69.3,32,64.7,49,66.3,2,0,0
1/23/2018 23:10,11,69.4,27,64.8,38,66.1,2,0,0
1/23/2018 23:15,16,69.4,31,64.8,47,66.4,2,0,0
1/23/2018 23:20,15,69.2,31,64.6,46,66.1,2,0,0
1/23/2018 23:25,12,69.3,27,64.7,39,66.2,2,0,0
1/23/2018 23:30,15,69.3,31,64.7,46,66.2,2,0,0
1/23/2018 23:35,16,69.4,32,64.8,48,66.4,2,0,0
1/23/2018 23:40,12,69.4,27,64.8,39,66.2,2,0,0
1/23/2018 23:45,10,69.4,26,64.8,36,66.1,2,0,0
1/23/2018 23:50,13,69.4,29,64.8,42,66.2,2,0,0
1/23/2018 23:55,10,69.4,25,64.8,35,66.1,2,0,0
1/24/2018 0:00,11,69.3,26,64.7,37,66.1,2,0,0
1/24/2018 0:05,13,69.1,28,64.5,41,66,2,0,0
1/24/2018 0:10,10,69.2,25,64.6,35,65.9,2,0,0
1/24/2018 0:15,9,69.3,24,64.6,33,65.9,2,0,0
1/24/2018 0:20,9,69.3,24,64.7,33,65.9,2,0,0
1/24/2018 0:25,6,69.3,21,64.7,27,65.8,2,0,0
1/24/2018 0:30,10,69.4,25,64.8,35,66.1,2,0,0
1/24/2018 0:35,10,69.2,25,64.5,35,65.9,2,0,0
1/24/2018 0:40,8,69.1,23,64.5,31,65.7,2,0,0
1/24/2018 0:45,6,69.1,22,64.5,28,65.5,2,0,0
1/24/2018 0:50,7,69.2,22,64.6,29,65.7,2,0,0
1/24/2018 0:55,6,69.3,21,64.7,27,65.8,2,0,0
1/24/2018 1:00,6,69.4,21,64.8,27,65.8,2,0,0
1/24/2018 1:05,9,69.3,19,64.7,28,66.1,2,0,0
1/24/2018 1:10,6,69.3,21,64.7,27,65.7,2,0,0
1/24/2018 1:15,6,69.2,21,64.6,27,65.6,2,0,0
1/24/2018 1:20,7,69.1,22,64.5,29,65.6,2,0,0
1/24/2018 1:25,8,69.2,23,64.6,31,65.8,2,0,0
1/24/2018 1:30,10,69.1,20,64.5,30,66,2,0,0
1/24/2018 1:35,9,69.3,24,64.7,33,65.9,2,0,0
1/24/2018 1:40,5,69.3,21,64.7,26,65.6,2,0,0
1/24/2018 1:45,5,69.3,20,64.7,25,65.6,2,0,0
1/24/2018 1:50,6,69.3,22,64.7,28,65.7,2,0,0
1/24/2018 1:55,5,69.3,20,64.7,25,65.7,2,0,0
1/24/2018 2:00,5,69.2,20,64.6,25,65.5,2,0,0
1/24/2018 2:05,8,69.2,24,64.5,32,65.7,2,0,0
1/24/2018 2:10,8,69.3,23,64.7,31,65.9,2,0,0
1/24/2018 2:15,7,69.3,23,64.6,30,65.7,2,0,0
1/24/2018 2:20,7,69.2,23,64.6,30,65.7,2,0,0
1/24/2018 2:25,7,69.3,22,64.7,29,65.8,2,0,0
1/24/2018 2:30,7,69.3,23,64.7,30,65.7,2,0,0
1/24/2018 2:35,10,69.3,20,64.7,30,66.2,2,0,0
1/24/2018 2:40,9,69.3,24,64.7,33,66,2,0,0
1/24/2018 2:45,7,69.3,22,64.7,29,65.8,2,0,0
1/24/2018 2:50,9,69.4,25,64.7,34,66,2,0,0
1/24/2018 2:55,7,69.4,22,64.8,29,66,2,0,0
1/24/2018 3:00,10,69.4,25,64.8,35,66.2,2,0,0
1/24/2018 3:05,9,69.3,25,64.7,34,66,2,0,0
1/24/2018 3:10,10,68.7,25,64.1,35,65.4,2,0,0
1/24/2018 3:15,10,68.7,25,64,35,65.3,2,0,0
1/24/2018 3:20,9,69.1,24,64.4,33,65.7,2,0,0
1/24/2018 3:25,14,69.3,29,64.7,43,66.2,2,0,0
1/24/2018 3:30,11,69.3,27,64.7,38,66,2,0,0
1/24/2018 3:35,13,69.3,28,64.7,41,66.2,2,0,0
1/24/2018 3:40,11,69.3,27,64.7,38,66,2,0,0
1/24/2018 3:45,14,69.2,29,64.6,43,66.1,2,0,0
1/24/2018 3:50,12,69.3,28,64.7,40,66,2,0,0
1/24/2018 3:55,13,69.4,29,64.8,42,66.2,2,0,0
1/24/2018 4:00,14,69.1,30,64.5,44,65.9,2,0,0
1/24/2018 4:05,20,68.8,36,64.2,56,65.9,2,0,0
1/24/2018 4:10,19,69.2,36,64.6,55,66.2,2,0,0
1/24/2018 4:15,22,69.2,39,64.6,61,66.3,2,0,0
1/24/2018 4:20,23,69.2,40,64.5,63,66.2,2,0,0
1/24/2018 4:25,19,69.4,35,64.8,54,66.4,2,0,0
1/24/2018 4:30,28,69.2,46,64.6,74,66.4,2,0,0
1/24/2018 4:35,27,69.3,44,64.7,71,66.4,2,0,0
1/24/2018 4:40,27,69.4,44,64.8,71,66.5,2,0,0
1/24/2018 4:45,41,70.3,59,65.8,100,67.7,2,0,0
1/24/2018 4:50,39,69.5,57,64.9,96,66.8,2,0,0
1/24/2018 4:55,31,67.8,49,63.1,80,64.9,2,0,0
1/24/2018 5:00,37,67.8,55,63.1,92,65,2,0,0
1/24/2018 5:05,37,69.2,56,64.7,93,66.5,2,0,0
1/24/2018 5:10,46,69.1,65,64.5,111,66.4,2,0,0
1/24/2018 5:15,47,69.9,67,65.2,114,67.1,2,0,0
1/24/2018 5:20,53,68,73,63.2,126,65.2,2,0,0
1/24/2018 5:25,56,67.2,77,62.4,133,64.4,2,0,0
1/24/2018 5:30,59,68.5,81,63.8,140,65.7,2,0,0
1/24/2018 5:35,53,69.7,73,65.1,126,67.1,2,0,0
1/24/2018 5:40,65,69.4,85,64.8,150,66.8,2,0,0
1/24/2018 5:45,64,69.4,85,64.8,149,66.8,2,0,0
1/24/2018 5:50,72,68.9,94,64.3,166,66.3,2,0,0
1/24/2018 5:55,70,68.4,91,63.6,161,65.7,2,0,0
1/24/2018 6:00,65,68.5,85,63.7,150,65.8,2,0,0
1/24/2018 6:05,64,67.8,85,63,149,65.1,2,0,0
1/24/2018 6:10,67,67.9,87,63.1,154,65.2,2,0,0
1/24/2018 6:15,69,66,92,60.9,161,63.1,2,0,0
1/24/2018 6:20,70,66.9,92,61.9,162,64.1,2,0,0
1/24/2018 6:25,64,67.3,85,62.4,149,64.5,2,0,0
1/24/2018 6:30,75,67.3,98,62.3,173,64.5,2,0,0
1/24/2018 6:35,58,68.1,80,63.3,138,65.3,2,0,0
1/24/2018 6:40,76,67.3,99,62.4,175,64.5,2,0,0
1/24/2018 6:45,76,67.3,98,62.4,174,64.5,2,0,0
1/24/2018 6:50,78,67.8,100,62.9,178,65,2,0,0
1/24/2018 6:55,76,67.8,98,62.9,174,65,2,0,0
1/24/2018 7:00,76,66.3,99,61.2,175,63.4,2,0,0
1/24/2018 7:05,76,65.9,98,60.9,174,63.1,2,0,0
1/24/2018 7:10,76,66,100,60.9,176,63.1,2,0,0
1/24/2018 7:15,80,66.7,103,61.7,183,63.9,2,0,0
1/24/2018 7:20,81,66.2,105,61.2,186,63.4,2,0,0
1/24/2018 7:25,79,66.6,101,61.7,180,63.9,2,0,0
1/24/2018 7:30,85,67,110,62,195,64.2,2,0,0
1/24/2018 7:35,93,66.5,118,61.5,211,63.7,2,0,0
1/24/2018 7:40,90,66.2,114,61.2,204,63.4,2,0,0
1/24/2018 7:45,90,66.2,113,61.2,203,63.4,2,0,0
1/24/2018 7:50,79,66.1,103,61.1,182,63.3,2,0,0
1/24/2018 7:55,87,66.4,111,61.4,198,63.6,2,0,0
1/24/2018 8:00,73,67.2,95,62.3,168,64.4,2,0,0
1/24/2018 8:05,71,67.3,94,62.4,165,64.5,2,0,0
1/24/2018 8:10,80,66.4,102,61.5,182,63.6,2,0,0
1/24/2018 8:15,87,65.7,111,60.7,198,62.9,2,0,0
1/24/2018 8:20,73,66.1,95,61.1,168,63.3,2,0,0
1/24/2018 8:25,76,65.7,98,60.7,174,62.9,2,0,0
1/24/2018 8:30,85,66.8,108,61.8,193,64,2,0,0
1/24/2018 8:35,90,67,112,62.1,202,64.3,2,0,0
1/24/2018 8:40,94,67.7,117,62.9,211,65,2,0,0
1/24/2018 8:45,80,68.1,103,63.3,183,65.4,2,0,0
1/24/2018 8:50,80,68.2,102,63.4,182,65.6,2,0,0
1/24/2018 8:55,79,68.3,101,63.5,180,65.6,2,0,0
1/24/2018 9:00,76,67.9,99,63.1,175,65.2,2,0,0
1/24/2018 9:05,95,65.7,117,60.7,212,62.9,2,0,0
1/24/2018 9:10,76,66.9,97,62,173,64.1,2,0,0
1/24/2018 9:15,70,66.5,92,61.6,162,63.7,2,0,0
1/24/2018 9:20,74,65.6,96,60.6,170,62.8,2,0,0
1/24/2018 9:25,68,67.1,88,62.2,156,64.3,2,0,0
1/24/2018 9:30,67,67,88,62.1,155,64.2,2,0,0
1/24/2018 9:35,59,68.5,78,63.8,137,65.8,2,0,0
1/24/2018 9:40,62,67.3,82,62.6,144,64.6,2,0,0
1/24/2018 9:45,62,66.8,82,62,144,64.1,2,0,0
1/24/2018 9:50,51,66.7,70,61.9,121,63.9,2,0,0
1/24/2018 9:55,63,67.8,82,63.1,145,65.1,2,0,0
1/24/2018 10:00,64,66.5,83,61.6,147,63.8,2,0,0
1/24/2018 10:05,55,66.7,74,61.9,129,64,2,0,0
1/24/2018 10:10,62,68,81,63.4,143,65.4,2,0,0
1/24/2018 10:15,54,68.5,73,63.9,127,65.8,2,0,0
1/24/2018 10:20,65,67.6,84,62.9,149,64.9,2,0,0
1/24/2018 10:25,59,68.4,78,63.8,137,65.8,2,0,0
1/24/2018 10:30,58,68.7,77,64.1,135,66.1,2,0,0
1/24/2018 10:35,54,68.7,71,64.1,125,66.1,2,0,0
1/24/2018 10:40,64,69,83,64.3,147,66.3,2,0,0
1/24/2018 10:45,58,67.9,77,63.2,135,65.2,2,0,0
1/24/2018 10:50,63,68.6,83,63.9,146,66,2,0,0
1/24/2018 10:55,62,69,56,63,118,66.2,2,0,0
1/24/2018 11:00,57,69.2,51,63.2,108,66.4,2,0,0
1/24/2018 11:05,59,68.7,53,62.9,112,66,2,0,0
1/24/2018 11:10,60,68.5,54,62.7,114,65.8,2,0,0
1/24/2018 11:15,62,68.5,55,62.7,117,65.8,2,0,0
1/24/2018 11:20,62,68.5,56,62.7,118,65.7,2,0,0
1/24/2018 11:25,51,71.5,68,67,119,68.9,2,0,0
1/24/2018 11:30,47,68.8,65,64,112,66,2,0,0
1/24/2018 11:35,42,68.9,60,64.2,102,66.1,2,0,0
1/24/2018 11:40,27,69.3,43,64.6,70,66.4,2,0,0
1/24/2018 11:45,42,69.7,59,65.1,101,67,2,0,0
1/24/2018 11:50,47,68.9,64,64.2,111,66.2,2,0,0
1/24/2018 11:55,52,69.6,69,64.9,121,66.9,2,0,0
1/24/2018 12:00,45,67.9,62,63.2,107,65.2,2,0,0
1/24/2018 12:05,48,67.4,66,62.6,114,64.6,2,0,0
1/24/2018 12:10,44,68.5,61,63.9,105,65.8,2,0,0
1/24/2018 12:15,47,69.3,65,64.7,112,66.6,2,0,0
1/24/2018 12:20,42,65.9,60,60.9,102,63,2,0,0
1/24/2018 12:25,46,67.2,64,62.5,110,64.5,2,0,0
1/24/2018 12:30,44,68.2,61,63.5,105,65.4,2,0,0
1/24/2018 12:35,59,69.8,78,65.3,137,67.2,2,0,0
1/24/2018 12:40,47,68,63,63.3,110,65.3,2,0,0
1/24/2018 12:45,48,69.2,66,64.5,114,66.5,2,0,0
1/24/2018 12:50,41,68.3,59,63.6,100,65.5,2,0,0
1/24/2018 12:55,41,68.9,58,64.2,99,66.1,2,0,0
1/24/2018 13:00,43,64.3,61,58.9,104,61.1,2,0,0
1/24/2018 13:05,48,65.1,65,59.9,113,62.1,2,0,0
1/24/2018 13:10,51,68.4,69,63.6,120,65.6,2,0,0
1/24/2018 13:15,52,69.8,69,65,121,67.1,2,0,0
1/24/2018 13:20,47,70.7,64,66.1,111,68.1,2,0,0
1/24/2018 13:25,50,70.2,67,65.6,117,67.6,2,0,0
1/24/2018 13:30,45,69,62,64.3,107,66.3,2,0,0
1/24/2018 13:35,56,68.8,74,64.1,130,66.2,2,0,0
1/24/2018 13:40,37,69.4,53,64.7,90,66.6,2,0,0
1/24/2018 13:45,47,69.8,65,65.2,112,67.1,2,0,0
1/24/2018 13:50,46,70.2,64,65.6,110,67.5,2,0,0
1/24/2018 13:55,40,67.8,57,63,97,65,2,0,0
1/24/2018 14:00,36,69.2,53,64.6,89,66.4,2,0,0
1/24/2018 14:05,41,70.4,58,65.8,99,67.7,2,0,0
1/24/2018 14:10,43,69.7,59,65.1,102,67.1,2,0,0
1/24/2018 14:15,39,69.7,56,65.1,95,67,2,0,0
1/24/2018 14:20,55,68.2,74,63.5,129,65.5,2,0,0
1/24/2018 14:25,57,67.6,76,62.8,133,64.9,2,0,0
1/24/2018 14:30,38,68.8,55,64.2,93,66.1,2,0,0
1/24/2018 14:35,47,68.1,64,63.3,111,65.3,2,0,0
1/24/2018 14:40,42,67.6,58,62.8,100,64.8,2,0,0
1/24/2018 14:45,56,65.5,75,60.6,131,62.7,2,0,0
1/24/2018 14:50,47,66.4,64,61.6,111,63.6,2,0,0
1/24/2018 14:55,50,68,68,63.2,118,65.2,2,0,0
1/24/2018 15:00,42,67.5,60,62.8,102,64.8,2,0,0
1/24/2018 15:05,47,66.5,65,61.7,112,63.7,2,0,0
1/24/2018 15:10,57,66.5,76,61.7,133,63.7,2,0,0
1/24/2018 15:15,52,66.9,70,62,122,64.1,2,0,0
1/24/2018 15:20,53,67.6,71,62.9,124,64.9,2,0,0
1/24/2018 15:25,54,67.8,73,63,127,65.1,2,0,0
1/24/2018 15:30,54,68.8,73,64.1,127,66.1,2,0,0
1/24/2018 15:35,57,68.9,75,64.2,132,66.2,2,0,0
1/24/2018 15:40,66,68.6,85,63.8,151,65.9,2,0,0
1/24/2018 15:45,51,69.2,69,64.6,120,66.6,2,0,0
1/24/2018 15:50,60,68.6,79,63.9,139,65.9,2,0,0
1/24/2018 15:55,47,69.1,64,64.4,111,66.4,2,0,0
1/24/2018 16:00,56,67.7,75,62.9,131,65,2,0,0
1/24/2018 16:05,48,67.8,66,63,114,65.1,2,0,0
1/24/2018 16:10,51,67.1,69,62.3,120,64.3,2,0,0
1/24/2018 16:15,48,67.9,65,63.2,113,65.2,2,0,0
1/24/2018 16:20,43,67.5,60,62.6,103,64.6,2,0,0
1/24/2018 16:25,41,66.6,59,61.6,100,63.7,2,0,0
1/24/2018 16:30,43,67.7,60,62.9,103,64.9,2,0,0
1/24/2018 16:35,45,69.3,63,64.6,108,66.5,2,0,0
1/24/2018 16:40,41,68.8,58,64,99,66,2,0,0
1/24/2018 16:45,41,69.3,58,64.6,99,66.5,2,0,0
1/24/2018 16:50,45,68.3,62,63.6,107,65.6,2,0,0
1/24/2018 16:55,47,67.5,65,62.6,112,64.7,2,0,0
1/24/2018 17:00,47,67.6,64,62.7,111,64.8,2,0,0
1/24/2018 17:05,42,68.7,59,64,101,66,2,0,0
1/24/2018 17:10,36,67.4,53,62.5,89,64.5,2,0,0
1/24/2018 17:15,43,63.8,61,58.6,104,60.8,2,0,0
1/24/2018 17:20,36,60.2,53,54.7,89,56.9,2,0,0
1/24/2018 17:25,45,58.5,63,52.6,108,55.1,2,0,0
1/24/2018 17:30,34,59.1,52,53.3,86,55.6,2,0,0
1/24/2018 17:35,43,60.2,61,54.6,104,56.9,2,0,0
1/24/2018 17:40,45,56.4,62,50.4,107,52.9,2,0,0
1/24/2018 17:45,35,56.3,54,50.2,89,52.6,2,0,0
1/24/2018 17:50,32,57.4,48,51.5,80,53.9,2,0,0
1/24/2018 17:55,45,57.4,63,51.4,108,53.9,2,0,0
1/24/2018 18:00,33,60.2,49,54.6,82,56.8,2,0,0
1/24/2018 18:05,45,60.3,62,54.7,107,57,2,0,0
1/24/2018 18:10,39,61.4,56,56,95,58.2,2,0,0
1/24/2018 18:15,36,61.9,52,56.4,88,58.6,2,0,0
1/24/2018 18:20,43,60.9,61,55.3,104,57.6,2,0,0
1/24/2018 18:25,34,60.9,51,55.5,85,57.6,2,0,0
1/24/2018 18:30,42,61.4,58,55.9,100,58.2,2,0,0
1/24/2018 18:35,41,62.7,59,57.3,100,59.5,2,0,0
1/24/2018 18:40,35,64.4,51,59.3,86,61.4,2,0,0
1/24/2018 18:45,38,65,54,60,92,62.1,2,0,0
1/24/2018 18:50,43,63.9,60,58.6,103,60.8,2,0,0
1/24/2018 18:55,38,65.7,55,60.6,93,62.7,2,0,0
1/24/2018 19:00,28,65.9,44,60.9,72,62.9,2,0,0
1/24/2018 19:05,38,66.5,55,61.5,93,63.6,2,0,0
1/24/2018 19:10,29,66.9,46,62,75,63.9,2,0,0
1/24/2018 19:15,31,67,48,62.2,79,64.1,2,0,0
1/24/2018 19:20,38,67.3,54,62.4,92,64.4,2,0,0
1/24/2018 19:25,44,64,61,58.8,105,61,2,0,0
1/24/2018 19:30,41,65.6,59,60.7,100,62.7,2,0,0
1/24/2018 19:35,26,66.6,42,61.7,68,63.6,2,0,0
1/24/2018 19:40,35,67.2,52,62.4,87,64.3,2,0,0
1/24/2018 19:45,36,67.3,53,62.6,89,64.5,2,0,0
1/24/2018 19:50,34,67.2,51,62.4,85,64.3,2,0,0
1/24/2018 19:55,32,66.5,48,61.6,80,63.5,2,0,0
1/24/2018 20:00,28,65.5,43,60.6,71,62.5,2,0,0
1/24/2018 20:05,29,66,45,61.1,74,63.1,2,0,0
1/24/2018 20:10,29,66.4,44,61.6,73,63.5,2,0,0
1/24/2018 20:15,30,66.1,46,61.2,76,63.2,2,0,0
1/24/2018 20:20,29,65.8,45,60.9,74,62.8,2,0,0
1/24/2018 20:25,29,66,46,61,75,63,2,0,0
1/24/2018 20:30,30,66,46,61.1,76,63,2,0,0
1/24/2018 20:35,29,67,45,62.2,74,64.1,2,0,0
1/24/2018 20:40,24,68,39,63.3,63,65.1,2,0,0
1/24/2018 20:45,30,67.4,46,62.6,76,64.5,2,0,0
1/24/2018 20:50,28,66.7,44,61.9,72,63.8,2,0,0
1/24/2018 20:55,27,67.3,43,62.5,70,64.3,2,0,0
1/24/2018 21:00,25,67.6,40,62.8,65,64.7,2,0,0
1/24/2018 21:05,26,67.9,42,63.1,68,64.9,2,0,0
1/24/2018 21:10,25,67.1,41,62.2,66,64.1,2,0,0
1/24/2018 21:15,28,67.8,44,63,72,64.9,2,0,0
1/24/2018 21:20,23,68.4,39,63.7,62,65.4,2,0,0
1/24/2018 21:25,33,67.9,49,63.1,82,65,2,0,0
1/24/2018 21:30,29,68.5,45,63.8,74,65.7,2,0,0
1/24/2018 21:35,25,69,41,64.4,66,66.1,2,0,0
1/24/2018 21:40,25,69.4,41,64.8,66,66.5,2,0,0
1/24/2018 21:45,24,69.4,40,64.8,64,66.5,2,0,0
1/24/2018 21:50,25,69.2,40,64.6,65,66.4,2,0,0
1/24/2018 21:55,23,68.9,39,64.3,62,66,2,0,0
1/24/2018 22:00,17,69,33,64.4,50,65.9,2,0,0
1/24/2018 22:05,21,69.1,37,64.5,58,66.2,2,0,0
1/24/2018 22:10,27,70.1,25,64.1,52,67.2,2,0,0
1/24/2018 22:15,28,70.1,25,64.1,53,67.3,2,0,0
1/24/2018 22:20,26,70.2,24,64.2,50,67.3,2,0,0
1/24/2018 22:25,26,70.1,23,64.1,49,67.3,2,0,0
1/24/2018 22:30,22,69.3,37,64.7,59,66.5,2,0,0
1/24/2018 22:35,14,69.3,31,64.7,45,66.1,2,0,0
1/24/2018 22:40,16,68.8,32,64.1,48,65.7,2,0,0
1/24/2018 22:45,16,69,31,64.4,47,66,2,0,0
1/24/2018 22:50,17,69,33,64.4,50,66,2,0,0
1/24/2018 22:55,13,69.1,28,64.5,41,65.9,2,0,0
1/24/2018 23:00,12,69.2,28,64.6,40,66,2,0,0
1/24/2018 23:05,14,69.3,30,64.7,44,66.2,2,0,0
1/24/2018 23:10,16,69.1,32,64.5,48,66,2,0,0
1/24/2018 23:15,18,69.5,34,64.9,52,66.5,2,0,0
1/24/2018 23:20,12,69.4,28,64.8,40,66.2,2,0,0
1/24/2018 23:25,14,68.9,29,64.3,43,65.8,2,0,0
1/24/2018 23:30,11,69.2,27,64.6,38,66,2,0,0
1/24/2018 23:35,12,69.4,28,64.8,40,66.2,2,0,0
1/24/2018 23:40,14,69.4,29,64.8,43,66.3,2,0,0
1/24/2018 23:45,13,69.4,28,64.8,41,66.3,2,0,0
1/24/2018 23:50,8,69.4,23,64.8,31,66,2,0,0
1/24/2018 23:55,9,69.5,24,64.9,33,66.1,2,0,0
1/25/2018 0:00,9,69.3,24,64.7,33,66,2,0,0
1/25/2018 0:05,10,69.2,26,64.6,36,65.9,2,0,0
1/25/2018 0:10,7,69.2,23,64.5,30,65.6,2,0,0
1/25/2018 0:15,10,69.5,25,64.9,35,66.2,2,0,0
1/25/2018 0:20,10,69.3,25,64.6,35,66,2,0,0
1/25/2018 0:25,9,69.4,24,64.8,33,66.1,2,0,0
1/25/2018 0:30,7,69.1,22,64.4,29,65.5,2,0,0
1/25/2018 0:35,15,69,22,64.4,37,66.3,2,0,0
1/25/2018 0:40,7,69.2,22,64.5,29,65.7,2,0,0
1/25/2018 0:45,8,69.3,24,64.7,32,65.8,2,0,0
1/25/2018 0:50,8,69.4,24,64.8,32,65.9,2,0,0
1/25/2018 0:55,6,69.3,21,64.7,27,65.8,2,0,0
1/25/2018 1:00,9,69.4,24,64.7,33,66,2,0,0
1/25/2018 1:05,7,69.1,22,64.5,29,65.6,2,0,0
1/25/2018 1:10,7,69.3,22,64.7,29,65.8,2,0,0
1/25/2018 1:15,9,69.2,24,64.5,33,65.8,2,0,0
1/25/2018 1:20,13,69.2,21,64.6,34,66.4,2,0,0
1/25/2018 1:25,6,69.3,21,64.7,27,65.7,2,0,0
1/25/2018 1:30,13,69.3,21,64.7,34,66.5,2,0,0
1/25/2018 1:35,10,69.2,26,64.6,36,65.9,2,0,0
1/25/2018 1:40,7,69.3,23,64.7,30,65.8,2,0,0
1/25/2018 1:45,7,69.3,22,64.7,29,65.8,2,0,0
1/25/2018 1:50,5,69.3,20,64.7,25,65.6,2,0,0
1/25/2018 1:55,9,69.2,19,64.6,28,66.1,2,0,0
1/25/2018 2:00,6,69.2,21,64.6,27,65.6,2,0,0
1/25/2018 2:05,6,69.3,21,64.7,27,65.7,2,0,0
1/25/2018 2:10,8,69.2,24,64.5,32,65.7,2,0,0
1/25/2018 2:15,7,69.2,22,64.5,29,65.7,2,0,0
1/25/2018 2:20,9,69.2,19,64.5,28,66,2,0,0
1/25/2018 2:25,7,69.1,22,64.4,29,65.5,2,0,0
1/25/2018 2:30,7,69,23,64.4,30,65.5,2,0,0
1/25/2018 2:35,5,69.3,21,64.7,26,65.5,2,0,0
1/25/2018 2:40,10,69.3,26,64.7,36,65.9,2,0,0
1/25/2018 2:45,6,69.3,21,64.7,27,65.7,2,0,0
1/25/2018 2:50,8,69.2,24,64.6,32,65.8,2,0,0
1/25/2018 2:55,9,69.3,24,64.7,33,66,2,0,0
1/25/2018 3:00,11,69.3,27,64.7,38,66,2,0,0
1/25/2018 3:05,10,69.1,25,64.4,35,65.8,2,0,0
1/25/2018 3:10,12,69,28,64.4,40,65.7,2,0,0
1/25/2018 3:15,9,69.1,24,64.5,33,65.7,2,0,0
1/25/2018 3:20,9,69.2,24,64.6,33,65.9,2,0,0
1/25/2018 3:25,12,69.3,28,64.7,40,66.1,2,0,0
1/25/2018 3:30,10,69.4,26,64.8,36,66.1,2,0,0
1/25/2018 3:35,14,69.4,30,64.8,44,66.3,2,0,0
1/25/2018 3:40,12,69.4,28,64.8,40,66.2,2,0,0
1/25/2018 3:45,13,69.5,29,64.9,42,66.3,2,0,0
1/25/2018 3:50,15,69.5,31,64.9,46,66.4,2,0,0
1/25/2018 3:55,14,69.5,30,64.9,44,66.4,2,0,0
1/25/2018 4:00,17,68.7,32,64.1,49,65.7,2,0,0
1/25/2018 4:05,16,68.9,32,64.2,48,65.8,2,0,0
1/25/2018 4:10,14,69,30,64.4,44,65.9,2,0,0
1/25/2018 4:15,23,68.6,39,64,62,65.7,2,0,0
1/25/2018 4:20,23,68.9,39,64.2,62,65.9,2,0,0
1/25/2018 4:25,22,69,38,64.4,60,66.1,2,0,0
1/25/2018 4:30,29,69.3,47,64.7,76,66.4,2,0,0
1/25/2018 4:35,29,69,46,64.3,75,66.1,2,0,0
1/25/2018 4:40,39,69,57,64.3,96,66.2,2,0,0
1/25/2018 4:45,31,69.2,49,64.5,80,66.3,2,0,0
1/25/2018 4:50,37,68,55,63.3,92,65.2,2,0,0
1/25/2018 4:55,37,68.5,55,63.8,92,65.7,2,0,0
1/25/2018 5:00,42,68.4,61,63.8,103,65.7,2,0,0
1/25/2018 5:05,37,68.8,55,64.2,92,66.1,2,0,0
1/25/2018 5:10,40,69.3,58,64.7,98,66.5,2,0,0
1/25/2018 5:15,48,68.4,68,63.7,116,65.6,2,0,0
1/25/2018 5:20,49,68.2,69,63.5,118,65.4,2,0,0
1/25/2018 5:25,52,69.1,73,64.4,125,66.4,2,0,0
1/25/2018 5:30,50,70,70,65.5,120,67.4,2,0,0
1/25/2018 5:35,58,70.3,80,65.8,138,67.7,2,0,0
1/25/2018 5:40,63,69.1,85,64.5,148,66.4,2,0,0
1/25/2018 5:45,62,69.2,83,64.6,145,66.6,2,0,0
1/25/2018 5:50,70,68.9,91,64.3,161,66.3,2,0,0
1/25/2018 5:55,65,69.5,86,64.9,151,66.9,2,0,0
1/25/2018 6:00,55,68.5,75,63.9,130,65.8,2,0,0
1/25/2018 6:05,63,67.3,84,62.5,147,64.5,2,0,0
1/25/2018 6:10,64,66,86,60.9,150,63.1,2,0,0
1/25/2018 6:15,67,66.4,89,61.4,156,63.5,2,0,0
1/25/2018 6:20,65,65.7,88,60.7,153,62.8,2,0,0
1/25/2018 6:25,68,66.2,90,61.2,158,63.3,2,0,0
1/25/2018 6:30,65,66.1,86,61,151,63.2,2,0,0
1/25/2018 6:35,70,67.1,92,62.1,162,64.3,2,0,0
1/25/2018 6:40,72,66.5,95,61.5,167,63.6,2,0,0
1/25/2018 6:45,76,66.1,97,61.1,173,63.3,2,0,0
1/25/2018 6:50,83,65.3,106,60.1,189,62.4,2,0,0
1/25/2018 6:55,69,65.8,91,60.6,160,62.9,2,0,0
1/25/2018 7:00,68,65.3,90,60.2,158,62.4,2,0,0
1/25/2018 7:05,68,65.7,89,60.7,157,62.8,2,0,0
1/25/2018 7:10,85,65.3,108,60.3,193,62.5,2,0,0
1/25/2018 7:15,88,65.6,112,60.5,200,62.7,2,0,0
1/25/2018 7:20,85,66,109,60.9,194,63.1,2,0,0
1/25/2018 7:25,82,66,106,61,188,63.1,2,0,0
1/25/2018 7:30,79,66.9,101,62,180,64.1,2,0,0
1/25/2018 7:35,77,66,98,60.9,175,63.2,2,0,0
1/25/2018 7:40,97,65.2,123,60.1,220,62.3,2,0,0
1/25/2018 7:45,89,65.8,112,60.7,201,62.9,2,0,0
1/25/2018 7:50,85,65.5,108,60.4,193,62.6,2,0,0
1/25/2018 7:55,83,65.1,105,60,188,62.3,2,0,0
1/25/2018 8:00,85,64.8,109,59.6,194,61.9,2,0,0
1/25/2018 8:05,79,65.2,101,60.1,180,62.3,2,0,0
1/25/2018 8:10,75,65.3,97,60.2,172,62.5,2,0,0
1/25/2018 8:15,76,66.6,97,61.7,173,63.9,2,0,0
1/25/2018 8:20,69,67.4,90,62.6,159,64.7,2,0,0
1/25/2018 8:25,76,66.3,99,61.4,175,63.5,2,0,0
1/25/2018 8:30,79,66.1,101,61.1,180,63.3,2,0,0
1/25/2018 8:35,57,66,77,61,134,63.1,2,0,0
1/25/2018 8:40,54,66.7,73,61.7,127,63.8,2,0,0
1/25/2018 8:45,56,65.6,76,60.5,132,62.7,2,0,0
1/25/2018 8:50,47,65.7,66,60.6,113,62.7,2,0,0
1/25/2018 8:55,62,65.5,83,60.4,145,62.6,2,0,0
1/25/2018 9:00,66,64.4,87,59.3,153,61.5,2,0,0
1/25/2018 9:05,51,65.3,70,60.3,121,62.4,2,0,0
1/25/2018 9:10,50,65.8,69,60.8,119,62.9,2,0,0
1/25/2018 9:15,51,66.3,69,61.3,120,63.4,2,0,0
1/25/2018 9:20,48,65.9,67,60.9,115,63,2,0,0
1/25/2018 9:25,49,65.8,68,60.9,117,63,2,0,0
1/25/2018 9:30,46,66.3,65,61.4,111,63.4,2,0,0
1/25/2018 9:35,47,66.2,65,61.2,112,63.3,2,0,0
1/25/2018 9:40,38,66.2,56,61.3,94,63.3,2,0,0
1/25/2018 9:45,37,67.5,55,62.7,92,64.7,2,0,0
1/25/2018 9:50,43,67.9,60,63.2,103,65.2,2,0,0
1/25/2018 9:55,38,68.3,56,63.6,94,65.5,2,0,0
1/25/2018 10:00,38,69.3,55,64.7,93,66.6,2,0,0
1/25/2018 10:05,40,69.5,57,64.9,97,66.8,2,0,0
1/25/2018 10:10,33,68.9,50,64.3,83,66.1,2,0,0
1/25/2018 10:15,39,68.4,56,63.8,95,65.7,2,0,0
1/25/2018 10:20,59,68.4,77,63.8,136,65.8,2,0,0
1/25/2018 10:25,56,67.5,75,62.8,131,64.8,2,0,0
1/25/2018 10:30,55,66.8,73,62,128,64.1,2,0,0
1/25/2018 10:35,58,67.1,76,62.3,134,64.4,2,0,0
1/25/2018 10:40,57,67.4,75,62.6,132,64.7,2,0,0
1/25/2018 10:45,56,67.4,74,62.6,130,64.6,2,0,0
1/25/2018 10:50,59,67.5,78,62.7,137,64.8,2,0,0
1/25/2018 10:55,57,66.7,76,61.9,133,63.9,2,0,0
1/25/2018 11:00,54,66.8,73,62,127,64.1,2,0,0
1/25/2018 11:05,56,66.5,75,61.6,131,63.7,2,0,0
1/25/2018 11:10,54,66,72,61.1,126,63.2,2,0,0
1/25/2018 11:15,59,66.9,78,62.1,137,64.2,2,0,0
1/25/2018 11:20,62,66.6,82,61.8,144,63.9,2,0,0
1/25/2018 11:25,56,67.7,75,62.9,131,64.9,2,0,0
1/25/2018 11:30,63,67.2,82,62.4,145,64.5,2,0,0
1/25/2018 11:35,52,69.2,70,64.5,122,66.5,2,0,0
1/25/2018 11:40,54,68.7,71,64.1,125,66.1,2,0,0
1/25/2018 11:45,59,68.4,77,63.7,136,65.7,2,0,0
1/25/2018 11:50,60,67.9,79,63.1,139,65.2,2,0,0
1/25/2018 11:55,54,68.9,72,64.3,126,66.3,2,0,0
1/25/2018 12:00,50,69.6,67,65,117,67,2,0,0
1/25/2018 12:05,42,68.2,60,63.5,102,65.5,2,0,0
1/25/2018 12:10,55,68.6,73,64,128,66,2,0,0
1/25/2018 12:15,44,69.1,61,64.5,105,66.4,2,0,0
1/25/2018 12:20,49,68.7,67,64.1,116,66.1,2,0,0
1/25/2018 12:25,50,67.9,67,63.1,117,65.1,2,0,0
1/25/2018 12:30,51,68.5,70,63.7,121,65.7,2,0,0
1/25/2018 12:35,57,70.1,74,65.6,131,67.5,2,0,0
1/25/2018 12:40,59,69,77,64.3,136,66.3,2,0,0
1/25/2018 12:45,46,68,64,63.3,110,65.3,2,0,0
1/25/2018 12:50,46,67.8,63,63.1,109,65.1,2,0,0
1/25/2018 12:55,44,68.5,61,63.9,105,65.8,2,0,0
1/25/2018 13:00,43,69.4,60,64.8,103,66.7,2,0,0
1/25/2018 13:05,45,68.8,61,64.1,106,66.1,2,0,0
1/25/2018 13:10,47,69.2,66,64.6,113,66.5,2,0,0
1/25/2018 13:15,45,69,62,64.3,107,66.3,2,0,0
1/25/2018 13:20,54,68.1,73,63.3,127,65.3,2,0,0
1/25/2018 13:25,50,68.2,67,63.5,117,65.5,2,0,0
1/25/2018 13:30,41,68.6,58,63.8,99,65.8,2,0,0
1/25/2018 13:35,52,68.5,69,63.8,121,65.8,2,0,0
1/25/2018 13:40,50,68.7,68,64,118,66,2,0,0
1/25/2018 13:45,47,67,66,62.1,113,64.1,2,0,0
1/25/2018 13:50,43,67.3,61,62.4,104,64.4,2,0,0
1/25/2018 13:55,43,65.9,61,60.9,104,63,2,0,0
1/25/2018 14:00,48,67.1,65,62.3,113,64.3,2,0,0
1/25/2018 14:05,47,66.9,64,62,111,64.1,2,0,0
1/25/2018 14:10,47,64.5,64,59.5,111,61.6,2,0,0
1/25/2018 14:15,49,64.4,66,59.3,115,61.5,2,0,0
1/25/2018 14:20,62,64.4,80,59.3,142,61.5,2,0,0
1/25/2018 14:25,52,64.9,70,59.7,122,61.9,2,0,0
1/25/2018 14:30,46,65.7,64,60.7,110,62.8,2,0,0
1/25/2018 14:35,52,65.6,71,60.4,123,62.6,2,0,0
1/25/2018 14:40,52,66.1,70,61.1,122,63.2,2,0,0
1/25/2018 14:45,47,67.4,65,62.5,112,64.6,2,0,0
1/25/2018 14:50,50,66.7,68,61.7,118,63.9,2,0,0
1/25/2018 14:55,56,66.7,75,61.7,131,63.8,2,0,0
1/25/2018 15:00,50,67.5,67,62.7,117,64.8,2,0,0
1/25/2018 15:05,53,68,71,63.2,124,65.3,2,0,0
1/25/2018 15:10,53,68.6,72,63.8,125,65.8,2,0,0
1/25/2018 15:15,61,68.3,79,63.5,140,65.6,2,0,0
1/25/2018 15:20,56,68.6,75,63.9,131,65.9,2,0,0
1/25/2018 15:25,63,68.9,81,64.2,144,66.2,2,0,0
1/25/2018 15:30,56,68.3,74,63.6,130,65.6,2,0,0
1/25/2018 15:35,53,69.7,71,65.1,124,67,2,0,0
1/25/2018 15:40,58,68.9,78,64.2,136,66.2,2,0,0
1/25/2018 15:45,66,70,85,65.4,151,67.4,2,0,0
1/25/2018 15:50,62,69,81,64.2,143,66.3,2,0,0
1/25/2018 15:55,66,68.6,84,63.8,150,65.9,2,0,0
1/25/2018 16:00,66,69.4,85,64.7,151,66.8,2,0,0
1/25/2018 16:05,63,69,81,64.3,144,66.3,2,0,0
1/25/2018 16:10,59,68,78,63.2,137,65.3,2,0,0
1/25/2018 16:15,63,69,81,64.3,144,66.3,2,0,0
1/25/2018 16:20,56,68,74,63.2,130,65.3,2,0,0
1/25/2018 16:25,59,68.2,77,63.4,136,65.5,2,0,0
1/25/2018 16:30,49,67,67,62.1,116,64.2,2,0,0
1/25/2018 16:35,53,67.8,71,63,124,65.1,2,0,0
1/25/2018 16:40,61,68.2,79,63.4,140,65.5,2,0,0
1/25/2018 16:45,55,68.7,74,63.9,129,65.9,2,0,0
1/25/2018 16:50,46,69.5,63,64.8,109,66.7,2,0,0
1/25/2018 16:55,54,68.9,73,64.2,127,66.2,2,0,0
1/25/2018 17:00,59,67.5,78,62.7,137,64.8,2,0,0
1/25/2018 17:05,54,67.8,73,63,127,65,2,0,0
1/25/2018 17:10,64,67.7,84,62.8,148,64.9,2,0,0
1/25/2018 17:15,59,68.9,77,64.3,136,66.3,2,0,0
1/25/2018 17:20,57,69.5,76,64.9,133,66.9,2,0,0
1/25/2018 17:25,58,69.1,77,64.5,135,66.5,2,0,0
1/25/2018 17:30,50,67.1,68,62.2,118,64.3,2,0,0
1/25/2018 17:35,49,64.2,67,59,116,61.2,2,0,0
1/25/2018 17:40,56,65.6,74,60.5,130,62.7,2,0,0
1/25/2018 17:45,48,64.9,66,59.7,114,61.9,2,0,0
1/25/2018 17:50,50,67.6,69,62.8,119,64.8,2,0,0
1/25/2018 17:55,54,66.8,72,61.9,126,64,2,0,0
1/25/2018 18:00,55,67,74,62.2,129,64.2,2,0,0
1/25/2018 18:05,57,67.5,76,62.8,133,64.8,2,0,0
1/25/2018 18:10,62,66.6,82,61.8,144,63.9,2,0,0
1/25/2018 18:15,62,62.9,81,57.7,143,60,2,0,0
1/25/2018 18:20,58,55.1,78,49,136,51.6,2,0,0
1/25/2018 18:25,60,49,78,42.2,138,45.2,2,0,0
1/25/2018 18:30,56,47.9,76,40.9,132,43.9,2,0,0
1/25/2018 18:35,47,55.3,65,49.1,112,51.7,2,0,0
1/25/2018 18:40,49,61.2,67,55.6,116,58,2,0,0
1/25/2018 18:45,44,64.7,62,59.6,106,61.8,2,0,0
1/25/2018 18:50,46,66.2,62,61.3,108,63.4,2,0,0
1/25/2018 18:55,46,67.1,64,62.3,110,64.3,2,0,0
1/25/2018 19:00,40,68.5,57,63.8,97,65.7,2,0,0
1/25/2018 19:05,46,69.2,64,64.6,110,66.5,2,0,0
1/25/2018 19:10,37,69.3,55,64.7,92,66.5,2,0,0
1/25/2018 19:15,43,69,60,64.4,103,66.3,2,0,0
1/25/2018 19:20,31,69.6,47,65,78,66.9,2,0,0
1/25/2018 19:25,48,68,66,63.3,114,65.3,2,0,0
1/25/2018 19:30,42,67.1,59,62.3,101,64.3,2,0,0
1/25/2018 19:35,39,68.2,55,63.4,94,65.3,2,0,0
1/25/2018 19:40,40,68.8,58,64.1,98,66,2,0,0
1/25/2018 19:45,31,70,47,65.4,78,67.2,2,0,0
1/25/2018 19:50,31,69.8,48,65.1,79,66.9,2,0,0
1/25/2018 19:55,38,70.2,54,65.6,92,67.5,2,0,0
1/25/2018 20:00,30,70.1,46,65.5,76,67.3,2,0,0
1/25/2018 20:05,35,69.7,52,65.1,87,66.9,2,0,0
1/25/2018 20:10,32,69.4,49,64.7,81,66.6,2,0,0
1/25/2018 20:15,38,69.5,55,64.9,93,66.8,2,0,0
1/25/2018 20:20,34,68.9,51,64.3,85,66.1,2,0,0
1/25/2018 20:25,39,68.6,57,63.9,96,65.8,2,0,0
1/25/2018 20:30,33,68.4,50,63.7,83,65.5,2,0,0
1/25/2018 20:35,27,68.6,44,63.9,71,65.7,2,0,0
1/25/2018 20:40,27,68.6,43,64,70,65.8,2,0,0
1/25/2018 20:45,36,69,52,64.4,88,66.3,2,0,0
1/25/2018 20:50,33,68.7,49,64.1,82,66,2,0,0
1/25/2018 20:55,28,69.3,45,64.7,73,66.5,2,0,0
1/25/2018 21:00,27,69.1,43,64.5,70,66.3,2,0,0
1/25/2018 21:05,30,68.1,47,63.5,77,65.3,2,0,0
1/25/2018 21:10,37,67.8,54,63.1,91,65,2,0,0
1/25/2018 21:15,36,67.3,52,62.6,88,64.5,2,0,0
1/25/2018 21:20,31,67.4,47,62.7,78,64.6,2,0,0
1/25/2018 21:25,29,67.9,45,63.2,74,65,2,0,0
1/25/2018 21:30,32,68.3,48,63.7,80,65.5,2,0,0
1/25/2018 21:35,32,68.2,49,63.4,81,65.3,2,0,0
1/25/2018 21:40,30,68.6,45,63.9,75,65.8,2,0,0
1/25/2018 21:45,30,69,46,64.4,76,66.3,2,0,0
1/25/2018 21:50,28,69.3,45,64.7,73,66.5,2,0,0
1/25/2018 21:55,22,69.2,38,64.6,60,66.3,2,0,0
1/25/2018 22:00,24,69,40,64.4,64,66.1,2,0,0
1/25/2018 22:05,27,68.6,43,64,70,65.8,2,0,0
1/25/2018 22:10,28,67.8,44,63.1,72,64.9,2,0,0
1/25/2018 22:15,21,67.7,36,63,57,64.8,2,0,0
1/25/2018 22:20,27,68.4,43,63.8,70,65.6,2,0,0
1/25/2018 22:25,25,68.3,41,63.6,66,65.4,2,0,0
1/25/2018 22:30,23,68.8,38,64.1,61,65.9,2,0,0
1/25/2018 22:35,25,68.8,41,64.1,66,65.9,2,0,0
1/25/2018 22:40,22,68.1,38,63.4,60,65.1,2,0,0
1/25/2018 22:45,22,68.6,38,63.9,60,65.6,2,0,0
1/25/2018 22:50,16,69,31,64.4,47,66,2,0,0
1/25/2018 22:55,18,68.7,33,64.1,51,65.7,2,0,0
1/25/2018 23:00,16,68.8,32,64.2,48,65.7,2,0,0
1/25/2018 23:05,23,68.8,38,64.2,61,66,2,0,0
1/25/2018 23:10,15,69.1,30,64.5,45,66,2,0,0
1/25/2018 23:15,16,69.3,31,64.7,47,66.3,2,0,0
1/25/2018 23:20,16,69.3,32,64.7,48,66.2,2,0,0
1/25/2018 23:25,13,69.2,29,64.5,42,66,2,0,0
1/25/2018 23:30,13,69.2,29,64.6,42,66,2,0,0
1/25/2018 23:35,17,69.6,32,65,49,66.6,2,0,0
1/25/2018 23:40,12,69.4,27,64.8,39,66.3,2,0,0
1/25/2018 23:45,16,69.4,31,64.8,47,66.4,2,0,0
1/25/2018 23:50,16,69.3,32,64.7,48,66.2,2,0,0
1/25/2018 23:55,17,69.2,23,64.6,40,66.6,2,0,0
1/26/2018 0:00,12,69.3,28,64.7,40,66.1,2,0,0
1/26/2018 0:05,9,69.2,24,64.6,33,65.9,2,0,0
1/26/2018 0:10,14,69.1,29,64.5,43,66,2,0,0
1/26/2018 0:15,16,69,31,64.4,47,66,2,0,0
1/26/2018 0:20,19,68.6,34,63.9,53,65.6,2,0,0
1/26/2018 0:25,8,68.6,23,63.9,31,65.1,2,0,0
1/26/2018 0:30,11,68.9,26,64.3,37,65.7,2,0,0
1/26/2018 0:35,13,69.1,28,64.5,41,66,2,0,0
1/26/2018 0:40,8,69.3,23,64.7,31,65.9,2,0,0
1/26/2018 0:45,11,68.6,27,64,38,65.3,2,0,0
1/26/2018 0:50,12,68.9,27,64.3,39,65.7,2,0,0
1/26/2018 0:55,11,68.7,26,64.1,37,65.4,2,0,0
1/26/2018 1:00,12,68.8,27,64.2,39,65.6,2,0,0
1/26/2018 1:05,9,68.9,25,64.3,34,65.5,2,0,0
1/26/2018 1:10,11,69.2,26,64.5,37,65.9,2,0,0
1/26/2018 1:15,8,69.4,24,64.8,32,65.9,2,0,0
1/26/2018 1:20,9,69,24,64.3,33,65.6,2,0,0
1/26/2018 1:25,11,69.3,27,64.7,38,66,2,0,0
1/26/2018 1:30,11,68.9,26,64.2,37,65.6,2,0,0
1/26/2018 1:35,14,69.3,30,64.7,44,66.1,2,0,0
1/26/2018 1:40,8,69.3,23,64.7,31,65.9,2,0,0
1/26/2018 1:45,7,69.3,22,64.7,29,65.8,2,0,0
1/26/2018 1:50,7,69.2,22,64.6,29,65.7,2,0,0
1/26/2018 1:55,7,69.3,22,64.7,29,65.8,2,0,0
1/26/2018 2:00,18,69.3,23,64.7,41,66.8,2,0,0
1/26/2018 2:05,7,69.4,22,64.7,29,65.9,2,0,0
1/26/2018 2:10,10,69.4,25,64.7,35,66.1,2,0,0
1/26/2018 2:15,6,69.3,21,64.7,27,65.7,2,0,0
1/26/2018 2:20,7,69.3,22,64.6,29,65.7,2,0,0
1/26/2018 2:25,7,69.4,23,64.8,30,65.9,2,0,0
1/26/2018 2:30,8,69.4,24,64.8,32,66,2,0,0
1/26/2018 2:35,10,69.4,25,64.8,35,66.1,2,0,0
1/26/2018 2:40,7,69.4,22,64.7,29,65.9,2,0,0
1/26/2018 2:45,9,69.4,25,64.8,34,66.1,2,0,0
1/26/2018 2:50,7,69.5,22,64.9,29,66,2,0,0
1/26/2018 2:55,9,69.5,25,65,34,66.2,2,0,0
1/26/2018 3:00,8,69.4,23,64.8,31,66,2,0,0
1/26/2018 3:05,14,69.4,30,64.8,44,66.3,2,0,0
1/26/2018 3:10,10,69.3,26,64.7,36,66,2,0,0
1/26/2018 3:15,11,69.1,26,64.5,37,65.9,2,0,0
1/26/2018 3:20,9,69.3,24,64.7,33,65.9,2,0,0
1/26/2018 3:25,9,69.3,25,64.7,34,66,2,0,0
1/26/2018 3:30,13,69.3,30,64.7,43,66.1,2,0,0
1/26/2018 3:35,13,69.3,29,64.7,42,66.1,2,0,0
1/26/2018 3:40,12,69.3,27,64.7,39,66.1,2,0,0
1/26/2018 3:45,17,68.3,32,63.7,49,65.3,2,0,0
1/26/2018 3:50,11,68.9,27,64.3,38,65.7,2,0,0
1/26/2018 3:55,15,69.2,30,64.6,45,66.2,2,0,0
1/26/2018 4:00,17,69.4,33,64.8,50,66.4,2,0,0
1/26/2018 4:05,14,69.1,30,64.5,44,66,2,0,0
1/26/2018 4:10,22,69.5,38,64.9,60,66.6,2,0,0
1/26/2018 4:15,20,69.7,37,65.1,57,66.7,2,0,0
1/26/2018 4:20,21,69.7,38,65.1,59,66.7,2,0,0
1/26/2018 4:25,22,69.4,38,64.8,60,66.5,2,0,0
1/26/2018 4:30,29,69.3,46,64.7,75,66.4,2,0,0
1/26/2018 4:35,31,69.8,49,65.2,80,67,2,0,0
1/26/2018 4:40,40,70.6,58,66.2,98,68,2,0,0
1/26/2018 4:45,34,70.7,51,66.2,85,68,2,0,0
1/26/2018 4:50,35,70.5,53,66,88,67.8,2,0,0
1/26/2018 4:55,34,69.8,52,65.2,86,67.1,2,0,0
1/26/2018 5:00,31,69,49,64.4,80,66.2,2,0,0
1/26/2018 5:05,39,69.3,57,64.7,96,66.5,2,0,0
1/26/2018 5:10,44,68,63,63.4,107,65.3,2,0,0
1/26/2018 5:15,47,68.7,65,64,112,65.9,2,0,0
1/26/2018 5:20,48,68.5,69,63.9,117,65.8,2,0,0
1/26/2018 5:25,50,68.9,70,64.2,120,66.2,2,0,0
1/26/2018 5:30,50,69.2,70,64.6,120,66.5,2,0,0
1/26/2018 5:35,61,69.2,81,64.5,142,66.5,2,0,0
1/26/2018 5:40,53,69.3,73,64.6,126,66.6,2,0,0
1/26/2018 5:45,72,69.4,93,64.7,165,66.8,2,0,0
1/26/2018 5:50,66,68.4,86,63.7,152,65.7,2,0,0
1/26/2018 5:55,71,66.8,94,61.9,165,64,2,0,0
1/26/2018 6:00,67,67.9,88,63.2,155,65.2,2,0,0
1/26/2018 6:05,58,68.2,77,63.4,135,65.5,2,0,0
1/26/2018 6:10,62,67.2,82,62.3,144,64.4,2,0,0
1/26/2018 6:15,52,66.9,71,62,123,64.1,2,0,0
1/26/2018 6:20,51,66.2,71,61.2,122,63.3,2,0,0
1/26/2018 6:25,51,67.1,71,62.2,122,64.2,2,0,0
1/26/2018 6:30,62,67.7,83,62.8,145,64.9,2,0,0
1/26/2018 6:35,59,67.5,81,62.5,140,64.6,2,0,0
1/26/2018 6:40,65,66.2,87,61.2,152,63.4,2,0,0
1/26/2018 6:45,73,66.3,94,61.3,167,63.5,2,0,0
1/26/2018 6:50,68,64.6,89,59.5,157,61.7,2,0,0
1/26/2018 6:55,70,66.3,91,61.3,161,63.5,2,0,0
1/26/2018 7:00,63,68.2,83,63.4,146,65.5,2,0,0
1/26/2018 7:05,70,67.3,93,62.5,163,64.6,2,0,0
1/26/2018 7:10,67,68.5,88,63.7,155,65.8,2,0,0
1/26/2018 7:15,79,66.7,102,61.7,181,63.9,2,0,0
1/26/2018 7:20,83,67.3,105,62.4,188,64.6,2,0,0
1/26/2018 7:25,74,67.2,96,62.3,170,64.5,2,0,0
1/26/2018 7:30,63,67.9,85,63,148,65.1,2,0,0
1/26/2018 7:35,74,68.1,97,63.3,171,65.4,2,0,0
1/26/2018 7:40,79,68.4,101,63.6,180,65.7,2,0,0
1/26/2018 7:45,86,67.5,110,62.6,196,64.8,2,0,0
1/26/2018 7:50,77,68.5,99,63.7,176,65.8,2,0,0
1/26/2018 7:55,69,68.9,88,64.1,157,66.2,2,0,0
1/26/2018 8:00,66,68.9,86,64.2,152,66.2,2,0,0
1/26/2018 8:05,61,68.6,81,63.8,142,65.9,2,0,0
1/26/2018 8:10,64,68.9,84,64.2,148,66.3,2,0,0
1/26/2018 8:15,69,68.3,89,63.7,158,65.7,2,0,0
1/26/2018 8:20,77,67,98,62.2,175,64.3,2,0,0
1/26/2018 8:25,78,66.5,99,61.6,177,63.7,2,0,0
1/26/2018 8:30,72,66.8,93,61.9,165,64,2,0,0
1/26/2018 8:35,64,66.4,85,61.5,149,63.6,2,0,0
1/26/2018 8:40,70,66.9,91,62,161,64.1,2,0,0
1/26/2018 8:45,75,66.4,96,61.5,171,63.6,2,0,0
1/26/2018 8:50,78,66.4,100,61.5,178,63.6,2,0,0
1/26/2018 8:55,64,67.2,84,62.3,148,64.4,2,0,0
1/26/2018 9:00,70,67.6,91,62.8,161,64.9,2,0,0
1/26/2018 9:05,67,66.9,87,62.1,154,64.2,2,0,0
1/26/2018 9:10,64,68,83,63.2,147,65.3,2,0,0
1/26/2018 9:15,61,68.4,80,63.7,141,65.8,2,0,0
1/26/2018 9:20,73,68,93,63.2,166,65.3,2,0,0
1/26/2018 9:25,68,67.7,90,63,158,65,2,0,0
1/26/2018 9:30,72,66.8,92,62,164,64.1,2,0,0
1/26/2018 9:35,63,67.2,83,62.4,146,64.5,2,0,0
1/26/2018 9:40,64,67.6,83,62.9,147,65,2,0,0
1/26/2018 9:45,66,66,86,61.1,152,63.3,2,0,0
1/26/2018 9:50,64,67,84,62.2,148,64.3,2,0,0
1/26/2018 9:55,61,65.6,81,60.7,142,62.8,2,0,0
1/26/2018 10:00,56,66.7,74,61.8,130,63.9,2,0,0
1/26/2018 10:05,56,67.3,75,62.5,131,64.6,2,0,0
1/26/2018 10:10,62,67.6,82,63,144,65,2,0,0
1/26/2018 10:15,69,68.2,88,63.5,157,65.6,2,0,0
1/26/2018 10:20,64,67.7,83,63.1,147,65.1,2,0,0
1/26/2018 10:25,57,68,75,63.4,132,65.4,2,0,0
1/26/2018 10:30,64,67.2,84,62.4,148,64.5,2,0,0
1/26/2018 10:35,60,68.6,79,64,139,66,2,0,0
1/26/2018 10:40,56,68.7,76,64.1,132,66.1,2,0,0
1/26/2018 10:45,58,68.8,78,64.3,136,66.2,2,0,0
1/26/2018 10:50,56,68.8,74,64.3,130,66.2,2,0,0
1/26/2018 10:55,50,68.2,68,63.6,118,65.6,2,0,0
1/26/2018 11:00,50,68.3,68,63.6,118,65.6,2,0,0
1/26/2018 11:05,43,69.1,60,64.5,103,66.4,2,0,0
1/26/2018 11:10,50,66.9,68,62.1,118,64.2,2,0,0
1/26/2018 11:15,49,68,66,63.2,115,65.2,2,0,0
1/26/2018 11:20,41,66.9,58,62.1,99,64.1,2,0,0
1/26/2018 11:25,49,68.6,66,64,115,65.9,2,0,0
1/26/2018 11:30,49,67.9,66,63.3,115,65.3,2,0,0
1/26/2018 11:35,47,69.1,65,64.5,112,66.4,2,0,0
1/26/2018 11:40,55,69.4,73,64.9,128,66.8,2,0,0
1/26/2018 11:45,64,68.6,83,64,147,66,2,0,0
1/26/2018 11:50,62,69.7,81,65.1,143,67.1,2,0,0
1/26/2018 11:55,56,70.6,74,66.1,130,68,2,0,0
1/26/2018 12:00,53,70.7,70,66.3,123,68.2,2,0,0
1/26/2018 12:05,47,71.1,64,66.6,111,68.5,2,0,0
1/26/2018 12:10,52,70.4,70,65.8,122,67.8,2,0,0
1/26/2018 12:15,52,70.1,70,65.7,122,67.6,2,0,0
1/26/2018 12:20,50,70.3,69,65.9,119,67.7,2,0,0
1/26/2018 12:25,49,69.6,66,65.1,115,67,2,0,0
1/26/2018 12:30,63,69.8,81,65.2,144,67.2,2,0,0
1/26/2018 12:35,53,70.1,71,65.6,124,67.6,2,0,0
1/26/2018 12:40,55,70,73,65.5,128,67.5,2,0,0
1/26/2018 12:45,58,68.9,76,64.3,134,66.3,2,0,0
1/26/2018 12:50,60,69.7,78,65.1,138,67.1,2,0,0
1/26/2018 12:55,46,70.3,63,65.8,109,67.7,2,0,0
1/26/2018 13:00,52,69.3,70,64.7,122,66.7,2,0,0
1/26/2018 13:05,53,70,71,65.5,124,67.5,2,0,0
1/26/2018 13:10,46,69.3,63,64.8,109,66.7,2,0,0
1/26/2018 13:15,61,69.2,79,64.6,140,66.6,2,0,0
1/26/2018 13:20,58,68.3,78,63.7,136,65.7,2,0,0
1/26/2018 13:25,57,67.5,75,62.8,132,64.8,2,0,0
1/26/2018 13:30,52,67.7,70,62.9,122,64.9,2,0,0
1/26/2018 13:35,49,68.3,66,63.6,115,65.6,2,0,0
1/26/2018 13:40,54,69.4,73,64.8,127,66.8,2,0,0
1/26/2018 13:45,59,69.2,78,64.7,137,66.6,2,0,0
1/26/2018 13:50,57,69.1,76,64.6,133,66.5,2,0,0
1/26/2018 13:55,54,69.6,71,65.1,125,67,2,0,0
1/26/2018 14:00,50,70.3,67,65.9,117,67.8,2,0,0
1/26/2018 14:05,47,71,63,66.6,110,68.5,2,0,0
1/26/2018 14:10,55,69.6,73,65.1,128,67,2,0,0
1/26/2018 14:15,51,70,69,65.4,120,67.4,2,0,0
1/26/2018 14:20,50,67.4,69,62.6,119,64.6,2,0,0
1/26/2018 14:25,52,68.2,70,63.5,122,65.5,2,0,0
1/26/2018 14:30,51,68.1,68,63.4,119,65.4,2,0,0
1/26/2018 14:35,51,68.4,68,63.7,119,65.7,2,0,0
1/26/2018 14:40,54,68,71,63.3,125,65.3,2,0,0
1/26/2018 14:45,44,67.6,61,62.9,105,64.9,2,0,0
1/26/2018 14:50,51,68.8,69,64.2,120,66.2,2,0,0
1/26/2018 14:55,43,69.2,61,64.6,104,66.5,2,0,0
1/26/2018 15:00,46,69.5,63,65,109,66.9,2,0,0
1/26/2018 15:05,51,69.7,69,65,120,67,2,0,0
1/26/2018 15:10,41,69.2,58,64.6,99,66.5,2,0,0
1/26/2018 15:15,49,68.9,67,64.3,116,66.3,2,0,0
1/26/2018 15:20,52,69.3,70,64.7,122,66.7,2,0,0
1/26/2018 15:25,63,69.2,84,64.5,147,66.5,2,0,0
1/26/2018 15:30,65,68.6,85,63.9,150,65.9,2,0,0
1/26/2018 15:35,62,68.9,81,64.3,143,66.3,2,0,0
1/26/2018 15:40,62,69.4,80,64.8,142,66.8,2,0,0
1/26/2018 15:45,64,70,84,65.5,148,67.4,2,0,0
1/26/2018 15:50,53,70,71,65.4,124,67.3,2,0,0
1/26/2018 15:55,51,70.3,69,65.8,120,67.7,2,0,0
1/26/2018 16:00,56,70.9,74,66.4,130,68.4,2,0,0
1/26/2018 16:05,55,70.2,74,65.7,129,67.7,2,0,0
1/26/2018 16:10,62,70.6,81,66.1,143,68,2,0,0
1/26/2018 16:15,56,70.7,74,66.1,130,68.1,2,0,0
1/26/2018 16:20,47,69.7,65,65,112,67,2,0,0
1/26/2018 16:25,51,69.3,69,64.7,120,66.7,2,0,0
1/26/2018 16:30,58,69.7,77,65.1,135,67,2,0,0
1/26/2018 16:35,59,70.1,77,65.4,136,67.4,2,0,0
1/26/2018 16:40,60,70.9,78,66.4,138,68.4,2,0,0
1/26/2018 16:45,50,70.9,68,66.3,118,68.3,2,0,0
1/26/2018 16:50,61,69.8,79,65.1,140,67.2,2,0,0
1/26/2018 16:55,58,70.1,75,65.5,133,67.5,2,0,0
1/26/2018 17:00,54,70.9,72,66.3,126,68.3,2,0,0
1/26/2018 17:05,52,71.2,69,66.7,121,68.6,2,0,0
1/26/2018 17:10,55,71.6,73,67.2,128,69.1,2,0,0
1/26/2018 17:15,54,71.1,72,66.6,126,68.5,2,0,0
1/26/2018 17:20,60,70.4,78,65.9,138,67.8,2,0,0
1/26/2018 17:25,58,68.9,75,64.2,133,66.3,2,0,0
1/26/2018 17:30,47,69.3,66,64.7,113,66.6,2,0,0
1/26/2018 17:35,51,69.5,69,64.9,120,66.9,2,0,0
1/26/2018 17:40,47,68.9,65,64.3,112,66.2,2,0,0
1/26/2018 17:45,47,70.4,65,65.9,112,67.8,2,0,0
1/26/2018 17:50,50,69.7,68,65.1,118,67,2,0,0
1/26/2018 17:55,49,69.9,67,65.3,116,67.2,2,0,0
1/26/2018 18:00,49,69.6,67,64.9,116,66.9,2,0,0
1/26/2018 18:05,47,69,66,64.4,113,66.3,2,0,0
1/26/2018 18:10,50,68.9,67,64.2,117,66.2,2,0,0
1/26/2018 18:15,49,67.8,67,63.1,116,65.1,2,0,0
1/26/2018 18:20,55,68.6,73,64,128,66,2,0,0
1/26/2018 18:25,48,69,66,64.3,114,66.3,2,0,0
1/26/2018 18:30,47,68.8,66,64.1,113,66,2,0,0
1/26/2018 18:35,55,67.4,74,62.6,129,64.6,2,0,0
1/26/2018 18:40,46,68.1,64,63.4,110,65.4,2,0,0
1/26/2018 18:45,52,68,71,63.2,123,65.2,2,0,0
1/26/2018 18:50,45,68.6,63,63.9,108,65.8,2,0,0
1/26/2018 18:55,51,68.3,69,63.6,120,65.6,2,0,0
1/26/2018 19:00,48,69.4,65,64.8,113,66.8,2,0,0
1/26/2018 19:05,54,68.1,73,63.3,127,65.4,2,0,0
1/26/2018 19:10,46,68.4,63,63.7,109,65.7,2,0,0
1/26/2018 19:15,40,68.6,58,63.9,98,65.8,2,0,0
1/26/2018 19:20,42,68.8,60,64.1,102,66.1,2,0,0
1/26/2018 19:25,47,67.8,65,63.1,112,65.1,2,0,0
1/26/2018 19:30,51,68.5,70,63.8,121,65.8,2,0,0
1/26/2018 19:35,40,69.1,57,64.5,97,66.4,2,0,0
1/26/2018 19:40,40,68.9,58,64.2,98,66.1,2,0,0
1/26/2018 19:45,35,69,53,64.3,88,66.2,2,0,0
1/26/2018 19:50,40,68.6,57,64,97,65.9,2,0,0
1/26/2018 19:55,39,68.6,56,64,95,65.9,2,0,0
1/26/2018 20:00,33,69.3,49,64.7,82,66.6,2,0,0
1/26/2018 20:05,35,69.3,51,64.7,86,66.6,2,0,0
1/26/2018 20:10,36,68.9,52,64.2,88,66.1,2,0,0
1/26/2018 20:15,41,69.5,57,64.9,98,66.8,2,0,0
1/26/2018 20:20,41,69.5,58,64.9,99,66.8,2,0,0
1/26/2018 20:25,37,68.8,54,64.2,91,66.1,2,0,0
1/26/2018 20:30,37,69.1,55,64.5,92,66.3,2,0,0
1/26/2018 20:35,32,69.5,48,64.9,80,66.7,2,0,0
1/26/2018 20:40,34,69.4,51,64.9,85,66.7,2,0,0
1/26/2018 20:45,31,68.6,49,64,80,65.8,2,0,0
1/26/2018 20:50,32,69.2,48,64.6,80,66.4,2,0,0
1/26/2018 20:55,35,69.9,51,65.3,86,67.2,2,0,0
1/26/2018 21:00,29,68.5,44,63.9,73,65.7,2,0,0
1/26/2018 21:05,33,69.3,50,64.7,83,66.5,2,0,0
1/26/2018 21:10,27,69.4,43,64.8,70,66.5,2,0,0
1/26/2018 21:15,29,69.2,46,64.6,75,66.4,2,0,0
1/26/2018 21:20,36,70.2,52,65.7,88,67.5,2,0,0
1/26/2018 21:25,28,69.7,44,65.2,72,67,2,0,0
1/26/2018 21:30,31,69.9,47,65.4,78,67.2,2,0,0
1/26/2018 21:35,25,69.5,41,64.9,66,66.7,2,0,0
1/26/2018 21:40,29,69.9,45,65.3,74,67.1,2,0,0
1/26/2018 21:45,25,69.8,41,65.2,66,67,2,0,0
1/26/2018 21:50,31,69.8,47,65.3,78,67.1,2,0,0
1/26/2018 21:55,25,69.5,41,65,66,66.7,2,0,0
1/26/2018 22:00,28,69.7,45,65.2,73,66.9,2,0,0
1/26/2018 22:05,23,69.9,38,65.4,61,67.1,2,0,0
1/26/2018 22:10,26,69.4,42,64.8,68,66.5,2,0,0
1/26/2018 22:15,28,69.2,44,64.6,72,66.4,2,0,0
1/26/2018 22:20,23,69.3,39,64.7,62,66.4,2,0,0
1/26/2018 22:25,30,68.5,46,63.8,76,65.7,2,0,0
1/26/2018 22:30,29,68.8,45,64.2,74,66,2,0,0
1/26/2018 22:35,20,69,36,64.3,56,66,2,0,0
1/26/2018 22:40,23,68.4,39,63.7,62,65.5,2,0,0
1/26/2018 22:45,25,68.5,41,63.9,66,65.6,2,0,0
1/26/2018 22:50,27,68.8,43,64.2,70,65.9,2,0,0
1/26/2018 22:55,19,69.2,34,64.5,53,66.2,2,0,0
1/26/2018 23:00,20,69.2,35,64.6,55,66.3,2,0,0
1/26/2018 23:05,26,69.4,42,64.8,68,66.5,2,0,0
1/26/2018 23:10,16,69,31,64.3,47,65.9,2,0,0
1/26/2018 23:15,21,69.2,37,64.5,58,66.2,2,0,0
1/26/2018 23:20,20,69.4,36,64.7,56,66.4,2,0,0
1/26/2018 23:25,22,69,38,64.4,60,66.1,2,0,0
1/26/2018 23:30,20,69.4,36,64.8,56,66.5,2,0,0
1/26/2018 23:35,16,69.4,31,64.8,47,66.4,2,0,0
1/26/2018 23:40,19,69.5,35,64.9,54,66.5,2,0,0
1/26/2018 23:45,19,69.4,35,64.8,54,66.4,2,0,0
1/26/2018 23:50,23,69.4,38,64.8,61,66.6,2,0,0
1/26/2018 23:55,18,69.5,34,64.9,52,66.5,2,0,0
1/27/2018 0:00,17,69.3,32,64.7,49,66.3,2,0,0
1/27/2018 0:05,18,69.4,33,64.8,51,66.4,2,0,0
1/27/2018 0:10,15,69.1,31,64.5,46,66,2,0,0
1/27/2018 0:15,17,69.4,33,64.8,50,66.3,2,0,0
1/27/2018 0:20,14,69.3,29,64.7,43,66.2,2,0,0
1/27/2018 0:25,19,69.6,35,65,54,66.6,2,0,0
1/27/2018 0:30,13,69.4,28,64.8,41,66.2,2,0,0
1/27/2018 0:35,12,69.3,28,64.7,40,66.1,2,0,0
1/27/2018 0:40,15,69.5,30,64.9,45,66.4,2,0,0
1/27/2018 0:45,10,69.4,26,64.8,36,66.1,2,0,0
1/27/2018 0:50,9,69.4,24,64.8,33,66.1,2,0,0
1/27/2018 0:55,11,69.5,27,64.9,38,66.2,2,0,0
1/27/2018 1:00,8,69.3,24,64.7,32,65.8,2,0,0
1/27/2018 1:05,13,69.4,28,64.8,41,66.3,2,0,0
1/27/2018 1:10,15,69.5,22,64.9,37,66.8,2,0,0
1/27/2018 1:15,11,69.6,26,65,37,66.4,2,0,0
1/27/2018 1:20,11,69.7,27,65.1,38,66.4,2,0,0
1/27/2018 1:25,6,69.5,21,65,27,66,2,0,0
1/27/2018 1:30,12,69.5,27,64.9,39,66.3,2,0,0
1/27/2018 1:35,11,69.2,26,64.5,37,65.9,2,0,0
1/27/2018 1:40,11,69.4,27,64.8,38,66.1,2,0,0
1/27/2018 1:45,12,69.4,27,64.8,39,66.3,2,0,0
1/27/2018 1:50,6,69.4,22,64.8,28,65.8,2,0,0
1/27/2018 1:55,7,69.4,22,64.8,29,65.9,2,0,0
1/27/2018 2:00,6,69.3,21,64.7,27,65.7,2,0,0
1/27/2018 2:05,7,69.4,23,64.8,30,65.9,2,0,0
1/27/2018 2:10,13,69.3,28,64.6,41,66.1,2,0,0
1/27/2018 2:15,7,69,22,64.4,29,65.5,2,0,0
1/27/2018 2:20,10,69.3,25,64.7,35,66,2,0,0
1/27/2018 2:25,11,69.3,27,64.7,38,66,2,0,0
1/27/2018 2:30,9,69.2,24,64.5,33,65.8,2,0,0
1/27/2018 2:35,13,69.2,21,64.6,34,66.4,2,0,0
1/27/2018 2:40,13,69.5,28,64.9,41,66.3,2,0,0
1/27/2018 2:45,7,69.4,22,64.8,29,66,2,0,0
1/27/2018 2:50,8,69.3,24,64.7,32,65.9,2,0,0
1/27/2018 2:55,10,69.2,25,64.6,35,65.9,2,0,0
1/27/2018 3:00,8,69.3,24,64.7,32,65.9,2,0,0
1/27/2018 3:05,8,69.4,24,64.8,32,66,2,0,0
1/27/2018 3:10,9,69.4,24,64.8,33,66.1,2,0,0
1/27/2018 3:15,8,69.4,23,64.8,31,66,2,0,0
1/27/2018 3:20,7,69.4,22,64.8,29,65.9,2,0,0
1/27/2018 3:25,10,69.3,25,64.7,35,66.1,2,0,0
1/27/2018 3:30,10,69.1,25,64.5,35,65.8,2,0,0
1/27/2018 3:35,10,69.2,26,64.6,36,65.9,2,0,0
1/27/2018 3:40,8,69.1,24,64.5,32,65.7,2,0,0
1/27/2018 3:45,11,69,27,64.4,38,65.7,2,0,0
1/27/2018 3:50,9,69.3,24,64.7,33,65.9,2,0,0
1/27/2018 3:55,10,69.3,25,64.7,35,66,2,0,0
1/27/2018 4:00,9,69.4,25,64.8,34,66,2,0,0
1/27/2018 4:05,13,69.4,28,64.8,41,66.2,2,0,0
1/27/2018 4:10,9,69.3,24,64.7,33,66,2,0,0
1/27/2018 4:15,10,69.2,26,64.6,36,65.9,2,0,0
1/27/2018 4:20,14,68.7,30,64.1,44,65.5,2,0,0
1/27/2018 4:25,15,69.1,30,64.4,45,66,2,0,0
1/27/2018 4:30,13,69,29,64.4,42,65.8,2,0,0
1/27/2018 4:35,10,69.2,26,64.6,36,65.9,2,0,0
1/27/2018 4:40,16,69,32,64.3,48,65.9,2,0,0
1/27/2018 4:45,15,69.1,31,64.5,46,66,2,0,0
1/27/2018 4:50,13,69.2,29,64.6,42,66,2,0,0
1/27/2018 4:55,15,68.2,30,63.6,45,65.1,2,0,0
1/27/2018 5:00,12,68.9,27,64.3,39,65.7,2,0,0
1/27/2018 5:05,13,69.2,29,64.6,42,66,2,0,0
1/27/2018 5:10,17,69.3,33,64.7,50,66.3,2,0,0
1/27/2018 5:15,14,69.3,29,64.7,43,66.2,2,0,0
1/27/2018 5:20,17,69.3,33,64.7,50,66.3,2,0,0
1/27/2018 5:25,19,69.4,35,64.8,54,66.4,2,0,0
1/27/2018 5:30,16,69.1,33,64.5,49,66,2,0,0
1/27/2018 5:35,18,69.2,34,64.6,52,66.2,2,0,0
1/27/2018 5:40,28,69.8,45,65.2,73,66.9,2,0,0
1/27/2018 5:45,18,69.5,34,64.9,52,66.5,2,0,0
1/27/2018 5:50,19,69.5,35,64.9,54,66.5,2,0,0
1/27/2018 5:55,18,69.4,34,64.8,52,66.4,2,0,0
1/27/2018 6:00,22,69.3,38,64.7,60,66.4,2,0,0
1/27/2018 6:05,17,69.1,34,64.5,51,66,2,0,0
1/27/2018 6:10,24,69.4,41,64.8,65,66.5,2,0,0
1/27/2018 6:15,25,69.9,41,65.3,66,67,2,0,0
1/27/2018 6:20,29,68.7,46,64.1,75,65.9,2,0,0
1/27/2018 6:25,24,69.1,39,64.4,63,66.2,2,0,0
1/27/2018 6:30,26,68.8,43,64.1,69,65.9,2,0,0
1/27/2018 6:35,27,69.1,44,64.5,71,66.2,2,0,0
1/27/2018 6:40,29,69.3,45,64.7,74,66.5,2,0,0
1/27/2018 6:45,29,68.9,45,64.2,74,66.1,2,0,0
1/27/2018 6:50,28,68.6,45,64,73,65.8,2,0,0
1/27/2018 6:55,24,69.1,40,64.5,64,66.2,2,0,0
1/27/2018 7:00,26,69,42,64.4,68,66.2,2,0,0
1/27/2018 7:05,22,69.1,38,64.5,60,66.2,2,0,0
1/27/2018 7:10,23,69.3,39,64.7,62,66.4,2,0,0
1/27/2018 7:15,31,68.8,48,64.2,79,66,2,0,0
1/27/2018 7:20,30,68.3,47,63.6,77,65.4,2,0,0
1/27/2018 7:25,29,69,45,64.3,74,66.1,2,0,0
1/27/2018 7:30,36,69.7,53,65.1,89,67,2,0,0
1/27/2018 7:35,28,69.6,45,65,73,66.8,2,0,0
1/27/2018 7:40,40,70.2,57,65.7,97,67.6,2,0,0
1/27/2018 7:45,31,69.6,48,65,79,66.8,2,0,0
1/27/2018 7:50,39,70.1,56,65.5,95,67.3,2,0,0
1/27/2018 7:55,39,71.1,56,66.6,95,68.5,2,0,0
1/27/2018 8:00,39,70.7,56,66.2,95,68,2,0,0
1/27/2018 8:05,33,69.8,50,65.2,83,67,2,0,0
1/27/2018 8:10,40,70.1,57,65.6,97,67.4,2,0,0
1/27/2018 8:15,34,69.7,51,65.1,85,66.9,2,0,0
1/27/2018 8:20,39,69.4,55,64.8,94,66.7,2,0,0
1/27/2018 8:25,45,69.7,63,65.2,108,67.1,2,0,0
1/27/2018 8:30,44,70.1,61,65.6,105,67.5,2,0,0
1/27/2018 8:35,55,70.5,73,66.1,128,68,2,0,0
1/27/2018 8:40,49,70.8,66,66.3,115,68.2,2,0,0
1/27/2018 8:45,54,69.7,72,65.1,126,67.1,2,0,0
1/27/2018 8:50,51,69.3,68,64.7,119,66.6,2,0,0
1/27/2018 8:55,56,69.2,74,64.6,130,66.6,2,0,0
1/27/2018 9:00,49,69.7,66,65.1,115,67,2,0,0
1/27/2018 9:05,44,69.9,61,65.3,105,67.2,2,0,0
1/27/2018 9:10,43,69.2,60,64.6,103,66.5,2,0,0
1/27/2018 9:15,52,68.4,70,63.7,122,65.7,2,0,0
1/27/2018 9:20,54,68.8,71,64.2,125,66.2,2,0,0
1/27/2018 9:25,61,69.7,79,65.1,140,67.1,2,0,0
1/27/2018 9:30,58,68.7,76,64,134,66,2,0,0
1/27/2018 9:35,50,68.5,68,63.8,118,65.8,2,0,0
1/27/2018 9:40,51,68.7,70,64.1,121,66,2,0,0
1/27/2018 9:45,69,67.9,89,63.1,158,65.2,2,0,0
1/27/2018 9:50,64,68,84,63.2,148,65.3,2,0,0
1/27/2018 9:55,54,68.3,72,63.6,126,65.6,2,0,0
1/27/2018 10:00,60,69.4,78,64.8,138,66.8,2,0,0
1/27/2018 10:05,59,68.4,78,63.7,137,65.7,2,0,0
1/27/2018 10:10,57,68.1,76,63.3,133,65.3,2,0,0
1/27/2018 10:15,53,68.6,71,64,124,66,2,0,0
1/27/2018 10:20,52,69.2,71,64.5,123,66.5,2,0,0
1/27/2018 10:25,61,68.6,80,63.9,141,66,2,0,0
1/27/2018 10:30,59,69.4,77,64.8,136,66.8,2,0,0
1/27/2018 10:35,65,69,83,64.4,148,66.4,2,0,0
1/27/2018 10:40,64,68,83,63.3,147,65.4,2,0,0
1/27/2018 10:45,62,68.3,81,63.6,143,65.7,2,0,0
1/27/2018 10:50,67,69,86,64.3,153,66.3,2,0,0
1/27/2018 10:55,74,68.6,94,63.9,168,66,2,0,0
1/27/2018 11:00,64,68.5,83,63.9,147,65.9,2,0,0
1/27/2018 11:05,62,69.3,81,64.8,143,66.7,2,0,0
1/27/2018 11:10,65,69.1,84,64.5,149,66.5,2,0,0
1/27/2018 11:15,57,68.2,75,63.5,132,65.5,2,0,0
1/27/2018 11:20,69,68.4,88,63.7,157,65.7,2,0,0
1/27/2018 11:25,66,69.1,84,64.5,150,66.6,2,0,0
1/27/2018 11:30,71,68.8,91,64.2,162,66.2,2,0,0
1/27/2018 11:35,67,68.8,86,64.1,153,66.1,2,0,0
1/27/2018 11:40,73,68.4,93,63.7,166,65.8,2,0,0
1/27/2018 11:45,57,69.6,76,65.1,133,67,2,0,0
1/27/2018 11:50,66,69,85,64.3,151,66.4,2,0,0
1/27/2018 11:55,65,68.9,84,64.2,149,66.3,2,0,0
1/27/2018 12:00,71,68.9,89,64.3,160,66.4,2,0,0
1/27/2018 12:05,70,68.6,89,64,159,66,2,0,0
1/27/2018 12:10,68,67.9,87,63.2,155,65.3,2,0,0
1/27/2018 12:15,68,68.6,87,64,155,66,2,0,0
1/27/2018 12:20,68,69.8,87,65.2,155,67.2,2,0,0
1/27/2018 12:25,70,69.7,88,65.2,158,67.2,2,0,0
1/27/2018 12:30,66,70,85,65.5,151,67.5,2,0,0
1/27/2018 12:35,73,69.3,91,64.7,164,66.8,2,0,0
1/27/2018 12:40,59,69.8,79,65.2,138,67.2,2,0,0
1/27/2018 12:45,73,69.1,93,64.5,166,66.5,2,0,0
1/27/2018 12:50,73,69.1,93,64.5,166,66.6,2,0,0
1/27/2018 12:55,73,68.8,93,64.2,166,66.2,2,0,0
1/27/2018 13:00,75,68.2,94,63.5,169,65.6,2,0,0
1/27/2018 13:05,67,69.3,84,64.7,151,66.7,2,0,0
1/27/2018 13:10,62,68.2,80,63.4,142,65.5,2,0,0
1/27/2018 13:15,67,68.7,86,64.1,153,66.1,2,0,0
1/27/2018 13:20,62,69.3,80,64.7,142,66.7,2,0,0
1/27/2018 13:25,62,68.8,80,64.2,142,66.2,2,0,0
1/27/2018 13:30,61,69.1,79,64.5,140,66.5,2,0,0
1/27/2018 13:35,61,69.1,80,64.5,141,66.5,2,0,0
1/27/2018 13:40,62,68.8,80,64.2,142,66.2,2,0,0
1/27/2018 13:45,52,70.6,71,66.1,123,68,2,0,0
1/27/2018 13:50,68,70.7,87,66.3,155,68.3,2,0,0
1/27/2018 13:55,59,71,78,66.6,137,68.5,2,0,0
1/27/2018 14:00,61,69.1,80,64.5,141,66.5,2,0,0
1/27/2018 14:05,63,69.4,81,64.8,144,66.9,2,0,0
1/27/2018 14:10,58,68.4,77,63.7,135,65.7,2,0,0
1/27/2018 14:15,64,68.5,83,63.8,147,65.8,2,0,0
1/27/2018 14:20,61,69,79,64.4,140,66.4,2,0,0
1/27/2018 14:25,55,68.3,74,63.5,129,65.6,2,0,0
1/27/2018 14:30,57,69.1,74,64.4,131,66.5,2,0,0
1/27/2018 14:35,53,68.5,71,63.8,124,65.8,2,0,0
1/27/2018 14:40,62,68.3,81,63.5,143,65.6,2,0,0
1/27/2018 14:45,57,68.5,76,63.8,133,65.8,2,0,0
1/27/2018 14:50,57,68.6,74,63.9,131,65.9,2,0,0
1/27/2018 14:55,58,68.6,77,64,135,66,2,0,0
1/27/2018 15:00,63,69.5,82,65,145,66.9,2,0,0
1/27/2018 15:05,67,69.7,86,65.1,153,67.1,2,0,0
1/27/2018 15:10,60,69.4,79,64.8,139,66.8,2,0,0
1/27/2018 15:15,55,69.3,73,64.7,128,66.7,2,0,0
1/27/2018 15:20,61,69.4,79,64.8,140,66.8,2,0,0
1/27/2018 15:25,58,68.8,76,64.1,134,66.1,2,0,0
1/27/2018 15:30,64,68.9,82,64.3,146,66.3,2,0,0
1/27/2018 15:35,53,69.1,71,64.4,124,66.4,2,0,0
1/27/2018 15:40,63,68.8,82,64.2,145,66.2,2,0,0
1/27/2018 15:45,66,68.8,84,64.1,150,66.2,2,0,0
1/27/2018 15:50,66,68.4,85,63.7,151,65.8,2,0,0
1/27/2018 15:55,58,68.6,76,63.9,134,66,2,0,0
1/27/2018 16:00,58,68.4,76,63.7,134,65.7,2,0,0
1/27/2018 16:05,62,68,82,63.2,144,65.3,2,0,0
1/27/2018 16:10,72,68.1,91,63.3,163,65.4,2,0,0
1/27/2018 16:15,67,68.1,87,63.3,154,65.4,2,0,0
1/27/2018 16:20,83,68.7,104,63.9,187,66,2,0,0
1/27/2018 16:25,74,68.5,94,63.8,168,65.8,2,0,0
1/27/2018 16:30,71,68.3,91,63.6,162,65.7,2,0,0
1/27/2018 16:35,75,68.2,96,63.4,171,65.5,2,0,0
1/27/2018 16:40,78,67.7,98,62.9,176,65,2,0,0
1/27/2018 16:45,74,68.4,95,63.7,169,65.8,2,0,0
1/27/2018 16:50,69,69.2,89,64.6,158,66.6,2,0,0
1/27/2018 16:55,64,69.5,82,64.9,146,66.9,2,0,0
1/27/2018 17:00,63,69.9,81,65.4,144,67.4,2,0,0
1/27/2018 17:05,52,70.7,70,66.2,122,68.1,2,0,0
1/27/2018 17:10,54,70.7,71,66.3,125,68.2,2,0,0
1/27/2018 17:15,54,69.5,72,65,126,66.9,2,0,0
1/27/2018 17:20,55,69.4,73,64.9,128,66.8,2,0,0
1/27/2018 17:25,49,70,67,65.5,116,67.4,2,0,0
1/27/2018 17:30,49,69.3,67,64.7,116,66.7,2,0,0
1/27/2018 17:35,54,69.7,72,65.1,126,67.1,2,0,0
1/27/2018 17:40,56,68.9,74,64.2,130,66.2,2,0,0
1/27/2018 17:45,60,68.2,79,63.5,139,65.6,2,0,0
1/27/2018 17:50,51,68.8,70,64.2,121,66.1,2,0,0
1/27/2018 17:55,54,67.9,72,63.2,126,65.2,2,0,0
1/27/2018 18:00,49,69.1,67,64.5,116,66.5,2,0,0
1/27/2018 18:05,58,69.1,77,64.6,135,66.5,2,0,0
1/27/2018 18:10,59,68.6,78,64,137,66,2,0,0
1/27/2018 18:15,65,68.3,83,63.6,148,65.7,2,0,0
1/27/2018 18:20,58,68.8,76,64.2,134,66.2,2,0,0
1/27/2018 18:25,60,68.9,79,64.3,139,66.3,2,0,0
1/27/2018 18:30,60,67.1,78,62.2,138,64.3,2,0,0
1/27/2018 18:35,57,67.7,75,62.9,132,65,2,0,0
1/27/2018 18:40,51,68.6,68,63.9,119,65.9,2,0,0
1/27/2018 18:45,50,68.1,68,63.4,118,65.4,2,0,0
1/27/2018 18:50,56,67.4,74,62.6,130,64.7,2,0,0
1/27/2018 18:55,47,68,65,63.3,112,65.3,2,0,0
1/27/2018 19:00,47,67.9,65,63.2,112,65.2,2,0,0
1/27/2018 19:05,39,67.7,55,62.9,94,64.9,2,0,0
1/27/2018 19:10,40,68.5,56,63.8,96,65.7,2,0,0
1/27/2018 19:15,50,68.8,67,64,117,66.1,2,0,0
1/27/2018 19:20,41,68.9,58,64.2,99,66.2,2,0,0
1/27/2018 19:25,42,68.9,59,64.3,101,66.2,2,0,0
1/27/2018 19:30,44,69.6,61,65,105,66.9,2,0,0
1/27/2018 19:35,41,69.2,57,64.6,98,66.5,2,0,0
1/27/2018 19:40,36,68.9,52,64.2,88,66.1,2,0,0
1/27/2018 19:45,43,68.9,59,64.2,102,66.2,2,0,0
1/27/2018 19:50,34,68.8,51,64.2,85,66.1,2,0,0
1/27/2018 19:55,38,68.2,55,63.5,93,65.4,2,0,0
1/27/2018 20:00,36,67.9,52,63.2,88,65.1,2,0,0
1/27/2018 20:05,35,68.2,52,63.5,87,65.4,2,0,0
1/27/2018 20:10,32,69,48,64.4,80,66.2,2,0,0
1/27/2018 20:15,30,69.2,46,64.6,76,66.4,2,0,0
1/27/2018 20:20,29,69.6,44,65,73,66.8,2,0,0
1/27/2018 20:25,27,69.2,43,64.5,70,66.3,2,0,0
1/27/2018 20:30,24,69.2,40,64.5,64,66.3,2,0,0
1/27/2018 20:35,23,69.1,39,64.5,62,66.2,2,0,0
1/27/2018 20:40,23,69.3,39,64.7,62,66.4,2,0,0
1/27/2018 20:45,19,69.4,34,64.8,53,66.4,2,0,0
1/27/2018 20:50,21,69.6,36,65,57,66.7,2,0,0
1/27/2018 20:55,24,69.5,40,64.9,64,66.6,2,0,0
1/27/2018 21:00,23,69.4,39,64.8,62,66.5,2,0,0
1/27/2018 21:05,23,68.9,39,64.3,62,66,2,0,0
1/27/2018 21:10,25,68.8,41,64.2,66,65.9,2,0,0
1/27/2018 21:15,30,69,46,64.4,76,66.2,2,0,0
1/27/2018 21:20,28,69.3,44,64.7,72,66.5,2,0,0
1/27/2018 21:25,20,69.5,36,64.9,56,66.5,2,0,0
1/27/2018 21:30,24,69,40,64.4,64,66.1,2,0,0
1/27/2018 21:35,30,69.1,47,64.5,77,66.3,2,0,0
1/27/2018 21:40,25,69,41,64.3,66,66.1,2,0,0
1/27/2018 21:45,19,68.5,35,63.9,54,65.5,2,0,0
1/27/2018 21:50,24,69.1,40,64.5,64,66.2,2,0,0
1/27/2018 21:55,22,69.3,38,64.7,60,66.4,2,0,0
1/27/2018 22:00,17,69.3,34,64.7,51,66.3,2,0,0
1/27/2018 22:05,19,69.3,35,64.7,54,66.3,2,0,0
1/27/2018 22:10,18,69.2,34,64.5,52,66.1,2,0,0
1/27/2018 22:15,20,68.9,36,64.3,56,65.9,2,0,0
1/27/2018 22:20,19,68.9,35,64.3,54,65.9,2,0,0
1/27/2018 22:25,20,69.1,36,64.4,56,66.1,2,0,0
1/27/2018 22:30,24,68.9,40,64.3,64,66,2,0,0
1/27/2018 22:35,23,68.8,40,64.2,63,65.9,2,0,0
1/27/2018 22:40,23,69.4,39,64.7,62,66.4,2,0,0
1/27/2018 22:45,16,69.3,31,64.7,47,66.3,2,0,0
1/27/2018 22:50,16,69.3,32,64.7,48,66.2,2,0,0
1/27/2018 22:55,15,69.2,31,64.6,46,66.1,2,0,0
1/27/2018 23:00,12,69.3,28,64.7,40,66,2,0,0
1/27/2018 23:05,17,69.4,33,64.8,50,66.3,2,0,0
1/27/2018 23:10,17,69.2,33,64.6,50,66.2,2,0,0
1/27/2018 23:15,14,69.3,29,64.7,43,66.2,2,0,0
1/27/2018 23:20,13,69.2,29,64.6,42,66,2,0,0
1/27/2018 23:25,13,69.3,29,64.7,42,66.1,2,0,0
1/27/2018 23:30,14,69.3,30,64.7,44,66.2,2,0,0
1/27/2018 23:35,15,69.4,30,64.8,45,66.3,2,0,0
1/27/2018 23:40,15,69.4,31,64.8,46,66.3,2,0,0
1/27/2018 23:45,14,69.3,30,64.7,44,66.1,2,0,0
1/27/2018 23:50,12,69.3,27,64.7,39,66.1,2,0,0
1/27/2018 23:55,13,69.3,28,64.7,41,66.2,2,0,0
1/28/2018 0:00,10,69.3,25,64.7,35,66.1,2,0,0
1/28/2018 0:05,11,69.3,26,64.7,37,66.1,2,0,0
1/28/2018 0:10,14,69.3,29,64.7,43,66.2,2,0,0
1/28/2018 0:15,10,69.4,25,64.8,35,66.1,2,0,0
1/28/2018 0:20,10,69.3,26,64.7,36,66,2,0,0
1/28/2018 0:25,8,69.3,23,64.7,31,65.9,2,0,0
1/28/2018 0:30,7,69.4,23,64.8,30,65.8,2,0,0
1/28/2018 0:35,12,69.2,27,64.5,39,66,2,0,0
1/28/2018 0:40,8,69.2,24,64.6,32,65.7,2,0,0
1/28/2018 0:45,9,69.4,24,64.8,33,66,2,0,0
1/28/2018 0:50,7,69.3,23,64.7,30,65.7,2,0,0
1/28/2018 0:55,7,69.3,23,64.7,30,65.8,2,0,0
1/28/2018 1:00,9,69.2,24,64.5,33,65.8,2,0,0
1/28/2018 1:05,7,69.3,22,64.7,29,65.8,2,0,0
1/28/2018 1:10,7,69.3,23,64.7,30,65.7,2,0,0
1/28/2018 1:15,8,69.3,23,64.7,31,65.9,2,0,0
1/28/2018 1:20,7,69.3,22,64.7,29,65.8,2,0,0
1/28/2018 1:25,6,69.4,21,64.8,27,65.8,2,0,0
1/28/2018 1:30,6,69.3,21,64.7,27,65.7,2,0,0
1/28/2018 1:35,6,69.4,21,64.8,27,65.8,2,0,0
1/28/2018 1:40,7,69.4,22,64.8,29,66,2,0,0
1/28/2018 1:45,5,69.4,20,64.8,25,65.8,2,0,0
1/28/2018 1:50,10,69.4,20,64.8,30,66.4,2,0,0
1/28/2018 1:55,6,69.4,22,64.8,28,65.8,2,0,0
1/28/2018 2:00,7,69.3,22,64.7,29,65.8,2,0,0
1/28/2018 2:05,7,69.4,22,64.8,29,65.9,2,0,0
1/28/2018 2:10,7,69.4,23,64.8,30,65.9,2,0,0
1/28/2018 2:15,6,69.2,21,64.6,27,65.6,2,0,0
1/28/2018 2:20,7,69.2,22,64.5,29,65.7,2,0,0
1/28/2018 2:25,8,69.2,24,64.6,32,65.8,2,0,0
1/28/2018 2:30,7,69.2,22,64.5,29,65.7,2,0,0
1/28/2018 2:35,8,69.3,23,64.7,31,65.9,2,0,0
1/28/2018 2:40,6,69.3,21,64.7,27,65.7,2,0,0
1/28/2018 2:45,6,69.2,22,64.6,28,65.6,2,0,0
1/28/2018 2:50,5,69.3,20,64.7,25,65.6,2,0,0
1/28/2018 2:55,7,69.2,22,64.6,29,65.7,2,0,0
1/28/2018 3:00,8,69.2,23,64.6,31,65.8,2,0,0
1/28/2018 3:05,8,69.3,23,64.7,31,65.9,2,0,0
1/28/2018 3:10,5,69.3,20,64.7,25,65.6,2,0,0
1/28/2018 3:15,6,69.4,21,64.8,27,65.8,2,0,0
1/28/2018 3:20,8,69.4,23,64.8,31,66,2,0,0
1/28/2018 3:25,6,69.4,21,64.8,27,65.8,2,0,0
1/28/2018 3:30,9,69.3,25,64.7,34,66,2,0,0
1/28/2018 3:35,10,69.4,20,64.8,30,66.3,2,0,0
1/28/2018 3:40,6,69.4,21,64.8,27,65.9,2,0,0
1/28/2018 3:45,6,69.4,21,64.8,27,65.9,2,0,0
1/28/2018 3:50,8,69.4,24,64.8,32,65.9,2,0,0
1/28/2018 3:55,4,69.5,20,64.9,24,65.7,2,0,0
1/28/2018 4:00,9,69.4,24,64.8,33,66,2,0,0
1/28/2018 4:05,7,69.4,23,64.8,30,65.8,2,0,0
1/28/2018 4:10,7,69.4,22,64.8,29,65.9,2,0,0
1/28/2018 4:15,5,69.3,20,64.7,25,65.6,2,0,0
1/28/2018 4:20,5,69.3,21,64.7,26,65.6,2,0,0
1/28/2018 4:25,9,69.4,24,64.8,33,66.1,2,0,0
1/28/2018 4:30,9,69.4,24,64.8,33,66.1,2,0,0
1/28/2018 4:35,10,69.4,25,64.8,35,66.1,2,0,0
1/28/2018 4:40,8,69.4,24,64.8,32,65.9,2,0,0
1/28/2018 4:45,12,69.3,27,64.7,39,66.1,2,0,0
1/28/2018 4:50,8,69.3,23,64.7,31,65.8,2,0,0
1/28/2018 4:55,8,69.3,24,64.7,32,65.8,2,0,0
1/28/2018 5:00,7,69.3,23,64.7,30,65.8,2,0,0
1/28/2018 5:05,10,69.3,25,64.7,35,66,2,0,0
1/28/2018 5:10,7,69.4,22,64.8,29,65.9,2,0,0
1/28/2018 5:15,8,69.4,23,64.8,31,66,2,0,0
1/28/2018 5:20,10,69.3,25,64.7,35,66.1,2,0,0
1/28/2018 5:25,11,69.3,27,64.7,38,66,2,0,0
1/28/2018 5:30,11,69.3,26,64.7,37,66.1,2,0,0
1/28/2018 5:35,9,69.3,25,64.7,34,65.9,2,0,0
1/28/2018 5:40,13,69.3,28,64.7,41,66.2,2,0,0
1/28/2018 5:45,11,69.2,27,64.6,38,65.9,2,0,0
1/28/2018 5:50,13,69.3,28,64.7,41,66.2,2,0,0
1/28/2018 5:55,10,69.4,25,64.7,35,66.1,2,0,0
1/28/2018 6:00,9,69.4,24,64.8,33,66,2,0,0
1/28/2018 6:05,13,69.2,28,64.6,41,66,2,0,0
1/28/2018 6:10,12,69,27,64.4,39,65.8,2,0,0
1/28/2018 6:15,19,69.3,34,64.7,53,66.3,2,0,0
1/28/2018 6:20,17,69.2,33,64.6,50,66.2,2,0,0
1/28/2018 6:25,17,69.3,33,64.7,50,66.3,2,0,0
1/28/2018 6:30,14,69.2,30,64.6,44,66.1,2,0,0
1/28/2018 6:35,20,69.1,36,64.4,56,66.1,2,0,0
1/28/2018 6:40,17,69.1,33,64.5,50,66.1,2,0,0
1/28/2018 6:45,17,69.3,33,64.7,50,66.2,2,0,0
1/28/2018 6:50,15,69.2,31,64.6,46,66.1,2,0,0
1/28/2018 6:55,17,69.3,33,64.7,50,66.2,2,0,0
1/28/2018 7:00,17,69.2,33,64.6,50,66.2,2,0,0
1/28/2018 7:05,17,69.2,32,64.6,49,66.2,2,0,0
1/28/2018 7:10,17,69.2,33,64.6,50,66.2,2,0,0
1/28/2018 7:15,19,69.2,35,64.5,54,66.2,2,0,0
1/28/2018 7:20,21,69.1,37,64.4,58,66.1,2,0,0
1/28/2018 7:25,17,69.1,33,64.5,50,66.1,2,0,0
1/28/2018 7:30,20,69.2,36,64.6,56,66.3,2,0,0
1/28/2018 7:35,21,69.2,37,64.5,58,66.2,2,0,0
1/28/2018 7:40,26,69.2,42,64.6,68,66.3,2,0,0
1/28/2018 7:45,20,69.3,36,64.7,56,66.3,2,0,0
1/28/2018 7:50,21,69.3,37,64.7,58,66.4,2,0,0
1/28/2018 7:55,24,69.3,40,64.7,64,66.4,2,0,0
1/28/2018 8:00,26,69.3,42,64.7,68,66.4,2,0,0
1/28/2018 8:05,21,69.3,37,64.7,58,66.3,2,0,0
1/28/2018 8:10,20,69.4,36,64.8,56,66.4,2,0,0
1/28/2018 8:15,27,69.4,43,64.8,70,66.6,2,0,0
1/28/2018 8:20,35,69.1,51,64.4,86,66.3,2,0,0
1/28/2018 8:25,36,69.3,53,64.7,89,66.5,2,0,0
1/28/2018 8:30,29,69.1,46,64.5,75,66.3,2,0,0
1/28/2018 8:35,32,69.2,48,64.6,80,66.4,2,0,0
1/28/2018 8:40,36,69,53,64.4,89,66.2,2,0,0
1/28/2018 8:45,38,69.2,55,64.5,93,66.4,2,0,0
1/28/2018 8:50,45,69.3,62,64.7,107,66.7,2,0,0
1/28/2018 8:55,42,69.4,58,64.7,100,66.7,2,0,0
1/28/2018 9:00,32,69.9,48,65.3,80,67.1,2,0,0
1/28/2018 9:05,22,69.6,37,65,59,66.7,2,0,0
1/28/2018 9:10,27,69.4,43,64.8,70,66.5,2,0,0
1/28/2018 9:15,40,68.7,56,64.1,96,66,2,0,0
1/28/2018 9:20,38,69.1,55,64.5,93,66.4,2,0,0
1/28/2018 9:25,41,69.3,57,64.7,98,66.7,2,0,0
1/28/2018 9:30,46,68.9,63,64.2,109,66.2,2,0,0
1/28/2018 9:35,42,69.3,59,64.7,101,66.6,2,0,0
1/28/2018 9:40,46,69.7,64,65.1,110,67,2,0,0
1/28/2018 9:45,48,69.3,64,64.7,112,66.7,2,0,0
1/28/2018 9:50,47,69.6,66,65.1,113,67,2,0,0
1/28/2018 9:55,53,69.6,71,65,124,67,2,0,0
1/28/2018 10:00,35,68.7,51,64.1,86,66,2,0,0
1/28/2018 10:05,52,69.1,70,64.5,122,66.5,2,0,0
1/28/2018 10:10,48,68.6,66,63.9,114,65.9,2,0,0
1/28/2018 10:15,46,68.9,63,64.2,109,66.2,2,0,0
1/28/2018 10:20,38,68.5,54,63.8,92,65.7,2,0,0
1/28/2018 10:25,35,68.8,52,64.2,87,66,2,0,0
1/28/2018 10:30,56,68.8,74,64.1,130,66.1,2,0,0
1/28/2018 10:35,39,68.9,56,64.3,95,66.2,2,0,0
1/28/2018 10:40,54,68.1,72,63.4,126,65.4,2,0,0
1/28/2018 10:45,57,69,75,64.4,132,66.4,2,0,0
1/28/2018 10:50,51,69,69,64.4,120,66.4,2,0,0
1/28/2018 10:55,45,68.7,63,64.1,108,66,2,0,0
1/28/2018 11:00,45,68.6,62,63.9,107,65.9,2,0,0
1/28/2018 11:05,47,68.5,64,63.8,111,65.8,2,0,0
1/28/2018 11:10,37,68.4,54,63.8,91,65.7,2,0,0
1/28/2018 11:15,47,68.8,64,64.1,111,66,2,0,0
1/28/2018 11:20,44,69,62,64.4,106,66.3,2,0,0
1/28/2018 11:25,57,68.4,75,63.7,132,65.7,2,0,0
1/28/2018 11:30,43,67.9,60,63.2,103,65.1,2,0,0
1/28/2018 11:35,49,69.6,67,65,116,66.9,2,0,0
1/28/2018 11:40,45,69.4,62,64.8,107,66.7,2,0,0
1/28/2018 11:45,54,69.6,73,65.1,127,67,2,0,0
1/28/2018 11:50,62,70,80,65.5,142,67.4,2,0,0
1/28/2018 11:55,38,69.7,54,65.1,92,67,2,0,0
1/28/2018 12:00,46,69.9,64,65.4,110,67.3,2,0,0
1/28/2018 12:05,61,69.1,80,64.5,141,66.5,2,0,0
1/28/2018 12:10,50,69.2,67,64.6,117,66.6,2,0,0
1/28/2018 12:15,39,68.2,55,63.5,94,65.4,2,0,0
1/28/2018 12:20,47,68,64,63.3,111,65.3,2,0,0
1/28/2018 12:25,58,68.8,77,64.2,135,66.2,2,0,0
1/28/2018 12:30,43,69.4,62,64.8,105,66.7,2,0,0
1/28/2018 12:35,58,69,76,64.4,134,66.4,2,0,0
1/28/2018 12:40,64,69.6,82,65,146,67,2,0,0
1/28/2018 12:45,57,69.4,76,64.8,133,66.7,2,0,0
1/28/2018 12:50,65,69.3,84,64.7,149,66.7,2,0,0
1/28/2018 12:55,53,69.2,71,64.7,124,66.6,2,0,0
1/28/2018 13:00,58,69.2,76,64.6,134,66.6,2,0,0
1/28/2018 13:05,62,69.2,81,64.6,143,66.6,2,0,0
1/28/2018 13:10,51,68.6,69,63.9,120,65.9,2,0,0
1/28/2018 13:15,64,69.5,83,65,147,67,2,0,0
1/28/2018 13:20,58,69.4,76,64.9,134,66.8,2,0,0
1/28/2018 13:25,49,69,67,64.4,116,66.3,2,0,0
1/28/2018 13:30,57,69.1,75,64.5,132,66.4,2,0,0
1/28/2018 13:35,59,69.5,77,64.9,136,66.9,2,0,0
1/28/2018 13:40,61,69.1,79,64.5,140,66.5,2,0,0
1/28/2018 13:45,65,69.3,83,64.7,148,66.7,2,0,0
1/28/2018 13:50,54,68.4,72,63.7,126,65.8,2,0,0
1/28/2018 13:55,66,68.6,84,64,150,66,2,0,0
1/28/2018 14:00,55,68.9,74,64.2,129,66.2,2,0,0
1/28/2018 14:05,49,68.9,66,64.3,115,66.3,2,0,0
1/28/2018 14:10,56,68.8,73,64.1,129,66.2,2,0,0
1/28/2018 14:15,47,68.3,64,63.6,111,65.6,2,0,0
1/28/2018 14:20,44,68.6,61,63.9,105,65.9,2,0,0
1/28/2018 14:25,46,68.5,64,63.9,110,65.8,2,0,0
1/28/2018 14:30,33,68.7,49,64,82,65.9,2,0,0
1/28/2018 14:35,40,68.9,58,64.3,98,66.2,2,0,0
1/28/2018 14:40,38,69.4,54,64.8,92,66.7,2,0,0
1/28/2018 14:45,43,69.3,61,64.7,104,66.6,2,0,0
1/28/2018 14:50,42,69.6,59,65,101,66.9,2,0,0
1/28/2018 14:55,45,69.7,62,65.1,107,67,2,0,0
1/28/2018 15:00,37,69.8,54,65.2,91,67.1,2,0,0
1/28/2018 15:05,25,69.7,42,65.1,67,66.8,2,0,0
1/28/2018 15:10,39,69.8,56,65.2,95,67.1,2,0,0
1/28/2018 15:15,30,69.6,47,65,77,66.8,2,0,0
1/28/2018 15:20,42,69.4,59,64.8,101,66.7,2,0,0
1/28/2018 15:25,34,69.9,51,65.4,85,67.2,2,0,0
1/28/2018 15:30,47,70,65,65.5,112,67.4,2,0,0
1/28/2018 15:35,36,69.5,54,64.9,90,66.8,2,0,0
1/28/2018 15:40,44,69.7,61,65.1,105,67.1,2,0,0
1/28/2018 15:45,38,69.8,55,65.3,93,67.1,2,0,0
1/28/2018 15:50,31,69.6,48,65.1,79,66.9,2,0,0
1/28/2018 15:55,36,69.5,52,65,88,66.8,2,0,0
1/28/2018 16:00,50,70.3,67,65.8,117,67.7,2,0,0
1/28/2018 16:05,58,70.5,77,66,135,68,2,0,0
1/28/2018 16:10,40,69.5,57,65,97,66.8,2,0,0
1/28/2018 16:15,53,69.3,71,64.6,124,66.6,2,0,0
1/28/2018 16:20,52,69.4,71,64.8,123,66.8,2,0,0
1/28/2018 16:25,39,70,55,65.4,94,67.3,2,0,0
1/28/2018 16:30,40,69.9,57,65.4,97,67.3,2,0,0
1/28/2018 16:35,47,70.2,64,65.7,111,67.6,2,0,0
1/28/2018 16:40,41,69.8,59,65.2,100,67.1,2,0,0
1/28/2018 16:45,53,69.2,70,64.6,123,66.6,2,0,0
1/28/2018 16:50,59,68.9,78,64.2,137,66.2,2,0,0
1/28/2018 16:55,54,68.5,72,63.8,126,65.8,2,0,0
1/28/2018 17:00,48,69.9,65,65.4,113,67.3,2,0,0
1/28/2018 17:05,58,70.1,76,65.6,134,67.5,2,0,0
1/28/2018 17:10,46,70.4,64,65.9,110,67.8,2,0,0
1/28/2018 17:15,52,71.2,71,66.8,123,68.6,2,0,0
1/28/2018 17:20,53,70.2,71,65.7,124,67.6,2,0,0
1/28/2018 17:25,68,70.2,86,65.7,154,67.7,2,0,0
1/28/2018 17:30,48,69.8,65,65.2,113,67.2,2,0,0
1/28/2018 17:35,49,70.1,66,65.5,115,67.5,2,0,0
1/28/2018 17:40,53,69.6,71,64.9,124,66.9,2,0,0
1/28/2018 17:45,60,69,78,64.2,138,66.3,2,0,0
1/28/2018 17:50,62,68.8,81,64,143,66.1,2,0,0
1/28/2018 17:55,51,68.9,69,64.2,120,66.2,2,0,0
1/28/2018 18:00,51,68.3,69,63.5,120,65.6,2,0,0
1/28/2018 18:05,52,68.1,69,63.3,121,65.4,2,0,0
1/28/2018 18:10,44,67.8,62,63,106,65,2,0,0
1/28/2018 18:15,53,68.5,70,63.8,123,65.8,2,0,0
1/28/2018 18:20,44,67.8,61,63,105,65,2,0,0
1/28/2018 18:25,58,68,76,63.3,134,65.3,2,0,0
1/28/2018 18:30,48,68,65,63.2,113,65.2,2,0,0
1/28/2018 18:35,60,68.4,79,63.7,139,65.7,2,0,0
1/28/2018 18:40,49,67.9,67,63.2,116,65.2,2,0,0
1/28/2018 18:45,45,68.4,62,63.8,107,65.7,2,0,0
1/28/2018 18:50,45,67.9,63,63.1,108,65.1,2,0,0
1/28/2018 18:55,54,68.5,72,63.8,126,65.8,2,0,0
1/28/2018 19:00,38,68.3,55,63.6,93,65.5,2,0,0
1/28/2018 19:05,37,68.1,54,63.4,91,65.3,2,0,0
1/28/2018 19:10,50,69.1,68,64.5,118,66.5,2,0,0
1/28/2018 19:15,40,69,57,64.4,97,66.3,2,0,0
1/28/2018 19:20,37,69.2,54,64.6,91,66.4,2,0,0
1/28/2018 19:25,32,69.4,48,64.8,80,66.6,2,0,0
1/28/2018 19:30,28,69.4,44,64.8,72,66.6,2,0,0
1/28/2018 19:35,34,69.1,50,64.5,84,66.4,2,0,0
1/28/2018 19:40,36,69.8,53,65.3,89,67.1,2,0,0
1/28/2018 19:45,33,69.7,48,65.1,81,66.9,2,0,0
1/28/2018 19:50,33,69.5,49,64.9,82,66.8,2,0,0
1/28/2018 19:55,28,69.4,44,64.8,72,66.6,2,0,0
1/28/2018 20:00,29,69.4,45,64.8,74,66.6,2,0,0
1/28/2018 20:05,38,69.2,55,64.6,93,66.5,2,0,0
1/28/2018 20:10,33,69.4,49,64.7,82,66.6,2,0,0
1/28/2018 20:15,34,68.9,50,64.2,84,66.1,2,0,0
1/28/2018 20:20,25,69.2,41,64.6,66,66.4,2,0,0
1/28/2018 20:25,21,68.9,37,64.2,58,65.9,2,0,0
1/28/2018 20:30,32,68.8,48,64.1,80,66,2,0,0
1/28/2018 20:35,26,69,43,64.4,69,66.1,2,0,0
1/28/2018 20:40,19,69,35,64.4,54,66,2,0,0
1/28/2018 20:45,21,69.3,37,64.7,58,66.4,2,0,0
1/28/2018 20:50,22,68.6,38,64,60,65.7,2,0,0
1/28/2018 20:55,15,68.9,30,64.3,45,65.9,2,0,0
1/28/2018 21:00,21,69.3,37,64.7,58,66.3,2,0,0
1/28/2018 21:05,16,69.4,32,64.8,48,66.3,2,0,0
1/28/2018 21:10,21,69.3,37,64.7,58,66.3,2,0,0
1/28/2018 21:15,23,69.3,39,64.7,62,66.4,2,0,0
1/28/2018 21:20,27,69.4,43,64.8,70,66.6,2,0,0
1/28/2018 21:25,24,69.3,40,64.7,64,66.4,2,0,0
1/28/2018 21:30,20,68.7,36,64,56,65.7,2,0,0
1/28/2018 21:35,15,69.1,31,64.5,46,66,2,0,0
1/28/2018 21:40,24,69,40,64.4,64,66.1,2,0,0
1/28/2018 21:45,24,69.2,40,64.6,64,66.3,2,0,0
1/28/2018 21:50,19,69.4,35,64.8,54,66.4,2,0,0
1/28/2018 21:55,19,69.4,34,64.8,53,66.4,2,0,0
1/28/2018 22:00,16,69.5,31,64.9,47,66.5,2,0,0
1/28/2018 22:05,21,69.4,37,64.8,58,66.4,2,0,0
1/28/2018 22:10,22,69.1,38,64.5,60,66.2,2,0,0
1/28/2018 22:15,16,69.2,31,64.5,47,66.1,2,0,0
1/28/2018 22:20,18,69.2,33,64.5,51,66.2,2,0,0
1/28/2018 22:25,15,69.2,31,64.6,46,66.1,2,0,0
1/28/2018 22:30,15,69.3,30,64.7,45,66.3,2,0,0
1/28/2018 22:35,22,69.2,38,64.6,60,66.3,2,0,0
1/28/2018 22:40,16,69.3,31,64.7,47,66.3,2,0,0
1/28/2018 22:45,17,69.3,32,64.7,49,66.3,2,0,0
1/28/2018 22:50,14,69.3,30,64.7,44,66.2,2,0,0
1/28/2018 22:55,16,69.3,32,64.7,48,66.3,2,0,0
1/28/2018 23:00,15,69.3,31,64.7,46,66.2,2,0,0
1/28/2018 23:05,18,69.3,34,64.7,52,66.3,2,0,0
1/28/2018 23:10,19,69.4,35,64.8,54,66.4,2,0,0
1/28/2018 23:15,14,69.3,29,64.7,43,66.2,2,0,0
1/28/2018 23:20,10,69.3,26,64.7,36,66,2,0,0
1/28/2018 23:25,10,69,25,64.4,35,65.7,2,0,0
1/28/2018 23:30,13,69,28,64.4,41,65.9,2,0,0
1/28/2018 23:35,10,69.1,26,64.5,36,65.8,2,0,0
1/28/2018 23:40,10,69.2,25,64.6,35,65.9,2,0,0
1/28/2018 23:45,12,69.3,27,64.7,39,66.2,2,0,0
1/28/2018 23:50,14,69.3,29,64.7,43,66.2,2,0,0
1/28/2018 23:55,14,69.3,29,64.7,43,66.2,2,0,0
