5 Minutes,Lane 1 Flow (Veh/5 Minutes),Lane 1 Speed (mph),Lane 2 Flow (Veh/5 Minutes),Lane 2 Speed (mph),Flow (Veh/5 Minutes),Speed (mph),# Lane Points,% Observed,Holiday
9/25/2017 0:00,10,69.3,26,64.7,36,66,2,0,0
9/25/2017 0:05,14,69.4,30,64.8,44,66.2,2,0,0
9/25/2017 0:10,11,69.3,27,64.7,38,66.1,2,0,0
9/25/2017 0:15,12,69.4,27,64.8,39,66.3,2,0,0
9/25/2017 0:20,16,69.5,32,64.9,48,66.5,2,0,0
9/25/2017 0:25,11,69.3,26,64.7,37,66.1,2,0,0
9/25/2017 0:30,13,69.3,29,64.7,42,66.2,2,0,0
9/25/2017 0:35,9,69.3,24,64.7,33,65.9,2,0,0
9/25/2017 0:40,9,69.3,24,64.7,33,66,2,0,0
9/25/2017 0:45,11,69.3,26,64.7,37,66.1,2,0,0
9/25/2017 0:50,8,69.3,24,64.7,32,65.9,2,0,0
9/25/2017 0:55,8,69.3,23,64.7,31,65.9,2,0,0
9/25/2017 1:00,8,69.4,23,64.8,31,66,2,0,0
9/25/2017 1:05,7,69.3,23,64.7,30,65.8,2,0,0
9/25/2017 1:10,7,69.4,22,64.8,29,65.9,2,0,0
9/25/2017 1:15,9,69.4,24,64.8,33,66.1,2,0,0
9/25/2017 1:20,7,69.4,22,64.8,29,65.9,2,0,0
9/25/2017 1:25,6,69.4,22,64.8,28,65.8,2,0,0
9/25/2017 1:30,14,69.2,22,64.6,36,66.4,2,0,0
9/25/2017 1:35,5,69.2,21,64.6,26,65.5,2,0,0
9/25/2017 1:40,9,69.3,24,64.7,33,65.9,2,0,0
9/25/2017 1:45,10,69,26,64.4,36,65.7,2,0,0
9/25/2017 1:50,12,69,21,64.3,33,66,2,0,0
9/25/2017 1:55,13,69.2,21,64.5,34,66.3,2,0,0
9/25/2017 2:00,11,69.2,21,64.6,32,66.2,2,0,0
9/25/2017 2:05,7,69.2,22,64.6,29,65.7,2,0,0
9/25/2017 2:10,8,69.2,24,64.6,32,65.8,2,0,0
9/25/2017 2:15,7,69.2,22,64.5,29,65.7,2,0,0
9/25/2017 2:20,6,69.2,21,64.6,27,65.6,2,0,0
9/25/2017 2:25,7,69.3,23,64.7,30,65.7,2,0,0
9/25/2017 2:30,8,69.1,23,64.5,31,65.7,2,0,0
9/25/2017 2:35,5,69.2,20,64.6,25,65.5,2,0,0
9/25/2017 2:40,11,69.2,26,64.6,37,66,2,0,0
9/25/2017 2:45,6,69.2,21,64.6,27,65.6,2,0,0
9/25/2017 2:50,13,69.3,28,64.7,41,66.2,2,0,0
9/25/2017 2:55,6,69.4,22,64.8,28,65.8,2,0,0
9/25/2017 3:00,7,69.3,23,64.7,30,65.8,2,0,0
9/25/2017 3:05,9,69.4,25,64.8,34,66,2,0,0
9/25/2017 3:10,11,69.4,26,64.7,37,66.1,2,0,0
9/25/2017 3:15,9,69.3,25,64.7,34,66,2,0,0
9/25/2017 3:20,7,69.4,23,64.8,30,65.8,2,0,0
9/25/2017 3:25,9,69.3,24,64.7,33,66,2,0,0
9/25/2017 3:30,8,69.2,24,64.6,32,65.7,2,0,0
9/25/2017 3:35,11,69.2,27,64.6,38,66,2,0,0
9/25/2017 3:40,12,69.2,27,64.6,39,66,2,0,0
9/25/2017 3:45,15,69.3,30,64.7,45,66.2,2,0,0
9/25/2017 3:50,14,68.8,30,64.1,44,65.6,2,0,0
9/25/2017 3:55,9,69,24,64.4,33,65.7,2,0,0
9/25/2017 4:00,17,68.9,33,64.2,50,65.8,2,0,0
9/25/2017 4:05,15,69,31,64.4,46,65.9,2,0,0
9/25/2017 4:10,16,68.5,32,63.8,48,65.4,2,0,0
9/25/2017 4:15,20,68.8,36,64.2,56,65.8,2,0,0
9/25/2017 4:20,24,69.1,40,64.4,64,66.2,2,0,0
9/25/2017 4:25,27,69.4,43,64.7,70,66.5,2,0,0
9/25/2017 4:30,27,69.3,43,64.6,70,66.4,2,0,0
9/25/2017 4:35,31,69.1,48,64.5,79,66.3,2,0,0
9/25/2017 4:40,36,69.2,53,64.5,89,66.4,2,0,0
9/25/2017 4:45,40,67.5,58,62.7,98,64.7,2,0,0
9/25/2017 4:50,48,68.6,66,63.9,114,65.9,2,0,0
9/25/2017 4:55,42,69.3,60,64.6,102,66.5,2,0,0
9/25/2017 5:00,38,69,56,64.4,94,66.3,2,0,0
9/25/2017 5:05,44,68.7,63,63.9,107,65.9,2,0,0
9/25/2017 5:10,53,66.9,73,62,126,64,2,0,0
9/25/2017 5:15,49,66.3,69,61.4,118,63.5,2,0,0
9/25/2017 5:20,58,66.2,79,61.2,137,63.3,2,0,0
9/25/2017 5:25,56,66.3,77,61.4,133,63.5,2,0,0
9/25/2017 5:30,60,66.8,80,61.9,140,64,2,0,0
9/25/2017 5:35,75,68.5,96,63.8,171,65.8,2,0,0
9/25/2017 5:40,61,67.3,83,62.5,144,64.5,2,0,0
9/25/2017 5:45,70,67.9,92,63.1,162,65.2,2,0,0
9/25/2017 5:50,86,66.8,110,61.8,196,64,2,0,0
9/25/2017 5:55,59,66.3,79,61.3,138,63.5,2,0,0
9/25/2017 6:00,61,66.2,82,61.3,143,63.4,2,0,0
9/25/2017 6:05,69,66.5,90,61.6,159,63.7,2,0,0
9/25/2017 6:10,59,67.5,79,62.7,138,64.8,2,0,0
9/25/2017 6:15,61,67.7,81,62.8,142,64.9,2,0,0
9/25/2017 6:20,76,65.5,98,60.5,174,62.7,2,0,0
9/25/2017 6:25,68,65.7,89,60.6,157,62.8,2,0,0
9/25/2017 6:30,64,64.8,85,59.6,149,61.8,2,0,0
9/25/2017 6:35,72,64.8,94,59.6,166,61.8,2,0,0
9/25/2017 6:40,78,65.7,100,60.7,178,62.9,2,0,0
9/25/2017 6:45,67,66.1,89,61,156,63.2,2,0,0
9/25/2017 6:50,62,66.3,83,61.3,145,63.5,2,0,0
9/25/2017 6:55,64,66.8,86,61.9,150,64,2,0,0
9/25/2017 7:00,63,67.6,84,62.7,147,64.8,2,0,0
9/25/2017 7:05,73,67.8,95,63,168,65.1,2,0,0
9/25/2017 7:10,78,68,100,63.1,178,65.3,2,0,0
9/25/2017 7:15,70,67.9,92,63,162,65.1,2,0,0
9/25/2017 7:20,77,67.8,99,63,176,65.1,2,0,0
9/25/2017 7:25,80,66.7,102,61.6,182,63.9,2,0,0
9/25/2017 7:30,72,67.2,94,62.2,166,64.4,2,0,0
9/25/2017 7:35,73,67,95,62.1,168,64.2,2,0,0
9/25/2017 7:40,86,67.3,108,62.3,194,64.5,2,0,0
9/25/2017 7:45,82,66,105,60.9,187,63.1,2,0,0
9/25/2017 7:50,79,67.1,101,62.1,180,64.3,2,0,0
9/25/2017 7:55,77,66.1,99,61,176,63.2,2,0,0
9/25/2017 8:00,79,65.3,102,60.2,181,62.4,2,0,0
9/25/2017 8:05,76,64.4,98,59.2,174,61.5,2,0,0
9/25/2017 8:10,89,65.8,112,60.8,201,63,2,0,0
9/25/2017 8:15,79,65.4,102,60.4,181,62.6,2,0,0
9/25/2017 8:20,82,65.4,104,60.4,186,62.6,2,0,0
9/25/2017 8:25,73,66.2,94,61.2,167,63.4,2,0,0
9/25/2017 8:30,79,65,102,59.9,181,62.1,2,0,0
9/25/2017 8:35,54,64.7,75,59.6,129,61.7,2,0,0
9/25/2017 8:40,64,65.6,84,60.6,148,62.7,2,0,0
9/25/2017 8:45,82,66.2,104,61.3,186,63.5,2,0,0
9/25/2017 8:50,70,65.7,90,60.7,160,62.9,2,0,0
9/25/2017 8:55,71,66.4,92,61.4,163,63.6,2,0,0
9/25/2017 9:00,68,66.6,88,61.7,156,63.8,2,0,0
9/25/2017 9:05,70,65.9,91,60.9,161,63.1,2,0,0
9/25/2017 9:10,69,66.3,89,61.4,158,63.5,2,0,0
9/25/2017 9:15,69,66.2,90,61.2,159,63.3,2,0,0
9/25/2017 9:20,70,66.2,91,61.2,161,63.4,2,0,0
9/25/2017 9:25,66,65,87,59.9,153,62.1,2,0,0
9/25/2017 9:30,62,64.9,82,59.8,144,62,2,0,0
9/25/2017 9:35,70,65.3,91,60.2,161,62.4,2,0,0
9/25/2017 9:40,71,64.8,94,59.7,165,61.9,2,0,0
9/25/2017 9:45,79,64.9,101,59.8,180,62.1,2,0,0
9/25/2017 9:50,78,64.8,99,59.7,177,61.9,2,0,0
9/25/2017 9:55,73,64.4,93,59.3,166,61.6,2,0,0
9/25/2017 10:00,67,64,87,58.9,154,61.1,2,0,0
9/25/2017 10:05,80,63.2,101,58,181,60.3,2,0,0
9/25/2017 10:10,56,64.7,75,59.6,131,61.8,2,0,0
9/25/2017 10:15,57,65.6,75,60.5,132,62.7,2,0,0
9/25/2017 10:20,70,65.2,91,60.1,161,62.4,2,0,0
9/25/2017 10:25,62,65.2,81,60.2,143,62.4,2,0,0
9/25/2017 10:30,64,66.3,84,61.3,148,63.5,2,0,0
9/25/2017 10:35,71,67.6,91,62.8,162,64.9,2,0,0
9/25/2017 10:40,60,67.5,78,62.7,138,64.8,2,0,0
9/25/2017 10:45,58,66.1,76,61.1,134,63.3,2,0,0
9/25/2017 10:50,53,66.3,71,61.4,124,63.5,2,0,0
9/25/2017 10:55,63,66.3,82,61.4,145,63.6,2,0,0
9/25/2017 11:00,54,66.1,72,61.2,126,63.3,2,0,0
9/25/2017 11:05,59,65.8,77,60.9,136,63,2,0,0
9/25/2017 11:10,59,65.8,77,60.8,136,63,2,0,0
9/25/2017 11:15,58,65.8,77,60.9,135,63,2,0,0
9/25/2017 11:20,57,66.2,76,61.3,133,63.4,2,0,0
9/25/2017 11:25,55,66.1,73,61.3,128,63.4,2,0,0
9/25/2017 11:30,48,66.1,66,61.2,114,63.2,2,0,0
9/25/2017 11:35,53,66.2,72,61.4,125,63.4,2,0,0
9/25/2017 11:40,55,66.3,73,61.4,128,63.5,2,0,0
9/25/2017 11:45,58,66,76,61,134,63.2,2,0,0
9/25/2017 11:50,60,65.3,79,60.4,139,62.5,2,0,0
9/25/2017 11:55,45,65,61,60.1,106,62.2,2,0,0
9/25/2017 12:00,56,65.5,74,60.5,130,62.7,2,0,0
9/25/2017 12:05,43,66.6,60,61.6,103,63.7,2,0,0
9/25/2017 12:10,54,65.5,71,60.5,125,62.7,2,0,0
9/25/2017 12:15,53,66.2,70,61.3,123,63.4,2,0,0
9/25/2017 12:20,51,66.7,69,61.9,120,63.9,2,0,0
9/25/2017 12:25,42,67.5,59,62.7,101,64.7,2,0,0
9/25/2017 12:30,51,66.9,70,62.1,121,64.1,2,0,0
9/25/2017 12:35,51,66,69,61.1,120,63.2,2,0,0
9/25/2017 12:40,51,66.3,69,61.4,120,63.5,2,0,0
9/25/2017 12:45,45,67.2,63,62.4,108,64.4,2,0,0
9/25/2017 12:50,41,65.9,58,61.1,99,63.1,2,0,0
9/25/2017 12:55,54,65.9,72,61,126,63.1,2,0,0
9/25/2017 13:00,40,66.7,57,61.9,97,63.9,2,0,0
9/25/2017 13:05,41,65,58,60,99,62.1,2,0,0
9/25/2017 13:10,51,66,69,61.1,120,63.2,2,0,0
9/25/2017 13:15,46,66.2,63,61.4,109,63.4,2,0,0
9/25/2017 13:20,49,66.3,67,61.4,116,63.5,2,0,0
9/25/2017 13:25,56,66.6,75,61.8,131,63.8,2,0,0
9/25/2017 13:30,48,67.1,66,62.2,114,64.3,2,0,0
9/25/2017 13:35,50,67.4,66,62.7,116,64.7,2,0,0
9/25/2017 13:40,56,66.3,73,61.5,129,63.6,2,0,0
9/25/2017 13:45,52,66.7,70,62,122,64,2,0,0
9/25/2017 13:50,42,66.7,59,61.9,101,63.9,2,0,0
9/25/2017 13:55,46,65.6,64,60.7,110,62.8,2,0,0
9/25/2017 14:00,49,66,66,61.1,115,63.2,2,0,0
9/25/2017 14:05,46,66.2,63,61.3,109,63.3,2,0,0
9/25/2017 14:10,42,66.5,59,61.6,101,63.7,2,0,0
9/25/2017 14:15,49,67.2,66,62.4,115,64.5,2,0,0
9/25/2017 14:20,47,66.1,64,61.2,111,63.3,2,0,0
9/25/2017 14:25,57,67.1,76,62.3,133,64.4,2,0,0
9/25/2017 14:30,53,67,71,62.2,124,64.2,2,0,0
9/25/2017 14:35,45,66.8,63,62,108,64,2,0,0
9/25/2017 14:40,47,67.6,65,62.8,112,64.8,2,0,0
9/25/2017 14:45,45,66.8,62,62,107,64,2,0,0
9/25/2017 14:50,49,66.2,66,61.4,115,63.5,2,0,0
9/25/2017 14:55,49,66.2,67,61.4,116,63.5,2,0,0
9/25/2017 15:00,49,68,66,63.3,115,65.3,2,0,0
9/25/2017 15:05,44,65.8,62,60.9,106,63,2,0,0
9/25/2017 15:10,52,64.7,70,59.7,122,61.8,2,0,0
9/25/2017 15:15,51,64.9,68,60,119,62.1,2,0,0
9/25/2017 15:20,59,66.4,78,61.6,137,63.6,2,0,0
9/25/2017 15:25,53,66.6,71,61.8,124,63.8,2,0,0
9/25/2017 15:30,52,66.1,70,61.2,122,63.3,2,0,0
9/25/2017 15:35,59,66.4,77,61.5,136,63.6,2,0,0
9/25/2017 15:40,61,66.8,79,62,140,64.1,2,0,0
9/25/2017 15:45,61,65.9,80,61,141,63.1,2,0,0
9/25/2017 15:50,57,66.8,75,62,132,64.1,2,0,0
9/25/2017 15:55,53,67.6,71,62.9,124,64.9,2,0,0
9/25/2017 16:00,59,66.8,77,62,136,64.1,2,0,0
9/25/2017 16:05,55,67.7,73,62.9,128,65,2,0,0
9/25/2017 16:10,52,65.8,70,60.8,122,62.9,2,0,0
9/25/2017 16:15,54,66.5,71,61.7,125,63.8,2,0,0
9/25/2017 16:20,60,66.5,78,61.7,138,63.8,2,0,0
9/25/2017 16:25,57,66.9,76,62.1,133,64.1,2,0,0
9/25/2017 16:30,62,67.7,80,62.9,142,65,2,0,0
9/25/2017 16:35,53,67.4,71,62.6,124,64.7,2,0,0
9/25/2017 16:40,61,67.1,79,62.3,140,64.4,2,0,0
9/25/2017 16:45,62,67.4,81,62.6,143,64.6,2,0,0
9/25/2017 16:50,47,67.7,65,62.9,112,64.9,2,0,0
9/25/2017 16:55,53,67,70,62.2,123,64.3,2,0,0
9/25/2017 17:00,57,67.8,76,63,133,65.1,2,0,0
9/25/2017 17:05,56,67.8,74,63.1,130,65.1,2,0,0
9/25/2017 17:10,50,67.8,68,63,118,65.1,2,0,0
9/25/2017 17:15,54,67.1,72,62.2,126,64.3,2,0,0
9/25/2017 17:20,53,66.9,72,62,125,64.1,2,0,0
9/25/2017 17:25,52,67.7,70,62.9,122,64.9,2,0,0
9/25/2017 17:30,51,67.3,70,62.5,121,64.5,2,0,0
9/25/2017 17:35,59,66.7,78,61.7,137,63.8,2,0,0
9/25/2017 17:40,56,66.6,75,61.6,131,63.8,2,0,0
9/25/2017 17:45,51,65.6,70,60.6,121,62.7,2,0,0
9/25/2017 17:50,70,65.5,90,60.5,160,62.7,2,0,0
9/25/2017 17:55,52,66.4,70,61.4,122,63.5,2,0,0
9/25/2017 18:00,49,66.7,67,61.8,116,63.9,2,0,0
9/25/2017 18:05,58,66.1,77,61.3,135,63.4,2,0,0
9/25/2017 18:10,58,66.4,78,61.6,136,63.6,2,0,0
9/25/2017 18:15,58,66.2,77,61.4,135,63.5,2,0,0
9/25/2017 18:20,60,67.2,78,62.4,138,64.5,2,0,0
9/25/2017 18:25,60,66.8,78,62,138,64,2,0,0
9/25/2017 18:30,67,67,86,62.2,153,64.3,2,0,0
9/25/2017 18:35,56,67.4,74,62.6,130,64.7,2,0,0
9/25/2017 18:40,45,66.8,62,62,107,64,2,0,0
9/25/2017 18:45,42,66.6,59,61.8,101,63.8,2,0,0
9/25/2017 18:50,37,67.8,53,63.1,90,65,2,0,0
9/25/2017 18:55,45,66.8,62,62,107,64.1,2,0,0
9/25/2017 19:00,38,67.8,55,63,93,64.9,2,0,0
9/25/2017 19:05,42,68.5,59,63.8,101,65.7,2,0,0
9/25/2017 19:10,38,69.2,55,64.5,93,66.4,2,0,0
9/25/2017 19:15,31,68.9,48,64.3,79,66.1,2,0,0
9/25/2017 19:20,38,67.7,55,63,93,64.9,2,0,0
9/25/2017 19:25,41,67.9,58,63.1,99,65.1,2,0,0
9/25/2017 19:30,42,67.4,59,62.6,101,64.6,2,0,0
9/25/2017 19:35,34,68.3,51,63.6,85,65.5,2,0,0
9/25/2017 19:40,34,68.4,51,63.7,85,65.6,2,0,0
9/25/2017 19:45,29,68.8,45,64.2,74,66,2,0,0
9/25/2017 19:50,33,68.8,49,64.1,82,66,2,0,0
9/25/2017 19:55,33,68.9,49,64.3,82,66.1,2,0,0
9/25/2017 20:00,32,69.1,48,64.4,80,66.3,2,0,0
9/25/2017 20:05,35,68.8,52,64.2,87,66,2,0,0
9/25/2017 20:10,35,68,52,63.3,87,65.2,2,0,0
9/25/2017 20:15,32,68.5,48,63.8,80,65.6,2,0,0
9/25/2017 20:20,34,68.7,50,63.9,84,65.9,2,0,0
9/25/2017 20:25,32,67.2,48,62.5,80,64.4,2,0,0
9/25/2017 20:30,34,67.8,50,63.1,84,65,2,0,0
9/25/2017 20:35,30,67.9,46,63.1,76,65,2,0,0
9/25/2017 20:40,27,68.7,44,64,71,65.7,2,0,0
9/25/2017 20:45,26,68.8,42,64.1,68,65.9,2,0,0
9/25/2017 20:50,30,69.1,47,64.4,77,66.3,2,0,0
9/25/2017 20:55,26,69.6,41,65,67,66.8,2,0,0
9/25/2017 21:00,26,68.6,42,63.9,68,65.7,2,0,0
9/25/2017 21:05,26,68.1,42,63.4,68,65.2,2,0,0
9/25/2017 21:10,23,68.2,39,63.5,62,65.3,2,0,0
9/25/2017 21:15,27,68.7,43,64,70,65.8,2,0,0
9/25/2017 21:20,32,68.9,48,64.2,80,66.1,2,0,0
9/25/2017 21:25,26,68.8,42,64.1,68,65.9,2,0,0
9/25/2017 21:30,30,69.1,46,64.5,76,66.3,2,0,0
9/25/2017 21:35,27,68.6,43,63.9,70,65.7,2,0,0
9/25/2017 21:40,21,68.8,37,64.1,58,65.8,2,0,0
9/25/2017 21:45,26,68.9,43,64.3,69,66,2,0,0
9/25/2017 21:50,26,69,42,64.4,68,66.2,2,0,0
9/25/2017 21:55,22,69.2,38,64.5,60,66.2,2,0,0
9/25/2017 22:00,28,68.9,44,64.2,72,66,2,0,0
9/25/2017 22:05,24,69,39,64.4,63,66.2,2,0,0
9/25/2017 22:10,31,69,47,64.3,78,66.2,2,0,0
9/25/2017 22:15,17,69.1,33,64.5,50,66,2,0,0
9/25/2017 22:20,16,69.1,32,64.5,48,66,2,0,0
9/25/2017 22:25,18,68.9,34,64.2,52,65.8,2,0,0
9/25/2017 22:30,25,68.5,42,63.9,67,65.6,2,0,0
9/25/2017 22:35,17,68.9,33,64.3,50,65.9,2,0,0
9/25/2017 22:40,14,68.9,30,64.2,44,65.7,2,0,0
9/25/2017 22:45,15,69.2,30,64.5,45,66.1,2,0,0
9/25/2017 22:50,21,69.3,37,64.7,58,66.4,2,0,0
9/25/2017 22:55,17,69.3,33,64.7,50,66.3,2,0,0
9/25/2017 23:00,17,69.3,32,64.7,49,66.3,2,0,0
9/25/2017 23:05,12,69.3,28,64.7,40,66,2,0,0
9/25/2017 23:10,13,68.9,28,64.3,41,65.7,2,0,0
9/25/2017 23:15,13,69,29,64.4,42,65.8,2,0,0
9/25/2017 23:20,12,68.8,27,64.2,39,65.6,2,0,0
9/25/2017 23:25,15,69.1,30,64.5,45,66,2,0,0
9/25/2017 23:30,15,69.2,30,64.6,45,66.1,2,0,0
9/25/2017 23:35,16,69.3,32,64.7,48,66.2,2,0,0
9/25/2017 23:40,15,69.4,31,64.8,46,66.3,2,0,0
9/25/2017 23:45,11,69.3,27,64.7,38,66,2,0,0
9/25/2017 23:50,14,69.4,29,64.8,43,66.3,2,0,0
9/25/2017 23:55,12,69.3,28,64.6,40,66,2,0,0
9/26/2017 0:00,11,69.3,26,64.7,37,66.1,2,0,0
9/26/2017 0:05,10,69.4,26,64.8,36,66.1,2,0,0
9/26/2017 0:10,9,69.3,24,64.7,33,66,2,0,0
9/26/2017 0:15,11,69.4,27,64.8,38,66.1,2,0,0
9/26/2017 0:20,9,69.3,25,64.7,34,66,2,0,0
9/26/2017 0:25,9,69.4,24,64.8,33,66,2,0,0
9/26/2017 0:30,7,69.3,22,64.7,29,65.8,2,0,0
9/26/2017 0:35,8,68.9,23,64.3,31,65.5,2,0,0
9/26/2017 0:40,8,69.1,24,64.5,32,65.7,2,0,0
9/26/2017 0:45,10,69.2,25,64.6,35,65.9,2,0,0
9/26/2017 0:50,9,69.2,24,64.6,33,65.9,2,0,0
9/26/2017 0:55,7,69.3,22,64.7,29,65.8,2,0,0
9/26/2017 1:00,7,69.3,22,64.7,29,65.8,2,0,0
9/26/2017 1:05,5,69.3,21,64.7,26,65.6,2,0,0
9/26/2017 1:10,5,69.3,21,64.7,26,65.6,2,0,0
9/26/2017 1:15,7,69.5,22,64.9,29,66,2,0,0
9/26/2017 1:20,8,69.5,23,64.9,31,66,2,0,0
9/26/2017 1:25,6,69.4,21,64.8,27,65.8,2,0,0
9/26/2017 1:30,7,69.4,23,64.8,30,65.8,2,0,0
9/26/2017 1:35,9,69.4,25,64.7,34,66,2,0,0
9/26/2017 1:40,7,69.4,22,64.8,29,65.9,2,0,0
9/26/2017 1:45,6,69.4,21,64.8,27,65.8,2,0,0
9/26/2017 1:50,5,69.4,20,64.8,25,65.7,2,0,0
9/26/2017 1:55,7,69.4,22,64.8,29,65.9,2,0,0
9/26/2017 2:00,7,69.4,22,64.8,29,65.9,2,0,0
9/26/2017 2:05,6,69.3,22,64.7,28,65.7,2,0,0
9/26/2017 2:10,9,69.3,25,64.7,34,65.9,2,0,0
9/26/2017 2:15,6,69.3,21,64.7,27,65.7,2,0,0
9/26/2017 2:20,9,69.3,24,64.7,33,66,2,0,0
9/26/2017 2:25,7,69.1,22,64.5,29,65.6,2,0,0
9/26/2017 2:30,7,69.2,23,64.6,30,65.7,2,0,0
9/26/2017 2:35,10,69,26,64.4,36,65.6,2,0,0
9/26/2017 2:40,9,69.1,24,64.5,33,65.7,2,0,0
9/26/2017 2:45,8,69.2,23,64.6,31,65.8,2,0,0
9/26/2017 2:50,10,69.3,26,64.7,36,66,2,0,0
9/26/2017 2:55,11,69.3,27,64.7,38,66,2,0,0
9/26/2017 3:00,10,69.4,25,64.8,35,66.1,2,0,0
9/26/2017 3:05,8,69.4,24,64.8,32,66,2,0,0
9/26/2017 3:10,10,69.5,26,64.9,36,66.2,2,0,0
9/26/2017 3:15,14,69.1,30,64.4,44,65.9,2,0,0
9/26/2017 3:20,9,69.2,25,64.5,34,65.8,2,0,0
9/26/2017 3:25,9,69.2,26,64.6,35,65.8,2,0,0
9/26/2017 3:30,10,69.3,26,64.7,36,65.9,2,0,0
9/26/2017 3:35,8,69.3,24,64.7,32,65.9,2,0,0
9/26/2017 3:40,14,69.2,30,64.5,44,66,2,0,0
9/26/2017 3:45,13,69.2,28,64.5,41,66,2,0,0
9/26/2017 3:50,14,69.3,31,64.7,45,66.1,2,0,0
9/26/2017 3:55,14,69.2,30,64.5,44,66,2,0,0
9/26/2017 4:00,10,69.2,25,64.5,35,65.9,2,0,0
9/26/2017 4:05,17,68.4,33,63.8,50,65.4,2,0,0
9/26/2017 4:10,16,69,32,64.4,48,65.9,2,0,0
9/26/2017 4:15,23,69.3,40,64.7,63,66.3,2,0,0
9/26/2017 4:20,16,69.4,32,64.8,48,66.3,2,0,0
9/26/2017 4:25,20,69.4,37,64.8,57,66.4,2,0,0
9/26/2017 4:30,24,69.4,40,64.8,64,66.6,2,0,0
9/26/2017 4:35,29,69.5,45,65,74,66.8,2,0,0
9/26/2017 4:40,32,68.4,49,63.8,81,65.6,2,0,0
9/26/2017 4:45,41,69.9,59,65.3,100,67.2,2,0,0
9/26/2017 4:50,33,69.3,52,64.8,85,66.5,2,0,0
9/26/2017 4:55,40,69.1,58,64.6,98,66.4,2,0,0
9/26/2017 5:00,35,68.6,52,63.9,87,65.8,2,0,0
9/26/2017 5:05,38,68.6,56,64,94,65.9,2,0,0
9/26/2017 5:10,42,69,61,64.4,103,66.3,2,0,0
9/26/2017 5:15,56,69,77,64.4,133,66.3,2,0,0
9/26/2017 5:20,54,69.4,74,64.9,128,66.8,2,0,0
9/26/2017 5:25,61,69.8,81,65.4,142,67.3,2,0,0
9/26/2017 5:30,55,68.9,76,64.3,131,66.2,2,0,0
9/26/2017 5:35,63,68,85,63.3,148,65.3,2,0,0
9/26/2017 5:40,67,68.3,90,63.6,157,65.6,2,0,0
9/26/2017 5:45,66,68.3,88,63.5,154,65.6,2,0,0
9/26/2017 5:50,61,68,82,63.3,143,65.3,2,0,0
9/26/2017 5:55,70,67.9,92,63.2,162,65.2,2,0,0
9/26/2017 6:00,54,66.4,74,61.5,128,63.6,2,0,0
9/26/2017 6:05,55,67.3,76,62.4,131,64.5,2,0,0
9/26/2017 6:10,62,66,83,61,145,63.2,2,0,0
9/26/2017 6:15,66,65.4,87,60.3,153,62.5,2,0,0
9/26/2017 6:20,62,65.5,83,60.5,145,62.6,2,0,0
9/26/2017 6:25,70,66.1,93,61.1,163,63.2,2,0,0
9/26/2017 6:30,71,66.3,93,61.3,164,63.4,2,0,0
9/26/2017 6:35,63,66.3,85,61.3,148,63.4,2,0,0
9/26/2017 6:40,67,67.5,89,62.5,156,64.7,2,0,0
9/26/2017 6:45,68,67.7,90,62.7,158,64.9,2,0,0
9/26/2017 6:50,66,68.3,88,63.5,154,65.5,2,0,0
9/26/2017 6:55,70,67.2,92,62.3,162,64.4,2,0,0
9/26/2017 7:00,69,67.3,91,62.4,160,64.5,2,0,0
9/26/2017 7:05,71,67.2,92,62.4,163,64.5,2,0,0
9/26/2017 7:10,72,67.9,95,63.1,167,65.1,2,0,0
9/26/2017 7:15,75,67.9,98,63.1,173,65.2,2,0,0
9/26/2017 7:20,73,66.9,94,62,167,64.2,2,0,0
9/26/2017 7:25,77,67.3,100,62.5,177,64.6,2,0,0
9/26/2017 7:30,77,67.8,100,63,177,65.1,2,0,0
9/26/2017 7:35,86,67.1,109,62.2,195,64.3,2,0,0
9/26/2017 7:40,92,67.4,116,62.5,208,64.7,2,0,0
9/26/2017 7:45,81,67.9,105,63,186,65.1,2,0,0
9/26/2017 7:50,85,66.8,107,61.8,192,64,2,0,0
9/26/2017 7:55,86,66.8,109,61.9,195,64,2,0,0
9/26/2017 8:00,81,67.1,103,62.2,184,64.4,2,0,0
9/26/2017 8:05,75,66.9,97,61.9,172,64.1,2,0,0
9/26/2017 8:10,82,66.2,104,61.3,186,63.4,2,0,0
9/26/2017 8:15,85,65.7,108,60.7,193,62.9,2,0,0
9/26/2017 8:20,69,64,91,58.8,160,61,2,0,0
9/26/2017 8:25,68,65.1,90,60,158,62.2,2,0,0
9/26/2017 8:30,73,65.9,95,60.9,168,63.1,2,0,0
9/26/2017 8:35,76,66.2,99,61.2,175,63.4,2,0,0
9/26/2017 8:40,78,65.4,100,60.3,178,62.5,2,0,0
9/26/2017 8:45,81,65.3,103,60.2,184,62.5,2,0,0
9/26/2017 8:50,81,65.5,104,60.4,185,62.7,2,0,0
9/26/2017 8:55,79,63.8,100,58.6,179,60.9,2,0,0
9/26/2017 9:00,72,65.2,91,60.1,163,62.4,2,0,0
9/26/2017 9:05,89,66,112,60.8,201,63.1,2,0,0
9/26/2017 9:10,68,67,89,62,157,64.1,2,0,0
9/26/2017 9:15,85,66.8,108,61.9,193,64,2,0,0
9/26/2017 9:20,73,65.1,96,60.1,169,62.2,2,0,0
9/26/2017 9:25,71,64.7,92,59.7,163,61.9,2,0,0
9/26/2017 9:30,76,63.3,98,58.1,174,60.4,2,0,0
9/26/2017 9:35,69,65,88,60,157,62.2,2,0,0
9/26/2017 9:40,60,66.6,79,61.7,139,63.8,2,0,0
9/26/2017 9:45,74,66.1,96,61.1,170,63.2,2,0,0
9/26/2017 9:50,80,67.1,101,62.3,181,64.4,2,0,0
9/26/2017 9:55,72,65.8,93,60.8,165,62.9,2,0,0
9/26/2017 10:00,60,65,80,60.1,140,62.2,2,0,0
9/26/2017 10:05,65,65.7,85,60.8,150,62.9,2,0,0
9/26/2017 10:10,68,65.6,89,60.7,157,62.8,2,0,0
9/26/2017 10:15,74,65.7,95,60.8,169,63,2,0,0
9/26/2017 10:20,68,66.1,88,61.2,156,63.3,2,0,0
9/26/2017 10:25,73,66,94,61.1,167,63.3,2,0,0
9/26/2017 10:30,67,66.2,87,61.4,154,63.5,2,0,0
9/26/2017 10:35,70,67,90,62.3,160,64.4,2,0,0
9/26/2017 10:40,72,68.6,91,64.1,163,66.1,2,0,0
9/26/2017 10:45,62,69.1,81,64.6,143,66.5,2,0,0
9/26/2017 10:50,61,68.6,79,64.1,140,66,2,0,0
9/26/2017 10:55,57,67.8,76,63.1,133,65.1,2,0,0
9/26/2017 11:00,61,66.8,80,62,141,64.1,2,0,0
9/26/2017 11:05,62,66.3,81,61.5,143,63.6,2,0,0
9/26/2017 11:10,58,66.4,76,61.5,134,63.6,2,0,0
9/26/2017 11:15,67,67.1,88,62.3,155,64.4,2,0,0
9/26/2017 11:20,59,66.6,77,61.9,136,63.9,2,0,0
9/26/2017 11:25,51,66.4,70,61.6,121,63.6,2,0,0
9/26/2017 11:30,64,65.9,83,61.1,147,63.2,2,0,0
9/26/2017 11:35,56,67.5,74,62.8,130,64.8,2,0,0
9/26/2017 11:40,57,68.2,75,63.5,132,65.5,2,0,0
9/26/2017 11:45,56,68.3,76,63.6,132,65.6,2,0,0
9/26/2017 11:50,57,67.3,76,62.5,133,64.6,2,0,0
9/26/2017 11:55,61,66.4,80,61.5,141,63.6,2,0,0
9/26/2017 12:00,48,68,65,63.3,113,65.3,2,0,0
9/26/2017 12:05,57,69.1,75,64.5,132,66.5,2,0,0
9/26/2017 12:10,52,69.6,71,65,123,66.9,2,0,0
9/26/2017 12:15,49,70.2,67,65.6,116,67.6,2,0,0
9/26/2017 12:20,51,67.8,69,63,120,65.1,2,0,0
9/26/2017 12:25,42,68.3,59,63.6,101,65.6,2,0,0
9/26/2017 12:30,53,67.9,70,63.1,123,65.1,2,0,0
9/26/2017 12:35,55,69,73,64.3,128,66.3,2,0,0
9/26/2017 12:40,48,67.9,67,63.2,115,65.1,2,0,0
9/26/2017 12:45,58,67.9,75,63.2,133,65.3,2,0,0
9/26/2017 12:50,55,69.9,74,65.4,129,67.3,2,0,0
9/26/2017 12:55,54,70.3,72,65.9,126,67.8,2,0,0
9/26/2017 13:00,45,69.6,63,65.1,108,67,2,0,0
9/26/2017 13:05,49,69.6,67,65,116,67,2,0,0
9/26/2017 13:10,50,69,68,64.4,118,66.4,2,0,0
9/26/2017 13:15,45,68.9,63,64.3,108,66.3,2,0,0
9/26/2017 13:20,60,68.5,79,63.8,139,65.8,2,0,0
9/26/2017 13:25,41,69.2,58,64.5,99,66.5,2,0,0
9/26/2017 13:30,55,69.6,74,64.9,129,66.9,2,0,0
9/26/2017 13:35,49,69,68,64.4,117,66.3,2,0,0
9/26/2017 13:40,59,68.7,78,64.1,137,66.1,2,0,0
9/26/2017 13:45,56,69.5,74,65,130,66.9,2,0,0
9/26/2017 13:50,41,69.3,58,64.7,99,66.6,2,0,0
9/26/2017 13:55,65,70.3,85,65.8,150,67.8,2,0,0
9/26/2017 14:00,54,68.7,73,64.1,127,66.1,2,0,0
9/26/2017 14:05,61,68.8,80,64.2,141,66.2,2,0,0
9/26/2017 14:10,60,68.7,79,64.1,139,66.1,2,0,0
9/26/2017 14:15,61,67.3,79,62.5,140,64.6,2,0,0
9/26/2017 14:20,62,66.9,82,62.1,144,64.2,2,0,0
9/26/2017 14:25,52,68.1,69,63.4,121,65.4,2,0,0
9/26/2017 14:30,53,68.3,71,63.6,124,65.6,2,0,0
9/26/2017 14:35,58,68.4,76,63.7,134,65.7,2,0,0
9/26/2017 14:40,59,68.3,77,63.6,136,65.7,2,0,0
9/26/2017 14:45,58,68.3,76,63.6,134,65.6,2,0,0
9/26/2017 14:50,56,67.9,74,63.2,130,65.2,2,0,0
9/26/2017 14:55,54,69,71,64.4,125,66.4,2,0,0
9/26/2017 15:00,55,69.5,72,65,127,66.9,2,0,0
9/26/2017 15:05,59,68.9,77,64.2,136,66.2,2,0,0
9/26/2017 15:10,60,68.4,78,63.8,138,65.8,2,0,0
9/26/2017 15:15,56,67.8,75,63.1,131,65.1,2,0,0
9/26/2017 15:20,64,68.6,83,64,147,66,2,0,0
9/26/2017 15:25,57,68.6,75,64,132,66,2,0,0
9/26/2017 15:30,65,68.7,84,64.1,149,66.1,2,0,0
9/26/2017 15:35,70,68.8,89,64.2,159,66.2,2,0,0
9/26/2017 15:40,72,67.8,92,63.1,164,65.2,2,0,0
9/26/2017 15:45,71,67,90,62.2,161,64.3,2,0,0
9/26/2017 15:50,67,60.5,86,55,153,57.4,2,0,0
9/26/2017 15:55,58,53.8,77,47.5,135,50.2,2,0,0
9/26/2017 16:00,50,52.7,69,46.4,119,49.1,2,0,0
9/26/2017 16:05,50,58.4,68,52.7,118,55.1,2,0,0
9/26/2017 16:10,55,62.4,73,57.1,128,59.4,2,0,0
9/26/2017 16:15,52,61,70,55.7,122,58,2,0,0
9/26/2017 16:20,48,58.4,66,52.6,114,55,2,0,0
9/26/2017 16:25,51,56.8,70,50.9,121,53.4,2,0,0
9/26/2017 16:30,54,58.8,72,53.1,126,55.5,2,0,0
9/26/2017 16:35,52,58.2,71,52.4,123,54.9,2,0,0
9/26/2017 16:40,50,61.9,68,56.4,118,58.7,2,0,0
9/26/2017 16:45,43,60.8,62,55.2,105,57.5,2,0,0
9/26/2017 16:50,43,62.7,61,57.4,104,59.6,2,0,0
9/26/2017 16:55,51,63.9,69,58.7,120,60.9,2,0,0
9/26/2017 17:00,56,61.2,74,55.7,130,58.1,2,0,0
9/26/2017 17:05,46,56.7,65,50.6,111,53.2,2,0,0
9/26/2017 17:10,51,54.6,69,48.2,120,50.9,2,0,0
9/26/2017 17:15,51,50.6,70,43.8,121,46.7,2,0,0
9/26/2017 17:20,47,46.4,66,39.1,113,42.1,2,0,0
9/26/2017 17:25,54,45.9,73,38.5,127,41.7,2,0,0
9/26/2017 17:30,47,39.8,66,31.9,113,35.2,2,0,0
9/26/2017 17:35,42,33.8,59,25.3,101,28.8,2,0,0
9/26/2017 17:40,55,32.8,74,24.2,129,27.9,2,0,0
9/26/2017 17:45,46,33.1,64,24.4,110,28.1,2,0,0
9/26/2017 17:50,42,37.8,61,29.6,103,33,2,0,0
9/26/2017 17:55,44,34.8,62,26.3,106,29.8,2,0,0
9/26/2017 18:00,48,46.7,65,39.5,113,42.6,2,0,0
9/26/2017 18:05,46,57,64,51.1,110,53.6,2,0,0
9/26/2017 18:10,58,62.4,77,57.1,135,59.4,2,0,0
9/26/2017 18:15,56,65,74,60,130,62.1,2,0,0
9/26/2017 18:20,49,65.1,67,60.2,116,62.3,2,0,0
9/26/2017 18:25,51,66.9,68,62.2,119,64.2,2,0,0
9/26/2017 18:30,52,68,71,63.3,123,65.3,2,0,0
9/26/2017 18:35,49,68.1,67,63.5,116,65.5,2,0,0
9/26/2017 18:40,36,69.5,53,64.9,89,66.7,2,0,0
9/26/2017 18:45,48,69.3,66,64.8,114,66.7,2,0,0
9/26/2017 18:50,45,69.7,63,65.1,108,67,2,0,0
9/26/2017 18:55,48,69,66,64.4,114,66.3,2,0,0
9/26/2017 19:00,53,69.5,70,65,123,66.9,2,0,0
9/26/2017 19:05,48,70.4,65,65.9,113,67.8,2,0,0
9/26/2017 19:10,38,70,55,65.5,93,67.3,2,0,0
9/26/2017 19:15,43,69.6,60,65.1,103,67,2,0,0
9/26/2017 19:20,39,69,57,64.3,96,66.2,2,0,0
9/26/2017 19:25,46,67.5,63,62.6,109,64.7,2,0,0
9/26/2017 19:30,44,67.9,62,63,106,65,2,0,0
9/26/2017 19:35,36,68.5,53,63.8,89,65.7,2,0,0
9/26/2017 19:40,38,68.2,55,63.4,93,65.3,2,0,0
9/26/2017 19:45,37,69.2,54,64.6,91,66.5,2,0,0
9/26/2017 19:50,39,67.9,55,63.2,94,65.2,2,0,0
9/26/2017 19:55,36,68.8,52,64.1,88,66,2,0,0
9/26/2017 20:00,43,67.9,59,63.1,102,65.1,2,0,0
9/26/2017 20:05,33,68.7,50,64,83,65.9,2,0,0
9/26/2017 20:10,34,69.1,51,64.4,85,66.3,2,0,0
9/26/2017 20:15,30,69.3,46,64.7,76,66.5,2,0,0
9/26/2017 20:20,38,68.2,54,63.5,92,65.4,2,0,0
9/26/2017 20:25,31,68.9,48,64.2,79,66,2,0,0
9/26/2017 20:30,37,69.1,53,64.5,90,66.4,2,0,0
9/26/2017 20:35,29,69.3,45,64.7,74,66.5,2,0,0
9/26/2017 20:40,29,69.5,46,64.9,75,66.7,2,0,0
9/26/2017 20:45,27,68.9,43,64.2,70,66,2,0,0
9/26/2017 20:50,34,69.1,50,64.5,84,66.4,2,0,0
9/26/2017 20:55,34,68.8,50,64.1,84,66,2,0,0
9/26/2017 21:00,27,68.7,44,64,71,65.8,2,0,0
9/26/2017 21:05,25,69.1,41,64.5,66,66.2,2,0,0
9/26/2017 21:10,32,69.1,49,64.4,81,66.3,2,0,0
9/26/2017 21:15,30,69.4,47,64.7,77,66.5,2,0,0
9/26/2017 21:20,36,69.2,52,64.5,88,66.4,2,0,0
9/26/2017 21:25,36,69.1,52,64.5,88,66.4,2,0,0
9/26/2017 21:30,26,69.5,42,64.9,68,66.6,2,0,0
9/26/2017 21:35,30,69.5,46,64.9,76,66.7,2,0,0
9/26/2017 21:40,27,69,44,64.4,71,66.1,2,0,0
9/26/2017 21:45,31,69,48,64.4,79,66.2,2,0,0
9/26/2017 21:50,22,69.2,38,64.6,60,66.3,2,0,0
9/26/2017 21:55,28,68.7,45,64.1,73,65.8,2,0,0
9/26/2017 22:00,23,68.3,40,63.7,63,65.4,2,0,0
9/26/2017 22:05,20,68.7,36,64,56,65.7,2,0,0
9/26/2017 22:10,19,68.9,34,64.3,53,66,2,0,0
9/26/2017 22:15,23,69,39,64.4,62,66.1,2,0,0
9/26/2017 22:20,23,69.4,39,64.8,62,66.5,2,0,0
9/26/2017 22:25,22,69,38,64.3,60,66,2,0,0
9/26/2017 22:30,16,69.3,32,64.7,48,66.2,2,0,0
9/26/2017 22:35,18,69.2,33,64.6,51,66.2,2,0,0
9/26/2017 22:40,18,69.5,33,64.9,51,66.5,2,0,0
9/26/2017 22:45,14,69.6,29,65,43,66.5,2,0,0
9/26/2017 22:50,17,69.4,33,64.8,50,66.3,2,0,0
9/26/2017 22:55,23,69.4,39,64.8,62,66.5,2,0,0
9/26/2017 23:00,13,69.4,28,64.8,41,66.2,2,0,0
9/26/2017 23:05,12,69.4,27,64.8,39,66.2,2,0,0
9/26/2017 23:10,19,69.5,35,64.9,54,66.5,2,0,0
9/26/2017 23:15,26,69.7,41,65.2,67,66.9,2,0,0
9/26/2017 23:20,12,69.5,27,64.9,39,66.3,2,0,0
9/26/2017 23:25,12,69.4,28,64.8,40,66.2,2,0,0
9/26/2017 23:30,14,69.3,30,64.7,44,66.2,2,0,0
9/26/2017 23:35,18,69,34,64.4,52,66,2,0,0
9/26/2017 23:40,14,69.1,30,64.5,44,65.9,2,0,0
9/26/2017 23:45,16,68.9,32,64.2,48,65.8,2,0,0
9/26/2017 23:50,15,69.1,31,64.5,46,66,2,0,0
9/26/2017 23:55,12,69.2,27,64.5,39,66,2,0,0
9/27/2017 0:00,9,69.3,24,64.7,33,66,2,0,0
9/27/2017 0:05,13,69,28,64.3,41,65.8,2,0,0
9/27/2017 0:10,10,69.2,25,64.6,35,65.9,2,0,0
9/27/2017 0:15,11,69.3,27,64.7,38,66,2,0,0
9/27/2017 0:20,12,68.7,27,64.1,39,65.5,2,0,0
9/27/2017 0:25,10,69,25,64.4,35,65.7,2,0,0
9/27/2017 0:30,10,69.2,26,64.6,36,65.9,2,0,0
9/27/2017 0:35,10,69.3,25,64.7,35,66,2,0,0
9/27/2017 0:40,9,69.1,24,64.5,33,65.8,2,0,0
9/27/2017 0:45,9,69.2,24,64.6,33,65.8,2,0,0
9/27/2017 0:50,7,69.2,23,64.5,30,65.6,2,0,0
9/27/2017 0:55,8,69.3,24,64.7,32,65.8,2,0,0
9/27/2017 1:00,9,69.4,24,64.8,33,66.1,2,0,0
9/27/2017 1:05,9,69.3,25,64.7,34,66,2,0,0
9/27/2017 1:10,6,69.1,21,64.5,27,65.5,2,0,0
9/27/2017 1:15,6,69.1,21,64.5,27,65.5,2,0,0
9/27/2017 1:20,6,69.1,21,64.4,27,65.5,2,0,0
9/27/2017 1:25,8,69.2,23,64.6,31,65.8,2,0,0
9/27/2017 1:30,6,69.3,21,64.7,27,65.7,2,0,0
9/27/2017 1:35,7,69.3,23,64.7,30,65.8,2,0,0
9/27/2017 1:40,7,69.1,22,64.5,29,65.6,2,0,0
9/27/2017 1:45,10,69.2,25,64.5,35,65.9,2,0,0
9/27/2017 1:50,7,69.2,22,64.6,29,65.7,2,0,0
9/27/2017 1:55,5,69.3,20,64.7,25,65.6,2,0,0
9/27/2017 2:00,8,69.3,23,64.7,31,65.9,2,0,0
9/27/2017 2:05,11,69.3,21,64.7,32,66.3,2,0,0
9/27/2017 2:10,8,69,23,64.4,31,65.6,2,0,0
9/27/2017 2:15,7,69.1,22,64.5,29,65.6,2,0,0
9/27/2017 2:20,7,69.2,22,64.6,29,65.7,2,0,0
9/27/2017 2:25,11,69.2,21,64.6,32,66.2,2,0,0
9/27/2017 2:30,8,69.3,23,64.7,31,65.9,2,0,0
9/27/2017 2:35,12,68.9,28,64.2,40,65.6,2,0,0
9/27/2017 2:40,7,69,22,64.4,29,65.5,2,0,0
9/27/2017 2:45,9,69.3,25,64.7,34,65.9,2,0,0
9/27/2017 2:50,9,69.2,25,64.6,34,65.8,2,0,0
9/27/2017 2:55,9,69.4,26,64.8,35,66,2,0,0
9/27/2017 3:00,12,69.4,28,64.8,40,66.2,2,0,0
9/27/2017 3:05,9,69.4,25,64.7,34,66,2,0,0
9/27/2017 3:10,10,69.4,25,64.8,35,66.1,2,0,0
9/27/2017 3:15,12,69.3,28,64.7,40,66,2,0,0
9/27/2017 3:20,8,69.3,24,64.6,32,65.8,2,0,0
9/27/2017 3:25,10,69.2,26,64.5,36,65.8,2,0,0
9/27/2017 3:30,12,68.5,28,63.9,40,65.3,2,0,0
9/27/2017 3:35,11,68.5,27,63.9,38,65.2,2,0,0
9/27/2017 3:40,12,68.7,28,64.1,40,65.5,2,0,0
9/27/2017 3:45,12,69.1,28,64.4,40,65.8,2,0,0
9/27/2017 3:50,13,69.2,29,64.5,42,66,2,0,0
9/27/2017 3:55,12,69.2,28,64.6,40,66,2,0,0
9/27/2017 4:00,12,69.1,28,64.5,40,65.9,2,0,0
9/27/2017 4:05,16,69.1,33,64.5,49,66,2,0,0
9/27/2017 4:10,14,68.8,29,64.2,43,65.7,2,0,0
9/27/2017 4:15,19,69.3,35,64.7,54,66.3,2,0,0
9/27/2017 4:20,17,69.2,33,64.5,50,66.1,2,0,0
9/27/2017 4:25,23,69.2,39,64.6,62,66.3,2,0,0
9/27/2017 4:30,23,69.3,39,64.6,62,66.3,2,0,0
9/27/2017 4:35,31,68.8,48,64.2,79,66,2,0,0
9/27/2017 4:40,31,68.7,49,64,80,65.8,2,0,0
9/27/2017 4:45,34,69.4,51,64.8,85,66.6,2,0,0
9/27/2017 4:50,36,69.2,53,64.6,89,66.5,2,0,0
9/27/2017 4:55,37,68.6,54,63.9,91,65.8,2,0,0
9/27/2017 5:00,45,68.4,64,63.7,109,65.7,2,0,0
9/27/2017 5:05,40,69,59,64.3,99,66.2,2,0,0
9/27/2017 5:10,52,69,71,64.3,123,66.3,2,0,0
9/27/2017 5:15,54,67.8,74,63,128,65,2,0,0
9/27/2017 5:20,61,68.7,82,63.9,143,65.9,2,0,0
9/27/2017 5:25,48,69.1,67,64.4,115,66.3,2,0,0
9/27/2017 5:30,58,69,79,64.3,137,66.3,2,0,0
9/27/2017 5:35,59,68,79,63.2,138,65.3,2,0,0
9/27/2017 5:40,67,66.5,89,61.6,156,63.7,2,0,0
9/27/2017 5:45,60,67.4,81,62.5,141,64.6,2,0,0
9/27/2017 5:50,68,67.3,89,62.4,157,64.5,2,0,0
9/27/2017 5:55,60,67.5,81,62.7,141,64.7,2,0,0
9/27/2017 6:00,54,67.8,75,63,129,65,2,0,0
9/27/2017 6:05,47,68.1,66,63.3,113,65.3,2,0,0
9/27/2017 6:10,57,66.9,77,62,134,64.1,2,0,0
9/27/2017 6:15,75,66.8,98,62,173,64.1,2,0,0
9/27/2017 6:20,60,66.2,81,61.3,141,63.4,2,0,0
9/27/2017 6:25,67,66.2,90,61.3,157,63.4,2,0,0
9/27/2017 6:30,60,65.7,81,60.7,141,62.8,2,0,0
9/27/2017 6:35,73,64.8,96,59.7,169,61.9,2,0,0
9/27/2017 6:40,70,64.2,93,59,163,61.2,2,0,0
9/27/2017 6:45,71,66.7,94,61.8,165,63.9,2,0,0
9/27/2017 6:50,72,66.5,94,61.5,166,63.7,2,0,0
9/27/2017 6:55,82,67.7,104,62.8,186,65,2,0,0
9/27/2017 7:00,66,67.8,87,62.9,153,65,2,0,0
9/27/2017 7:05,61,68.5,83,63.7,144,65.7,2,0,0
9/27/2017 7:10,56,68.5,76,63.8,132,65.8,2,0,0
9/27/2017 7:15,82,68.1,105,63.3,187,65.4,2,0,0
9/27/2017 7:20,87,66.6,110,61.7,197,63.8,2,0,0
9/27/2017 7:25,81,67.3,103,62.5,184,64.6,2,0,0
9/27/2017 7:30,85,67.8,109,62.9,194,65.1,2,0,0
9/27/2017 7:35,79,68,100,63.3,179,65.4,2,0,0
9/27/2017 7:40,83,67.4,106,62.5,189,64.6,2,0,0
9/27/2017 7:45,83,66.6,108,61.7,191,63.8,2,0,0
9/27/2017 7:50,84,66.9,108,62,192,64.1,2,0,0
9/27/2017 7:55,85,67.6,108,62.7,193,64.9,2,0,0
9/27/2017 8:00,81,67.2,103,62.3,184,64.4,2,0,0
9/27/2017 8:05,84,66.9,107,62,191,64.2,2,0,0
9/27/2017 8:10,82,66,104,61.1,186,63.2,2,0,0
9/27/2017 8:15,82,66.8,104,61.9,186,64,2,0,0
9/27/2017 8:20,83,65.4,106,60.4,189,62.6,2,0,0
9/27/2017 8:25,71,65.2,91,60.2,162,62.4,2,0,0
9/27/2017 8:30,80,65.7,101,60.7,181,62.9,2,0,0
9/27/2017 8:35,83,65.6,106,60.6,189,62.8,2,0,0
9/27/2017 8:40,80,66.4,102,61.6,182,63.7,2,0,0
9/27/2017 8:45,79,66.6,101,61.8,180,63.9,2,0,0
9/27/2017 8:50,76,66.9,97,62,173,64.2,2,0,0
9/27/2017 8:55,76,66.1,98,61.1,174,63.3,2,0,0
9/27/2017 9:00,69,66.4,89,61.4,158,63.6,2,0,0
9/27/2017 9:05,66,66.7,88,61.9,154,64,2,0,0
9/27/2017 9:10,75,65.7,97,60.8,172,62.9,2,0,0
9/27/2017 9:15,71,65.2,92,60.3,163,62.4,2,0,0
9/27/2017 9:20,68,64.2,90,59.1,158,61.3,2,0,0
9/27/2017 9:25,63,65.1,84,60.2,147,62.3,2,0,0
9/27/2017 9:30,63,65.1,82,60.1,145,62.3,2,0,0
9/27/2017 9:35,69,66.3,90,61.4,159,63.5,2,0,0
9/27/2017 9:40,65,65.8,85,60.9,150,63,2,0,0
9/27/2017 9:45,75,66.3,96,61.4,171,63.6,2,0,0
9/27/2017 9:50,71,65.4,93,60.5,164,62.6,2,0,0
9/27/2017 9:55,68,65.5,90,60.5,158,62.7,2,0,0
9/27/2017 10:00,81,65.2,102,60.2,183,62.5,2,0,0
9/27/2017 10:05,69,66.4,89,61.5,158,63.6,2,0,0
9/27/2017 10:10,84,65.4,106,60.4,190,62.6,2,0,0
9/27/2017 10:15,66,64.7,85,59.7,151,61.9,2,0,0
9/27/2017 10:20,78,64.9,100,59.9,178,62,2,0,0
9/27/2017 10:25,63,65.3,83,60.3,146,62.4,2,0,0
9/27/2017 10:30,65,63.9,84,58.7,149,61,2,0,0
9/27/2017 10:35,68,63.7,88,58.5,156,60.8,2,0,0
9/27/2017 10:40,67,61.7,88,56.4,155,58.7,2,0,0
9/27/2017 10:45,64,69,57,63,121,66.2,2,0,0
9/27/2017 10:50,38,69.3,56,64.7,94,66.6,2,0,0
9/27/2017 10:55,63,68.5,83,63.8,146,65.8,2,0,0
9/27/2017 11:00,75,67.8,95,63,170,65.1,2,0,0
9/27/2017 11:05,82,68,103,63.3,185,65.4,2,0,0
9/27/2017 11:10,69,67.2,89,62.5,158,64.5,2,0,0
9/27/2017 11:15,78,67,98,62.2,176,64.3,2,0,0
9/27/2017 11:20,86,64.9,108,60,194,62.2,2,0,0
9/27/2017 11:25,81,65.2,102,60.3,183,62.5,2,0,0
9/27/2017 11:30,75,64.1,96,59.1,171,61.3,2,0,0
9/27/2017 11:35,89,64.1,111,59.1,200,61.4,2,0,0
9/27/2017 11:40,66,63.7,87,58.6,153,60.8,2,0,0
9/27/2017 11:45,74,64,96,59,170,61.2,2,0,0
9/27/2017 11:50,82,64.1,103,59.1,185,61.3,2,0,0
9/27/2017 11:55,79,64.7,100,59.7,179,61.9,2,0,0
9/27/2017 12:00,78,64.1,99,59.1,177,61.4,2,0,0
9/27/2017 12:05,92,64.5,115,59.5,207,61.7,2,0,0
9/27/2017 12:10,86,64.7,108,59.7,194,61.9,2,0,0
9/27/2017 12:15,85,65.5,106,60.6,191,62.8,2,0,0
9/27/2017 12:20,78,65.5,98,60.7,176,62.8,2,0,0
9/27/2017 12:25,93,64.6,116,59.7,209,61.9,2,0,0
9/27/2017 12:30,82,64.7,104,59.8,186,62,2,0,0
9/27/2017 12:35,77,65.5,97,60.6,174,62.8,2,0,0
9/27/2017 12:40,67,65.6,87,60.8,154,62.9,2,0,0
9/27/2017 12:45,61,65.7,80,60.8,141,62.9,2,0,0
9/27/2017 12:50,66,65.2,86,60.4,152,62.5,2,0,0
9/27/2017 12:55,64,66.9,83,62.3,147,64.3,2,0,0
9/27/2017 13:00,60,68.2,78,63.6,138,65.6,2,0,0
9/27/2017 13:05,58,68.3,77,63.7,135,65.6,2,0,0
9/27/2017 13:10,68,68.2,88,63.5,156,65.6,2,0,0
9/27/2017 13:15,66,69.2,84,64.6,150,66.6,2,0,0
9/27/2017 13:20,67,69,86,64.4,153,66.4,2,0,0
9/27/2017 13:25,60,67.3,79,62.6,139,64.6,2,0,0
9/27/2017 13:30,66,66.9,85,62.1,151,64.2,2,0,0
9/27/2017 13:35,65,67.4,85,62.7,150,64.7,2,0,0
9/27/2017 13:40,57,69.6,74,65.1,131,67.1,2,0,0
9/27/2017 13:45,67,68.8,87,64.3,154,66.3,2,0,0
9/27/2017 13:50,73,70.5,93,66.1,166,68,2,0,0
9/27/2017 13:55,73,70.2,94,65.7,167,67.6,2,0,0
9/27/2017 14:00,56,69.1,74,64.6,130,66.5,2,0,0
9/27/2017 14:05,63,68.4,82,63.8,145,65.8,2,0,0
9/27/2017 14:10,56,66.7,76,61.9,132,63.9,2,0,0
9/27/2017 14:15,63,67.3,82,62.5,145,64.6,2,0,0
9/27/2017 14:20,67,67.9,87,63.1,154,65.2,2,0,0
9/27/2017 14:25,58,66.3,78,61.5,136,63.5,2,0,0
9/27/2017 14:30,58,67.2,76,62.4,134,64.5,2,0,0
9/27/2017 14:35,50,67.1,69,62.4,119,64.4,2,0,0
9/27/2017 14:40,38,67.2,55,62.5,93,64.4,2,0,0
9/27/2017 14:45,48,68.1,65,63.4,113,65.4,2,0,0
9/27/2017 14:50,44,67.1,61,62.4,105,64.3,2,0,0
9/27/2017 14:55,41,67.7,59,63,100,65,2,0,0
9/27/2017 15:00,44,69.5,61,64.9,105,66.8,2,0,0
9/27/2017 15:05,43,68.2,60,63.6,103,65.5,2,0,0
9/27/2017 15:10,47,68.6,65,64,112,65.9,2,0,0
9/27/2017 15:15,48,67.9,67,63.2,115,65.2,2,0,0
9/27/2017 15:20,61,66.1,81,61.3,142,63.4,2,0,0
9/27/2017 15:25,54,66.8,74,62.2,128,64.1,2,0,0
9/27/2017 15:30,64,68.1,83,63.5,147,65.5,2,0,0
9/27/2017 15:35,72,68,92,63.3,164,65.4,2,0,0
9/27/2017 15:40,73,68.7,94,64,167,66.1,2,0,0
9/27/2017 15:45,71,68.5,92,63.8,163,65.8,2,0,0
9/27/2017 15:50,78,68.2,99,63.5,177,65.5,2,0,0
9/27/2017 15:55,80,67.7,100,63,180,65.1,2,0,0
9/27/2017 16:00,73,68.5,92,63.8,165,65.9,2,0,0
9/27/2017 16:05,61,68.9,80,64.2,141,66.2,2,0,0
9/27/2017 16:10,62,69.2,81,64.6,143,66.6,2,0,0
9/27/2017 16:15,58,70.9,78,66.5,136,68.3,2,0,0
9/27/2017 16:20,69,70,89,65.5,158,67.5,2,0,0
9/27/2017 16:25,71,70,91,65.4,162,67.4,2,0,0
9/27/2017 16:30,68,69.5,88,64.9,156,66.9,2,0,0
9/27/2017 16:35,74,69.3,95,64.7,169,66.7,2,0,0
9/27/2017 16:40,71,68.4,90,63.6,161,65.7,2,0,0
9/27/2017 16:45,83,68.6,105,63.9,188,66,2,0,0
9/27/2017 16:50,73,67.8,93,63,166,65.1,2,0,0
9/27/2017 16:55,70,68.4,90,63.7,160,65.7,2,0,0
9/27/2017 17:00,67,69.5,86,65,153,67,2,0,0
9/27/2017 17:05,66,68.4,86,63.8,152,65.8,2,0,0
9/27/2017 17:10,76,68.3,96,63.7,172,65.7,2,0,0
9/27/2017 17:15,74,68.9,94,64.3,168,66.3,2,0,0
9/27/2017 17:20,72,67.5,93,62.8,165,64.8,2,0,0
9/27/2017 17:25,73,66.7,93,61.9,166,64,2,0,0
9/27/2017 17:30,84,66.7,107,61.9,191,64,2,0,0
9/27/2017 17:35,78,67,99,62.2,177,64.3,2,0,0
9/27/2017 17:40,73,67.6,93,62.8,166,64.9,2,0,0
9/27/2017 17:45,72,67.5,94,62.8,166,64.8,2,0,0
9/27/2017 17:50,74,68.3,94,63.7,168,65.7,2,0,0
9/27/2017 17:55,64,67.9,84,63.2,148,65.2,2,0,0
9/27/2017 18:00,70,68,90,63.4,160,65.4,2,0,0
9/27/2017 18:05,57,67.7,76,63,133,65,2,0,0
9/27/2017 18:10,66,68.8,86,64.2,152,66.2,2,0,0
9/27/2017 18:15,65,69.1,84,64.6,149,66.5,2,0,0
9/27/2017 18:20,66,68.1,84,63.4,150,65.5,2,0,0
9/27/2017 18:25,61,67.1,80,62.3,141,64.4,2,0,0
9/27/2017 18:30,63,68.6,81,64,144,66,2,0,0
9/27/2017 18:35,56,67.8,73,63.2,129,65.2,2,0,0
9/27/2017 18:40,54,67.4,72,62.7,126,64.7,2,0,0
9/27/2017 18:45,64,68,83,63.4,147,65.4,2,0,0
9/27/2017 18:50,56,67.6,74,62.8,130,64.9,2,0,0
9/27/2017 18:55,47,67,65,62.3,112,64.2,2,0,0
9/27/2017 19:00,49,67.8,67,63.1,116,65.1,2,0,0
9/27/2017 19:05,48,69,65,64.5,113,66.4,2,0,0
9/27/2017 19:10,44,70.2,62,65.6,106,67.5,2,0,0
9/27/2017 19:15,42,69.9,60,65.3,102,67.2,2,0,0
9/27/2017 19:20,48,68.9,65,64.2,113,66.2,2,0,0
9/27/2017 19:25,43,67.8,60,62.9,103,65,2,0,0
9/27/2017 19:30,38,68,55,63.2,93,65.2,2,0,0
9/27/2017 19:35,46,68.4,64,63.6,110,65.6,2,0,0
9/27/2017 19:40,36,67.1,53,62.2,89,64.2,2,0,0
9/27/2017 19:45,39,68.3,57,63.5,96,65.4,2,0,0
9/27/2017 19:50,38,68.6,55,63.9,93,65.9,2,0,0
9/27/2017 19:55,41,68.8,58,64.1,99,66,2,0,0
9/27/2017 20:00,31,69.3,48,64.7,79,66.5,2,0,0
9/27/2017 20:05,32,69.2,49,64.6,81,66.4,2,0,0
9/27/2017 20:10,40,67.6,57,62.9,97,64.8,2,0,0
9/27/2017 20:15,37,67.6,54,62.9,91,64.8,2,0,0
9/27/2017 20:20,33,68.5,50,63.8,83,65.7,2,0,0
9/27/2017 20:25,33,68.9,50,64.2,83,66.1,2,0,0
9/27/2017 20:30,31,69.6,47,65,78,66.8,2,0,0
9/27/2017 20:35,31,69,48,64.4,79,66.2,2,0,0
9/27/2017 20:40,28,69.5,44,64.9,72,66.7,2,0,0
9/27/2017 20:45,28,68.6,45,63.9,73,65.7,2,0,0
9/27/2017 20:50,20,69,36,64.4,56,66,2,0,0
9/27/2017 20:55,24,68.8,40,64.2,64,65.9,2,0,0
9/27/2017 21:00,22,69.3,38,64.6,60,66.3,2,0,0
9/27/2017 21:05,29,68.8,46,64.1,75,65.9,2,0,0
9/27/2017 21:10,26,68.9,44,64.2,70,66,2,0,0
9/27/2017 21:15,30,69.2,46,64.5,76,66.3,2,0,0
9/27/2017 21:20,28,68.8,45,64.2,73,66,2,0,0
9/27/2017 21:25,39,69.5,56,64.9,95,66.8,2,0,0
9/27/2017 21:30,24,69.7,40,65.1,64,66.8,2,0,0
9/27/2017 21:35,27,69.6,44,65,71,66.8,2,0,0
9/27/2017 21:40,28,69.5,45,64.9,73,66.7,2,0,0
9/27/2017 21:45,25,69.4,41,64.8,66,66.5,2,0,0
9/27/2017 21:50,22,69.5,39,64.9,61,66.6,2,0,0
9/27/2017 21:55,18,69.1,34,64.5,52,66.1,2,0,0
9/27/2017 22:00,15,68.8,31,64.2,46,65.7,2,0,0
9/27/2017 22:05,16,69.1,32,64.5,48,66.1,2,0,0
9/27/2017 22:10,18,69.1,34,64.4,52,66,2,0,0
9/27/2017 22:15,18,68.7,35,64,53,65.6,2,0,0
9/27/2017 22:20,18,69,34,64.3,52,65.9,2,0,0
9/27/2017 22:25,17,69.1,33,64.5,50,66,2,0,0
9/27/2017 22:30,19,69.1,35,64.5,54,66.1,2,0,0
9/27/2017 22:35,12,68.9,29,64.3,41,65.6,2,0,0
9/27/2017 22:40,18,69.1,34,64.5,52,66.1,2,0,0
9/27/2017 22:45,18,69,34,64.3,52,65.9,2,0,0
9/27/2017 22:50,11,68.9,26,64.3,37,65.7,2,0,0
9/27/2017 22:55,12,69.2,28,64.6,40,66,2,0,0
9/27/2017 23:00,10,69.3,26,64.7,36,65.9,2,0,0
9/27/2017 23:05,18,69.4,34,64.8,52,66.4,2,0,0
9/27/2017 23:10,10,69.3,26,64.7,36,66,2,0,0
9/27/2017 23:15,11,69.3,27,64.7,38,66.1,2,0,0
9/27/2017 23:20,10,69.3,25,64.7,35,66,2,0,0
9/27/2017 23:25,9,69.3,24,64.7,33,65.9,2,0,0
9/27/2017 23:30,14,69.3,30,64.6,44,66.1,2,0,0
9/27/2017 23:35,9,69.3,25,64.7,34,65.9,2,0,0
9/27/2017 23:40,9,69.3,25,64.7,34,65.9,2,0,0
9/27/2017 23:45,11,69,26,64.4,37,65.7,2,0,0
9/27/2017 23:50,12,69.2,27,64.5,39,66,2,0,0
9/27/2017 23:55,10,69.2,26,64.5,36,65.8,2,0,0
9/28/2017 0:00,9,69.3,25,64.7,34,66,2,0,0
9/28/2017 0:05,10,69.4,25,64.8,35,66.1,2,0,0
9/28/2017 0:10,6,69.4,21,64.8,27,65.8,2,0,0
9/28/2017 0:15,6,69.4,22,64.8,28,65.8,2,0,0
9/28/2017 0:20,8,69.4,23,64.8,31,66,2,0,0
9/28/2017 0:25,7,69.4,22,64.8,29,65.9,2,0,0
9/28/2017 0:30,8,69.4,23,64.8,31,66,2,0,0
9/28/2017 0:35,6,69.4,21,64.8,27,65.8,2,0,0
9/28/2017 0:40,8,69.3,23,64.7,31,65.9,2,0,0
9/28/2017 0:45,5,69.3,20,64.7,25,65.6,2,0,0
9/28/2017 0:50,8,69.3,23,64.7,31,65.9,2,0,0
9/28/2017 0:55,7,69.1,22,64.4,29,65.5,2,0,0
9/28/2017 1:00,4,69.2,20,64.6,24,65.4,2,0,0
9/28/2017 1:05,4,69.2,19,64.6,23,65.4,2,0,0
9/28/2017 1:10,6,69.3,21,64.7,27,65.7,2,0,0
9/28/2017 1:15,5,69.3,20,64.7,25,65.6,2,0,0
9/28/2017 1:20,6,69.3,21,64.7,27,65.7,2,0,0
9/28/2017 1:25,6,68.8,21,64.2,27,65.2,2,0,0
9/28/2017 1:30,5,69,21,64.4,26,65.3,2,0,0
9/28/2017 1:35,10,69.1,26,64.5,36,65.8,2,0,0
9/28/2017 1:40,9,69.2,19,64.6,28,66.1,2,0,0
9/28/2017 1:45,6,69.2,21,64.6,27,65.7,2,0,0
9/28/2017 1:50,7,69.2,22,64.6,29,65.7,2,0,0
9/28/2017 1:55,5,69.3,21,64.7,26,65.5,2,0,0
9/28/2017 2:00,5,69.4,20,64.8,25,65.7,2,0,0
9/28/2017 2:05,11,69.3,21,64.7,32,66.2,2,0,0
9/28/2017 2:10,7,69,22,64.4,29,65.5,2,0,0
9/28/2017 2:15,8,69.2,23,64.6,31,65.8,2,0,0
9/28/2017 2:20,7,69.1,22,64.5,29,65.6,2,0,0
9/28/2017 2:25,7,69.2,23,64.6,30,65.7,2,0,0
9/28/2017 2:30,7,69.3,23,64.7,30,65.8,2,0,0
9/28/2017 2:35,6,69.4,22,64.7,28,65.7,2,0,0
9/28/2017 2:40,6,69.5,22,64.9,28,65.8,2,0,0
9/28/2017 2:45,13,69.2,29,64.6,42,66,2,0,0
9/28/2017 2:50,9,69.3,25,64.7,34,66,2,0,0
9/28/2017 2:55,9,69.4,25,64.8,34,66,2,0,0
9/28/2017 3:00,9,69.4,24,64.8,33,66.1,2,0,0
9/28/2017 3:05,10,69.2,26,64.6,36,65.9,2,0,0
9/28/2017 3:10,10,69.2,25,64.6,35,65.9,2,0,0
9/28/2017 3:15,12,68.9,27,64.3,39,65.7,2,0,0
9/28/2017 3:20,10,69.2,25,64.6,35,65.9,2,0,0
9/28/2017 3:25,9,69.3,24,64.7,33,66,2,0,0
9/28/2017 3:30,11,69.3,26,64.7,37,66.1,2,0,0
9/28/2017 3:35,12,69.2,27,64.5,39,66,2,0,0
9/28/2017 3:40,15,69.4,30,64.8,45,66.3,2,0,0
9/28/2017 3:45,12,69.1,28,64.5,40,65.9,2,0,0
9/28/2017 3:50,13,69.3,28,64.7,41,66.2,2,0,0
9/28/2017 3:55,14,69,30,64.4,44,65.8,2,0,0
9/28/2017 4:00,15,69,30,64.4,45,65.9,2,0,0
9/28/2017 4:05,16,69.3,32,64.7,48,66.3,2,0,0
9/28/2017 4:10,11,69.2,27,64.5,38,65.9,2,0,0
9/28/2017 4:15,16,69.2,33,64.6,49,66.1,2,0,0
9/28/2017 4:20,25,69.2,42,64.6,67,66.3,2,0,0
9/28/2017 4:25,18,69.4,34,64.8,52,66.4,2,0,0
9/28/2017 4:30,24,69.9,41,65.4,65,67.1,2,0,0
9/28/2017 4:35,23,69.9,40,65.3,63,67,2,0,0
9/28/2017 4:40,36,68.7,54,64,90,65.9,2,0,0
9/28/2017 4:45,38,68.2,57,63.5,95,65.4,2,0,0
9/28/2017 4:50,33,69.3,50,64.7,83,66.5,2,0,0
9/28/2017 4:55,38,69.3,57,64.7,95,66.5,2,0,0
9/28/2017 5:00,38,70.5,57,66,95,67.8,2,0,0
9/28/2017 5:05,41,71.7,59,67.3,100,69.1,2,0,0
9/28/2017 5:10,44,70.4,63,66,107,67.8,2,0,0
9/28/2017 5:15,43,71.1,61,66.7,104,68.5,2,0,0
9/28/2017 5:20,49,69.3,69,64.8,118,66.7,2,0,0
9/28/2017 5:25,56,70.2,76,65.7,132,67.6,2,0,0
9/28/2017 5:30,58,70.4,80,65.9,138,67.8,2,0,0
9/28/2017 5:35,59,70.1,80,65.5,139,67.4,2,0,0
9/28/2017 5:40,61,70.2,82,65.7,143,67.6,2,0,0
9/28/2017 5:45,71,69.7,94,65.2,165,67.1,2,0,0
9/28/2017 5:50,64,71,86,66.6,150,68.5,2,0,0
9/28/2017 5:55,61,69,82,64.4,143,66.4,2,0,0
9/28/2017 6:00,53,69,74,64.4,127,66.3,2,0,0
9/28/2017 6:05,61,69.4,83,64.8,144,66.7,2,0,0
9/28/2017 6:10,52,68.6,73,63.9,125,65.9,2,0,0
9/28/2017 6:15,63,68.3,85,63.6,148,65.6,2,0,0
9/28/2017 6:20,58,68.2,79,63.4,137,65.4,2,0,0
9/28/2017 6:25,54,68.4,74,63.6,128,65.6,2,0,0
9/28/2017 6:30,57,67.4,78,62.5,135,64.6,2,0,0
9/28/2017 6:35,58,67.7,78,62.8,136,64.9,2,0,0
9/28/2017 6:40,60,67.8,80,62.9,140,65,2,0,0
9/28/2017 6:45,62,67.5,83,62.6,145,64.7,2,0,0
9/28/2017 6:50,70,67.3,92,62.5,162,64.6,2,0,0
9/28/2017 6:55,63,68.5,84,63.7,147,65.7,2,0,0
9/28/2017 7:00,70,69.6,93,64.9,163,66.9,2,0,0
9/28/2017 7:05,65,69,87,64.3,152,66.3,2,0,0
9/28/2017 7:10,75,68.2,97,63.4,172,65.5,2,0,0
9/28/2017 7:15,70,66.4,93,61.5,163,63.6,2,0,0
9/28/2017 7:20,75,67.5,97,62.6,172,64.7,2,0,0
9/28/2017 7:25,62,67,83,62.2,145,64.3,2,0,0
9/28/2017 7:30,75,68,97,63.2,172,65.3,2,0,0
9/28/2017 7:35,71,68.7,94,64,165,66,2,0,0
9/28/2017 7:40,87,67.3,110,62.5,197,64.6,2,0,0
9/28/2017 7:45,82,66.2,104,61.3,186,63.5,2,0,0
9/28/2017 7:50,79,66.8,102,61.8,181,64,2,0,0
9/28/2017 7:55,72,68.6,94,63.9,166,66,2,0,0
9/28/2017 8:00,79,68.1,101,63.3,180,65.4,2,0,0
9/28/2017 8:05,80,68.3,102,63.6,182,65.7,2,0,0
9/28/2017 8:10,75,68,97,63.3,172,65.3,2,0,0
9/28/2017 8:15,96,67.1,121,62.3,217,64.4,2,0,0
9/28/2017 8:20,83,67.5,105,62.6,188,64.8,2,0,0
9/28/2017 8:25,76,66.3,98,61.3,174,63.4,2,0,0
9/28/2017 8:30,75,66.8,98,61.8,173,63.9,2,0,0
9/28/2017 8:35,84,65.7,107,60.6,191,62.8,2,0,0
9/28/2017 8:40,83,66.1,107,61.1,190,63.3,2,0,0
9/28/2017 8:45,80,66.5,101,61.5,181,63.7,2,0,0
9/28/2017 8:50,91,65.2,115,60.1,206,62.3,2,0,0
9/28/2017 8:55,84,63.8,107,58.6,191,60.9,2,0,0
9/28/2017 9:00,77,64.9,98,59.8,175,62.1,2,0,0
9/28/2017 9:05,79,66.2,101,61.2,180,63.4,2,0,0
9/28/2017 9:10,68,67,89,62,157,64.2,2,0,0
9/28/2017 9:15,74,66.4,95,61.5,169,63.7,2,0,0
9/28/2017 9:20,68,66.7,90,61.8,158,63.9,2,0,0
9/28/2017 9:25,81,65.6,103,60.6,184,62.8,2,0,0
9/28/2017 9:30,63,66.8,82,61.9,145,64,2,0,0
9/28/2017 9:35,67,65.7,88,60.7,155,62.9,2,0,0
9/28/2017 9:40,76,65.1,97,60,173,62.2,2,0,0
9/28/2017 9:45,69,66,90,61.1,159,63.2,2,0,0
9/28/2017 9:50,74,65.7,95,60.8,169,62.9,2,0,0
9/28/2017 9:55,66,66,86,61,152,63.2,2,0,0
9/28/2017 10:00,65,66.2,87,61.3,152,63.4,2,0,0
9/28/2017 10:05,61,66.1,81,61.3,142,63.4,2,0,0
9/28/2017 10:10,76,66.7,96,62,172,64.1,2,0,0
9/28/2017 10:15,72,67.8,92,63.1,164,65.2,2,0,0
9/28/2017 10:20,82,68,105,63.4,187,65.4,2,0,0
9/28/2017 10:25,73,68.6,94,64,167,66,2,0,0
9/28/2017 10:30,63,68.8,81,64.2,144,66.2,2,0,0
9/28/2017 10:35,73,67.9,93,63.2,166,65.3,2,0,0
9/28/2017 10:40,72,67.7,93,63,165,65,2,0,0
9/28/2017 10:45,79,66.9,101,62.1,180,64.2,2,0,0
9/28/2017 10:50,74,66.9,96,62.1,170,64.2,2,0,0
9/28/2017 10:55,73,66.2,95,61.4,168,63.5,2,0,0
9/28/2017 11:00,63,64.4,83,59.4,146,61.5,2,0,0
9/28/2017 11:05,69,65.8,90,60.9,159,63,2,0,0
9/28/2017 11:10,55,67.3,73,62.5,128,64.5,2,0,0
9/28/2017 11:15,52,67.6,71,62.9,123,64.9,2,0,0
9/28/2017 11:20,54,68.3,73,63.6,127,65.6,2,0,0
9/28/2017 11:25,57,66.9,76,62.1,133,64.2,2,0,0
9/28/2017 11:30,53,66.1,72,61.2,125,63.3,2,0,0
9/28/2017 11:35,51,67.1,70,62.3,121,64.4,2,0,0
9/28/2017 11:40,64,66,83,61.2,147,63.3,2,0,0
9/28/2017 11:45,55,65.5,74,60.5,129,62.6,2,0,0
9/28/2017 11:50,59,66.5,77,61.7,136,63.8,2,0,0
9/28/2017 11:55,58,66,77,61.1,135,63.2,2,0,0
9/28/2017 12:00,55,66.6,74,61.7,129,63.8,2,0,0
9/28/2017 12:05,71,66.7,91,62,162,64,2,0,0
9/28/2017 12:10,63,66.4,82,61.6,145,63.7,2,0,0
9/28/2017 12:15,53,67,71,62.2,124,64.2,2,0,0
9/28/2017 12:20,50,68,68,63.4,118,65.4,2,0,0
9/28/2017 12:25,51,68.3,68,63.7,119,65.7,2,0,0
9/28/2017 12:30,57,67.5,74,62.8,131,64.9,2,0,0
9/28/2017 12:35,59,67.7,77,62.9,136,65,2,0,0
9/28/2017 12:40,54,68.3,72,63.6,126,65.6,2,0,0
9/28/2017 12:45,59,68.6,77,64,136,66,2,0,0
9/28/2017 12:50,56,69.4,74,64.9,130,66.8,2,0,0
9/28/2017 12:55,57,70.2,75,65.7,132,67.6,2,0,0
9/28/2017 13:00,59,68.7,78,64,137,66,2,0,0
9/28/2017 13:05,50,69.4,68,64.9,118,66.8,2,0,0
9/28/2017 13:10,49,69.5,66,64.9,115,66.9,2,0,0
9/28/2017 13:15,49,68.9,67,64.4,116,66.3,2,0,0
9/28/2017 13:20,47,68.1,64,63.5,111,65.4,2,0,0
9/28/2017 13:25,50,68,67,63.4,117,65.4,2,0,0
9/28/2017 13:30,49,69.2,67,64.7,116,66.6,2,0,0
9/28/2017 13:35,53,66.9,72,62.2,125,64.2,2,0,0
9/28/2017 13:40,52,66.1,71,61.3,123,63.3,2,0,0
9/28/2017 13:45,53,68.2,71,63.5,124,65.5,2,0,0
9/28/2017 13:50,54,67.4,72,62.7,126,64.8,2,0,0
9/28/2017 13:55,51,67.7,68,63.1,119,65.1,2,0,0
9/28/2017 14:00,51,68.3,69,63.6,120,65.6,2,0,0
9/28/2017 14:05,50,68.2,68,63.5,118,65.5,2,0,0
9/28/2017 14:10,57,66.4,75,61.6,132,63.7,2,0,0
9/28/2017 14:15,38,68,56,63.3,94,65.2,2,0,0
9/28/2017 14:20,53,67.3,73,62.5,126,64.5,2,0,0
9/28/2017 14:25,52,66.4,71,61.6,123,63.7,2,0,0
9/28/2017 14:30,59,67,77,62.2,136,64.3,2,0,0
9/28/2017 14:35,57,67.8,77,63.2,134,65.1,2,0,0
9/28/2017 14:40,56,68.7,74,64.1,130,66.1,2,0,0
9/28/2017 14:45,54,68,72,63.3,126,65.3,2,0,0
9/28/2017 14:50,49,69,66,64.5,115,66.4,2,0,0
9/28/2017 14:55,43,68.4,61,63.7,104,65.7,2,0,0
9/28/2017 15:00,48,69.1,66,64.6,114,66.5,2,0,0
9/28/2017 15:05,54,69.1,73,64.5,127,66.4,2,0,0
9/28/2017 15:10,48,67.6,66,63,114,65,2,0,0
9/28/2017 15:15,51,68.1,69,63.6,120,65.5,2,0,0
9/28/2017 15:20,50,68.6,67,64.1,117,66,2,0,0
9/28/2017 15:25,61,68.6,80,64.1,141,66,2,0,0
9/28/2017 15:30,64,63,85,57.8,149,60,2,0,0
9/28/2017 15:35,55,55.1,75,49,130,51.5,2,0,0
9/28/2017 15:40,55,42.6,74,35.1,129,38.3,2,0,0
9/28/2017 15:45,42,35.2,60,26.9,102,30.3,2,0,0
9/28/2017 15:50,62,33.6,81,25.1,143,28.8,2,0,0
9/28/2017 15:55,48,41.1,67,33.5,115,36.7,2,0,0
9/28/2017 16:00,46,52.7,64,46.3,110,49,2,0,0
9/28/2017 16:05,40,60.3,58,54.7,98,57,2,0,0
9/28/2017 16:10,50,63.9,68,58.9,118,61,2,0,0
9/28/2017 16:15,54,66.1,73,61.3,127,63.4,2,0,0
9/28/2017 16:20,51,68,69,63.4,120,65.3,2,0,0
9/28/2017 16:25,57,68.6,76,64,133,66,2,0,0
9/28/2017 16:30,51,68.4,69,63.8,120,65.8,2,0,0
9/28/2017 16:35,45,67.9,63,63.3,108,65.2,2,0,0
9/28/2017 16:40,52,67.1,70,62.5,122,64.5,2,0,0
9/28/2017 16:45,47,69.2,65,64.6,112,66.5,2,0,0
9/28/2017 16:50,52,69.2,71,64.6,123,66.6,2,0,0
9/28/2017 16:55,51,68.8,69,64.3,120,66.2,2,0,0
9/28/2017 17:00,57,70.1,75,65.6,132,67.6,2,0,0
9/28/2017 17:05,56,70.2,74,65.7,130,67.7,2,0,0
9/28/2017 17:10,51,69.3,68,64.7,119,66.7,2,0,0
9/28/2017 17:15,50,69.5,69,64.9,119,66.9,2,0,0
9/28/2017 17:20,53,68.8,72,64.2,125,66.2,2,0,0
9/28/2017 17:25,53,68.6,71,63.9,124,65.9,2,0,0
9/28/2017 17:30,50,66.7,70,61.7,120,63.8,2,0,0
9/28/2017 17:35,45,68.4,64,63.7,109,65.7,2,0,0
9/28/2017 17:40,64,68.3,84,63.6,148,65.7,2,0,0
9/28/2017 17:45,49,69.8,66,65.2,115,67.2,2,0,0
9/28/2017 17:50,58,69.6,77,65,135,67,2,0,0
9/28/2017 17:55,50,68.9,69,64.2,119,66.2,2,0,0
9/28/2017 18:00,55,67.4,74,62.7,129,64.7,2,0,0
9/28/2017 18:05,50,68.4,68,63.7,118,65.7,2,0,0
9/28/2017 18:10,52,69.3,71,64.7,123,66.6,2,0,0
9/28/2017 18:15,51,68.6,70,63.9,121,65.9,2,0,0
9/28/2017 18:20,57,69.6,75,65,132,67,2,0,0
9/28/2017 18:25,53,69.2,71,64.6,124,66.6,2,0,0
9/28/2017 18:30,45,67,63,62.2,108,64.2,2,0,0
9/28/2017 18:35,45,68,62,63.3,107,65.3,2,0,0
9/28/2017 18:40,41,68.5,58,63.9,99,65.8,2,0,0
9/28/2017 18:45,44,69.7,61,65.2,105,67.1,2,0,0
9/28/2017 18:50,50,70,68,65.5,118,67.4,2,0,0
9/28/2017 18:55,42,70.1,58,65.5,100,67.4,2,0,0
9/28/2017 19:00,43,69.8,61,65.2,104,67.1,2,0,0
9/28/2017 19:05,44,70.6,61,66,105,67.9,2,0,0
9/28/2017 19:10,40,69.8,58,65.3,98,67.1,2,0,0
9/28/2017 19:15,38,68.7,53,64.1,91,66,2,0,0
9/28/2017 19:20,29,68.2,46,63.5,75,65.3,2,0,0
9/28/2017 19:25,37,68.4,54,63.7,91,65.6,2,0,0
9/28/2017 19:30,40,68.1,57,63.4,97,65.4,2,0,0
9/28/2017 19:35,36,68.1,53,63.4,89,65.3,2,0,0
9/28/2017 19:40,47,68.7,63,64,110,66,2,0,0
9/28/2017 19:45,41,68.8,59,64.2,100,66.1,2,0,0
9/28/2017 19:50,36,68.3,52,63.6,88,65.6,2,0,0
9/28/2017 19:55,36,69.3,53,64.6,89,66.5,2,0,0
9/28/2017 20:00,41,69.9,57,65.2,98,67.2,2,0,0
9/28/2017 20:05,38,69.5,54,64.9,92,66.8,2,0,0
9/28/2017 20:10,45,68.8,62,64.1,107,66,2,0,0
9/28/2017 20:15,34,68,51,63.1,85,65.1,2,0,0
9/28/2017 20:20,35,67.7,52,62.8,87,64.8,2,0,0
9/28/2017 20:25,39,67.1,56,62.2,95,64.2,2,0,0
9/28/2017 20:30,38,66.4,55,61.6,93,63.6,2,0,0
9/28/2017 20:35,41,68.3,57,63.7,98,65.6,2,0,0
9/28/2017 20:40,34,69.1,50,64.5,84,66.4,2,0,0
9/28/2017 20:45,43,69.4,60,64.8,103,66.8,2,0,0
9/28/2017 20:50,38,69.5,54,64.9,92,66.8,2,0,0
9/28/2017 20:55,34,70.2,51,65.7,85,67.5,2,0,0
9/28/2017 21:00,29,69.1,45,64.5,74,66.3,2,0,0
9/28/2017 21:05,31,69.3,47,64.7,78,66.5,2,0,0
9/28/2017 21:10,29,69.6,45,65,74,66.8,2,0,0
9/28/2017 21:15,26,69.8,42,65.2,68,67,2,0,0
9/28/2017 21:20,22,69.8,37,65.2,59,66.9,2,0,0
9/28/2017 21:25,36,70,52,65.5,88,67.3,2,0,0
9/28/2017 21:30,30,68.7,46,64,76,65.9,2,0,0
9/28/2017 21:35,28,68.6,44,63.9,72,65.7,2,0,0
9/28/2017 21:40,31,68.8,47,64.2,78,66,2,0,0
9/28/2017 21:45,26,68.5,42,63.8,68,65.6,2,0,0
9/28/2017 21:50,26,69,41,64.4,67,66.2,2,0,0
9/28/2017 21:55,30,69.4,46,64.8,76,66.6,2,0,0
9/28/2017 22:00,19,69.3,34,64.7,53,66.3,2,0,0
9/28/2017 22:05,26,68.8,42,64.1,68,65.9,2,0,0
9/28/2017 22:10,22,69,37,64.4,59,66.1,2,0,0
9/28/2017 22:15,23,69.2,39,64.6,62,66.3,2,0,0
9/28/2017 22:20,19,69.3,35,64.7,54,66.3,2,0,0
9/28/2017 22:25,21,69.5,36,64.9,57,66.6,2,0,0
9/28/2017 22:30,20,69.4,36,64.8,56,66.4,2,0,0
9/28/2017 22:35,18,69,34,64.4,52,66,2,0,0
9/28/2017 22:40,22,69.3,38,64.7,60,66.4,2,0,0
9/28/2017 22:45,22,69.7,37,65.2,59,66.9,2,0,0
9/28/2017 22:50,18,69.7,33,65.2,51,66.8,2,0,0
9/28/2017 22:55,21,69.6,36,65,57,66.7,2,0,0
9/28/2017 23:00,16,69.5,32,64.9,48,66.5,2,0,0
9/28/2017 23:05,15,69.5,30,64.9,45,66.4,2,0,0
9/28/2017 23:10,13,69.5,28,64.9,41,66.4,2,0,0
9/28/2017 23:15,16,69.5,32,64.9,48,66.5,2,0,0
9/28/2017 23:20,18,69.1,33,64.5,51,66.1,2,0,0
9/28/2017 23:25,13,69.3,28,64.7,41,66.2,2,0,0
9/28/2017 23:30,15,69.4,30,64.8,45,66.3,2,0,0
9/28/2017 23:35,16,69.6,32,65,48,66.5,2,0,0
9/28/2017 23:40,14,69.5,29,64.9,43,66.4,2,0,0
9/28/2017 23:45,14,69.4,29,64.8,43,66.3,2,0,0
9/28/2017 23:50,12,69.4,27,64.8,39,66.3,2,0,0
9/28/2017 23:55,11,69.4,27,64.8,38,66.1,2,0,0
9/29/2017 0:00,12,69.3,27,64.7,39,66.2,2,0,0
9/29/2017 0:05,13,69.4,28,64.8,41,66.3,2,0,0
9/29/2017 0:10,11,69.5,27,64.9,38,66.3,2,0,0
9/29/2017 0:15,10,69.5,25,64.9,35,66.2,2,0,0
9/29/2017 0:20,13,69.6,28,65,41,66.4,2,0,0
9/29/2017 0:25,11,69.5,26,64.9,37,66.3,2,0,0
9/29/2017 0:30,11,69.4,26,64.7,37,66.1,2,0,0
9/29/2017 0:35,9,69.4,24,64.8,33,66.1,2,0,0
9/29/2017 0:40,9,69.4,24,64.8,33,66,2,0,0
9/29/2017 0:45,6,69.2,22,64.6,28,65.6,2,0,0
9/29/2017 0:50,8,69.2,24,64.5,32,65.7,2,0,0
9/29/2017 0:55,12,69.3,26,64.7,38,66.2,2,0,0
9/29/2017 1:00,9,69.2,24,64.6,33,65.9,2,0,0
9/29/2017 1:05,6,69.2,21,64.5,27,65.6,2,0,0
9/29/2017 1:10,7,69.3,22,64.7,29,65.8,2,0,0
9/29/2017 1:15,9,69.5,24,64.9,33,66.1,2,0,0
9/29/2017 1:20,8,69.3,23,64.7,31,65.9,2,0,0
9/29/2017 1:25,6,69.3,21,64.7,27,65.8,2,0,0
9/29/2017 1:30,11,69.4,26,64.8,37,66.2,2,0,0
9/29/2017 1:35,10,69.3,25,64.7,35,66,2,0,0
9/29/2017 1:40,5,69.4,20,64.8,25,65.7,2,0,0
9/29/2017 1:45,10,69.4,25,64.8,35,66.1,2,0,0
9/29/2017 1:50,8,69.3,23,64.7,31,65.9,2,0,0
9/29/2017 1:55,6,69.3,21,64.7,27,65.7,2,0,0
9/29/2017 2:00,9,69.3,24,64.7,33,66,2,0,0
9/29/2017 2:05,7,69.2,22,64.6,29,65.7,2,0,0
9/29/2017 2:10,6,69.2,22,64.5,28,65.5,2,0,0
9/29/2017 2:15,6,69.3,21,64.7,27,65.8,2,0,0
9/29/2017 2:20,5,69.4,21,64.8,26,65.7,2,0,0
9/29/2017 2:25,7,69.4,23,64.8,30,65.9,2,0,0
9/29/2017 2:30,11,69.3,26,64.7,37,66,2,0,0
9/29/2017 2:35,9,69,25,64.3,34,65.6,2,0,0
9/29/2017 2:40,9,68.9,25,64.2,34,65.5,2,0,0
9/29/2017 2:45,7,69.2,23,64.5,30,65.6,2,0,0
9/29/2017 2:50,12,69.4,28,64.8,40,66.2,2,0,0
9/29/2017 2:55,9,69.2,25,64.6,34,65.8,2,0,0
9/29/2017 3:00,12,69.2,28,64.6,40,66,2,0,0
9/29/2017 3:05,11,69.2,27,64.6,38,66,2,0,0
9/29/2017 3:10,11,69.2,27,64.6,38,65.9,2,0,0
9/29/2017 3:15,8,69.3,24,64.7,32,65.9,2,0,0
9/29/2017 3:20,10,69.3,25,64.7,35,66,2,0,0
9/29/2017 3:25,11,69.2,27,64.6,38,65.9,2,0,0
9/29/2017 3:30,9,69.2,25,64.5,34,65.8,2,0,0
9/29/2017 3:35,13,68.7,29,64,42,65.4,2,0,0
9/29/2017 3:40,13,68.7,29,64,42,65.5,2,0,0
9/29/2017 3:45,15,69.1,31,64.5,46,66,2,0,0
9/29/2017 3:50,14,69.3,30,64.7,44,66.1,2,0,0
9/29/2017 3:55,17,69.5,33,64.9,50,66.5,2,0,0
9/29/2017 4:00,12,69.5,28,64.9,40,66.3,2,0,0
9/29/2017 4:05,15,69.4,31,64.8,46,66.3,2,0,0
9/29/2017 4:10,17,69.3,32,64.7,49,66.3,2,0,0
9/29/2017 4:15,20,69.4,37,64.8,57,66.5,2,0,0
9/29/2017 4:20,20,69.4,36,64.8,56,66.5,2,0,0
9/29/2017 4:25,29,67.9,46,63.1,75,64.9,2,0,0
9/29/2017 4:30,22,68.6,38,63.9,60,65.6,2,0,0
9/29/2017 4:35,26,68.5,43,63.8,69,65.6,2,0,0
9/29/2017 4:40,34,69.3,52,64.6,86,66.5,2,0,0
9/29/2017 4:45,37,69.1,54,64.5,91,66.4,2,0,0
9/29/2017 4:50,42,69.1,61,64.4,103,66.4,2,0,0
9/29/2017 4:55,33,68.9,50,64.2,83,66.1,2,0,0
9/29/2017 5:00,32,68.9,49,64.3,81,66.1,2,0,0
9/29/2017 5:05,40,67.8,59,63.1,99,65,2,0,0
9/29/2017 5:10,43,67.2,61,62.4,104,64.4,2,0,0
9/29/2017 5:15,50,67.6,70,62.9,120,64.8,2,0,0
9/29/2017 5:20,51,68.6,70,64,121,65.9,2,0,0
9/29/2017 5:25,48,67.7,68,63,116,64.9,2,0,0
9/29/2017 5:30,52,67,72,62.3,124,64.3,2,0,0
9/29/2017 5:35,53,68.5,73,63.9,126,65.8,2,0,0
9/29/2017 5:40,68,67.1,90,62.3,158,64.4,2,0,0
9/29/2017 5:45,68,66.9,90,62.1,158,64.2,2,0,0
9/29/2017 5:50,70,66.7,92,61.9,162,64,2,0,0
9/29/2017 5:55,58,66.1,78,61.3,136,63.3,2,0,0
9/29/2017 6:00,55,66.7,75,61.9,130,63.9,2,0,0
9/29/2017 6:05,61,65.8,83,60.9,144,63,2,0,0
9/29/2017 6:10,52,65.2,71,60.2,123,62.3,2,0,0
9/29/2017 6:15,57,66.4,77,61.5,134,63.6,2,0,0
9/29/2017 6:20,46,67.3,66,62.4,112,64.4,2,0,0
9/29/2017 6:25,58,66.9,78,62,136,64.1,2,0,0
9/29/2017 6:30,53,68.5,73,63.7,126,65.7,2,0,0
9/29/2017 6:35,53,68.6,74,63.9,127,65.9,2,0,0
9/29/2017 6:40,54,68.2,74,63.4,128,65.4,2,0,0
9/29/2017 6:45,50,68.7,69,64,119,66,2,0,0
9/29/2017 6:50,52,67.6,72,62.8,124,64.8,2,0,0
9/29/2017 6:55,55,68,75,63.2,130,65.2,2,0,0
9/29/2017 7:00,53,68.6,73,63.9,126,65.9,2,0,0
9/29/2017 7:05,53,68.6,73,64,126,65.9,2,0,0
9/29/2017 7:10,59,68.4,79,63.7,138,65.7,2,0,0
9/29/2017 7:15,65,67.5,86,62.7,151,64.8,2,0,0
9/29/2017 7:20,68,68.6,90,63.9,158,65.9,2,0,0
9/29/2017 7:25,72,69.3,93,64.7,165,66.7,2,0,0
9/29/2017 7:30,64,68.8,85,64.2,149,66.2,2,0,0
9/29/2017 7:35,75,68.1,96,63.4,171,65.4,2,0,0
9/29/2017 7:40,79,68.1,102,63.3,181,65.4,2,0,0
9/29/2017 7:45,78,67.3,100,62.5,178,64.6,2,0,0
9/29/2017 7:50,83,67.7,106,63,189,65.1,2,0,0
9/29/2017 7:55,82,67,105,62.2,187,64.3,2,0,0
9/29/2017 8:00,78,65.7,101,60.8,179,63,2,0,0
9/29/2017 8:05,73,66.3,95,61.5,168,63.6,2,0,0
9/29/2017 8:10,78,67.1,101,62.3,179,64.4,2,0,0
9/29/2017 8:15,70,67.8,92,63,162,65.1,2,0,0
9/29/2017 8:20,80,67.8,102,63,182,65.1,2,0,0
9/29/2017 8:25,72,67.7,93,63,165,65.1,2,0,0
9/29/2017 8:30,80,66.3,102,61.4,182,63.6,2,0,0
9/29/2017 8:35,80,67.7,101,62.9,181,65,2,0,0
9/29/2017 8:40,74,68.4,96,63.7,170,65.7,2,0,0
9/29/2017 8:45,73,67.3,93,62.4,166,64.6,2,0,0
9/29/2017 8:50,76,67.1,97,62.3,173,64.4,2,0,0
9/29/2017 8:55,76,66.9,97,62.1,173,64.2,2,0,0
9/29/2017 9:00,67,65.8,88,60.9,155,63,2,0,0
9/29/2017 9:05,63,66.3,84,61.5,147,63.6,2,0,0
9/29/2017 9:10,66,66.7,86,61.9,152,64,2,0,0
9/29/2017 9:15,68,66,88,61.2,156,63.3,2,0,0
9/29/2017 9:20,74,65.7,95,60.8,169,63,2,0,0
9/29/2017 9:25,54,65.7,73,60.8,127,62.9,2,0,0
9/29/2017 9:30,60,65.7,80,60.8,140,62.9,2,0,0
9/29/2017 9:35,69,65.5,90,60.5,159,62.7,2,0,0
9/29/2017 9:40,68,66.6,87,61.6,155,63.8,2,0,0
9/29/2017 9:45,68,67.9,87,63.1,155,65.2,2,0,0
9/29/2017 9:50,59,67.4,77,62.6,136,64.7,2,0,0
9/29/2017 9:55,53,67.3,71,62.6,124,64.6,2,0,0
9/29/2017 10:00,43,67.5,60,62.8,103,64.8,2,0,0
9/29/2017 10:05,46,68,65,63.2,111,65.2,2,0,0
9/29/2017 10:10,45,68.2,62,63.5,107,65.5,2,0,0
9/29/2017 10:15,43,66.9,61,62.1,104,64.1,2,0,0
9/29/2017 10:20,42,68.1,60,63.5,102,65.4,2,0,0
9/29/2017 10:25,41,66,58,61.1,99,63.1,2,0,0
9/29/2017 10:30,47,62.9,66,57.6,113,59.8,2,0,0
9/29/2017 10:35,43,62.8,61,57.5,104,59.7,2,0,0
9/29/2017 10:40,39,63.6,56,58.5,95,60.6,2,0,0
9/29/2017 10:45,50,64.6,69,59.7,119,61.7,2,0,0
9/29/2017 10:50,49,65.2,68,60.3,117,62.3,2,0,0
9/29/2017 10:55,52,66.9,71,62.1,123,64.1,2,0,0
9/29/2017 11:00,57,66.4,75,61.6,132,63.7,2,0,0
9/29/2017 11:05,55,67.5,74,62.8,129,64.8,2,0,0
9/29/2017 11:10,47,66.7,65,62,112,64,2,0,0
9/29/2017 11:15,49,69,66,64.4,115,66.4,2,0,0
9/29/2017 11:20,65,68,59,62.2,124,65.2,2,0,0
9/29/2017 11:25,65,68.1,59,62.3,124,65.3,2,0,0
9/29/2017 11:30,56,70.2,75,65.6,131,67.5,2,0,0
9/29/2017 11:35,57,69,75,64.3,132,66.3,2,0,0
9/29/2017 11:40,55,69.4,74,64.8,129,66.7,2,0,0
9/29/2017 11:45,68,69.3,87,64.6,155,66.7,2,0,0
9/29/2017 11:50,55,70.3,73,65.8,128,67.7,2,0,0
9/29/2017 11:55,57,70.2,76,65.7,133,67.6,2,0,0
9/29/2017 12:00,56,69.6,74,65,130,67,2,0,0
9/29/2017 12:05,51,69.4,69,64.8,120,66.8,2,0,0
9/29/2017 12:10,68,68.1,61,62.3,129,65.4,2,0,0
9/29/2017 12:15,55,72.1,73,67.7,128,69.6,2,0,0
9/29/2017 12:20,56,70.3,75,65.7,131,67.7,2,0,0
9/29/2017 12:25,55,69.9,74,65.3,129,67.2,2,0,0
9/29/2017 12:30,52,68.6,70,64,122,66,2,0,0
9/29/2017 12:35,96,71.8,117,67.3,213,69.3,2,0,0
9/29/2017 12:40,52,70.6,70,66,122,68,2,0,0
9/29/2017 12:45,49,68.7,67,64.1,116,66.1,2,0,0
9/29/2017 12:50,51,69.7,69,65.1,120,67.1,2,0,0
9/29/2017 12:55,69,68.3,62,62.5,131,65.6,2,0,0
9/29/2017 13:00,53,65.3,70,60.4,123,62.5,2,0,0
9/29/2017 13:05,55,67.8,73,63.1,128,65.1,2,0,0
9/29/2017 13:10,54,67.7,72,62.9,126,65,2,0,0
9/29/2017 13:15,51,67.8,69,63.1,120,65.1,2,0,0
9/29/2017 13:20,58,68.2,77,63.4,135,65.5,2,0,0
9/29/2017 13:25,38,68.4,54,63.7,92,65.7,2,0,0
9/29/2017 13:30,57,67.4,76,62.7,133,64.7,2,0,0
9/29/2017 13:35,55,66.4,74,61.6,129,63.7,2,0,0
9/29/2017 13:40,53,67.2,71,62.5,124,64.5,2,0,0
9/29/2017 13:45,46,67,64,62.2,110,64.2,2,0,0
9/29/2017 13:50,58,68.2,76,63.4,134,65.5,2,0,0
9/29/2017 13:55,53,68.1,71,63.3,124,65.3,2,0,0
9/29/2017 14:00,47,68.3,65,63.5,112,65.5,2,0,0
9/29/2017 14:05,45,67.1,62,62.3,107,64.3,2,0,0
9/29/2017 14:10,54,67.7,73,63,127,65,2,0,0
9/29/2017 14:15,49,68.4,66,63.7,115,65.7,2,0,0
9/29/2017 14:20,44,67.1,61,62.4,105,64.4,2,0,0
9/29/2017 14:25,47,66.1,64,61.3,111,63.3,2,0,0
9/29/2017 14:30,44,67.5,61,62.7,105,64.7,2,0,0
9/29/2017 14:35,60,67.8,78,63,138,65.1,2,0,0
9/29/2017 14:40,41,67.6,57,62.8,98,64.8,2,0,0
9/29/2017 14:45,45,67.7,62,63,107,65,2,0,0
9/29/2017 14:50,46,66.4,64,61.6,110,63.6,2,0,0
9/29/2017 14:55,48,67.3,65,62.5,113,64.5,2,0,0
9/29/2017 15:00,47,67.7,65,63,112,65,2,0,0
9/29/2017 15:05,56,68.4,75,63.8,131,65.8,2,0,0
9/29/2017 15:10,52,68.4,69,63.8,121,65.7,2,0,0
9/29/2017 15:15,48,68.9,67,64.3,115,66.2,2,0,0
9/29/2017 15:20,57,67.4,76,62.7,133,64.8,2,0,0
9/29/2017 15:25,61,67.3,80,62.5,141,64.6,2,0,0
9/29/2017 15:30,64,67.1,83,62.3,147,64.4,2,0,0
9/29/2017 15:35,54,66.8,73,61.9,127,64,2,0,0
9/29/2017 15:40,61,66.2,81,61.3,142,63.4,2,0,0
9/29/2017 15:45,50,67.6,67,62.8,117,64.8,2,0,0
9/29/2017 15:50,84,68,76,62.2,160,65.2,2,0,0
9/29/2017 15:55,64,65.9,83,61,147,63.2,2,0,0
9/29/2017 16:00,51,67.1,69,62.3,120,64.3,2,0,0
9/29/2017 16:05,56,67.9,75,63.1,131,65.1,2,0,0
9/29/2017 16:10,58,68.2,77,63.5,135,65.5,2,0,0
9/29/2017 16:15,60,67.8,79,63.1,139,65.1,2,0,0
9/29/2017 16:20,60,68.8,78,64.1,138,66.1,2,0,0
9/29/2017 16:25,52,69.5,69,64.8,121,66.8,2,0,0
9/29/2017 16:30,56,69,74,64.4,130,66.4,2,0,0
9/29/2017 16:35,53,68.7,71,64,124,66,2,0,0
9/29/2017 16:40,58,68.5,76,63.9,134,65.9,2,0,0
9/29/2017 16:45,40,69.4,58,64.9,98,66.7,2,0,0
9/29/2017 16:50,58,69.3,76,64.8,134,66.7,2,0,0
9/29/2017 16:55,49,68.4,67,63.7,116,65.7,2,0,0
9/29/2017 17:00,85,68,76,62.2,161,65.3,2,0,0
9/29/2017 17:05,52,68.2,70,63.4,122,65.4,2,0,0
9/29/2017 17:10,50,69.2,68,64.6,118,66.5,2,0,0
9/29/2017 17:15,58,68.1,76,63.4,134,65.4,2,0,0
9/29/2017 17:20,56,68.3,74,63.6,130,65.7,2,0,0
9/29/2017 17:25,60,68.6,78,63.9,138,66,2,0,0
9/29/2017 17:30,60,68.6,79,63.9,139,66,2,0,0
9/29/2017 17:35,56,68.2,73,63.5,129,65.6,2,0,0
9/29/2017 17:40,87,66.3,78,60.7,165,63.7,2,0,0
9/29/2017 17:45,84,66.3,76,60.7,160,63.6,2,0,0
9/29/2017 17:50,83,66,74,60.4,157,63.4,2,0,0
9/29/2017 17:55,81,66,73,60.4,154,63.3,2,0,0
9/29/2017 18:00,80,66.6,71,60.8,151,63.9,2,0,0
9/29/2017 18:05,79,66.8,70,61,149,64.1,2,0,0
9/29/2017 18:10,80,66.9,71,61.1,151,64.2,2,0,0
9/29/2017 18:15,81,66.7,73,60.9,154,63.9,2,0,0
9/29/2017 18:20,79,66.9,71,61.1,150,64.2,2,0,0
9/29/2017 18:25,77,67.2,69,61.4,146,64.5,2,0,0
9/29/2017 18:30,75,67.3,67,61.5,142,64.6,2,0,0
9/29/2017 18:35,73,67.3,66,61.5,139,64.5,2,0,0
9/29/2017 18:40,75,67.7,67,61.9,142,65,2,0,0
9/29/2017 18:45,73,67.7,65,61.9,138,65,2,0,0
9/29/2017 18:50,48,68.1,65,63.4,113,65.4,2,0,0
9/29/2017 18:55,53,68.8,71,64.1,124,66.1,2,0,0
9/29/2017 19:00,67,68.5,61,62.7,128,65.7,2,0,0
9/29/2017 19:05,66,68.9,59,62.9,125,66.1,2,0,0
9/29/2017 19:10,66,69.1,59,63.1,125,66.3,2,0,0
9/29/2017 19:15,64,69.1,57,63.1,121,66.3,2,0,0
9/29/2017 19:20,41,70.4,58,65.8,99,67.7,2,0,0
9/29/2017 19:25,48,68.6,66,63.8,114,65.8,2,0,0
9/29/2017 19:30,59,69.6,53,63.6,112,66.8,2,0,0
9/29/2017 19:35,58,69.8,52,63.8,110,67,2,0,0
9/29/2017 19:40,55,70,50,64,105,67.1,2,0,0
9/29/2017 19:45,53,70.2,47,64.2,100,67.4,2,0,0
9/29/2017 19:50,30,69.3,46,64.7,76,66.6,2,0,0
9/29/2017 19:55,40,69.3,57,64.7,97,66.6,2,0,0
9/29/2017 20:00,42,69,60,64.4,102,66.3,2,0,0
9/29/2017 20:05,41,69.7,58,65.1,99,67,2,0,0
9/29/2017 20:10,40,69.1,57,64.6,97,66.4,2,0,0
9/29/2017 20:15,44,70.2,40,64.2,84,67.3,2,0,0
9/29/2017 20:20,45,70.2,40,64.2,85,67.4,2,0,0
9/29/2017 20:25,33,69.3,50,64.7,83,66.6,2,0,0
9/29/2017 20:30,37,69.7,54,65.2,91,67,2,0,0
9/29/2017 20:35,43,69.2,60,64.6,103,66.5,2,0,0
9/29/2017 20:40,30,69.4,46,64.8,76,66.6,2,0,0
9/29/2017 20:45,44,69,60,64.4,104,66.4,2,0,0
9/29/2017 20:50,35,69.1,51,64.4,86,66.3,2,0,0
9/29/2017 20:55,37,67.7,53,63,90,65,2,0,0
9/29/2017 21:00,31,68.8,48,64.2,79,66,2,0,0
9/29/2017 21:05,32,68.6,49,64,81,65.8,2,0,0
9/29/2017 21:10,39,68.9,56,64.3,95,66.2,2,0,0
9/29/2017 21:15,29,69.1,46,64.4,75,66.2,2,0,0
9/29/2017 21:20,38,69.5,55,64.9,93,66.8,2,0,0
9/29/2017 21:25,36,69.6,53,65,89,66.9,2,0,0
9/29/2017 21:30,34,69.8,51,65.3,85,67.1,2,0,0
9/29/2017 21:35,35,69.9,52,65.3,87,67.2,2,0,0
9/29/2017 21:40,29,69.8,45,65.3,74,67.1,2,0,0
9/29/2017 21:45,31,69.4,47,64.7,78,66.6,2,0,0
9/29/2017 21:50,46,64.1,66,59.3,112,61.3,2,0,0
9/29/2017 21:55,33,67.1,49,62.4,82,64.3,2,0,0
9/29/2017 22:00,31,68,47,63.4,78,65.2,2,0,0
9/29/2017 22:05,37,68.9,53,64.3,90,66.2,2,0,0
9/29/2017 22:10,33,68.2,49,63.6,82,65.5,2,0,0
9/29/2017 22:15,30,68.6,47,64,77,65.8,2,0,0
9/29/2017 22:20,32,69.4,49,64.8,81,66.6,2,0,0
9/29/2017 22:25,29,69.1,45,64.5,74,66.3,2,0,0
9/29/2017 22:30,30,68.8,46,64.2,76,66,2,0,0
9/29/2017 22:35,28,69.4,43,64.8,71,66.6,2,0,0
9/29/2017 22:40,31,69,48,64.4,79,66.2,2,0,0
9/29/2017 22:45,29,68.9,45,64.2,74,66.1,2,0,0
9/29/2017 22:50,33,68.9,49,64.2,82,66.1,2,0,0
9/29/2017 22:55,20,67.1,35,62.4,55,64.1,2,0,0
9/29/2017 23:00,25,70.4,23,64.4,48,67.5,2,0,0
9/29/2017 23:05,20,69.3,36,64.7,56,66.4,2,0,0
9/29/2017 23:10,22,69.4,38,64.8,60,66.5,2,0,0
9/29/2017 23:15,25,70.4,22,64.4,47,67.6,2,0,0
9/29/2017 23:20,23,69.3,38,64.7,61,66.5,2,0,0
9/29/2017 23:25,29,68.9,45,64.3,74,66.1,2,0,0
9/29/2017 23:30,20,69.2,35,64.6,55,66.3,2,0,0
9/29/2017 23:35,21,69.4,36,64.8,57,66.5,2,0,0
9/29/2017 23:40,21,69.3,36,64.7,57,66.4,2,0,0
9/29/2017 23:45,17,69.4,32,64.8,49,66.4,2,0,0
9/29/2017 23:50,21,69.6,36,65,57,66.7,2,0,0
9/29/2017 23:55,24,68.7,39,64.1,63,65.9,2,0,0
9/30/2017 0:00,15,69.3,31,64.7,46,66.2,2,0,0
9/30/2017 0:05,14,69.3,29,64.7,43,66.2,2,0,0
9/30/2017 0:10,16,69.2,32,64.5,48,66.1,2,0,0
9/30/2017 0:15,16,69.2,32,64.6,48,66.2,2,0,0
9/30/2017 0:20,18,69.3,33,64.6,51,66.3,2,0,0
9/30/2017 0:25,14,70.4,12,64.4,26,67.6,2,0,0
9/30/2017 0:30,13,70.3,12,64.3,25,67.4,2,0,0
9/30/2017 0:35,28,69.3,44,64.7,72,66.5,2,0,0
9/30/2017 0:40,17,68.9,33,64.3,50,65.9,2,0,0
9/30/2017 0:45,11,70.3,10,64.3,21,67.4,2,0,0
9/30/2017 0:50,11,70.2,10,64.2,21,67.3,2,0,0
9/30/2017 0:55,11,70.4,10,64.4,21,67.5,2,0,0
9/30/2017 1:00,9,70.3,9,64.3,18,67.3,2,0,0
9/30/2017 1:05,11,69.3,26,64.7,37,66.1,2,0,0
9/30/2017 1:10,9,69.4,24,64.8,33,66,2,0,0
9/30/2017 1:15,11,69.4,27,64.8,38,66.1,2,0,0
9/30/2017 1:20,16,68.8,31,64.2,47,65.8,2,0,0
9/30/2017 1:25,8,70.2,7,64.2,15,67.4,2,0,0
9/30/2017 1:30,8,70.3,8,64.3,16,67.3,2,0,0
9/30/2017 1:35,12,69.3,21,64.7,33,66.4,2,0,0
9/30/2017 1:40,10,69.4,26,64.8,36,66.1,2,0,0
9/30/2017 1:45,8,70.2,7,64.2,15,67.4,2,0,0
9/30/2017 1:50,8,70.2,8,64.2,16,67.2,2,0,0
9/30/2017 1:55,8,70.1,8,64.1,16,67.1,2,0,0
9/30/2017 2:00,6,69.3,21,64.7,27,65.7,2,0,0
9/30/2017 2:05,15,69.4,22,64.7,37,66.6,2,0,0
9/30/2017 2:10,8,70.2,7,64.2,15,67.4,2,0,0
9/30/2017 2:15,13,69.3,21,64.7,34,66.5,2,0,0
9/30/2017 2:20,10,69.2,25,64.6,35,65.9,2,0,0
9/30/2017 2:25,6,70.2,6,64.2,12,67.2,2,0,0
9/30/2017 2:30,6,70.2,6,64.2,12,67.2,2,0,0
9/30/2017 2:35,6,70.4,5,64.4,11,67.7,2,0,0
9/30/2017 2:40,6,70.1,5,64.1,11,67.4,2,0,0
9/30/2017 2:45,6,70,5,64,11,67.3,2,0,0
9/30/2017 2:50,6,70.1,5,64.1,11,67.4,2,0,0
9/30/2017 2:55,6,70,5,64,11,67.3,2,0,0
9/30/2017 3:00,5,70.2,4,64.2,9,67.5,2,0,0
9/30/2017 3:05,9,69.3,24,64.7,33,66,2,0,0
9/30/2017 3:10,8,69.4,24,64.8,32,66,2,0,0
9/30/2017 3:15,5,70.3,4,64.3,9,67.6,2,0,0
9/30/2017 3:20,14,69.3,22,64.7,36,66.5,2,0,0
9/30/2017 3:25,8,69.4,23,64.8,31,66,2,0,0
9/30/2017 3:30,10,69.4,25,64.8,35,66.1,2,0,0
9/30/2017 3:35,12,69.5,28,64.9,40,66.3,2,0,0
9/30/2017 3:40,5,70.3,5,64.3,10,67.3,2,0,0
9/30/2017 3:45,10,69.3,26,64.7,36,66,2,0,0
9/30/2017 3:50,10,69.3,26,64.7,36,66,2,0,0
9/30/2017 3:55,7,69.4,22,64.8,29,65.9,2,0,0
9/30/2017 4:00,9,69.3,25,64.7,34,65.9,2,0,0
9/30/2017 4:05,5,70.2,4,64.2,9,67.5,2,0,0
9/30/2017 4:10,18,69.3,23,64.7,41,66.8,2,0,0
9/30/2017 4:15,10,69.4,25,64.8,35,66.2,2,0,0
9/30/2017 4:20,5,70.3,5,64.3,10,67.3,2,0,0
9/30/2017 4:25,5,70.4,5,64.4,10,67.4,2,0,0
9/30/2017 4:30,6,70.2,5,64.2,11,67.5,2,0,0
9/30/2017 4:35,6,70.1,6,64.1,12,67.1,2,0,0
9/30/2017 4:40,7,70.3,6,64.3,13,67.5,2,0,0
9/30/2017 4:45,7,70.2,6,64.2,13,67.4,2,0,0
9/30/2017 4:50,7,70.2,6,64.2,13,67.4,2,0,0
9/30/2017 4:55,7,70.3,6,64.3,13,67.5,2,0,0
9/30/2017 5:00,7,70.3,6,64.3,13,67.5,2,0,0
9/30/2017 5:05,20,69.3,37,64.7,57,66.4,2,0,0
9/30/2017 5:10,20,69.1,36,64.5,56,66.1,2,0,0
9/30/2017 5:15,15,69.2,31,64.6,46,66.1,2,0,0
9/30/2017 5:20,21,68.7,36,64,57,65.8,2,0,0
9/30/2017 5:25,9,70.3,9,64.3,18,67.3,2,0,0
9/30/2017 5:30,11,70.4,10,64.4,21,67.5,2,0,0
9/30/2017 5:35,21,69.3,37,64.7,58,66.4,2,0,0
9/30/2017 5:40,24,69.2,40,64.5,64,66.3,2,0,0
9/30/2017 5:45,13,70.6,12,64.6,25,67.7,2,0,0
9/30/2017 5:50,14,70.5,12,64.5,26,67.7,2,0,0
9/30/2017 5:55,13,70.5,12,64.5,25,67.6,2,0,0
9/30/2017 6:00,13,70.4,12,64.4,25,67.5,2,0,0
9/30/2017 6:05,14,70.5,12,64.5,26,67.7,2,0,0
9/30/2017 6:10,15,70.5,13,64.5,28,67.7,2,0,0
9/30/2017 6:15,16,70.4,14,64.4,30,67.6,2,0,0
9/30/2017 6:20,17,70.4,16,64.4,33,67.5,2,0,0
9/30/2017 6:25,18,70.6,16,64.6,34,67.8,2,0,0
9/30/2017 6:30,25,69.3,42,64.7,67,66.5,2,0,0
9/30/2017 6:35,32,70.5,48,65.9,80,67.8,2,0,0
9/30/2017 6:40,22,70.6,20,64.6,42,67.7,2,0,0
9/30/2017 6:45,24,70.5,21,64.5,45,67.7,2,0,0
9/30/2017 6:50,28,69.3,45,64.7,73,66.5,2,0,0
9/30/2017 6:55,22,70.5,20,64.5,42,67.6,2,0,0
9/30/2017 7:00,21,70.3,19,64.3,40,67.5,2,0,0
9/30/2017 7:05,27,69.3,44,64.7,71,66.5,2,0,0
9/30/2017 7:10,30,67.6,46,62.9,76,64.7,2,0,0
9/30/2017 7:15,37,67.1,54,62.3,91,64.3,2,0,0
9/30/2017 7:20,30,67.2,47,62.4,77,64.3,2,0,0
9/30/2017 7:25,32,68,50,63.3,82,65.1,2,0,0
9/30/2017 7:30,31,68.3,48,63.6,79,65.4,2,0,0
9/30/2017 7:35,34,67.7,50,63,84,64.9,2,0,0
9/30/2017 7:40,41,66.7,58,61.9,99,63.9,2,0,0
9/30/2017 7:45,43,67.9,62,63.1,105,65,2,0,0
9/30/2017 7:50,35,70.7,31,64.7,66,67.9,2,0,0
9/30/2017 7:55,34,70.7,31,64.7,65,67.8,2,0,0
9/30/2017 8:00,33,70.6,29,64.6,62,67.8,2,0,0
9/30/2017 8:05,33,70.4,29,64.4,62,67.6,2,0,0
9/30/2017 8:10,34,70.4,30,64.4,64,67.6,2,0,0
9/30/2017 8:15,36,70.4,33,64.4,69,67.5,2,0,0
9/30/2017 8:20,39,70.4,35,64.4,74,67.6,2,0,0
9/30/2017 8:25,40,70.5,36,64.5,76,67.7,2,0,0
9/30/2017 8:30,42,70.6,38,64.6,80,67.8,2,0,0
9/30/2017 8:35,43,70.5,39,64.5,82,67.6,2,0,0
9/30/2017 8:40,46,70.6,41,64.6,87,67.8,2,0,0
9/30/2017 8:45,49,70.6,44,64.6,93,67.8,2,0,0
9/30/2017 8:50,51,70.6,45,64.6,96,67.8,2,0,0
9/30/2017 8:55,47,70.7,42,64.7,89,67.9,2,0,0
9/30/2017 9:00,45,70.6,41,64.6,86,67.7,2,0,0
9/30/2017 9:05,45,70.6,40,64.6,85,67.8,2,0,0
9/30/2017 9:10,46,70.5,41,64.5,87,67.7,2,0,0
9/30/2017 9:15,48,70.5,43,64.5,91,67.7,2,0,0
9/30/2017 9:20,51,70.5,45,64.5,96,67.7,2,0,0
9/30/2017 9:25,52,70.3,47,64.3,99,67.5,2,0,0
9/30/2017 9:30,59,69.5,76,64.9,135,66.9,2,0,0
9/30/2017 9:35,63,68.6,83,63.9,146,65.9,2,0,0
9/30/2017 9:40,57,70.3,52,64.3,109,67.4,2,0,0
9/30/2017 9:45,58,70.4,53,64.4,111,67.5,2,0,0
9/30/2017 9:50,59,70.2,78,65.7,137,67.6,2,0,0
9/30/2017 9:55,71,70,91,65.4,162,67.4,2,0,0
9/30/2017 10:00,54,70.2,72,65.7,126,67.7,2,0,0
9/30/2017 10:05,44,69.1,60,64.5,104,66.4,2,0,0
9/30/2017 10:10,48,67.7,66,63,114,65,2,0,0
9/30/2017 10:15,58,68.2,77,63.5,135,65.5,2,0,0
9/30/2017 10:20,59,67.3,77,62.5,136,64.6,2,0,0
9/30/2017 10:25,59,67.6,78,62.8,137,64.9,2,0,0
9/30/2017 10:30,55,67.3,74,62.5,129,64.6,2,0,0
9/30/2017 10:35,66,66.9,84,62.1,150,64.2,2,0,0
9/30/2017 10:40,68,67,88,62.1,156,64.2,2,0,0
9/30/2017 10:45,60,67.4,79,62.6,139,64.7,2,0,0
9/30/2017 10:50,58,67.7,77,63,135,65,2,0,0
9/30/2017 10:55,70,66.8,90,62,160,64.1,2,0,0
9/30/2017 11:00,71,67.3,91,62.5,162,64.6,2,0,0
9/30/2017 11:05,75,67.1,96,62.3,171,64.4,2,0,0
9/30/2017 11:10,72,67,93,62.2,165,64.3,2,0,0
9/30/2017 11:15,81,67,101,62.1,182,64.3,2,0,0
9/30/2017 11:20,69,65.9,88,61,157,63.2,2,0,0
9/30/2017 11:25,78,67.1,98,62.2,176,64.4,2,0,0
9/30/2017 11:30,57,67.2,76,62.4,133,64.4,2,0,0
9/30/2017 11:35,69,67.5,89,62.7,158,64.8,2,0,0
9/30/2017 11:40,65,67,84,62.1,149,64.3,2,0,0
9/30/2017 11:45,80,66.9,100,62.1,180,64.2,2,0,0
9/30/2017 11:50,70,67.2,90,62.5,160,64.6,2,0,0
9/30/2017 11:55,72,68.2,91,63.4,163,65.5,2,0,0
9/30/2017 12:00,69,68.4,88,63.8,157,65.8,2,0,0
9/30/2017 12:05,70,68.2,90,63.5,160,65.5,2,0,0
9/30/2017 12:10,79,68.1,100,63.5,179,65.5,2,0,0
9/30/2017 12:15,72,67.7,92,63,164,65.1,2,0,0
9/30/2017 12:20,77,67.9,96,63.2,173,65.3,2,0,0
9/30/2017 12:25,65,67.8,83,63.1,148,65.1,2,0,0
9/30/2017 12:30,71,68.3,91,63.6,162,65.6,2,0,0
9/30/2017 12:35,68,68.3,87,63.7,155,65.7,2,0,0
9/30/2017 12:40,68,67.6,87,62.9,155,65,2,0,0
9/30/2017 12:45,75,67.7,95,63,170,65,2,0,0
9/30/2017 12:50,73,67.4,93,62.7,166,64.7,2,0,0
9/30/2017 12:55,69,68,89,63.3,158,65.4,2,0,0
9/30/2017 13:00,73,69.9,66,63.9,139,67.1,2,0,0
9/30/2017 13:05,60,71,78,66.7,138,68.5,2,0,0
9/30/2017 13:10,65,69.8,83,65.3,148,67.3,2,0,0
9/30/2017 13:15,55,69.1,74,64.6,129,66.5,2,0,0
9/30/2017 13:20,74,67.6,94,62.8,168,64.9,2,0,0
9/30/2017 13:25,68,68.3,87,63.6,155,65.7,2,0,0
9/30/2017 13:30,63,67.9,83,63.2,146,65.2,2,0,0
9/30/2017 13:35,64,67.9,83,63.3,147,65.3,2,0,0
9/30/2017 13:40,70,68.8,89,64.2,159,66.2,2,0,0
9/30/2017 13:45,76,68.8,96,64.2,172,66.2,2,0,0
9/30/2017 13:50,72,67.4,91,62.6,163,64.7,2,0,0
9/30/2017 13:55,67,68.3,86,63.6,153,65.7,2,0,0
9/30/2017 14:00,73,67.6,93,62.9,166,65,2,0,0
9/30/2017 14:05,68,67.8,87,63.1,155,65.1,2,0,0
9/30/2017 14:10,67,67.9,86,63.2,153,65.3,2,0,0
9/30/2017 14:15,64,68.4,82,63.7,146,65.8,2,0,0
9/30/2017 14:20,68,68.4,87,63.7,155,65.8,2,0,0
9/30/2017 14:25,64,68.1,82,63.4,146,65.4,2,0,0
9/30/2017 14:30,64,68.6,84,63.9,148,65.9,2,0,0
9/30/2017 14:35,63,68.4,82,63.7,145,65.8,2,0,0
9/30/2017 14:40,51,68.8,69,64.2,120,66.1,2,0,0
9/30/2017 14:45,64,69.2,83,64.6,147,66.6,2,0,0
9/30/2017 14:50,58,69.2,75,64.6,133,66.6,2,0,0
9/30/2017 14:55,60,68.9,78,64.3,138,66.3,2,0,0
9/30/2017 15:00,62,68.9,79,64.3,141,66.3,2,0,0
9/30/2017 15:05,60,69.1,79,64.5,139,66.4,2,0,0
9/30/2017 15:10,68,69,87,64.5,155,66.5,2,0,0
9/30/2017 15:15,69,68.6,88,64,157,66,2,0,0
9/30/2017 15:20,77,67.9,98,63.2,175,65.3,2,0,0
9/30/2017 15:25,75,68.6,95,64,170,66,2,0,0
9/30/2017 15:30,62,68.5,81,63.9,143,65.9,2,0,0
9/30/2017 15:35,74,67.7,94,62.9,168,65,2,0,0
9/30/2017 15:40,65,68,84,63.3,149,65.3,2,0,0
9/30/2017 15:45,65,68.1,83,63.4,148,65.5,2,0,0
9/30/2017 15:50,69,68.3,88,63.6,157,65.7,2,0,0
9/30/2017 15:55,66,68.6,85,64,151,66,2,0,0
9/30/2017 16:00,63,68,83,63.4,146,65.4,2,0,0
9/30/2017 16:05,70,68.2,89,63.5,159,65.6,2,0,0
9/30/2017 16:10,68,68.1,87,63.4,155,65.5,2,0,0
9/30/2017 16:15,60,68.9,78,64.4,138,66.4,2,0,0
9/30/2017 16:20,65,68.9,85,64.4,150,66.4,2,0,0
9/30/2017 16:25,66,69.3,85,64.8,151,66.7,2,0,0
9/30/2017 16:30,58,69.3,76,64.7,134,66.7,2,0,0
9/30/2017 16:35,64,68.9,83,64.4,147,66.3,2,0,0
9/30/2017 16:40,69,68.1,89,63.5,158,65.5,2,0,0
9/30/2017 16:45,65,68.2,84,63.5,149,65.5,2,0,0
9/30/2017 16:50,59,68.5,76,63.9,135,65.9,2,0,0
9/30/2017 16:55,61,68.3,79,63.6,140,65.6,2,0,0
9/30/2017 17:00,64,67.9,83,63.2,147,65.3,2,0,0
9/30/2017 17:05,59,68.3,76,63.6,135,65.7,2,0,0
9/30/2017 17:10,60,67.8,77,63.1,137,65.1,2,0,0
9/30/2017 17:15,48,68.8,65,64.2,113,66.1,2,0,0
9/30/2017 17:20,59,68,78,63.3,137,65.3,2,0,0
9/30/2017 17:25,49,67,66,62.1,115,64.2,2,0,0
9/30/2017 17:30,53,66.9,71,62.1,124,64.1,2,0,0
9/30/2017 17:35,55,67.8,73,63,128,65,2,0,0
9/30/2017 17:40,51,67.5,69,62.8,120,64.8,2,0,0
9/30/2017 17:45,56,67.8,74,63.1,130,65.1,2,0,0
9/30/2017 17:50,51,67.9,70,63.1,121,65.1,2,0,0
9/30/2017 17:55,51,68.2,68,63.4,119,65.4,2,0,0
9/30/2017 18:00,41,68.5,58,63.8,99,65.7,2,0,0
9/30/2017 18:05,47,68.2,64,63.5,111,65.5,2,0,0
9/30/2017 18:10,59,67.4,78,62.7,137,64.7,2,0,0
9/30/2017 18:15,58,67.4,75,62.7,133,64.7,2,0,0
9/30/2017 18:20,61,67.6,80,62.9,141,64.9,2,0,0
9/30/2017 18:25,48,67.2,65,62.5,113,64.5,2,0,0
9/30/2017 18:30,52,66.9,70,62.1,122,64.1,2,0,0
9/30/2017 18:35,48,67.6,66,62.8,114,64.8,2,0,0
9/30/2017 18:40,46,67.9,64,63.2,110,65.2,2,0,0
9/30/2017 18:45,56,67.7,73,63,129,65,2,0,0
9/30/2017 18:50,54,67.2,73,62.3,127,64.4,2,0,0
9/30/2017 18:55,60,66.7,78,61.7,138,63.9,2,0,0
9/30/2017 19:00,49,68.5,67,63.8,116,65.8,2,0,0
9/30/2017 19:05,45,68.9,62,64.2,107,66.1,2,0,0
9/30/2017 19:10,46,68.8,64,64.1,110,66.1,2,0,0
9/30/2017 19:15,39,69.1,56,64.4,95,66.3,2,0,0
9/30/2017 19:20,48,68.3,65,63.6,113,65.6,2,0,0
9/30/2017 19:25,48,68.6,65,63.9,113,65.9,2,0,0
9/30/2017 19:30,45,67.8,62,63,107,65.1,2,0,0
9/30/2017 19:35,45,67.6,63,62.8,108,64.8,2,0,0
9/30/2017 19:40,43,67.7,60,62.9,103,64.9,2,0,0
9/30/2017 19:45,40,67.9,57,63.2,97,65.1,2,0,0
9/30/2017 19:50,49,68.7,67,64.1,116,66,2,0,0
9/30/2017 19:55,39,68.7,56,64,95,66,2,0,0
9/30/2017 20:00,39,68.6,56,63.8,95,65.8,2,0,0
9/30/2017 20:05,44,68.1,60,63.4,104,65.4,2,0,0
9/30/2017 20:10,37,64.5,54,59.4,91,61.4,2,0,0
9/30/2017 20:15,47,66.2,64,61.3,111,63.3,2,0,0
9/30/2017 20:20,40,67.4,56,62.7,96,64.6,2,0,0
9/30/2017 20:25,38,68.4,54,63.7,92,65.7,2,0,0
9/30/2017 20:30,38,68.6,54,63.9,92,65.9,2,0,0
9/30/2017 20:35,31,69.1,48,64.5,79,66.3,2,0,0
9/30/2017 20:40,38,69.1,54,64.5,92,66.4,2,0,0
9/30/2017 20:45,34,69.1,50,64.5,84,66.4,2,0,0
9/30/2017 20:50,37,69.1,53,64.5,90,66.4,2,0,0
9/30/2017 20:55,32,69.2,48,64.5,80,66.4,2,0,0
9/30/2017 21:00,33,69.3,49,64.7,82,66.5,2,0,0
9/30/2017 21:05,36,68.9,52,64.3,88,66.2,2,0,0
9/30/2017 21:10,31,68.9,47,64.3,78,66.1,2,0,0
9/30/2017 21:15,35,68.8,51,64.1,86,66,2,0,0
9/30/2017 21:20,33,68.4,49,63.7,82,65.6,2,0,0
9/30/2017 21:25,38,68.7,53,64,91,65.9,2,0,0
9/30/2017 21:30,34,69,50,64.4,84,66.2,2,0,0
9/30/2017 21:35,29,69,46,64.4,75,66.2,2,0,0
9/30/2017 21:40,34,68.8,51,64.1,85,66,2,0,0
9/30/2017 21:45,35,69,51,64.4,86,66.3,2,0,0
9/30/2017 21:50,31,68.9,47,64.2,78,66.1,2,0,0
9/30/2017 21:55,32,69.2,48,64.5,80,66.4,2,0,0
9/30/2017 22:00,32,69.4,48,64.7,80,66.6,2,0,0
9/30/2017 22:05,36,69.4,52,64.8,88,66.7,2,0,0
9/30/2017 22:10,30,69.4,46,64.8,76,66.6,2,0,0
9/30/2017 22:15,35,69.1,52,64.4,87,66.3,2,0,0
9/30/2017 22:20,34,68.7,49,64.1,83,66,2,0,0
9/30/2017 22:25,35,68.8,50,64.2,85,66.1,2,0,0
9/30/2017 22:30,39,69.2,55,64.7,94,66.6,2,0,0
9/30/2017 22:35,29,69.1,44,64.5,73,66.3,2,0,0
9/30/2017 22:40,36,68.7,53,64.1,89,66,2,0,0
9/30/2017 22:45,42,68.6,58,64,100,65.9,2,0,0
9/30/2017 22:50,33,68.9,50,64.2,83,66.1,2,0,0
9/30/2017 22:55,39,69.3,55,64.7,94,66.6,2,0,0
9/30/2017 23:00,32,69.3,48,64.7,80,66.5,2,0,0
9/30/2017 23:05,30,69.4,46,64.7,76,66.6,2,0,0
9/30/2017 23:10,31,69.3,47,64.7,78,66.5,2,0,0
9/30/2017 23:15,25,69.4,41,64.8,66,66.6,2,0,0
9/30/2017 23:20,23,69.4,38,64.8,61,66.5,2,0,0
9/30/2017 23:25,32,69.3,48,64.7,80,66.5,2,0,0
9/30/2017 23:30,30,69.6,46,65,76,66.8,2,0,0
9/30/2017 23:35,26,69.6,42,65,68,66.8,2,0,0
9/30/2017 23:40,21,69.6,37,65,58,66.7,2,0,0
9/30/2017 23:45,26,69.4,41,64.8,67,66.6,2,0,0
9/30/2017 23:50,24,69.3,40,64.7,64,66.5,2,0,0
9/30/2017 23:55,20,69.6,36,65,56,66.6,2,0,0
10/01/2017 0:00,18,69.3,34,64.7,52,66.3,2,0,0
10/01/2017 0:05,18,69.2,33,64.6,51,66.2,2,0,0
10/01/2017 0:10,16,69.2,31,64.6,47,66.2,2,0,0
10/01/2017 0:15,18,69.5,34,64.9,52,66.4,2,0,0
10/01/2017 0:20,18,69.6,33,65,51,66.6,2,0,0
10/01/2017 0:25,19,69.6,34,65,53,66.6,2,0,0
10/01/2017 0:30,16,69.5,31,64.9,47,66.5,2,0,0
10/01/2017 0:35,12,69.5,27,64.9,39,66.3,2,0,0
10/01/2017 0:40,13,69.4,29,64.8,42,66.2,2,0,0
10/01/2017 0:45,14,68.9,30,64.3,44,65.8,2,0,0
10/01/2017 0:50,15,69,30,64.4,45,65.9,2,0,0
10/01/2017 0:55,11,69.1,26,64.5,37,65.9,2,0,0
10/01/2017 1:00,11,69.2,26,64.6,37,66,2,0,0
10/01/2017 1:05,10,69.3,25,64.7,35,66,2,0,0
10/01/2017 1:10,13,69.4,28,64.8,41,66.2,2,0,0
10/01/2017 1:15,8,69.3,23,64.7,31,65.9,2,0,0
10/01/2017 1:20,11,69.4,27,64.8,38,66.1,2,0,0
10/01/2017 1:25,13,69.2,28,64.5,41,66,2,0,0
10/01/2017 1:30,8,69.3,23,64.7,31,65.9,2,0,0
10/01/2017 1:35,10,69.1,25,64.5,35,65.8,2,0,0
10/01/2017 1:40,6,69.3,21,64.7,27,65.7,2,0,0
10/01/2017 1:45,11,69.3,27,64.7,38,66,2,0,0
10/01/2017 1:50,7,69.3,22,64.7,29,65.8,2,0,0
10/01/2017 1:55,10,69.2,25,64.6,35,65.9,2,0,0
10/01/2017 2:00,11,69.3,26,64.7,37,66.1,2,0,0
10/01/2017 2:05,9,69.3,24,64.7,33,66,2,0,0
10/01/2017 2:10,10,69.2,25,64.6,35,65.9,2,0,0
10/01/2017 2:15,9,69.3,24,64.7,33,65.9,2,0,0
10/01/2017 2:20,10,69.2,25,64.5,35,65.9,2,0,0
10/01/2017 2:25,9,69.3,24,64.7,33,65.9,2,0,0
10/01/2017 2:30,7,69.2,22,64.6,29,65.7,2,0,0
10/01/2017 2:35,12,69,27,64.3,39,65.7,2,0,0
10/01/2017 2:40,8,69.1,23,64.5,31,65.7,2,0,0
10/01/2017 2:45,9,69.2,24,64.6,33,65.8,2,0,0
10/01/2017 2:50,9,69.2,24,64.6,33,65.9,2,0,0
10/01/2017 2:55,8,69.2,23,64.6,31,65.8,2,0,0
10/01/2017 3:00,10,69.2,25,64.6,35,65.9,2,0,0
10/01/2017 3:05,7,69.3,22,64.7,29,65.8,2,0,0
10/01/2017 3:10,7,69.3,22,64.7,29,65.8,2,0,0
10/01/2017 3:15,6,69.4,21,64.8,27,65.8,2,0,0
10/01/2017 3:20,7,69.4,23,64.8,30,65.9,2,0,0
10/01/2017 3:25,6,69.4,21,64.8,27,65.8,2,0,0
10/01/2017 3:30,9,69.4,24,64.8,33,66.1,2,0,0
10/01/2017 3:35,8,69.4,23,64.8,31,66,2,0,0
10/01/2017 3:40,8,69.3,24,64.7,32,65.8,2,0,0
10/01/2017 3:45,6,69.3,22,64.7,28,65.6,2,0,0
10/01/2017 3:50,6,69.3,22,64.7,28,65.7,2,0,0
10/01/2017 3:55,6,69.3,21,64.7,27,65.7,2,0,0
10/01/2017 4:00,15,69.2,22,64.6,37,66.5,2,0,0
10/01/2017 4:05,6,69.2,21,64.5,27,65.6,2,0,0
10/01/2017 4:10,7,69.4,22,64.8,29,65.9,2,0,0
10/01/2017 4:15,9,69.4,24,64.8,33,66,2,0,0
10/01/2017 4:20,10,69.4,25,64.8,35,66.1,2,0,0
10/01/2017 4:25,8,69.3,24,64.7,32,65.9,2,0,0
10/01/2017 4:30,10,69.2,26,64.6,36,65.9,2,0,0
10/01/2017 4:35,18,69.1,34,64.4,52,66,2,0,0
10/01/2017 4:40,13,69,29,64.4,42,65.8,2,0,0
10/01/2017 4:45,14,69.1,30,64.5,44,66,2,0,0
10/01/2017 4:50,12,69.3,27,64.7,39,66.1,2,0,0
10/01/2017 4:55,13,69.4,29,64.8,42,66.2,2,0,0
10/01/2017 5:00,12,69.3,28,64.7,40,66.1,2,0,0
10/01/2017 5:05,14,69.4,29,64.8,43,66.3,2,0,0
10/01/2017 5:10,12,69.4,27,64.8,39,66.2,2,0,0
10/01/2017 5:15,15,69.5,31,64.9,46,66.4,2,0,0
10/01/2017 5:20,10,69.4,25,64.8,35,66.2,2,0,0
10/01/2017 5:25,15,69.4,30,64.8,45,66.3,2,0,0
10/01/2017 5:30,13,69.1,28,64.4,41,65.9,2,0,0
10/01/2017 5:35,15,69.3,31,64.7,46,66.2,2,0,0
10/01/2017 5:40,13,69.4,29,64.8,42,66.2,2,0,0
10/01/2017 5:45,12,69.4,28,64.8,40,66.2,2,0,0
10/01/2017 5:50,14,69.3,29,64.7,43,66.2,2,0,0
10/01/2017 5:55,13,69.3,28,64.7,41,66.1,2,0,0
10/01/2017 6:00,15,69.3,31,64.7,46,66.2,2,0,0
10/01/2017 6:05,12,69.1,28,64.5,40,65.9,2,0,0
10/01/2017 6:10,17,69.2,32,64.6,49,66.2,2,0,0
10/01/2017 6:15,18,69.5,33,64.9,51,66.5,2,0,0
10/01/2017 6:20,18,69.5,34,64.9,52,66.5,2,0,0
10/01/2017 6:25,15,69.3,30,64.7,45,66.3,2,0,0
10/01/2017 6:30,19,69.1,35,64.5,54,66.1,2,0,0
10/01/2017 6:35,20,68.8,35,64.1,55,65.8,2,0,0
10/01/2017 6:40,20,69.2,36,64.5,56,66.2,2,0,0
10/01/2017 6:45,18,68.5,33,63.8,51,65.4,2,0,0
10/01/2017 6:50,21,68.4,36,63.7,57,65.5,2,0,0
10/01/2017 6:55,18,69,33,64.3,51,66,2,0,0
10/01/2017 7:00,15,69.1,30,64.5,45,66,2,0,0
10/01/2017 7:05,23,69.4,39,64.8,62,66.5,2,0,0
10/01/2017 7:10,24,69.2,40,64.5,64,66.3,2,0,0
10/01/2017 7:15,24,68.9,41,64.3,65,66,2,0,0
10/01/2017 7:20,21,69.1,37,64.4,58,66.1,2,0,0
10/01/2017 7:25,22,69.3,39,64.7,61,66.4,2,0,0
10/01/2017 7:30,23,69.3,38,64.7,61,66.4,2,0,0
10/01/2017 7:35,33,69.4,49,64.8,82,66.6,2,0,0
10/01/2017 7:40,32,70.1,49,65.5,81,67.3,2,0,0
10/01/2017 7:45,23,69.9,40,65.4,63,67,2,0,0
10/01/2017 7:50,35,69.8,52,65.3,87,67.1,2,0,0
10/01/2017 7:55,28,69.6,44,65,72,66.8,2,0,0
10/01/2017 8:00,29,69.7,45,65.1,74,66.9,2,0,0
10/01/2017 8:05,25,69.3,41,64.7,66,66.4,2,0,0
10/01/2017 8:10,32,69.3,47,64.7,79,66.6,2,0,0
10/01/2017 8:15,31,69.2,46,64.6,77,66.5,2,0,0
10/01/2017 8:20,32,69.5,48,64.9,80,66.8,2,0,0
10/01/2017 8:25,34,69,51,64.4,85,66.2,2,0,0
10/01/2017 8:30,34,69.2,52,64.5,86,66.3,2,0,0
10/01/2017 8:35,37,69.3,54,64.7,91,66.6,2,0,0
10/01/2017 8:40,41,69.1,59,64.5,100,66.4,2,0,0
10/01/2017 8:45,31,69.4,48,64.8,79,66.6,2,0,0
10/01/2017 8:50,35,69.2,52,64.6,87,66.5,2,0,0
10/01/2017 8:55,32,69.4,49,64.8,81,66.6,2,0,0
10/01/2017 9:00,38,69,55,64.4,93,66.3,2,0,0
10/01/2017 9:05,36,69.8,52,65.2,88,67.1,2,0,0
10/01/2017 9:10,34,69.5,51,64.8,85,66.7,2,0,0
10/01/2017 9:15,40,69.6,57,65,97,66.9,2,0,0
10/01/2017 9:20,41,69.8,58,65.2,99,67.1,2,0,0
10/01/2017 9:25,41,69.2,57,64.6,98,66.5,2,0,0
10/01/2017 9:30,49,69.3,67,64.7,116,66.6,2,0,0
10/01/2017 9:35,41,69.4,58,64.8,99,66.7,2,0,0
10/01/2017 9:40,50,68.9,68,64.3,118,66.2,2,0,0
10/01/2017 9:45,61,68.6,80,63.9,141,65.9,2,0,0
10/01/2017 9:50,50,68.4,68,63.6,118,65.6,2,0,0
10/01/2017 9:55,53,68.6,70,63.9,123,65.9,2,0,0
10/01/2017 10:00,53,69.2,71,64.6,124,66.6,2,0,0
10/01/2017 10:05,51,69.2,69,64.5,120,66.5,2,0,0
10/01/2017 10:10,62,68.8,81,64.2,143,66.2,2,0,0
10/01/2017 10:15,54,68.2,72,63.4,126,65.5,2,0,0
10/01/2017 10:20,55,68.5,73,63.8,128,65.8,2,0,0
10/01/2017 10:25,55,69.1,72,64.4,127,66.4,2,0,0
10/01/2017 10:30,53,69,70,64.3,123,66.3,2,0,0
10/01/2017 10:35,53,68.4,72,63.7,125,65.7,2,0,0
10/01/2017 10:40,62,68.6,80,63.9,142,66,2,0,0
10/01/2017 10:45,51,69.1,69,64.5,120,66.4,2,0,0
10/01/2017 10:50,53,69.1,70,64.5,123,66.5,2,0,0
10/01/2017 10:55,58,69.3,78,64.7,136,66.6,2,0,0
10/01/2017 11:00,50,69.7,67,65.2,117,67.1,2,0,0
10/01/2017 11:05,62,68.7,81,64,143,66,2,0,0
10/01/2017 11:10,64,68.8,83,64.1,147,66.2,2,0,0
10/01/2017 11:15,63,68.5,82,63.8,145,65.8,2,0,0
10/01/2017 11:20,61,68.6,79,63.9,140,65.9,2,0,0
10/01/2017 11:25,64,69.2,82,64.6,146,66.6,2,0,0
10/01/2017 11:30,70,68.7,89,64,159,66,2,0,0
10/01/2017 11:35,66,69.2,85,64.5,151,66.6,2,0,0
10/01/2017 11:40,61,69,80,64.3,141,66.3,2,0,0
10/01/2017 11:45,65,69.5,84,64.9,149,66.9,2,0,0
10/01/2017 11:50,70,69.7,89,65.1,159,67.1,2,0,0
10/01/2017 11:55,64,70.3,58,64.3,122,67.4,2,0,0
10/01/2017 12:00,62,70.3,56,64.3,118,67.5,2,0,0
10/01/2017 12:05,64,70.4,57,64.4,121,67.6,2,0,0
10/01/2017 12:10,64,70.2,58,64.2,122,67.3,2,0,0
10/01/2017 12:15,65,70.3,59,64.3,124,67.4,2,0,0
10/01/2017 12:20,65,70.3,59,64.3,124,67.4,2,0,0
10/01/2017 12:25,66,70.2,60,64.2,126,67.3,2,0,0
10/01/2017 12:30,67,70.4,61,64.4,128,67.5,2,0,0
10/01/2017 12:35,67,70.2,60,64.2,127,67.4,2,0,0
10/01/2017 12:40,69,70.2,62,64.2,131,67.4,2,0,0
10/01/2017 12:45,71,70.2,63,64.2,134,67.4,2,0,0
10/01/2017 12:50,70,70.3,62,64.3,132,67.5,2,0,0
10/01/2017 12:55,54,68.2,72,63.4,126,65.5,2,0,0
10/01/2017 13:00,60,67.6,79,62.9,139,64.9,2,0,0
10/01/2017 13:05,56,68.4,74,63.7,130,65.7,2,0,0
10/01/2017 13:10,57,67.8,76,63.1,133,65.1,2,0,0
10/01/2017 13:15,58,68.3,77,63.7,135,65.7,2,0,0
10/01/2017 13:20,62,67.9,81,63.2,143,65.3,2,0,0
10/01/2017 13:25,69,67.5,88,62.8,157,64.8,2,0,0
10/01/2017 13:30,64,68,82,63.3,146,65.4,2,0,0
10/01/2017 13:35,62,68,81,63.3,143,65.3,2,0,0
10/01/2017 13:40,65,68,84,63.2,149,65.3,2,0,0
10/01/2017 13:45,69,67.5,88,62.7,157,64.8,2,0,0
10/01/2017 13:50,54,68.5,72,63.9,126,65.8,2,0,0
10/01/2017 13:55,61,68.6,81,64,142,66,2,0,0
10/01/2017 14:00,55,67.8,74,63.1,129,65.1,2,0,0
10/01/2017 14:05,60,68.1,79,63.3,139,65.4,2,0,0
10/01/2017 14:10,61,67.8,80,63.1,141,65.2,2,0,0
10/01/2017 14:15,52,68,70,63.3,122,65.3,2,0,0
10/01/2017 14:20,58,67.9,76,63.2,134,65.2,2,0,0
10/01/2017 14:25,53,67.9,71,63.1,124,65.2,2,0,0
10/01/2017 14:30,52,68.3,70,63.6,122,65.6,2,0,0
10/01/2017 14:35,53,68.4,70,63.7,123,65.7,2,0,0
10/01/2017 14:40,58,68,76,63.2,134,65.3,2,0,0
10/01/2017 14:45,59,68.5,77,63.7,136,65.8,2,0,0
10/01/2017 14:50,59,67.8,77,63,136,65.1,2,0,0
10/01/2017 14:55,52,68.7,69,64.1,121,66.1,2,0,0
10/01/2017 15:00,60,68.8,78,64.1,138,66.1,2,0,0
10/01/2017 15:05,60,69,78,64.4,138,66.4,2,0,0
10/01/2017 15:10,53,67.9,71,63.2,124,65.2,2,0,0
10/01/2017 15:15,56,68.9,74,64.3,130,66.3,2,0,0
10/01/2017 15:20,55,69.4,74,64.9,129,66.8,2,0,0
10/01/2017 15:25,55,68.9,73,64.2,128,66.2,2,0,0
10/01/2017 15:30,52,69,69,64.4,121,66.4,2,0,0
10/01/2017 15:35,58,68.9,77,64.2,135,66.2,2,0,0
10/01/2017 15:40,57,68.7,74,64,131,66,2,0,0
10/01/2017 15:45,66,68.6,85,63.9,151,66,2,0,0
10/01/2017 15:50,64,68.8,82,64.1,146,66.1,2,0,0
10/01/2017 15:55,63,68,81,63.3,144,65.4,2,0,0
10/01/2017 16:00,53,68.7,71,64,124,66,2,0,0
10/01/2017 16:05,51,68.8,69,64.1,120,66.1,2,0,0
10/01/2017 16:10,43,68.1,60,63.4,103,65.3,2,0,0
10/01/2017 16:15,37,68.8,55,64.1,92,66,2,0,0
10/01/2017 16:20,52,67.8,70,63,122,65,2,0,0
10/01/2017 16:25,53,67.4,72,62.5,125,64.6,2,0,0
10/01/2017 16:30,44,68.5,61,63.7,105,65.7,2,0,0
10/01/2017 16:35,52,69.1,70,64.4,122,66.4,2,0,0
10/01/2017 16:40,58,69.1,76,64.4,134,66.5,2,0,0
10/01/2017 16:45,50,67.8,70,62.9,120,64.9,2,0,0
10/01/2017 16:50,65,68.1,83,63.3,148,65.4,2,0,0
10/01/2017 16:55,44,68,61,63.1,105,65.2,2,0,0
10/01/2017 17:00,48,67.4,65,62.6,113,64.7,2,0,0
10/01/2017 17:05,56,67.7,74,62.9,130,65,2,0,0
10/01/2017 17:10,56,67.5,74,62.6,130,64.7,2,0,0
10/01/2017 17:15,62,67.7,81,62.9,143,65,2,0,0
10/01/2017 17:20,57,68.1,75,63.4,132,65.4,2,0,0
10/01/2017 17:25,62,67.7,80,62.9,142,65,2,0,0
10/01/2017 17:30,57,68.5,75,63.8,132,65.9,2,0,0
10/01/2017 17:35,48,68.5,65,63.8,113,65.8,2,0,0
10/01/2017 17:40,57,68.8,75,64,132,66.1,2,0,0
10/01/2017 17:45,42,68.6,59,63.9,101,65.8,2,0,0
10/01/2017 17:50,54,68.8,71,64.1,125,66.1,2,0,0
10/01/2017 17:55,42,69.4,59,64.7,101,66.7,2,0,0
10/01/2017 18:00,55,68.3,72,63.5,127,65.6,2,0,0
10/01/2017 18:05,42,69.2,59,64.6,101,66.5,2,0,0
10/01/2017 18:10,52,68.8,70,64,122,66.1,2,0,0
10/01/2017 18:15,59,68.1,77,63.2,136,65.3,2,0,0
10/01/2017 18:20,53,68.8,71,64.1,124,66.1,2,0,0
10/01/2017 18:25,56,68.1,73,63.3,129,65.4,2,0,0
10/01/2017 18:30,60,68.7,78,64,138,66,2,0,0
10/01/2017 18:35,51,68.9,69,64.2,120,66.2,2,0,0
10/01/2017 18:40,52,68.8,70,64.1,122,66.2,2,0,0
10/01/2017 18:45,53,69.3,71,64.7,124,66.7,2,0,0
10/01/2017 18:50,59,68.3,77,63.5,136,65.6,2,0,0
10/01/2017 18:55,46,67.5,64,62.6,110,64.7,2,0,0
10/01/2017 19:00,46,67.7,64,62.9,110,64.9,2,0,0
10/01/2017 19:05,51,68.2,69,63.5,120,65.5,2,0,0
10/01/2017 19:10,47,68.4,65,63.7,112,65.7,2,0,0
10/01/2017 19:15,47,68.7,64,64,111,66,2,0,0
10/01/2017 19:20,43,68.3,60,63.6,103,65.6,2,0,0
10/01/2017 19:25,39,68.3,56,63.6,95,65.5,2,0,0
10/01/2017 19:30,41,68.3,58,63.6,99,65.5,2,0,0
10/01/2017 19:35,35,68.1,51,63.4,86,65.3,2,0,0
10/01/2017 19:40,31,67.6,47,62.8,78,64.7,2,0,0
10/01/2017 19:45,31,68.3,47,63.6,78,65.5,2,0,0
10/01/2017 19:50,32,68.2,49,63.5,81,65.4,2,0,0
10/01/2017 19:55,37,68.7,54,63.9,91,65.9,2,0,0
10/01/2017 20:00,39,68.2,56,63.5,95,65.4,2,0,0
10/01/2017 20:05,34,68.4,51,63.7,85,65.6,2,0,0
10/01/2017 20:10,27,68.8,43,64.2,70,66,2,0,0
10/01/2017 20:15,29,69.1,45,64.5,74,66.3,2,0,0
10/01/2017 20:20,27,69.2,43,64.6,70,66.4,2,0,0
10/01/2017 20:25,35,69,52,64.3,87,66.2,2,0,0
10/01/2017 20:30,34,68.8,51,64.1,85,66,2,0,0
10/01/2017 20:35,29,69.3,46,64.7,75,66.4,2,0,0
10/01/2017 20:40,35,69,52,64.3,87,66.2,2,0,0
10/01/2017 20:45,34,69,50,64.3,84,66.2,2,0,0
10/01/2017 20:50,31,68.3,48,63.6,79,65.5,2,0,0
10/01/2017 20:55,27,69.2,42,64.6,69,66.4,2,0,0
10/01/2017 21:00,29,68.8,45,64.2,74,66,2,0,0
10/01/2017 21:05,28,68.6,45,63.9,73,65.7,2,0,0
10/01/2017 21:10,25,69.4,41,64.7,66,66.5,2,0,0
10/01/2017 21:15,25,69,41,64.4,66,66.2,2,0,0
10/01/2017 21:20,29,68.9,45,64.3,74,66.1,2,0,0
10/01/2017 21:25,24,69.3,40,64.6,64,66.4,2,0,0
10/01/2017 21:30,27,69.2,44,64.6,71,66.3,2,0,0
10/01/2017 21:35,31,69.3,48,64.7,79,66.5,2,0,0
10/01/2017 21:40,28,69.4,45,64.8,73,66.6,2,0,0
10/01/2017 21:45,25,69.2,41,64.6,66,66.3,2,0,0
10/01/2017 21:50,21,69.3,37,64.7,58,66.3,2,0,0
10/01/2017 21:55,26,69.3,43,64.7,69,66.5,2,0,0
10/01/2017 22:00,23,69.5,40,64.9,63,66.6,2,0,0
10/01/2017 22:05,25,69.2,42,64.5,67,66.3,2,0,0
10/01/2017 22:10,26,69.5,42,64.9,68,66.6,2,0,0
10/01/2017 22:15,23,69.1,40,64.4,63,66.1,2,0,0
10/01/2017 22:20,25,69.2,41,64.6,66,66.3,2,0,0
10/01/2017 22:25,16,69.3,32,64.7,48,66.2,2,0,0
10/01/2017 22:30,18,69.2,33,64.6,51,66.2,2,0,0
10/01/2017 22:35,18,69.2,34,64.5,52,66.1,2,0,0
10/01/2017 22:40,20,69.3,36,64.7,56,66.3,2,0,0
10/01/2017 22:45,17,69.2,32,64.6,49,66.2,2,0,0
10/01/2017 22:50,22,69.3,38,64.7,60,66.4,2,0,0
10/01/2017 22:55,16,69.3,31,64.7,47,66.3,2,0,0
10/01/2017 23:00,19,69.3,34,64.7,53,66.4,2,0,0
10/01/2017 23:05,16,69.4,32,64.8,48,66.3,2,0,0
10/01/2017 23:10,17,69.1,33,64.5,50,66,2,0,0
10/01/2017 23:15,17,69.4,32,64.8,49,66.4,2,0,0
10/01/2017 23:20,20,69.7,35,65.1,55,66.7,2,0,0
10/01/2017 23:25,14,69.7,29,65.1,43,66.6,2,0,0
10/01/2017 23:30,17,69.6,33,65,50,66.5,2,0,0
10/01/2017 23:35,18,69.2,33,64.5,51,66.2,2,0,0
10/01/2017 23:40,13,68.9,28,64.3,41,65.7,2,0,0
10/01/2017 23:45,16,69.2,31,64.6,47,66.2,2,0,0
10/01/2017 23:50,14,69.3,30,64.7,44,66.2,2,0,0
10/01/2017 23:55,11,69.3,27,64.7,38,66,2,0,0
