5 Minutes,Lane 1 Flow (Veh/5 Minutes),Lane 1 Speed (mph),Lane 2 Flow (Veh/5 Minutes),Lane 2 Speed (mph),Flow (Veh/5 Minutes),Speed (mph),# Lane Points,% Observed,Holiday
1/29/2018 0:00,7,69.3,23,64.7,30,65.8,2,0,0
1/29/2018 0:05,9,69.4,24,64.8,33,66.1,2,0,0
1/29/2018 0:10,9,69.4,24,64.8,33,66,2,0,0
1/29/2018 0:15,10,69.4,25,64.8,35,66.1,2,0,0
1/29/2018 0:20,14,69.3,22,64.7,36,66.5,2,0,0
1/29/2018 0:25,8,69.3,23,64.7,31,65.8,2,0,0
1/29/2018 0:30,7,69.4,22,64.8,29,65.9,2,0,0
1/29/2018 0:35,10,69.3,25,64.7,35,66,2,0,0
1/29/2018 0:40,7,69.4,22,64.8,29,65.9,2,0,0
1/29/2018 0:45,5,69.4,20,64.8,25,65.7,2,0,0
1/29/2018 0:50,7,69.3,22,64.7,29,65.8,2,0,0
1/29/2018 0:55,7,69.3,22,64.7,29,65.8,2,0,0
1/29/2018 1:00,8,69.3,23,64.7,31,65.9,2,0,0
1/29/2018 1:05,6,69.1,21,64.5,27,65.5,2,0,0
1/29/2018 1:10,5,69.2,20,64.6,25,65.5,2,0,0
1/29/2018 1:15,5,69.2,20,64.6,25,65.5,2,0,0
1/29/2018 1:20,9,69.3,19,64.7,28,66.1,2,0,0
1/29/2018 1:25,10,69.3,20,64.7,30,66.3,2,0,0
1/29/2018 1:30,5,69.3,21,64.7,26,65.6,2,0,0
1/29/2018 1:35,12,69.3,21,64.7,33,66.4,2,0,0
1/29/2018 1:40,4,69.3,19,64.7,23,65.5,2,0,0
1/29/2018 1:45,7,69.4,22,64.8,29,65.9,2,0,0
1/29/2018 1:50,7,69.2,22,64.6,29,65.7,2,0,0
1/29/2018 1:55,4,69.2,19,64.6,23,65.4,2,0,0
1/29/2018 2:00,10,69.3,20,64.7,30,66.2,2,0,0
1/29/2018 2:05,6,69.3,21,64.7,27,65.7,2,0,0
1/29/2018 2:10,6,69.4,21,64.8,27,65.8,2,0,0
1/29/2018 2:15,5,69.4,20,64.8,25,65.7,2,0,0
1/29/2018 2:20,8,69.3,19,64.7,27,66.1,2,0,0
1/29/2018 2:25,5,69.3,20,64.7,25,65.6,2,0,0
1/29/2018 2:30,7,69.2,22,64.6,29,65.7,2,0,0
1/29/2018 2:35,5,69.3,21,64.7,26,65.6,2,0,0
1/29/2018 2:40,8,69.4,23,64.8,31,66,2,0,0
1/29/2018 2:45,8,69.4,23,64.8,31,66,2,0,0
1/29/2018 2:50,9,69.4,24,64.8,33,66.1,2,0,0
1/29/2018 2:55,10,69.5,25,64.9,35,66.2,2,0,0
1/29/2018 3:00,8,69.2,24,64.6,32,65.7,2,0,0
1/29/2018 3:05,10,68.8,26,64.2,36,65.5,2,0,0
1/29/2018 3:10,7,69.1,23,64.5,30,65.5,2,0,0
1/29/2018 3:15,10,69.3,26,64.7,36,65.9,2,0,0
1/29/2018 3:20,8,69.2,24,64.5,32,65.7,2,0,0
1/29/2018 3:25,10,69.3,25,64.7,35,66,2,0,0
1/29/2018 3:30,10,69.3,26,64.7,36,66,2,0,0
1/29/2018 3:35,17,69.2,33,64.6,50,66.2,2,0,0
1/29/2018 3:40,12,69.5,27,64.9,39,66.3,2,0,0
1/29/2018 3:45,11,69.5,26,64.9,37,66.2,2,0,0
1/29/2018 3:50,12,69.6,28,65,40,66.3,2,0,0
1/29/2018 3:55,14,69.5,29,64.9,43,66.4,2,0,0
1/29/2018 4:00,14,69.6,29,65,43,66.5,2,0,0
1/29/2018 4:05,19,69.6,36,65,55,66.6,2,0,0
1/29/2018 4:10,17,69.6,33,65,50,66.5,2,0,0
1/29/2018 4:15,17,69.4,33,64.8,50,66.4,2,0,0
1/29/2018 4:20,25,69.6,42,65.1,67,66.8,2,0,0
1/29/2018 4:25,25,69.3,41,64.8,66,66.5,2,0,0
1/29/2018 4:30,29,69.7,46,65.1,75,66.9,2,0,0
1/29/2018 4:35,35,70,53,65.5,88,67.3,2,0,0
1/29/2018 4:40,30,70.3,47,65.8,77,67.5,2,0,0
1/29/2018 4:45,41,70.4,59,65.9,100,67.7,2,0,0
1/29/2018 4:50,40,70.3,58,65.7,98,67.6,2,0,0
1/29/2018 4:55,40,70.8,58,66.3,98,68.1,2,0,0
1/29/2018 5:00,34,70.9,52,66.4,86,68.2,2,0,0
1/29/2018 5:05,41,70.6,59,66.1,100,67.9,2,0,0
1/29/2018 5:10,42,68.8,61,64.2,103,66.1,2,0,0
1/29/2018 5:15,50,68.5,70,63.8,120,65.8,2,0,0
1/29/2018 5:20,58,69.2,77,64.7,135,66.6,2,0,0
1/29/2018 5:25,52,67,72,62.3,124,64.3,2,0,0
1/29/2018 5:30,67,68.5,88,63.8,155,65.8,2,0,0
1/29/2018 5:35,56,67.7,76,63,132,65,2,0,0
1/29/2018 5:40,65,67.4,86,62.7,151,64.7,2,0,0
1/29/2018 5:45,62,68.3,83,63.6,145,65.6,2,0,0
1/29/2018 5:50,73,68.8,96,64.2,169,66.2,2,0,0
1/29/2018 5:55,56,69.3,75,64.7,131,66.7,2,0,0
1/29/2018 6:00,58,69.3,78,64.7,136,66.6,2,0,0
1/29/2018 6:05,53,68.3,73,63.6,126,65.6,2,0,0
1/29/2018 6:10,66,68.3,88,63.5,154,65.6,2,0,0
1/29/2018 6:15,67,67.2,90,62.4,157,64.4,2,0,0
1/29/2018 6:20,64,68.7,85,64,149,66,2,0,0
1/29/2018 6:25,69,68.2,91,63.5,160,65.5,2,0,0
1/29/2018 6:30,64,67.7,85,63,149,65,2,0,0
1/29/2018 6:35,68,67.4,90,62.6,158,64.7,2,0,0
1/29/2018 6:40,72,68,95,63.2,167,65.3,2,0,0
1/29/2018 6:45,77,67.8,100,63,177,65.1,2,0,0
1/29/2018 6:50,82,67.1,107,62.2,189,64.3,2,0,0
1/29/2018 6:55,71,68.4,92,63.7,163,65.7,2,0,0
1/29/2018 7:00,71,68.4,94,63.6,165,65.7,2,0,0
1/29/2018 7:05,74,68.7,96,64,170,66,2,0,0
1/29/2018 7:10,82,68.7,104,64,186,66,2,0,0
1/29/2018 7:15,79,69.5,102,64.9,181,66.9,2,0,0
1/29/2018 7:20,84,70.1,107,65.5,191,67.5,2,0,0
1/29/2018 7:25,68,69.3,89,64.5,157,66.6,2,0,0
1/29/2018 7:30,91,69,113,64.2,204,66.3,2,0,0
1/29/2018 7:35,80,68.5,103,63.7,183,65.8,2,0,0
1/29/2018 7:40,79,70,101,65.5,180,67.5,2,0,0
1/29/2018 7:45,89,69.6,112,65,201,67,2,0,0
1/29/2018 7:50,86,68.7,109,64,195,66.1,2,0,0
1/29/2018 7:55,74,69.7,96,65.2,170,67.1,2,0,0
1/29/2018 8:00,81,68.9,104,64.2,185,66.2,2,0,0
1/29/2018 8:05,72,68.1,93,63.3,165,65.4,2,0,0
1/29/2018 8:10,67,68.2,88,63.5,155,65.5,2,0,0
1/29/2018 8:15,75,68.1,97,63.2,172,65.3,2,0,0
1/29/2018 8:20,80,68.5,103,63.7,183,65.8,2,0,0
1/29/2018 8:25,81,68,105,63.2,186,65.3,2,0,0
1/29/2018 8:30,78,67.5,101,62.7,179,64.8,2,0,0
1/29/2018 8:35,71,67.5,93,62.7,164,64.8,2,0,0
1/29/2018 8:40,78,67.5,99,62.8,177,64.9,2,0,0
1/29/2018 8:45,74,67.1,96,62.2,170,64.3,2,0,0
1/29/2018 8:50,77,67.7,99,62.9,176,65,2,0,0
1/29/2018 8:55,80,68.2,103,63.4,183,65.5,2,0,0
1/29/2018 9:00,66,67.5,87,62.7,153,64.8,2,0,0
1/29/2018 9:05,64,66.9,84,62,148,64.1,2,0,0
1/29/2018 9:10,46,68,65,63.1,111,65.1,2,0,0
1/29/2018 9:15,68,68.4,89,63.6,157,65.7,2,0,0
1/29/2018 9:20,77,67.4,99,62.6,176,64.7,2,0,0
1/29/2018 9:25,71,67.5,92,62.8,163,64.8,2,0,0
1/29/2018 9:30,64,68.6,84,63.9,148,65.9,2,0,0
1/29/2018 9:35,67,68.1,87,63.4,154,65.5,2,0,0
1/29/2018 9:40,63,68,82,63.2,145,65.3,2,0,0
1/29/2018 9:45,62,69.5,81,64.9,143,66.9,2,0,0
1/29/2018 9:50,60,70.5,79,65.9,139,67.9,2,0,0
1/29/2018 9:55,78,69.1,99,64.5,177,66.5,2,0,0
1/29/2018 10:00,62,68.9,81,64.3,143,66.3,2,0,0
1/29/2018 10:05,63,68.4,82,63.7,145,65.8,2,0,0
1/29/2018 10:10,56,69.6,74,65,130,67,2,0,0
1/29/2018 10:15,54,69,73,64.3,127,66.3,2,0,0
1/29/2018 10:20,64,68.8,83,64.1,147,66.2,2,0,0
1/29/2018 10:25,61,68.2,81,63.4,142,65.5,2,0,0
1/29/2018 10:30,62,66.9,82,62,144,64.1,2,0,0
1/29/2018 10:35,58,68.2,76,63.5,134,65.5,2,0,0
1/29/2018 10:40,57,67.1,76,62.4,133,64.4,2,0,0
1/29/2018 10:45,70,68.1,90,63.4,160,65.5,2,0,0
1/29/2018 10:50,49,68.3,67,63.6,116,65.6,2,0,0
1/29/2018 10:55,61,68.4,80,63.7,141,65.8,2,0,0
1/29/2018 11:00,53,68.1,71,63.5,124,65.4,2,0,0
1/29/2018 11:05,53,70,70,65.5,123,67.4,2,0,0
1/29/2018 11:10,46,69.7,64,65.2,110,67.1,2,0,0
1/29/2018 11:15,48,68.7,65,64.1,113,66.1,2,0,0
1/29/2018 11:20,51,68.2,69,63.6,120,65.5,2,0,0
1/29/2018 11:25,47,69.1,63,64.6,110,66.5,2,0,0
1/29/2018 11:30,51,68.4,69,63.8,120,65.8,2,0,0
1/29/2018 11:35,39,69.2,57,64.7,96,66.5,2,0,0
1/29/2018 11:40,51,70.4,69,66,120,67.9,2,0,0
1/29/2018 11:45,50,70.8,69,66.3,119,68.2,2,0,0
1/29/2018 11:50,50,70.6,68,66.1,118,68,2,0,0
1/29/2018 11:55,49,69.6,67,65,116,67,2,0,0
1/29/2018 12:00,45,69.3,62,64.7,107,66.7,2,0,0
1/29/2018 12:05,51,67.1,70,62.2,121,64.2,2,0,0
1/29/2018 12:10,42,67.4,59,62.6,101,64.6,2,0,0
1/29/2018 12:15,45,68.5,62,63.7,107,65.7,2,0,0
1/29/2018 12:20,51,68.9,68,64.2,119,66.2,2,0,0
1/29/2018 12:25,44,68.9,62,64.3,106,66.2,2,0,0
1/29/2018 12:30,44,68.9,61,64.3,105,66.2,2,0,0
1/29/2018 12:35,50,69.5,68,64.8,118,66.8,2,0,0
1/29/2018 12:40,52,69,70,64.4,122,66.3,2,0,0
1/29/2018 12:45,48,68.5,66,63.9,114,65.8,2,0,0
1/29/2018 12:50,42,70.4,59,65.9,101,67.8,2,0,0
1/29/2018 12:55,44,69.6,60,65,104,67,2,0,0
1/29/2018 13:00,39,69.6,55,65,94,66.9,2,0,0
1/29/2018 13:05,35,68.8,51,64.2,86,66.1,2,0,0
1/29/2018 13:10,34,69.2,50,64.6,84,66.5,2,0,0
1/29/2018 13:15,46,69.4,63,64.7,109,66.7,2,0,0
1/29/2018 13:20,45,69.5,63,64.9,108,66.8,2,0,0
1/29/2018 13:25,44,69.2,60,64.5,104,66.5,2,0,0
1/29/2018 13:30,39,68.7,56,64,95,66,2,0,0
1/29/2018 13:35,43,69.3,60,64.7,103,66.6,2,0,0
1/29/2018 13:40,53,69.5,70,64.8,123,66.8,2,0,0
1/29/2018 13:45,47,70.1,64,65.5,111,67.4,2,0,0
1/29/2018 13:50,46,69.5,64,65,110,66.9,2,0,0
1/29/2018 13:55,41,69.4,58,64.8,99,66.7,2,0,0
1/29/2018 14:00,45,68.9,62,64.3,107,66.2,2,0,0
1/29/2018 14:05,41,68.6,57,64,98,66,2,0,0
1/29/2018 14:10,45,67.9,62,63.1,107,65.1,2,0,0
1/29/2018 14:15,43,68.2,61,63.5,104,65.4,2,0,0
1/29/2018 14:20,46,68.6,63,64,109,65.9,2,0,0
1/29/2018 14:25,45,67.6,62,62.8,107,64.8,2,0,0
1/29/2018 14:30,43,67.6,60,62.8,103,64.8,2,0,0
1/29/2018 14:35,43,67.9,60,63.2,103,65.2,2,0,0
1/29/2018 14:40,39,67.9,57,63.2,96,65.1,2,0,0
1/29/2018 14:45,38,69,55,64.3,93,66.2,2,0,0
1/29/2018 14:50,49,69,66,64.4,115,66.4,2,0,0
1/29/2018 14:55,45,69,62,64.4,107,66.3,2,0,0
1/29/2018 15:00,42,69.3,59,64.7,101,66.6,2,0,0
1/29/2018 15:05,46,69.6,64,65,110,67,2,0,0
1/29/2018 15:10,47,68.6,64,63.9,111,65.9,2,0,0
1/29/2018 15:15,48,69,66,64.4,114,66.4,2,0,0
1/29/2018 15:20,49,70.1,67,65.5,116,67.4,2,0,0
1/29/2018 15:25,44,69.8,62,65.3,106,67.1,2,0,0
1/29/2018 15:30,60,68.3,80,63.7,140,65.7,2,0,0
1/29/2018 15:35,54,67.9,72,63.2,126,65.3,2,0,0
1/29/2018 15:40,54,69.2,73,64.5,127,66.5,2,0,0
1/29/2018 15:45,51,69,69,64.4,120,66.3,2,0,0
1/29/2018 15:50,52,68.8,71,64.2,123,66.1,2,0,0
1/29/2018 15:55,48,69,66,64.4,114,66.3,2,0,0
1/29/2018 16:00,42,69.3,59,64.7,101,66.6,2,0,0
1/29/2018 16:05,38,69.9,55,65.4,93,67.3,2,0,0
1/29/2018 16:10,39,68.6,56,64,95,65.9,2,0,0
1/29/2018 16:15,49,70.1,66,65.7,115,67.6,2,0,0
1/29/2018 16:20,41,70.3,58,65.8,99,67.7,2,0,0
1/29/2018 16:25,39,70.7,56,66.2,95,68.1,2,0,0
1/29/2018 16:30,33,69.9,50,65.4,83,67.2,2,0,0
1/29/2018 16:35,46,70.3,63,65.8,109,67.7,2,0,0
1/29/2018 16:40,37,70.6,54,66.1,91,67.9,2,0,0
1/29/2018 16:45,37,70,54,65.5,91,67.4,2,0,0
1/29/2018 16:50,44,68.6,61,63.8,105,65.8,2,0,0
1/29/2018 16:55,46,67.8,63,63,109,65,2,0,0
1/29/2018 17:00,36,67.9,52,63.2,88,65.1,2,0,0
1/29/2018 17:05,34,68.6,51,63.9,85,65.8,2,0,0
1/29/2018 17:10,42,69.1,60,64.4,102,66.3,2,0,0
1/29/2018 17:15,39,67.9,56,63.1,95,65.1,2,0,0
1/29/2018 17:20,44,68,62,63.4,106,65.3,2,0,0
1/29/2018 17:25,35,69.1,52,64.5,87,66.4,2,0,0
1/29/2018 17:30,44,67.7,62,62.8,106,64.9,2,0,0
1/29/2018 17:35,37,68.1,54,63.3,91,65.2,2,0,0
1/29/2018 17:40,34,67.8,51,63.1,85,65,2,0,0
1/29/2018 17:45,38,67.7,55,63,93,64.9,2,0,0
1/29/2018 17:50,40,68.3,57,63.6,97,65.5,2,0,0
1/29/2018 17:55,45,68.8,61,64.2,106,66.1,2,0,0
1/29/2018 18:00,37,69.1,53,64.4,90,66.4,2,0,0
1/29/2018 18:05,35,68.2,51,63.5,86,65.4,2,0,0
1/29/2018 18:10,43,68,60,63.3,103,65.3,2,0,0
1/29/2018 18:15,45,67.9,62,63.2,107,65.1,2,0,0
1/29/2018 18:20,41,67.7,59,63,100,64.9,2,0,0
1/29/2018 18:25,30,68.4,46,63.8,76,65.6,2,0,0
1/29/2018 18:30,29,68.7,47,64.1,76,65.8,2,0,0
1/29/2018 18:35,25,68.9,41,64.3,66,66.1,2,0,0
1/29/2018 18:40,34,67.9,51,63.2,85,65.1,2,0,0
1/29/2018 18:45,38,67.7,55,62.9,93,64.9,2,0,0
1/29/2018 18:50,31,67.8,48,63.1,79,65,2,0,0
1/29/2018 18:55,27,68.5,43,63.8,70,65.6,2,0,0
1/29/2018 19:00,27,69.2,43,64.5,70,66.3,2,0,0
1/29/2018 19:05,30,68.4,47,63.7,77,65.5,2,0,0
1/29/2018 19:10,36,68.9,53,64.2,89,66.1,2,0,0
1/29/2018 19:15,24,69.3,40,64.7,64,66.4,2,0,0
1/29/2018 19:20,21,69.4,37,64.8,58,66.5,2,0,0
1/29/2018 19:25,30,69.4,46,64.8,76,66.6,2,0,0
1/29/2018 19:30,35,69.3,52,64.6,87,66.5,2,0,0
1/29/2018 19:35,32,69.6,48,64.9,80,66.8,2,0,0
1/29/2018 19:40,28,69.4,45,64.7,73,66.5,2,0,0
1/29/2018 19:45,30,69.5,46,64.9,76,66.7,2,0,0
1/29/2018 19:50,29,69.9,46,65.3,75,67.1,2,0,0
1/29/2018 19:55,31,70,48,65.4,79,67.2,2,0,0
1/29/2018 20:00,27,69.7,43,65.1,70,66.9,2,0,0
1/29/2018 20:05,27,69.7,42,65.2,69,66.9,2,0,0
1/29/2018 20:10,28,69.1,45,64.5,73,66.3,2,0,0
1/29/2018 20:15,28,68.5,44,63.8,72,65.6,2,0,0
1/29/2018 20:20,25,69,41,64.4,66,66.1,2,0,0
1/29/2018 20:25,27,68.5,44,63.8,71,65.6,2,0,0
1/29/2018 20:30,30,69.1,46,64.5,76,66.3,2,0,0
1/29/2018 20:35,24,69.4,40,64.8,64,66.5,2,0,0
1/29/2018 20:40,31,69.6,47,65,78,66.8,2,0,0
1/29/2018 20:45,29,68.7,45,64,74,65.9,2,0,0
1/29/2018 20:50,29,68.8,46,64.2,75,66,2,0,0
1/29/2018 20:55,25,68.7,41,64.1,66,65.9,2,0,0
1/29/2018 21:00,26,69,42,64.3,68,66.1,2,0,0
1/29/2018 21:05,26,69.4,42,64.8,68,66.5,2,0,0
1/29/2018 21:10,23,69,38,64.4,61,66.1,2,0,0
1/29/2018 21:15,26,69.3,43,64.6,69,66.4,2,0,0
1/29/2018 21:20,24,69.4,40,64.8,64,66.5,2,0,0
1/29/2018 21:25,26,69.2,42,64.6,68,66.4,2,0,0
1/29/2018 21:30,20,69.4,36,64.8,56,66.4,2,0,0
1/29/2018 21:35,19,69,34,64.4,53,66,2,0,0
1/29/2018 21:40,16,69.2,31,64.6,47,66.2,2,0,0
1/29/2018 21:45,26,69.5,42,64.9,68,66.7,2,0,0
1/29/2018 21:50,21,68.9,36,64.3,57,66,2,0,0
1/29/2018 21:55,18,68.9,33,64.3,51,65.9,2,0,0
1/29/2018 22:00,16,69.2,32,64.6,48,66.1,2,0,0
1/29/2018 22:05,24,69.2,40,64.6,64,66.3,2,0,0
1/29/2018 22:10,18,69.3,33,64.6,51,66.3,2,0,0
1/29/2018 22:15,18,69.2,34,64.5,52,66.2,2,0,0
1/29/2018 22:20,19,69.3,35,64.7,54,66.3,2,0,0
1/29/2018 22:25,24,69.5,40,64.9,64,66.7,2,0,0
1/29/2018 22:30,16,69.4,31,64.8,47,66.3,2,0,0
1/29/2018 22:35,16,69.3,31,64.7,47,66.3,2,0,0
1/29/2018 22:40,21,69.5,37,64.9,58,66.6,2,0,0
1/29/2018 22:45,16,69.3,32,64.7,48,66.3,2,0,0
1/29/2018 22:50,16,69,32,64.4,48,65.9,2,0,0
1/29/2018 22:55,15,69.2,30,64.5,45,66.1,2,0,0
1/29/2018 23:00,16,69.3,31,64.7,47,66.2,2,0,0
1/29/2018 23:05,12,69.4,28,64.7,40,66.1,2,0,0
1/29/2018 23:10,15,69.3,30,64.7,45,66.2,2,0,0
1/29/2018 23:15,11,69.4,26,64.8,37,66.2,2,0,0
1/29/2018 23:20,13,69.4,28,64.8,41,66.2,2,0,0
1/29/2018 23:25,12,69.5,27,64.9,39,66.3,2,0,0
1/29/2018 23:30,19,69.4,35,64.8,54,66.4,2,0,0
1/29/2018 23:35,16,69.6,31,65,47,66.5,2,0,0
1/29/2018 23:40,11,69.4,27,64.8,38,66.1,2,0,0
1/29/2018 23:45,12,69.2,28,64.6,40,66,2,0,0
1/29/2018 23:50,13,69.4,28,64.8,41,66.3,2,0,0
1/29/2018 23:55,9,69.3,24,64.7,33,65.9,2,0,0
1/30/2018 0:00,9,69.3,24,64.7,33,66,2,0,0
1/30/2018 0:05,12,69.4,27,64.8,39,66.3,2,0,0
1/30/2018 0:10,8,69.3,23,64.7,31,65.9,2,0,0
1/30/2018 0:15,12,69.2,28,64.6,40,66,2,0,0
1/30/2018 0:20,10,69.2,26,64.6,36,65.9,2,0,0
1/30/2018 0:25,5,69.3,20,64.7,25,65.6,2,0,0
1/30/2018 0:30,9,69.4,24,64.8,33,66.1,2,0,0
1/30/2018 0:35,6,69.4,21,64.7,27,65.8,2,0,0
1/30/2018 0:40,7,69.1,22,64.5,29,65.6,2,0,0
1/30/2018 0:45,5,69,21,64.4,26,65.3,2,0,0
1/30/2018 0:50,16,69.2,23,64.6,39,66.5,2,0,0
1/30/2018 0:55,6,69.4,21,64.8,27,65.8,2,0,0
1/30/2018 1:00,4,69.3,20,64.7,24,65.5,2,0,0
1/30/2018 1:05,5,69.4,20,64.8,25,65.7,2,0,0
1/30/2018 1:10,8,69.4,23,64.8,31,66,2,0,0
1/30/2018 1:15,5,69.3,21,64.7,26,65.5,2,0,0
1/30/2018 1:20,5,69.3,20,64.7,25,65.7,2,0,0
1/30/2018 1:25,9,69.4,19,64.8,28,66.2,2,0,0
1/30/2018 1:30,7,69.4,22,64.8,29,65.9,2,0,0
1/30/2018 1:35,12,69.4,27,64.7,39,66.2,2,0,0
1/30/2018 1:40,5,68.9,21,64.3,26,65.2,2,0,0
1/30/2018 1:45,6,69,21,64.3,27,65.3,2,0,0
1/30/2018 1:50,7,69.2,23,64.6,30,65.7,2,0,0
1/30/2018 1:55,5,69.3,21,64.7,26,65.6,2,0,0
1/30/2018 2:00,5,69.3,20,64.7,25,65.6,2,0,0
1/30/2018 2:05,5,69.3,20,64.7,25,65.7,2,0,0
1/30/2018 2:10,9,69.4,24,64.8,33,66.1,2,0,0
1/30/2018 2:15,8,69.1,23,64.4,31,65.6,2,0,0
1/30/2018 2:20,5,69.3,21,64.6,26,65.5,2,0,0
1/30/2018 2:25,6,69.3,22,64.7,28,65.6,2,0,0
1/30/2018 2:30,10,69.3,25,64.7,35,66,2,0,0
1/30/2018 2:35,9,69.4,24,64.8,33,66,2,0,0
1/30/2018 2:40,8,69.3,24,64.7,32,65.9,2,0,0
1/30/2018 2:45,12,69.3,27,64.7,39,66.1,2,0,0
1/30/2018 2:50,7,69.4,22,64.8,29,65.9,2,0,0
1/30/2018 2:55,8,69,24,64.4,32,65.5,2,0,0
1/30/2018 3:00,11,68.9,27,64.3,38,65.6,2,0,0
1/30/2018 3:05,11,69,27,64.4,38,65.7,2,0,0
1/30/2018 3:10,10,69.2,26,64.6,36,65.9,2,0,0
1/30/2018 3:15,12,69.3,28,64.7,40,66.1,2,0,0
1/30/2018 3:20,11,69.2,26,64.6,37,66,2,0,0
1/30/2018 3:25,9,69.2,25,64.6,34,65.8,2,0,0
1/30/2018 3:30,11,69.3,27,64.7,38,66,2,0,0
1/30/2018 3:35,17,69.5,32,64.9,49,66.4,2,0,0
1/30/2018 3:40,10,69.2,25,64.6,35,65.9,2,0,0
1/30/2018 3:45,15,69,30,64.4,45,66,2,0,0
1/30/2018 3:50,12,69.3,28,64.7,40,66.1,2,0,0
1/30/2018 3:55,16,69.4,31,64.8,47,66.4,2,0,0
1/30/2018 4:00,18,69.5,34,64.9,52,66.4,2,0,0
1/30/2018 4:05,15,68.9,31,64.2,46,65.7,2,0,0
1/30/2018 4:10,18,69,34,64.4,52,66,2,0,0
1/30/2018 4:15,19,69.2,36,64.6,55,66.2,2,0,0
1/30/2018 4:20,27,68.4,44,63.6,71,65.4,2,0,0
1/30/2018 4:25,30,68.4,47,63.7,77,65.5,2,0,0
1/30/2018 4:30,18,68.8,34,64.1,52,65.7,2,0,0
1/30/2018 4:35,28,69.8,45,65.2,73,66.9,2,0,0
1/30/2018 4:40,39,69.7,56,65.1,95,67,2,0,0
1/30/2018 4:45,35,69.7,52,65.1,87,66.9,2,0,0
1/30/2018 4:50,30,69.7,48,65.1,78,66.9,2,0,0
1/30/2018 4:55,33,70.4,50,65.9,83,67.7,2,0,0
1/30/2018 5:00,40,68.7,58,64.1,98,66,2,0,0
1/30/2018 5:05,40,68.5,59,63.8,99,65.7,2,0,0
1/30/2018 5:10,37,68.8,55,64.1,92,66,2,0,0
1/30/2018 5:15,53,68.4,73,63.7,126,65.7,2,0,0
1/30/2018 5:20,54,67.2,73,62.4,127,64.5,2,0,0
1/30/2018 5:25,56,69.5,77,64.9,133,66.9,2,0,0
1/30/2018 5:30,60,68.8,81,64,141,66,2,0,0
1/30/2018 5:35,65,68,87,63.1,152,65.2,2,0,0
1/30/2018 5:40,56,68.8,77,64,133,66,2,0,0
1/30/2018 5:45,69,69.1,90,64.4,159,66.5,2,0,0
1/30/2018 5:50,69,69.1,91,64.4,160,66.4,2,0,0
1/30/2018 5:55,61,69,81,64.3,142,66.4,2,0,0
1/30/2018 6:00,63,68.2,83,63.4,146,65.5,2,0,0
1/30/2018 6:05,62,67.2,82,62.2,144,64.4,2,0,0
1/30/2018 6:10,62,67.6,82,62.7,144,64.8,2,0,0
1/30/2018 6:15,70,67.6,90,62.6,160,64.8,2,0,0
1/30/2018 6:20,63,68.1,85,63.2,148,65.3,2,0,0
1/30/2018 6:25,61,67.7,82,62.8,143,64.9,2,0,0
1/30/2018 6:30,54,67.4,74,62.5,128,64.6,2,0,0
1/30/2018 6:35,64,68,86,63.1,150,65.2,2,0,0
1/30/2018 6:40,72,67,94,61.9,166,64.1,2,0,0
1/30/2018 6:45,76,66.2,98,61.1,174,63.3,2,0,0
1/30/2018 6:50,73,66.9,95,61.9,168,64.1,2,0,0
1/30/2018 6:55,78,66.6,101,61.6,179,63.8,2,0,0
1/30/2018 7:00,66,66.3,87,61.3,153,63.4,2,0,0
1/30/2018 7:05,73,66.5,96,61.5,169,63.6,2,0,0
1/30/2018 7:10,80,66.5,102,61.5,182,63.7,2,0,0
1/30/2018 7:15,85,67.7,108,62.8,193,65,2,0,0
1/30/2018 7:20,70,67.3,91,62.4,161,64.6,2,0,0
1/30/2018 7:25,88,67,112,62.1,200,64.3,2,0,0
1/30/2018 7:30,76,67,97,62.1,173,64.3,2,0,0
1/30/2018 7:35,80,67.5,102,62.5,182,64.7,2,0,0
1/30/2018 7:40,87,68.1,111,63.2,198,65.4,2,0,0
1/30/2018 7:45,86,68.3,111,63.4,197,65.5,2,0,0
1/30/2018 7:50,79,68.3,101,63.5,180,65.6,2,0,0
1/30/2018 7:55,86,66.8,110,61.9,196,64.1,2,0,0
1/30/2018 8:00,86,65.3,109,60.2,195,62.5,2,0,0
1/30/2018 8:05,76,66.3,100,61.4,176,63.5,2,0,0
1/30/2018 8:10,79,66.2,102,61.2,181,63.4,2,0,0
1/30/2018 8:15,86,66.7,109,61.8,195,64,2,0,0
1/30/2018 8:20,74,67.2,96,62.3,170,64.4,2,0,0
1/30/2018 8:25,90,65.7,114,60.7,204,62.9,2,0,0
1/30/2018 8:30,74,66.2,96,61.2,170,63.4,2,0,0
1/30/2018 8:35,75,66.5,96,61.5,171,63.7,2,0,0
1/30/2018 8:40,86,67.1,108,62.3,194,64.4,2,0,0
1/30/2018 8:45,75,67.8,98,63,173,65.1,2,0,0
1/30/2018 8:50,89,66.8,111,61.9,200,64.1,2,0,0
1/30/2018 8:55,82,66.7,103,61.8,185,63.9,2,0,0
1/30/2018 9:00,82,65.1,103,60,185,62.3,2,0,0
1/30/2018 9:05,74,66.4,95,61.5,169,63.6,2,0,0
1/30/2018 9:10,76,67.2,98,62.4,174,64.5,2,0,0
1/30/2018 9:15,72,66.6,93,61.8,165,63.9,2,0,0
1/30/2018 9:20,76,66.1,97,61.2,173,63.3,2,0,0
1/30/2018 9:25,70,64.8,91,59.7,161,61.9,2,0,0
1/30/2018 9:30,67,65.7,87,60.7,154,62.9,2,0,0
1/30/2018 9:35,69,66.4,88,61.5,157,63.7,2,0,0
1/30/2018 9:40,62,66.1,82,61.1,144,63.2,2,0,0
1/30/2018 9:45,68,67.1,87,62.2,155,64.4,2,0,0
1/30/2018 9:50,59,65,77,59.9,136,62.1,2,0,0
1/30/2018 9:55,72,62.5,89,57.1,161,59.6,2,0,0
1/30/2018 10:00,71,63.3,90,58.1,161,60.4,2,0,0
1/30/2018 10:05,72,64.4,92,59.3,164,61.5,2,0,0
1/30/2018 10:10,50,65.8,68,60.8,118,62.9,2,0,0
1/30/2018 10:15,54,67.3,72,62.6,126,64.6,2,0,0
1/30/2018 10:20,52,67.7,70,63.1,122,65.1,2,0,0
1/30/2018 10:25,58,69,76,64.5,134,66.5,2,0,0
1/30/2018 10:30,52,69,70,64.5,122,66.4,2,0,0
1/30/2018 10:35,49,68.4,68,63.7,117,65.7,2,0,0
1/30/2018 10:40,65,67.8,85,63,150,65.1,2,0,0
1/30/2018 10:45,58,68.9,77,64.3,135,66.3,2,0,0
1/30/2018 10:50,56,68.8,73,64.3,129,66.2,2,0,0
1/30/2018 10:55,61,70.1,79,65.6,140,67.6,2,0,0
1/30/2018 11:00,48,70,65,65.5,113,67.4,2,0,0
1/30/2018 11:05,51,70,68,65.5,119,67.4,2,0,0
1/30/2018 11:10,56,68.8,75,64.2,131,66.1,2,0,0
1/30/2018 11:15,61,69.9,79,65.4,140,67.4,2,0,0
1/30/2018 11:20,58,70.2,75,65.6,133,67.6,2,0,0
1/30/2018 11:25,52,70,69,65.5,121,67.4,2,0,0
1/30/2018 11:30,52,71.2,71,66.8,123,68.7,2,0,0
1/30/2018 11:35,54,69.9,72,65.4,126,67.3,2,0,0
1/30/2018 11:40,53,69.2,72,64.6,125,66.6,2,0,0
1/30/2018 11:45,47,69.1,64,64.5,111,66.4,2,0,0
1/30/2018 11:50,52,68.8,69,64.1,121,66.1,2,0,0
1/30/2018 11:55,55,69.8,73,65.2,128,67.2,2,0,0
1/30/2018 12:00,52,67.6,69,62.8,121,64.8,2,0,0
1/30/2018 12:05,46,68.6,63,63.9,109,65.9,2,0,0
1/30/2018 12:10,52,69.9,70,65.3,122,67.3,2,0,0
1/30/2018 12:15,51,70.7,68,66.2,119,68.1,2,0,0
1/30/2018 12:20,48,71,65,66.6,113,68.5,2,0,0
1/30/2018 12:25,52,70.8,69,66.3,121,68.2,2,0,0
1/30/2018 12:30,46,70.8,63,66.3,109,68.2,2,0,0
1/30/2018 12:35,47,69.2,64,64.6,111,66.6,2,0,0
1/30/2018 12:40,63,69.2,82,64.6,145,66.6,2,0,0
1/30/2018 12:45,51,70,69,65.5,120,67.4,2,0,0
1/30/2018 12:50,52,70.5,70,65.9,122,67.8,2,0,0
1/30/2018 12:55,59,69.9,76,65.4,135,67.4,2,0,0
1/30/2018 13:00,42,69.2,59,64.6,101,66.5,2,0,0
1/30/2018 13:05,46,68.7,64,64.1,110,66.1,2,0,0
1/30/2018 13:10,51,68.7,69,64.1,120,66.1,2,0,0
1/30/2018 13:15,48,69.2,65,64.5,113,66.5,2,0,0
1/30/2018 13:20,51,69.2,69,64.6,120,66.5,2,0,0
1/30/2018 13:25,42,69.8,59,65.2,101,67.1,2,0,0
1/30/2018 13:30,49,68.8,67,64.2,116,66.1,2,0,0
1/30/2018 13:35,60,68.6,79,63.9,139,65.9,2,0,0
1/30/2018 13:40,51,68.6,69,63.9,120,65.9,2,0,0
1/30/2018 13:45,51,68,69,63.3,120,65.3,2,0,0
1/30/2018 13:50,39,68.7,57,64,96,65.9,2,0,0
1/30/2018 13:55,49,67,68,62.3,117,64.3,2,0,0
1/30/2018 14:00,47,68,64,63.4,111,65.3,2,0,0
1/30/2018 14:05,46,68.2,63,63.5,109,65.5,2,0,0
1/30/2018 14:10,44,69.2,62,64.7,106,66.6,2,0,0
1/30/2018 14:15,47,67.6,65,62.9,112,64.8,2,0,0
1/30/2018 14:20,53,69.3,70,64.8,123,66.7,2,0,0
1/30/2018 14:25,42,70,59,65.4,101,67.3,2,0,0
1/30/2018 14:30,44,69.6,62,65.1,106,67,2,0,0
1/30/2018 14:35,34,70,52,65.5,86,67.3,2,0,0
1/30/2018 14:40,50,70.2,69,65.6,119,67.6,2,0,0
1/30/2018 14:45,52,69.4,70,64.7,122,66.7,2,0,0
1/30/2018 14:50,49,70,67,65.4,116,67.3,2,0,0
1/30/2018 14:55,41,70.2,58,65.6,99,67.5,2,0,0
1/30/2018 15:00,62,69.2,80,64.6,142,66.6,2,0,0
1/30/2018 15:05,55,69,74,64.4,129,66.3,2,0,0
1/30/2018 15:10,59,67.3,78,62.6,137,64.6,2,0,0
1/30/2018 15:15,54,68.7,72,64.1,126,66.1,2,0,0
1/30/2018 15:20,52,69.2,70,64.7,122,66.6,2,0,0
1/30/2018 15:25,63,68.9,81,64.3,144,66.3,2,0,0
1/30/2018 15:30,56,69.6,74,65,130,67,2,0,0
1/30/2018 15:35,65,69.8,83,65.1,148,67.2,2,0,0
1/30/2018 15:40,69,69.4,87,64.8,156,66.8,2,0,0
1/30/2018 15:45,69,68,87,63.2,156,65.3,2,0,0
1/30/2018 15:50,64,69.1,82,64.5,146,66.5,2,0,0
1/30/2018 15:55,62,68.1,81,63.4,143,65.4,2,0,0
1/30/2018 16:00,61,68.7,80,64,141,66,2,0,0
1/30/2018 16:05,57,69.1,75,64.5,132,66.4,2,0,0
1/30/2018 16:10,58,68.9,77,64.2,135,66.2,2,0,0
1/30/2018 16:15,55,69.5,74,64.8,129,66.8,2,0,0
1/30/2018 16:20,54,68.9,72,64.3,126,66.3,2,0,0
1/30/2018 16:25,49,68.5,67,63.8,116,65.8,2,0,0
1/30/2018 16:30,50,68.7,68,63.9,118,65.9,2,0,0
1/30/2018 16:35,47,68.7,65,64.1,112,66,2,0,0
1/30/2018 16:40,50,69.1,68,64.5,118,66.4,2,0,0
1/30/2018 16:45,44,66.6,63,61.7,107,63.7,2,0,0
1/30/2018 16:50,43,68.4,60,63.7,103,65.7,2,0,0
1/30/2018 16:55,41,69.1,60,64.5,101,66.4,2,0,0
1/30/2018 17:00,48,69.2,66,64.6,114,66.5,2,0,0
1/30/2018 17:05,45,69.5,62,64.9,107,66.8,2,0,0
1/30/2018 17:10,45,69.1,64,64.4,109,66.3,2,0,0
1/30/2018 17:15,51,69.5,69,64.8,120,66.8,2,0,0
1/30/2018 17:20,45,69.5,63,64.9,108,66.8,2,0,0
1/30/2018 17:25,48,69.6,66,65,114,67,2,0,0
1/30/2018 17:30,56,69.7,75,65.2,131,67.1,2,0,0
1/30/2018 17:35,45,70,62,65.5,107,67.4,2,0,0
1/30/2018 17:40,44,71,61,66.5,105,68.4,2,0,0
1/30/2018 17:45,51,69.4,69,64.8,120,66.7,2,0,0
1/30/2018 17:50,48,68.4,66,63.6,114,65.6,2,0,0
1/30/2018 17:55,45,63,64,57.6,109,59.8,2,0,0
1/30/2018 18:00,35,62.3,52,56.9,87,59.1,2,0,0
1/30/2018 18:05,39,62,57,56.4,96,58.7,2,0,0
1/30/2018 18:10,33,63.8,50,58.5,83,60.6,2,0,0
1/30/2018 18:15,38,64.8,55,59.7,93,61.8,2,0,0
1/30/2018 18:20,33,66.8,50,61.9,83,63.9,2,0,0
1/30/2018 18:25,37,66.9,53,62,90,64,2,0,0
1/30/2018 18:30,36,67.2,53,62.4,89,64.4,2,0,0
1/30/2018 18:35,35,67.9,52,63.1,87,65.1,2,0,0
1/30/2018 18:40,30,68.8,46,64.1,76,66,2,0,0
1/30/2018 18:45,32,69.2,49,64.6,81,66.4,2,0,0
1/30/2018 18:50,41,68.3,59,63.6,100,65.5,2,0,0
1/30/2018 18:55,44,69.4,61,64.8,105,66.7,2,0,0
1/30/2018 19:00,33,68.7,50,64,83,65.9,2,0,0
1/30/2018 19:05,39,69.6,56,65,95,66.9,2,0,0
1/30/2018 19:10,40,69.7,58,65,98,66.9,2,0,0
1/30/2018 19:15,31,69.8,48,65.2,79,67,2,0,0
1/30/2018 19:20,34,68.8,51,64.1,85,65.9,2,0,0
1/30/2018 19:25,32,69.3,48,64.7,80,66.5,2,0,0
1/30/2018 19:30,37,69.9,53,65.3,90,67.2,2,0,0
1/30/2018 19:35,35,68.7,52,63.9,87,65.9,2,0,0
1/30/2018 19:40,35,69.5,52,64.8,87,66.7,2,0,0
1/30/2018 19:45,36,69.4,53,64.7,89,66.6,2,0,0
1/30/2018 19:50,37,69.5,54,64.9,91,66.8,2,0,0
1/30/2018 19:55,32,70.2,48,65.6,80,67.4,2,0,0
1/30/2018 20:00,31,69.2,48,64.6,79,66.4,2,0,0
1/30/2018 20:05,32,69.3,50,64.7,82,66.5,2,0,0
1/30/2018 20:10,34,68.9,51,64.2,85,66,2,0,0
1/30/2018 20:15,31,69.1,48,64.4,79,66.2,2,0,0
1/30/2018 20:20,31,68.9,47,64.2,78,66,2,0,0
1/30/2018 20:25,32,69.2,49,64.6,81,66.4,2,0,0
1/30/2018 20:30,29,69.3,46,64.7,75,66.5,2,0,0
1/30/2018 20:35,26,69.3,42,64.7,68,66.5,2,0,0
1/30/2018 20:40,25,69.4,42,64.8,67,66.6,2,0,0
1/30/2018 20:45,28,69.8,45,65.2,73,66.9,2,0,0
1/30/2018 20:50,21,69.5,37,64.9,58,66.5,2,0,0
1/30/2018 20:55,19,68.8,35,64.2,54,65.8,2,0,0
1/30/2018 21:00,24,68.3,40,63.6,64,65.3,2,0,0
1/30/2018 21:05,27,68.9,43,64.2,70,66,2,0,0
1/30/2018 21:10,23,69,38,64.4,61,66.1,2,0,0
1/30/2018 21:15,27,69.4,43,64.8,70,66.6,2,0,0
1/30/2018 21:20,19,69.1,35,64.5,54,66.1,2,0,0
1/30/2018 21:25,21,69.3,37,64.7,58,66.3,2,0,0
1/30/2018 21:30,26,69.3,42,64.7,68,66.5,2,0,0
1/30/2018 21:35,27,68.4,43,63.7,70,65.5,2,0,0
1/30/2018 21:40,24,68.8,40,64.2,64,65.9,2,0,0
1/30/2018 21:45,17,69.2,33,64.6,50,66.2,2,0,0
1/30/2018 21:50,28,69,44,64.3,72,66.1,2,0,0
1/30/2018 21:55,22,68.7,38,64.1,60,65.8,2,0,0
1/30/2018 22:00,23,69.2,39,64.5,62,66.3,2,0,0
1/30/2018 22:05,26,69.4,42,64.8,68,66.6,2,0,0
1/30/2018 22:10,27,69.8,42,65.2,69,67,2,0,0
1/30/2018 22:15,26,69.3,41,64.7,67,66.5,2,0,0
1/30/2018 22:20,26,69.5,42,64.9,68,66.7,2,0,0
1/30/2018 22:25,18,69,34,64.4,52,66,2,0,0
1/30/2018 22:30,21,69.1,37,64.4,58,66.1,2,0,0
1/30/2018 22:35,21,69.3,37,64.7,58,66.3,2,0,0
1/30/2018 22:40,18,69.1,33,64.4,51,66.1,2,0,0
1/30/2018 22:45,10,69.2,26,64.6,36,65.9,2,0,0
1/30/2018 22:50,15,69.4,31,64.8,46,66.3,2,0,0
1/30/2018 22:55,19,68.8,35,64.2,54,65.8,2,0,0
1/30/2018 23:00,14,69,30,64.4,44,65.8,2,0,0
1/30/2018 23:05,19,69.1,35,64.5,54,66.1,2,0,0
1/30/2018 23:10,16,69.2,32,64.6,48,66.1,2,0,0
1/30/2018 23:15,11,68.9,26,64.2,37,65.6,2,0,0
1/30/2018 23:20,12,68.9,27,64.3,39,65.7,2,0,0
1/30/2018 23:25,11,69.2,27,64.6,38,66,2,0,0
1/30/2018 23:30,14,69.3,30,64.7,44,66.2,2,0,0
1/30/2018 23:35,15,69.3,30,64.7,45,66.2,2,0,0
1/30/2018 23:40,14,69.3,29,64.7,43,66.2,2,0,0
1/30/2018 23:45,15,69.3,30,64.7,45,66.3,2,0,0
1/30/2018 23:50,13,69.4,29,64.8,42,66.2,2,0,0
1/30/2018 23:55,9,69.4,24,64.8,33,66.1,2,0,0
1/31/2018 0:00,11,69.3,27,64.7,38,66.1,2,0,0
1/31/2018 0:05,9,69.4,24,64.8,33,66.1,2,0,0
1/31/2018 0:10,10,69.4,26,64.8,36,66.1,2,0,0
1/31/2018 0:15,10,69.3,25,64.7,35,66,2,0,0
1/31/2018 0:20,8,69.1,23,64.5,31,65.7,2,0,0
1/31/2018 0:25,7,69.2,22,64.5,29,65.7,2,0,0
1/31/2018 0:30,7,69.3,22,64.7,29,65.8,2,0,0
1/31/2018 0:35,8,69.2,23,64.6,31,65.8,2,0,0
1/31/2018 0:40,9,69.4,24,64.8,33,66,2,0,0
1/31/2018 0:45,11,69.4,21,64.8,32,66.4,2,0,0
1/31/2018 0:50,8,69.5,23,64.9,31,66.1,2,0,0
1/31/2018 0:55,4,69.5,19,64.9,23,65.7,2,0,0
1/31/2018 1:00,7,69.4,22,64.8,29,65.9,2,0,0
1/31/2018 1:05,6,69.4,22,64.8,28,65.8,2,0,0
1/31/2018 1:10,8,69.2,23,64.5,31,65.7,2,0,0
1/31/2018 1:15,5,69.1,21,64.5,26,65.4,2,0,0
1/31/2018 1:20,15,69,22,64.4,37,66.3,2,0,0
1/31/2018 1:25,5,69.4,21,64.8,26,65.6,2,0,0
1/31/2018 1:30,9,69.2,24,64.6,33,65.9,2,0,0
1/31/2018 1:35,10,69.2,25,64.6,35,65.9,2,0,0
1/31/2018 1:40,6,69.2,21,64.6,27,65.6,2,0,0
1/31/2018 1:45,7,69.2,22,64.5,29,65.7,2,0,0
1/31/2018 1:50,7,69.3,23,64.7,30,65.8,2,0,0
1/31/2018 1:55,15,69.4,22,64.8,37,66.6,2,0,0
1/31/2018 2:00,8,69.3,23,64.7,31,65.9,2,0,0
1/31/2018 2:05,9,69.2,24,64.5,33,65.8,2,0,0
1/31/2018 2:10,8,69.2,24,64.5,32,65.7,2,0,0
1/31/2018 2:15,7,69.2,23,64.6,30,65.7,2,0,0
1/31/2018 2:20,7,69.2,22,64.6,29,65.7,2,0,0
1/31/2018 2:25,6,69.3,21,64.7,27,65.7,2,0,0
1/31/2018 2:30,7,69.2,22,64.6,29,65.7,2,0,0
1/31/2018 2:35,6,69.2,21,64.5,27,65.6,2,0,0
1/31/2018 2:40,10,69.4,25,64.8,35,66.1,2,0,0
1/31/2018 2:45,9,69.4,24,64.8,33,66,2,0,0
1/31/2018 2:50,10,69.4,26,64.8,36,66.1,2,0,0
1/31/2018 2:55,10,69.4,26,64.7,36,66,2,0,0
1/31/2018 3:00,6,69.4,21,64.8,27,65.8,2,0,0
1/31/2018 3:05,9,69.4,24,64.8,33,66.1,2,0,0
1/31/2018 3:10,10,69.3,26,64.7,36,66,2,0,0
1/31/2018 3:15,10,68.8,26,64.2,36,65.5,2,0,0
1/31/2018 3:20,11,68.9,26,64.3,37,65.7,2,0,0
1/31/2018 3:25,8,69.1,24,64.5,32,65.6,2,0,0
1/31/2018 3:30,13,69.3,29,64.7,42,66.1,2,0,0
1/31/2018 3:35,15,69.4,31,64.8,46,66.3,2,0,0
1/31/2018 3:40,11,69.2,27,64.5,38,65.9,2,0,0
1/31/2018 3:45,13,69.4,29,64.8,42,66.2,2,0,0
1/31/2018 3:50,12,69.5,27,64.9,39,66.3,2,0,0
1/31/2018 3:55,11,69.4,27,64.8,38,66.1,2,0,0
1/31/2018 4:00,17,69.5,34,64.9,51,66.5,2,0,0
1/31/2018 4:05,17,69.5,34,64.9,51,66.5,2,0,0
1/31/2018 4:10,18,69.4,34,64.7,52,66.3,2,0,0
1/31/2018 4:15,25,69.7,42,65.1,67,66.8,2,0,0
1/31/2018 4:20,24,69.9,40,65.3,64,67.1,2,0,0
1/31/2018 4:25,24,69.8,41,65.3,65,67,2,0,0
1/31/2018 4:30,26,69.6,43,65,69,66.7,2,0,0
1/31/2018 4:35,24,68.8,41,64.2,65,65.9,2,0,0
1/31/2018 4:40,39,69.3,57,64.6,96,66.5,2,0,0
1/31/2018 4:45,38,69.1,56,64.4,94,66.3,2,0,0
1/31/2018 4:50,47,69.5,66,64.7,113,66.7,2,0,0
1/31/2018 4:55,35,68.1,53,63.3,88,65.2,2,0,0
1/31/2018 5:00,43,69.3,62,64.6,105,66.6,2,0,0
1/31/2018 5:05,34,68.8,51,64.1,85,66,2,0,0
1/31/2018 5:10,42,68.9,61,64.2,103,66.1,2,0,0
1/31/2018 5:15,45,67.6,65,62.9,110,64.9,2,0,0
1/31/2018 5:20,48,68.8,68,64.1,116,66.1,2,0,0
1/31/2018 5:25,51,70.3,71,65.7,122,67.6,2,0,0
1/31/2018 5:30,59,70.7,79,66.1,138,68.1,2,0,0
1/31/2018 5:35,65,69.6,88,64.9,153,66.9,2,0,0
1/31/2018 5:40,65,69.3,86,64.6,151,66.7,2,0,0
1/31/2018 5:45,70,69.3,93,64.6,163,66.6,2,0,0
1/31/2018 5:50,70,69.5,93,64.8,163,66.8,2,0,0
1/31/2018 5:55,60,68.6,79,63.9,139,65.9,2,0,0
1/31/2018 6:00,58,67.7,79,62.8,137,64.9,2,0,0
1/31/2018 6:05,62,68.1,84,63.2,146,65.3,2,0,0
1/31/2018 6:10,68,67.1,89,62.2,157,64.3,2,0,0
1/31/2018 6:15,59,68.1,79,63.2,138,65.3,2,0,0
1/31/2018 6:20,63,67.2,85,62.3,148,64.4,2,0,0
1/31/2018 6:25,60,67.3,81,62.4,141,64.4,2,0,0
1/31/2018 6:30,62,66.6,84,61.6,146,63.7,2,0,0
1/31/2018 6:35,60,66.3,82,61.3,142,63.4,2,0,0
1/31/2018 6:40,75,67.5,98,62.6,173,64.7,2,0,0
1/31/2018 6:45,80,67.9,103,63,183,65.1,2,0,0
1/31/2018 6:50,74,67.5,96,62.6,170,64.7,2,0,0
1/31/2018 6:55,70,67.3,93,62.4,163,64.5,2,0,0
1/31/2018 7:00,66,66.9,87,62,153,64.1,2,0,0
1/31/2018 7:05,82,67.7,104,62.9,186,65,2,0,0
1/31/2018 7:10,78,67.5,100,62.7,178,64.8,2,0,0
1/31/2018 7:15,84,68.3,107,63.5,191,65.6,2,0,0
1/31/2018 7:20,88,68.1,111,63.3,199,65.4,2,0,0
1/31/2018 7:25,86,66.2,110,61.2,196,63.4,2,0,0
1/31/2018 7:30,86,66.3,109,61.4,195,63.6,2,0,0
1/31/2018 7:35,88,66.4,111,61.4,199,63.6,2,0,0
1/31/2018 7:40,87,66.2,111,61.3,198,63.5,2,0,0
1/31/2018 7:45,80,66.8,103,61.8,183,64,2,0,0
1/31/2018 7:50,76,67,98,62.1,174,64.3,2,0,0
1/31/2018 7:55,98,66.7,122,61.7,220,63.9,2,0,0
1/31/2018 8:00,73,66.9,95,61.9,168,64.1,2,0,0
1/31/2018 8:05,72,67.3,94,62.4,166,64.5,2,0,0
1/31/2018 8:10,73,67.2,95,62.3,168,64.4,2,0,0
1/31/2018 8:15,74,68.2,96,63.4,170,65.5,2,0,0
1/31/2018 8:20,91,67.4,115,62.5,206,64.6,2,0,0
1/31/2018 8:25,79,67.1,100,62.2,179,64.4,2,0,0
1/31/2018 8:30,79,65.3,101,60.1,180,62.4,2,0,0
1/31/2018 8:35,72,66.8,94,61.8,166,64,2,0,0
1/31/2018 8:40,86,67,110,62.2,196,64.3,2,0,0
1/31/2018 8:45,83,68.7,105,64,188,66.1,2,0,0
1/31/2018 8:50,82,66.5,103,61.7,185,63.8,2,0,0
1/31/2018 8:55,69,67.3,90,62.5,159,64.6,2,0,0
1/31/2018 9:00,76,66.8,97,61.9,173,64,2,0,0
1/31/2018 9:05,73,67.1,94,62.2,167,64.4,2,0,0
1/31/2018 9:10,80,67.2,103,62.3,183,64.4,2,0,0
1/31/2018 9:15,75,66.5,96,61.6,171,63.8,2,0,0
1/31/2018 9:20,62,66.6,83,61.7,145,63.8,2,0,0
1/31/2018 9:25,60,66.1,79,61.3,139,63.4,2,0,0
1/31/2018 9:30,65,67.8,85,63,150,65.1,1,0,0
1/31/2018 9:35,73,66.7,94,61.9,167,64,1,0,0
1/31/2018 9:40,87,66,111,61.1,198,63.2,1,0,0
1/31/2018 9:45,85,65.9,107,60.9,192,63.1,1,0,0
1/31/2018 9:50,75,67.7,96,62.9,171,65,1,0,0
1/31/2018 9:55,77,67.3,98,62.4,175,64.6,1,0,0
1/31/2018 10:00,71,64.6,92,59.6,163,61.8,1,0,0
1/31/2018 10:05,73,65.7,94,60.8,167,62.9,1,0,0
1/31/2018 10:10,75,66.2,95,61.3,170,63.5,1,0,0
1/31/2018 10:15,71,66.4,92,61.6,163,63.7,1,0,0
1/31/2018 10:20,58,67.1,78,62.3,136,64.4,1,0,0
1/31/2018 10:25,63,67.5,83,62.7,146,64.8,1,0,0
1/31/2018 10:30,66,66.7,85,61.9,151,64,1,0,0
1/31/2018 10:35,61,67.9,80,63.1,141,65.2,1,0,0
1/31/2018 10:40,61,69.6,79,65,140,67,1,0,0
1/31/2018 10:45,58,67.5,77,62.8,135,64.8,1,0,0
1/31/2018 10:50,61,68,80,63.4,141,65.4,1,0,0
1/31/2018 10:55,64,68.6,84,63.9,148,65.9,1,0,0
1/31/2018 11:00,59,69.8,76,65.3,135,67.3,1,0,0
1/31/2018 11:05,66,68.9,86,64.3,152,66.3,1,0,0
1/31/2018 11:10,56,68.7,75,64,131,66,1,0,0
1/31/2018 11:15,66,68.2,86,63.4,152,65.5,1,0,0
1/31/2018 11:20,56,68.9,74,64.3,130,66.3,1,0,0
1/31/2018 11:25,55,69.7,73,65.2,128,67.1,1,0,0
1/31/2018 11:30,59,69.1,80,64.5,139,66.5,1,0,0
1/31/2018 11:35,54,68.2,74,63.4,128,65.4,1,0,0
1/31/2018 11:40,59,66.5,79,61.6,138,63.7,1,0,0
1/31/2018 11:45,79,64.5,100,59.4,179,61.7,1,0,0
1/31/2018 11:50,71,62.5,91,57.2,162,59.5,1,0,0
1/31/2018 11:55,59,65.4,78,60.3,137,62.5,1,0,0
1/31/2018 12:00,64,67.9,82,63.1,146,65.2,1,0,0
1/31/2018 12:05,52,67.6,69,62.9,121,64.9,1,0,0
1/31/2018 12:10,58,69.9,76,65.3,134,67.3,1,0,0
1/31/2018 12:15,56,68.3,74,63.6,130,65.7,1,0,0
1/31/2018 12:20,48,69.5,66,64.9,114,66.8,1,0,0
1/31/2018 12:25,54,68.6,73,63.9,127,65.9,1,0,0
1/31/2018 12:30,54,69.6,72,65,126,67,1,0,0
1/31/2018 12:35,55,70.1,74,65.5,129,67.5,1,0,0
1/31/2018 12:40,47,69.5,65,64.9,112,66.8,1,0,0
1/31/2018 12:45,51,70.1,68,65.5,119,67.4,1,0,0
1/31/2018 12:50,39,70,56,65.4,95,67.3,1,0,0
1/31/2018 12:55,36,68.6,53,64,89,65.9,1,0,0
1/31/2018 13:00,49,68.6,68,63.8,117,65.8,1,0,0
1/31/2018 13:05,50,69.7,68,65.1,118,67.1,1,0,0
1/31/2018 13:10,42,70.4,59,65.8,101,67.7,1,0,0
1/31/2018 13:15,48,70.8,66,66.2,114,68.1,1,0,0
1/31/2018 13:20,51,69.7,70,65.1,121,67,1,0,0
1/31/2018 13:25,53,69.9,71,65.3,124,67.2,1,0,0
1/31/2018 13:30,55,70,72,65.5,127,67.5,1,0,0
1/31/2018 13:35,50,70.1,68,65.7,118,67.5,2,0,0
1/31/2018 13:40,57,70.3,75,65.9,132,67.8,2,0,0
1/31/2018 13:45,52,69.1,70,64.6,122,66.5,2,0,0
1/31/2018 13:50,53,69.5,72,65,125,66.9,2,0,0
1/31/2018 13:55,50,69.5,67,64.9,117,66.9,2,0,0
1/31/2018 14:00,48,69.8,65,65.2,113,67.2,2,0,0
1/31/2018 14:05,38,69.4,55,64.8,93,66.6,2,0,0
1/31/2018 14:10,39,68.3,56,63.6,95,65.5,2,0,0
1/31/2018 14:15,39,69.5,55,65,94,66.9,2,0,0
1/31/2018 14:20,43,70,60,65.5,103,67.4,2,0,0
1/31/2018 14:25,45,70.9,63,66.5,108,68.3,2,0,0
1/31/2018 14:30,44,70,61,65.5,105,67.4,2,0,0
1/31/2018 14:35,40,69.7,57,65.1,97,67,2,0,0
1/31/2018 14:40,49,69.1,67,64.4,116,66.4,2,0,0
1/31/2018 14:45,43,70.5,61,66,104,67.9,2,0,0
1/31/2018 14:50,55,70.2,74,65.7,129,67.6,2,0,0
1/31/2018 14:55,50,70.1,68,65.6,118,67.5,2,0,0
1/31/2018 15:00,45,70.8,62,66.4,107,68.2,2,0,0
1/31/2018 15:05,47,69.9,64,65.4,111,67.3,2,0,0
1/31/2018 15:10,48,69.4,66,64.8,114,66.7,2,0,0
1/31/2018 15:15,43,69.5,61,64.9,104,66.8,2,0,0
1/31/2018 15:20,45,69,63,64.4,108,66.4,2,0,0
1/31/2018 15:25,49,69.2,67,64.5,116,66.5,2,0,0
1/31/2018 15:30,58,69.7,76,65.2,134,67.2,2,0,0
1/31/2018 15:35,59,69.7,77,65.2,136,67.2,2,0,0
1/31/2018 15:40,60,68,80,63.4,140,65.4,2,0,0
1/31/2018 15:45,54,69.8,72,65.2,126,67.2,2,0,0
1/31/2018 15:50,41,70.4,58,65.9,99,67.8,2,0,0
1/31/2018 15:55,52,70.3,69,65.8,121,67.7,2,0,0
1/31/2018 16:00,44,69.4,62,64.7,106,66.7,2,0,0
1/31/2018 16:05,50,70,67,65.4,117,67.4,2,0,0
1/31/2018 16:10,50,68.9,70,64.2,120,66.2,2,0,0
1/31/2018 16:15,49,70.1,67,65.6,116,67.5,2,0,0
1/31/2018 16:20,52,71.3,70,66.9,122,68.7,2,0,0
1/31/2018 16:25,57,69.9,75,65.3,132,67.3,2,0,0
1/31/2018 16:30,50,70.4,67,65.9,117,67.8,2,0,0
1/31/2018 16:35,58,70.2,77,65.7,135,67.7,2,0,0
1/31/2018 16:40,49,69.4,66,64.9,115,66.8,2,0,0
1/31/2018 16:45,54,70.3,71,65.9,125,67.8,2,0,0
1/31/2018 16:50,46,69.8,63,65.2,109,67.1,2,0,0
1/31/2018 16:55,48,69.1,66,64.5,114,66.4,2,0,0
1/31/2018 17:00,42,74.6,60,70.5,102,72.2,2,0,0
1/31/2018 17:05,45,76.1,63,72.3,108,73.9,2,0,0
1/31/2018 17:10,45,76.1,63,72.3,108,73.9,2,0,0
1/31/2018 17:15,53,74.9,73,71,126,72.6,2,0,0
1/31/2018 17:20,51,76.1,69,72.3,120,73.9,2,0,0
1/31/2018 17:25,45,76.1,63,72.3,108,73.9,2,0,0
1/31/2018 17:30,48,76.1,67,72.3,115,73.9,2,0,0
1/31/2018 17:35,47,76.1,65,72.3,112,73.9,2,0,0
1/31/2018 17:40,52,76.1,70,72.3,122,73.9,2,0,0
1/31/2018 17:45,49,76.1,67,72.3,116,73.9,2,0,0
1/31/2018 17:50,49,76.1,68,72.3,117,73.9,2,0,0
1/31/2018 17:55,55,76.1,72,72.3,127,73.9,2,0,0
1/31/2018 18:00,49,72.6,67,68.4,116,70.2,2,0,0
1/31/2018 18:05,42,70.6,60,66.1,102,68,2,0,0
1/31/2018 18:10,47,68.4,64,63.7,111,65.7,2,0,0
1/31/2018 18:15,48,68.7,65,64,113,66,2,0,0
1/31/2018 18:20,42,68.5,59,63.8,101,65.8,2,0,0
1/31/2018 18:25,45,68.2,63,63.5,108,65.5,2,0,0
1/31/2018 18:30,48,68.6,66,63.9,114,65.9,2,0,0
1/31/2018 18:35,42,69.4,58,64.7,100,66.7,2,0,0
1/31/2018 18:40,43,69.4,60,64.8,103,66.7,2,0,0
1/31/2018 18:45,49,68.7,68,64.1,117,66,2,0,0
1/31/2018 18:50,43,68.9,61,64.3,104,66.2,2,0,0
1/31/2018 18:55,48,69.2,66,64.6,114,66.5,2,0,0
1/31/2018 19:00,56,68.9,76,64.3,132,66.3,2,0,0
1/31/2018 19:05,45,69.2,64,64.6,109,66.5,2,0,0
1/31/2018 19:10,49,69.1,67,64.4,116,66.4,2,0,0
1/31/2018 19:15,48,69.8,65,65.2,113,67.1,2,0,0
1/31/2018 19:20,45,70.1,62,65.6,107,67.5,2,0,0
1/31/2018 19:25,47,69.6,64,65,111,67,2,0,0
1/31/2018 19:30,46,68.6,64,63.9,110,65.9,2,0,0
1/31/2018 19:35,44,69.6,62,65,106,66.9,2,0,0
1/31/2018 19:40,37,70,54,65.5,91,67.3,2,0,0
1/31/2018 19:45,34,70,50,65.5,84,67.3,2,0,0
1/31/2018 19:50,35,69.6,52,65,87,66.9,2,0,0
1/31/2018 19:55,36,70.4,52,65.9,88,67.8,2,0,0
1/31/2018 20:00,40,70.2,57,65.7,97,67.6,2,0,0
1/31/2018 20:05,39,69.4,56,64.8,95,66.7,2,0,0
1/31/2018 20:10,29,69.6,46,65.1,75,66.8,2,0,0
1/31/2018 20:15,33,70,49,65.5,82,67.3,2,0,0
1/31/2018 20:20,30,69.5,46,65,76,66.8,2,0,0
1/31/2018 20:25,35,69.6,52,65,87,66.9,2,0,0
1/31/2018 20:30,34,69.1,51,64.5,85,66.3,2,0,0
1/31/2018 20:35,37,69.7,54,65.1,91,67,2,0,0
1/31/2018 20:40,24,70,40,65.4,64,67.1,2,0,0
1/31/2018 20:45,29,69.7,46,65.1,75,66.9,2,0,0
1/31/2018 20:50,24,70,40,65.5,64,67.2,2,0,0
1/31/2018 20:55,26,68.9,42,64.3,68,66,2,0,0
1/31/2018 21:00,23,69.5,39,64.9,62,66.6,2,0,0
1/31/2018 21:05,26,69.6,42,65,68,66.7,2,0,0
1/31/2018 21:10,29,69.7,45,65.2,74,66.9,2,0,0
1/31/2018 21:15,24,69.9,40,65.3,64,67,2,0,0
1/31/2018 21:20,31,70.1,48,65.6,79,67.4,2,0,0
1/31/2018 21:25,23,69.9,39,65.3,62,67,2,0,0
1/31/2018 21:30,31,69.7,48,65.1,79,66.9,2,0,0
1/31/2018 21:35,21,69.8,37,65.3,58,66.9,2,0,0
1/31/2018 21:40,27,69.8,43,65.2,70,66.9,2,0,0
1/31/2018 21:45,25,69.8,41,65.2,66,66.9,2,0,0
1/31/2018 21:50,20,69.7,36,65.1,56,66.7,2,0,0
1/31/2018 21:55,28,69.4,45,64.8,73,66.5,2,0,0
1/31/2018 22:00,18,67.8,33,63.1,51,64.8,2,0,0
1/31/2018 22:05,30,69.4,45,64.8,75,66.7,2,0,0
1/31/2018 22:10,25,69.7,41,65.2,66,66.9,2,0,0
1/31/2018 22:15,20,69.6,36,65,56,66.7,2,0,0
1/31/2018 22:20,19,69.5,35,64.9,54,66.5,2,0,0
1/31/2018 22:25,20,69,36,64.3,56,66,2,0,0
1/31/2018 22:30,15,69.3,30,64.7,45,66.3,2,0,0
1/31/2018 22:35,21,69.3,36,64.7,57,66.4,2,0,0
1/31/2018 22:40,16,69.4,31,64.8,47,66.4,2,0,0
1/31/2018 22:45,12,69.4,28,64.8,40,66.2,2,0,0
1/31/2018 22:50,17,69.6,32,65,49,66.6,2,0,0
1/31/2018 22:55,18,69.7,34,65.1,52,66.7,2,0,0
1/31/2018 23:00,15,69.5,30,65,45,66.5,2,0,0
1/31/2018 23:05,15,69.5,30,64.9,45,66.4,2,0,0
1/31/2018 23:10,14,69.5,29,65,43,66.5,2,0,0
1/31/2018 23:15,15,68.6,30,64,45,65.5,2,0,0
1/31/2018 23:20,11,69,26,64.4,37,65.8,2,0,0
1/31/2018 23:25,10,69.2,25,64.6,35,65.9,2,0,0
1/31/2018 23:30,19,69.3,35,64.7,54,66.4,2,0,0
1/31/2018 23:35,14,69.5,30,64.9,44,66.3,2,0,0
1/31/2018 23:40,14,69.4,29,64.8,43,66.3,2,0,0
1/31/2018 23:45,15,69.1,31,64.4,46,65.9,2,0,0
1/31/2018 23:50,13,69,28,64.4,41,65.8,2,0,0
1/31/2018 23:55,9,69.2,24,64.5,33,65.8,2,0,0
2/01/2018 0:00,10,69.3,26,64.7,36,66,2,0,0
2/01/2018 0:05,13,69.2,29,64.6,42,66,2,0,0
2/01/2018 0:10,10,69.1,25,64.4,35,65.7,2,0,0
2/01/2018 0:15,11,69,27,64.4,38,65.7,2,0,0
2/01/2018 0:20,11,69.2,27,64.5,38,65.9,2,0,0
2/01/2018 0:25,8,69.4,23,64.8,31,66,2,0,0
2/01/2018 0:30,8,69.4,23,64.8,31,66,2,0,0
2/01/2018 0:35,8,69.3,24,64.7,32,65.8,2,0,0
2/01/2018 0:40,11,69.4,26,64.8,37,66.1,2,0,0
2/01/2018 0:45,7,69.2,22,64.6,29,65.7,2,0,0
2/01/2018 0:50,6,69.3,21,64.7,27,65.7,2,0,0
2/01/2018 0:55,5,69.4,21,64.8,26,65.7,2,0,0
2/01/2018 1:00,9,69.5,24,64.9,33,66.1,2,0,0
2/01/2018 1:05,7,69.3,23,64.7,30,65.8,2,0,0
2/01/2018 1:10,9,69.3,24,64.7,33,65.9,2,0,0
2/01/2018 1:15,8,69.2,23,64.6,31,65.8,2,0,0
2/01/2018 1:20,5,69.4,20,64.8,25,65.7,2,0,0
2/01/2018 1:25,11,69.5,21,64.9,32,66.5,2,0,0
2/01/2018 1:30,6,69.4,21,64.8,27,65.8,2,0,0
2/01/2018 1:35,9,69.3,25,64.7,34,66,2,0,0
2/01/2018 1:40,10,69.5,25,64.9,35,66.2,2,0,0
2/01/2018 1:45,7,69.5,22,64.9,29,66,2,0,0
2/01/2018 1:50,7,69.4,22,64.8,29,65.9,2,0,0
2/01/2018 1:55,9,69.4,19,64.8,28,66.3,2,0,0
2/01/2018 2:00,9,69.6,19,65,28,66.4,2,0,0
2/01/2018 2:05,6,69.5,21,64.9,27,65.9,2,0,0
2/01/2018 2:10,12,69,27,64.4,39,65.8,2,0,0
2/01/2018 2:15,7,69.1,22,64.5,29,65.6,2,0,0
2/01/2018 2:20,11,69.2,21,64.5,32,66.1,2,0,0
2/01/2018 2:25,8,69.2,24,64.6,32,65.8,2,0,0
2/01/2018 2:30,7,69.2,23,64.5,30,65.6,2,0,0
2/01/2018 2:35,8,69.3,24,64.6,32,65.8,2,0,0
2/01/2018 2:40,9,69.4,24,64.8,33,66,2,0,0
2/01/2018 2:45,10,69.4,25,64.7,35,66.1,2,0,0
2/01/2018 2:50,6,69.6,21,65,27,66,2,0,0
2/01/2018 2:55,9,69.5,24,65,33,66.2,2,0,0
2/01/2018 3:00,9,69.5,24,64.9,33,66.2,2,0,0
2/01/2018 3:05,10,69.4,26,64.8,36,66,2,0,0
2/01/2018 3:10,10,69.3,25,64.7,35,66.1,2,0,0
2/01/2018 3:15,9,69.3,24,64.7,33,66,2,0,0
2/01/2018 3:20,9,69.3,24,64.7,33,66,2,0,0
2/01/2018 3:25,12,69.4,28,64.8,40,66.2,2,0,0
2/01/2018 3:30,14,69.5,30,64.9,44,66.3,2,0,0
2/01/2018 3:35,10,69.5,26,64.9,36,66.2,2,0,0
2/01/2018 3:40,9,69.5,25,64.9,34,66.1,2,0,0
2/01/2018 3:45,11,69.5,27,64.9,38,66.2,2,0,0
2/01/2018 3:50,13,68.7,28,64.1,41,65.6,2,0,0
2/01/2018 3:55,17,67.9,33,63.2,50,64.8,2,0,0
2/01/2018 4:00,15,68.7,31,64.1,46,65.6,2,0,0
2/01/2018 4:05,14,68.9,30,64.2,44,65.7,2,0,0
2/01/2018 4:10,17,69,33,64.3,50,65.9,2,0,0
2/01/2018 4:15,20,69.1,36,64.5,56,66.1,2,0,0
2/01/2018 4:20,25,67.3,42,62.6,67,64.3,2,0,0
2/01/2018 4:25,22,68.5,39,63.9,61,65.6,2,0,0
2/01/2018 4:30,25,68.8,41,64.2,66,65.9,2,0,0
2/01/2018 4:35,28,69.3,46,64.7,74,66.4,2,0,0
2/01/2018 4:40,30,70,46,65.4,76,67.2,2,0,0
2/01/2018 4:45,37,70.6,55,66.1,92,67.9,2,0,0
2/01/2018 4:50,41,71,60,66.5,101,68.3,2,0,0
2/01/2018 4:55,34,70.4,52,65.9,86,67.7,2,0,0
2/01/2018 5:00,40,70.7,58,66.2,98,68,2,0,0
2/01/2018 5:05,43,70.6,62,66.1,105,67.9,2,0,0
2/01/2018 5:10,42,71.3,60,66.8,102,68.7,2,0,0
2/01/2018 5:15,50,71.6,69,67.2,119,69,2,0,0
2/01/2018 5:20,52,71.4,73,67,125,68.8,2,0,0
2/01/2018 5:25,57,70.2,78,65.6,135,67.5,2,0,0
2/01/2018 5:30,53,69.6,73,64.9,126,66.9,2,0,0
2/01/2018 5:35,56,69.6,76,65.1,132,67,2,0,0
2/01/2018 5:40,54,70.1,75,65.5,129,67.4,2,0,0
2/01/2018 5:45,67,69.5,90,64.9,157,66.9,2,0,0
2/01/2018 5:50,72,70.4,93,65.9,165,67.8,2,0,0
2/01/2018 5:55,58,70.2,79,65.7,137,67.6,2,0,0
2/01/2018 6:00,56,68.3,77,63.6,133,65.6,2,0,0
2/01/2018 6:05,67,68,88,63.2,155,65.3,2,0,0
2/01/2018 6:10,68,68.4,90,63.6,158,65.7,2,0,0
2/01/2018 6:15,71,68.2,94,63.4,165,65.5,2,0,0
2/01/2018 6:20,63,68.2,84,63.4,147,65.5,2,0,0
2/01/2018 6:25,63,69,85,64.3,148,66.3,2,0,0
2/01/2018 6:30,73,68.8,96,64.1,169,66.1,2,0,0
2/01/2018 6:35,64,67.9,87,63.1,151,65.1,2,0,0
2/01/2018 6:40,68,67.7,90,62.9,158,64.9,2,0,0
2/01/2018 6:45,70,68,93,63.2,163,65.2,2,0,0
2/01/2018 6:50,73,67.4,95,62.6,168,64.7,2,0,0
2/01/2018 6:55,64,68.9,85,64.2,149,66.2,2,0,0
2/01/2018 7:00,72,67.1,95,62.3,167,64.4,2,0,0
2/01/2018 7:05,76,67.6,99,62.7,175,64.8,2,0,0
2/01/2018 7:10,81,67.4,104,62.6,185,64.7,2,0,0
2/01/2018 7:15,82,68.2,104,63.4,186,65.5,2,0,0
2/01/2018 7:20,96,67.4,120,62.5,216,64.7,2,0,0
2/01/2018 7:25,84,66.8,108,61.9,192,64.1,2,0,0
2/01/2018 7:30,84,67.8,106,63,190,65.1,2,0,0
2/01/2018 7:35,97,67,121,62.1,218,64.2,2,0,0
2/01/2018 7:40,80,68.3,103,63.6,183,65.6,2,0,0
2/01/2018 7:45,91,67,116,62.1,207,64.2,2,0,0
2/01/2018 7:50,98,68,124,63.2,222,65.4,2,0,0
2/01/2018 7:55,86,67.5,110,62.6,196,64.8,2,0,0
2/01/2018 8:00,88,66.2,112,61.3,200,63.5,2,0,0
2/01/2018 8:05,78,65,101,59.9,179,62.1,2,0,0
2/01/2018 8:10,75,65.9,98,60.9,173,63.1,2,0,0
2/01/2018 8:15,79,66.5,101,61.6,180,63.7,2,0,0
2/01/2018 8:20,80,65.9,103,61,183,63.2,2,0,0
2/01/2018 8:25,78,66.4,99,61.5,177,63.7,2,0,0
2/01/2018 8:30,79,66.6,101,61.7,180,63.8,2,0,0
2/01/2018 8:35,73,65.7,94,60.8,167,62.9,2,0,0
2/01/2018 8:40,77,66.5,98,61.6,175,63.8,2,0,0
2/01/2018 8:45,81,66.7,104,61.8,185,63.9,2,0,0
2/01/2018 8:50,86,66.9,108,62,194,64.2,2,0,0
2/01/2018 8:55,86,65,108,60.1,194,62.3,2,0,0
2/01/2018 9:00,74,65.2,95,60.3,169,62.4,2,0,0
2/01/2018 9:05,82,66.5,104,61.6,186,63.8,2,0,0
2/01/2018 9:10,86,66.3,108,61.4,194,63.6,2,0,0
2/01/2018 9:15,78,66.4,99,61.5,177,63.7,2,0,0
2/01/2018 9:20,70,66.9,90,62.1,160,64.2,2,0,0
2/01/2018 9:25,81,67,102,62.1,183,64.3,2,0,0
2/01/2018 9:30,73,67.6,94,62.8,167,64.9,2,0,0
2/01/2018 9:35,73,67.5,93,62.7,166,64.8,2,0,0
2/01/2018 9:40,87,66.2,109,61.3,196,63.4,2,0,0
2/01/2018 9:45,81,67.5,101,62.8,182,64.9,2,0,0
2/01/2018 9:50,67,68,88,63.3,155,65.3,2,0,0
2/01/2018 9:55,60,68.9,80,64.2,140,66.2,2,0,0
2/01/2018 10:00,70,67.9,91,63.2,161,65.2,2,0,0
2/01/2018 10:05,73,69,93,64.4,166,66.4,2,0,0
2/01/2018 10:10,59,68.7,79,64,138,66,2,0,0
2/01/2018 10:15,67,69.3,87,64.5,154,66.6,2,0,0
2/01/2018 10:20,61,69.5,81,64.9,142,66.9,2,0,0
2/01/2018 10:25,61,70.4,80,65.9,141,67.8,2,0,0
2/01/2018 10:30,65,69.1,84,64.4,149,66.4,2,0,0
2/01/2018 10:35,52,69.6,71,65,123,66.9,2,0,0
2/01/2018 10:40,53,69.5,71,64.9,124,66.8,2,0,0
2/01/2018 10:45,49,69.9,67,65.3,116,67.3,2,0,0
2/01/2018 10:50,64,70.5,83,66,147,68,2,0,0
2/01/2018 10:55,61,68.9,81,64.3,142,66.3,2,0,0
2/01/2018 11:00,57,68.8,76,64.1,133,66.1,2,0,0
2/01/2018 11:05,62,68.3,81,63.6,143,65.6,2,0,0
2/01/2018 11:10,57,67.6,75,62.9,132,64.9,2,0,0
2/01/2018 11:15,52,67.5,70,62.8,122,64.8,2,0,0
2/01/2018 11:20,59,67.2,77,62.4,136,64.5,2,0,0
2/01/2018 11:25,62,67.5,80,62.9,142,64.9,2,0,0
2/01/2018 11:30,53,68.3,71,63.7,124,65.6,2,0,0
2/01/2018 11:35,54,67.9,73,63.3,127,65.3,2,0,0
2/01/2018 11:40,57,68.3,76,63.8,133,65.7,2,0,0
2/01/2018 11:45,62,67.7,80,63,142,65,2,0,0
2/01/2018 11:50,55,68.1,74,63.4,129,65.4,2,0,0
2/01/2018 11:55,52,69.3,69,64.7,121,66.7,2,0,0
2/01/2018 12:00,56,67.8,50,62,106,65.1,2,0,0
2/01/2018 12:05,56,67.7,51,61.9,107,64.9,2,0,0
2/01/2018 12:10,57,67.8,52,62,109,65,2,0,0
2/01/2018 12:15,58,67.7,53,61.9,111,64.9,2,0,0
2/01/2018 12:20,43,66.8,60,62,103,64,2,0,0
2/01/2018 12:25,50,66.7,69,62,119,64,2,0,0
2/01/2018 12:30,61,67.1,78,62.4,139,64.5,2,0,0
2/01/2018 12:35,50,67.7,67,63.1,117,65.1,2,0,0
2/01/2018 12:40,43,68.6,61,64,104,65.9,2,0,0
2/01/2018 12:45,53,69,70,64.5,123,66.4,2,0,0
2/01/2018 12:50,54,68.8,71,64.2,125,66.2,2,0,0
2/01/2018 12:55,48,69.1,65,64.4,113,66.4,2,0,0
2/01/2018 13:00,46,68.9,64,64.2,110,66.2,2,0,0
2/01/2018 13:05,48,68.2,65,63.6,113,65.6,2,0,0
2/01/2018 13:10,55,69.4,72,64.8,127,66.8,2,0,0
2/01/2018 13:15,49,69.6,67,65.1,116,67,2,0,0
2/01/2018 13:20,54,68.6,72,64,126,66,2,0,0
2/01/2018 13:25,51,68.9,69,64.3,120,66.3,2,0,0
2/01/2018 13:30,48,68.4,66,63.8,114,65.8,2,0,0
2/01/2018 13:35,47,68.4,65,63.8,112,65.7,2,0,0
2/01/2018 13:40,48,69.8,65,65.3,113,67.2,2,0,0
2/01/2018 13:45,52,69.9,71,65.4,123,67.3,2,0,0
2/01/2018 13:50,47,69.8,65,65.3,112,67.2,2,0,0
2/01/2018 13:55,56,70.2,74,65.7,130,67.6,2,0,0
2/01/2018 14:00,44,70.6,61,66.1,105,68,2,0,0
2/01/2018 14:05,51,69.3,69,64.7,120,66.7,2,0,0
2/01/2018 14:10,47,69,65,64.3,112,66.3,2,0,0
2/01/2018 14:15,53,68.6,72,63.9,125,65.9,2,0,0
2/01/2018 14:20,54,68.6,72,63.9,126,66,2,0,0
2/01/2018 14:25,54,69.4,71,64.7,125,66.7,2,0,0
2/01/2018 14:30,54,68.6,72,63.8,126,65.8,2,0,0
2/01/2018 14:35,49,68.7,68,64,117,66,2,0,0
2/01/2018 14:40,54,68.5,72,63.8,126,65.9,2,0,0
2/01/2018 14:45,55,68.1,74,63.4,129,65.4,2,0,0
2/01/2018 14:50,44,68.9,62,64.2,106,66.1,2,0,0
2/01/2018 14:55,51,68.6,69,63.8,120,65.9,2,0,0
2/01/2018 15:00,53,68.4,70,63.7,123,65.7,2,0,0
2/01/2018 15:05,54,68.3,73,63.7,127,65.7,2,0,0
2/01/2018 15:10,53,68.6,72,64,125,66,2,0,0
2/01/2018 15:15,54,69.3,72,64.7,126,66.7,2,0,0
2/01/2018 15:20,53,68.8,71,64.3,124,66.2,2,0,0
2/01/2018 15:25,56,67.5,75,62.8,131,64.8,2,0,0
2/01/2018 15:30,52,68.5,70,63.9,122,65.9,2,0,0
2/01/2018 15:35,62,67.6,81,62.9,143,64.9,2,0,0
2/01/2018 15:40,65,67.7,84,63,149,65,2,0,0
2/01/2018 15:45,62,68.1,81,63.5,143,65.5,2,0,0
2/01/2018 15:50,49,67.9,66,63.3,115,65.3,2,0,0
2/01/2018 15:55,52,68.2,70,63.6,122,65.6,2,0,0
2/01/2018 16:00,56,68.1,75,63.4,131,65.4,2,0,0
2/01/2018 16:05,58,68,76,63.2,134,65.3,2,0,0
2/01/2018 16:10,60,68.4,78,63.8,138,65.8,2,0,0
2/01/2018 16:15,53,68.5,71,63.9,124,65.9,2,0,0
2/01/2018 16:20,58,67.8,77,63.1,135,65.2,2,0,0
2/01/2018 16:25,57,68.4,74,63.8,131,65.8,2,0,0
2/01/2018 16:30,54,68,72,63.3,126,65.3,2,0,0
2/01/2018 16:35,49,68.8,66,64.3,115,66.2,2,0,0
2/01/2018 16:40,53,68.2,70,63.6,123,65.6,2,0,0
2/01/2018 16:45,48,68,65,63.4,113,65.4,2,0,0
2/01/2018 16:50,54,68.6,73,64,127,65.9,2,0,0
2/01/2018 16:55,48,67.8,66,63.3,114,65.2,2,0,0
2/01/2018 17:00,50,68.9,68,64.3,118,66.2,2,0,0
2/01/2018 17:05,49,70.1,67,65.7,116,67.5,2,0,0
2/01/2018 17:10,47,69.4,66,64.9,113,66.8,2,0,0
2/01/2018 17:15,52,70.8,70,66.4,122,68.3,2,0,0
2/01/2018 17:20,50,70.9,69,66.5,119,68.3,2,0,0
2/01/2018 17:25,48,70.9,66,66.6,114,68.4,2,0,0
2/01/2018 17:30,56,71.4,75,67.1,131,68.9,2,0,0
2/01/2018 17:35,52,71.4,70,67,122,68.8,2,0,0
2/01/2018 17:40,47,70.7,64,66.3,111,68.2,2,0,0
2/01/2018 17:45,48,71.3,66,66.9,114,68.7,2,0,0
2/01/2018 17:50,47,70.5,64,66.1,111,67.9,2,0,0
2/01/2018 17:55,43,69.3,61,64.7,104,66.6,2,0,0
2/01/2018 18:00,46,69.4,63,64.8,109,66.8,2,0,0
2/01/2018 18:05,46,69.6,63,65,109,66.9,2,0,0
2/01/2018 18:10,49,69,67,64.5,116,66.4,2,0,0
2/01/2018 18:15,59,68.1,78,63.5,137,65.5,2,0,0
2/01/2018 18:20,50,68.7,67,64.1,117,66.1,2,0,0
2/01/2018 18:25,50,68.5,67,63.9,117,65.9,2,0,0
2/01/2018 18:30,50,68.6,67,63.9,117,65.9,2,0,0
2/01/2018 18:35,47,68.9,64,64.3,111,66.2,2,0,0
2/01/2018 18:40,43,69.5,60,64.9,103,66.8,2,0,0
2/01/2018 18:45,39,69.5,56,65,95,66.9,2,0,0
2/01/2018 18:50,36,69.4,52,64.7,88,66.6,2,0,0
2/01/2018 18:55,37,68.4,55,63.8,92,65.7,2,0,0
2/01/2018 19:00,42,68.4,60,63.7,102,65.7,2,0,0
2/01/2018 19:05,35,69.4,51,64.8,86,66.7,2,0,0
2/01/2018 19:10,39,69.3,55,64.7,94,66.6,2,0,0
2/01/2018 19:15,44,69.6,62,65,106,66.9,2,0,0
2/01/2018 19:20,41,69.2,58,64.5,99,66.5,2,0,0
2/01/2018 19:25,45,69.3,62,64.6,107,66.6,2,0,0
2/01/2018 19:30,46,69.5,63,64.9,109,66.8,2,0,0
2/01/2018 19:35,37,70.5,54,65.9,91,67.8,2,0,0
2/01/2018 19:40,37,70.5,54,66,91,67.9,2,0,0
2/01/2018 19:45,40,69.6,58,65,98,66.9,2,0,0
2/01/2018 19:50,35,69.1,53,64.5,88,66.3,2,0,0
2/01/2018 19:55,31,69.8,48,65.2,79,67,2,0,0
2/01/2018 20:00,36,70.2,53,65.7,89,67.5,2,0,0
2/01/2018 20:05,29,69.6,46,65.1,75,66.8,2,0,0
2/01/2018 20:10,29,69.4,46,64.9,75,66.7,2,0,0
2/01/2018 20:15,39,69.4,56,64.8,95,66.7,2,0,0
2/01/2018 20:20,33,69.6,50,65,83,66.9,2,0,0
2/01/2018 20:25,33,69.9,49,65.4,82,67.2,2,0,0
2/01/2018 20:30,35,69.7,51,65.1,86,67,2,0,0
2/01/2018 20:35,31,70.2,47,65.7,78,67.5,2,0,0
2/01/2018 20:40,43,69.8,61,65.3,104,67.2,2,0,0
2/01/2018 20:45,32,70.3,49,65.7,81,67.5,2,0,0
2/01/2018 20:50,29,70.1,46,65.6,75,67.3,2,0,0
2/01/2018 20:55,27,69.4,43,64.8,70,66.6,2,0,0
2/01/2018 21:00,26,69.7,42,65.2,68,66.9,2,0,0
2/01/2018 21:05,28,69.6,44,65,72,66.8,2,0,0
2/01/2018 21:10,32,69.5,49,64.9,81,66.7,2,0,0
2/01/2018 21:15,29,69.9,45,65.3,74,67.1,2,0,0
2/01/2018 21:20,27,69.8,43,65.2,70,67,2,0,0
2/01/2018 21:25,27,69.6,44,65.1,71,66.8,2,0,0
2/01/2018 21:30,25,69.8,42,65.2,67,66.9,2,0,0
2/01/2018 21:35,22,69.8,39,65.2,61,66.9,2,0,0
2/01/2018 21:40,22,69.3,38,64.7,60,66.4,2,0,0
2/01/2018 21:45,23,69.8,38,65.2,61,66.9,2,0,0
2/01/2018 21:50,27,70,44,65.5,71,67.2,2,0,0
2/01/2018 21:55,26,70,42,65.4,68,67.2,2,0,0
2/01/2018 22:00,23,69,39,64.4,62,66.1,2,0,0
2/01/2018 22:05,24,69.2,39,64.6,63,66.4,2,0,0
2/01/2018 22:10,25,69.4,41,64.8,66,66.6,2,0,0
2/01/2018 22:15,31,69.1,48,64.5,79,66.3,2,0,0
2/01/2018 22:20,24,69.2,40,64.6,64,66.3,2,0,0
2/01/2018 22:25,24,69.3,39,64.7,63,66.5,2,0,0
2/01/2018 22:30,22,69.3,38,64.7,60,66.4,2,0,0
2/01/2018 22:35,24,69.5,40,64.9,64,66.6,2,0,0
2/01/2018 22:40,23,68.2,39,63.5,62,65.3,2,0,0
2/01/2018 22:45,20,68.8,35,64.2,55,65.8,2,0,0
2/01/2018 22:50,15,68.9,30,64.2,45,65.8,2,0,0
2/01/2018 22:55,13,69.1,29,64.4,42,65.9,2,0,0
2/01/2018 23:00,18,69.3,34,64.7,52,66.3,2,0,0
2/01/2018 23:05,16,69.5,31,64.9,47,66.5,2,0,0
2/01/2018 23:10,11,69.5,27,64.9,38,66.2,2,0,0
2/01/2018 23:15,18,69.2,34,64.6,52,66.2,2,0,0
2/01/2018 23:20,14,69.2,30,64.6,44,66.1,2,0,0
2/01/2018 23:25,13,69.3,29,64.7,42,66.1,2,0,0
2/01/2018 23:30,11,69,27,64.4,38,65.7,2,0,0
2/01/2018 23:35,17,69.1,32,64.4,49,66,2,0,0
2/01/2018 23:40,13,69.4,29,64.8,42,66.2,2,0,0
2/01/2018 23:45,13,69.3,28,64.7,41,66.2,2,0,0
2/01/2018 23:50,11,69.3,27,64.7,38,66,2,0,0
2/01/2018 23:55,10,69.4,25,64.8,35,66.1,2,0,0
2/02/2018 0:00,11,69.3,27,64.7,38,66.1,2,0,0
2/02/2018 0:05,10,69.2,25,64.6,35,65.9,2,0,0
2/02/2018 0:10,9,69.3,24,64.7,33,65.9,2,0,0
2/02/2018 0:15,11,69.2,26,64.6,37,66,2,0,0
2/02/2018 0:20,8,69,24,64.4,32,65.6,2,0,0
2/02/2018 0:25,9,68.7,25,64,34,65.3,2,0,0
2/02/2018 0:30,6,68.9,21,64.2,27,65.3,2,0,0
2/02/2018 0:35,8,69,23,64.3,31,65.5,2,0,0
2/02/2018 0:40,8,69.2,23,64.5,31,65.7,2,0,0
2/02/2018 0:45,8,68.7,23,64,31,65.2,2,0,0
2/02/2018 0:50,5,69,21,64.4,26,65.2,2,0,0
2/02/2018 0:55,8,68.9,23,64.3,31,65.5,2,0,0
2/02/2018 1:00,9,69.2,24,64.5,33,65.8,2,0,0
2/02/2018 1:05,6,69.3,22,64.7,28,65.7,2,0,0
2/02/2018 1:10,7,69.3,22,64.7,29,65.8,2,0,0
2/02/2018 1:15,7,69.1,22,64.5,29,65.6,2,0,0
2/02/2018 1:20,7,69,23,64.4,30,65.5,2,0,0
2/02/2018 1:25,7,69.1,22,64.5,29,65.6,2,0,0
2/02/2018 1:30,8,69.1,23,64.4,31,65.6,2,0,0
2/02/2018 1:35,10,69.2,25,64.6,35,65.9,2,0,0
2/02/2018 1:40,9,69.3,25,64.7,34,65.9,2,0,0
2/02/2018 1:45,7,69.3,22,64.7,29,65.8,2,0,0
2/02/2018 1:50,8,69.3,24,64.7,32,65.9,2,0,0
2/02/2018 1:55,6,69.2,22,64.6,28,65.6,2,0,0
2/02/2018 2:00,6,69.3,21,64.7,27,65.7,2,0,0
2/02/2018 2:05,8,69.3,24,64.7,32,65.8,2,0,0
2/02/2018 2:10,10,69.3,25,64.7,35,66,2,0,0
2/02/2018 2:15,10,69.2,26,64.5,36,65.8,2,0,0
2/02/2018 2:20,8,69.2,23,64.6,31,65.8,2,0,0
2/02/2018 2:25,10,68.7,25,64,35,65.4,2,0,0
2/02/2018 2:30,7,68.8,22,64.2,29,65.3,2,0,0
2/02/2018 2:35,8,69,23,64.4,31,65.6,2,0,0
2/02/2018 2:40,8,69.1,23,64.5,31,65.7,2,0,0
2/02/2018 2:45,11,69.3,27,64.7,38,66,2,0,0
2/02/2018 2:50,7,69.5,22,64.9,29,66,2,0,0
2/02/2018 2:55,9,69.3,24,64.7,33,66,2,0,0
2/02/2018 3:00,12,69.3,27,64.7,39,66.1,2,0,0
2/02/2018 3:05,9,69.2,25,64.5,34,65.8,2,0,0
2/02/2018 3:10,13,69.2,28,64.6,41,66.1,2,0,0
2/02/2018 3:15,9,69.2,25,64.6,34,65.8,2,0,0
2/02/2018 3:20,11,69.2,27,64.6,38,65.9,2,0,0
2/02/2018 3:25,11,69.3,27,64.7,38,66.1,2,0,0
2/02/2018 3:30,12,69.3,28,64.7,40,66.1,2,0,0
2/02/2018 3:35,14,69.4,30,64.8,44,66.3,2,0,0
2/02/2018 3:40,10,69.5,25,64.9,35,66.2,2,0,0
2/02/2018 3:45,15,69.5,30,65,45,66.5,2,0,0
2/02/2018 3:50,15,69.5,31,64.9,46,66.4,2,0,0
2/02/2018 3:55,15,69,31,64.3,46,65.9,2,0,0
2/02/2018 4:00,18,69.3,34,64.7,52,66.3,2,0,0
2/02/2018 4:05,14,69.4,30,64.8,44,66.3,2,0,0
2/02/2018 4:10,22,69.6,38,65,60,66.7,2,0,0
2/02/2018 4:15,17,69.6,34,65,51,66.6,2,0,0
2/02/2018 4:20,24,69.3,39,64.7,63,66.4,2,0,0
2/02/2018 4:25,21,69.4,38,64.8,59,66.4,2,0,0
2/02/2018 4:30,28,69.5,45,64.9,73,66.7,2,0,0
2/02/2018 4:35,23,69.7,39,65.1,62,66.8,2,0,0
2/02/2018 4:40,33,69.8,50,65.3,83,67.1,2,0,0
2/02/2018 4:45,34,69.2,52,64.6,86,66.4,2,0,0
2/02/2018 4:50,35,68.6,54,63.9,89,65.7,2,0,0
2/02/2018 4:55,36,69.3,55,64.6,91,66.4,2,0,0
2/02/2018 5:00,36,69.2,54,64.6,90,66.5,2,0,0
2/02/2018 5:05,32,69.6,50,65,82,66.8,2,0,0
2/02/2018 5:10,46,69.2,65,64.5,111,66.4,2,0,0
2/02/2018 5:15,46,69.4,64,64.7,110,66.7,2,0,0
2/02/2018 5:20,55,68.8,74,64.1,129,66.1,2,0,0
2/02/2018 5:25,55,68.8,75,64.1,130,66.1,2,0,0
2/02/2018 5:30,54,68.4,75,63.7,129,65.7,2,0,0
2/02/2018 5:35,54,69.1,74,64.5,128,66.4,2,0,0
2/02/2018 5:40,58,68.5,78,63.9,136,65.9,2,0,0
2/02/2018 5:45,70,69.2,92,64.6,162,66.6,2,0,0
2/02/2018 5:50,56,69.7,77,65,133,67,2,0,0
2/02/2018 5:55,65,69,86,64.4,151,66.4,2,0,0
2/02/2018 6:00,54,69.5,74,64.8,128,66.8,2,0,0
2/02/2018 6:05,52,68.5,72,63.7,124,65.7,2,0,0
2/02/2018 6:10,75,67.9,97,63.1,172,65.2,2,0,0
2/02/2018 6:15,59,67.4,79,62.7,138,64.7,2,0,0
2/02/2018 6:20,58,67.3,80,62.5,138,64.5,2,0,0
2/02/2018 6:25,64,67.3,86,62.5,150,64.6,2,0,0
2/02/2018 6:30,66,68.3,87,63.6,153,65.6,2,0,0
2/02/2018 6:35,71,67.5,93,62.7,164,64.8,2,0,0
2/02/2018 6:40,66,68.1,88,63.3,154,65.4,2,0,0
2/02/2018 6:45,71,68.1,93,63.3,164,65.4,2,0,0
2/02/2018 6:50,62,68.9,83,64.2,145,66.2,2,0,0
2/02/2018 6:55,67,69.6,88,65,155,67,2,0,0
2/02/2018 7:00,58,68.7,79,64.1,137,66,2,0,0
2/02/2018 7:05,59,68.4,80,63.8,139,65.8,2,0,0
2/02/2018 7:10,67,68.8,87,64.2,154,66.2,2,0,0
2/02/2018 7:15,65,68,86,63.3,151,65.3,2,0,0
2/02/2018 7:20,77,68.7,99,64,176,66,2,0,0
2/02/2018 7:25,81,68,105,63.3,186,65.4,2,0,0
2/02/2018 7:30,82,68.5,105,63.8,187,65.8,2,0,0
2/02/2018 7:35,70,68.2,91,63.5,161,65.6,2,0,0
2/02/2018 7:40,80,68.3,102,63.6,182,65.7,2,0,0
2/02/2018 7:45,77,68.2,99,63.5,176,65.6,2,0,0
2/02/2018 7:50,77,68.3,98,63.5,175,65.6,2,0,0
2/02/2018 7:55,82,68.4,105,63.7,187,65.8,2,0,0
2/02/2018 8:00,78,66.5,100,61.6,178,63.8,2,0,0
2/02/2018 8:05,78,66.7,101,61.8,179,63.9,2,0,0
2/02/2018 8:10,86,66.7,109,61.8,195,63.9,2,0,0
2/02/2018 8:15,88,66.8,110,61.9,198,64.1,2,0,0
2/02/2018 8:20,83,67.4,105,62.6,188,64.7,2,0,0
2/02/2018 8:25,80,66.5,102,61.6,182,63.8,2,0,0
2/02/2018 8:30,83,66.6,105,61.7,188,63.8,2,0,0
2/02/2018 8:35,87,66.5,111,61.5,198,63.7,2,0,0
2/02/2018 8:40,78,66.3,100,61.4,178,63.6,2,0,0
2/02/2018 8:45,81,66.5,104,61.6,185,63.7,2,0,0
2/02/2018 8:50,85,66.8,107,61.8,192,64,2,0,0
2/02/2018 8:55,87,66.5,108,61.5,195,63.8,2,0,0
2/02/2018 9:00,76,66.9,96,62,172,64.2,2,0,0
2/02/2018 9:05,71,68,92,63.2,163,65.3,2,0,0
2/02/2018 9:10,74,68,96,63.3,170,65.3,2,0,0
2/02/2018 9:15,71,67.4,92,62.6,163,64.7,2,0,0
2/02/2018 9:20,72,67.6,93,62.8,165,64.9,2,0,0
2/02/2018 9:25,63,67.3,84,62.5,147,64.5,2,0,0
2/02/2018 9:30,71,66.1,92,61.2,163,63.4,2,0,0
2/02/2018 9:35,64,66.9,84,62.1,148,64.1,2,0,0
2/02/2018 9:40,81,66.6,102,61.8,183,63.9,2,0,0
2/02/2018 9:45,61,67.1,80,62.4,141,64.4,2,0,0
2/02/2018 9:50,64,67.9,84,63.2,148,65.2,2,0,0
2/02/2018 9:55,60,67.4,79,62.6,139,64.7,2,0,0
2/02/2018 10:00,70,66.3,89,61.4,159,63.6,2,0,0
2/02/2018 10:05,50,67.3,69,62.6,119,64.6,2,0,0
2/02/2018 10:10,54,67.4,73,62.8,127,64.8,2,0,0
2/02/2018 10:15,54,67.6,73,62.9,127,64.9,2,0,0
2/02/2018 10:20,61,68,81,63.4,142,65.4,2,0,0
2/02/2018 10:25,48,68.3,67,63.7,115,65.6,2,0,0
2/02/2018 10:30,56,67.9,74,63.3,130,65.3,2,0,0
2/02/2018 10:35,52,68.2,70,63.7,122,65.6,2,0,0
2/02/2018 10:40,64,68.1,84,63.4,148,65.4,2,0,0
2/02/2018 10:45,63,68.6,81,64,144,66,2,0,0
2/02/2018 10:50,66,66.8,85,61.9,151,64,2,0,0
2/02/2018 10:55,62,68.4,81,63.7,143,65.8,2,0,0
2/02/2018 11:00,57,68.6,75,64,132,65.9,2,0,0
2/02/2018 11:05,56,69,75,64.5,131,66.4,2,0,0
2/02/2018 11:10,52,68.1,70,63.5,122,65.5,2,0,0
2/02/2018 11:15,65,68,84,63.4,149,65.4,2,0,0
2/02/2018 11:20,65,67.1,84,62.4,149,64.4,2,0,0
2/02/2018 11:25,51,66.8,70,62.1,121,64.1,2,0,0
2/02/2018 11:30,56,68.2,74,63.5,130,65.5,2,0,0
2/02/2018 11:35,54,68.1,72,63.3,126,65.4,2,0,0
2/02/2018 11:40,62,67.8,81,63,143,65.1,2,0,0
2/02/2018 11:45,63,68.7,82,64,145,66,2,0,0
2/02/2018 11:50,62,67.9,80,63.2,142,65.2,2,0,0
2/02/2018 11:55,60,67.7,78,63,138,65,2,0,0
2/02/2018 12:00,49,67.1,67,62.4,116,64.4,2,0,0
2/02/2018 12:05,56,67.6,73,62.9,129,64.9,2,0,0
2/02/2018 12:10,48,67.3,66,62.6,114,64.6,2,0,0
2/02/2018 12:15,56,68.2,74,63.6,130,65.6,2,0,0
2/02/2018 12:20,46,68.1,64,63.4,110,65.4,2,0,0
2/02/2018 12:25,55,68.1,73,63.4,128,65.4,2,0,0
2/02/2018 12:30,54,68.9,72,64.2,126,66.2,2,0,0
2/02/2018 12:35,62,69.5,81,64.9,143,66.9,2,0,0
2/02/2018 12:40,44,69.6,61,65,105,66.9,2,0,0
2/02/2018 12:45,57,68.8,75,64.2,132,66.2,2,0,0
2/02/2018 12:50,45,68.4,63,63.8,108,65.7,2,0,0
2/02/2018 12:55,45,67.6,63,62.9,108,64.8,2,0,0
2/02/2018 13:00,54,68.5,72,63.9,126,65.9,2,0,0
2/02/2018 13:05,48,70.3,65,65.8,113,67.7,2,0,0
2/02/2018 13:10,46,68.6,63,64,109,65.9,2,0,0
2/02/2018 13:15,48,68.1,66,63.5,114,65.4,2,0,0
2/02/2018 13:20,59,69.3,77,64.8,136,66.7,2,0,0
2/02/2018 13:25,51,69.3,69,64.7,120,66.6,2,0,0
2/02/2018 13:30,51,69.9,69,65.3,120,67.3,2,0,0
2/02/2018 13:35,52,70,70,65.5,122,67.4,2,0,0
2/02/2018 13:40,51,69.9,68,65.4,119,67.3,2,0,0
2/02/2018 13:45,52,68.3,70,63.7,122,65.7,2,0,0
2/02/2018 13:50,51,69.3,69,64.8,120,66.7,2,0,0
2/02/2018 13:55,56,68.4,74,63.8,130,65.8,2,0,0
2/02/2018 14:00,45,69.6,62,65,107,66.9,2,0,0
2/02/2018 14:05,48,68.8,66,64.2,114,66.2,2,0,0
2/02/2018 14:10,54,69.3,72,64.8,126,66.7,2,0,0
2/02/2018 14:15,55,69.3,73,64.8,128,66.7,2,0,0
2/02/2018 14:20,60,69,78,64.4,138,66.4,2,0,0
2/02/2018 14:25,54,69.3,72,64.8,126,66.8,2,0,0
2/02/2018 14:30,55,68.7,73,64.1,128,66.1,2,0,0
2/02/2018 14:35,80,68.2,71,62.4,151,65.5,2,0,0
2/02/2018 14:40,82,68.2,73,62.4,155,65.5,2,0,0
2/02/2018 14:45,51,69.6,70,65.1,121,67,2,0,0
2/02/2018 14:50,54,69.7,72,65.2,126,67.2,2,0,0
2/02/2018 14:55,49,70.8,68,66.4,117,68.2,2,0,0
2/02/2018 15:00,56,68.3,75,63.6,131,65.6,2,0,0
2/02/2018 15:05,59,68.3,77,63.7,136,65.7,2,0,0
2/02/2018 15:10,53,69.1,71,64.5,124,66.5,2,0,0
2/02/2018 15:15,54,70,73,65.5,127,67.4,2,0,0
2/02/2018 15:20,55,68.8,74,64.1,129,66.1,2,0,0
2/02/2018 15:25,57,69.4,76,64.8,133,66.8,2,0,0
2/02/2018 15:30,60,69.5,79,64.9,139,66.9,2,0,0
2/02/2018 15:35,54,69,73,64.4,127,66.4,2,0,0
2/02/2018 15:40,59,69.4,79,64.9,138,66.8,2,0,0
2/02/2018 15:45,55,69.6,74,65,129,67,2,0,0
2/02/2018 15:50,49,70.3,66,65.9,115,67.8,2,0,0
2/02/2018 15:55,52,70.1,71,65.7,123,67.6,2,0,0
2/02/2018 16:00,56,69.6,75,65.1,131,67,2,0,0
2/02/2018 16:05,54,70,72,65.6,126,67.5,2,0,0
2/02/2018 16:10,57,69.2,76,64.6,133,66.6,2,0,0
2/02/2018 16:15,63,69.3,81,64.7,144,66.7,2,0,0
2/02/2018 16:20,56,70.2,74,65.7,130,67.6,2,0,0
2/02/2018 16:25,50,70.3,68,65.9,118,67.8,2,0,0
2/02/2018 16:30,61,69.5,79,64.9,140,66.9,2,0,0
2/02/2018 16:35,61,69.5,79,65,140,67,2,0,0
2/02/2018 16:40,49,69.6,67,65.1,116,67,2,0,0
2/02/2018 16:45,54,69.7,72,65.1,126,67.1,2,0,0
2/02/2018 16:50,53,67.8,71,63.1,124,65.1,2,0,0
2/02/2018 16:55,56,68.7,73,64.1,129,66.1,2,0,0
2/02/2018 17:00,44,69,62,64.5,106,66.3,2,0,0
2/02/2018 17:05,36,69.8,53,65.3,89,67.1,2,0,0
2/02/2018 17:10,54,70.8,73,66.4,127,68.3,2,0,0
2/02/2018 17:15,54,69.8,72,65.2,126,67.2,2,0,0
2/02/2018 17:20,46,70,64,65.5,110,67.4,2,0,0
2/02/2018 17:25,55,70.3,73,65.9,128,67.8,2,0,0
2/02/2018 17:30,55,70.6,72,66.3,127,68.2,2,0,0
2/02/2018 17:35,60,69.7,80,65.2,140,67.2,2,0,0
2/02/2018 17:40,61,69.4,80,64.9,141,66.8,2,0,0
2/02/2018 17:45,59,68.7,78,64.1,137,66.1,2,0,0
2/02/2018 17:50,60,68.1,79,63.5,139,65.5,2,0,0
2/02/2018 17:55,59,67.8,77,63,136,65.1,2,0,0
2/02/2018 18:00,48,68.6,65,63.9,113,65.9,2,0,0
2/02/2018 18:05,59,67.7,76,62.9,135,65,2,0,0
2/02/2018 18:10,42,68.4,59,63.6,101,65.6,2,0,0
2/02/2018 18:15,50,68.3,68,63.7,118,65.7,2,0,0
2/02/2018 18:20,45,68.2,62,63.5,107,65.5,2,0,0
2/02/2018 18:25,47,69.6,64,65,111,66.9,2,0,0
2/02/2018 18:30,43,68.8,60,64.1,103,66.1,2,0,0
2/02/2018 18:35,47,67.9,65,63.1,112,65.1,2,0,0
2/02/2018 18:40,48,68.5,65,63.8,113,65.8,2,0,0
2/02/2018 18:45,52,68.6,69,63.9,121,65.9,2,0,0
2/02/2018 18:50,46,69.1,63,64.5,109,66.4,2,0,0
2/02/2018 18:55,35,68.7,52,64,87,65.9,2,0,0
2/02/2018 19:00,41,69.2,58,64.6,99,66.5,2,0,0
2/02/2018 19:05,37,68.6,54,64,91,65.9,2,0,0
2/02/2018 19:10,43,68.9,62,64.3,105,66.2,2,0,0
2/02/2018 19:15,38,69.6,55,65.1,93,66.9,2,0,0
2/02/2018 19:20,39,68.6,56,64,95,65.9,2,0,0
2/02/2018 19:25,48,69,66,64.3,114,66.3,2,0,0
2/02/2018 19:30,46,69.5,64,64.9,110,66.8,2,0,0
2/02/2018 19:35,47,70.4,65,65.9,112,67.8,2,0,0
2/02/2018 19:40,46,70.3,64,65.8,110,67.7,2,0,0
2/02/2018 19:45,49,70.1,66,65.6,115,67.6,2,0,0
2/02/2018 19:50,35,69.8,52,65.3,87,67.1,2,0,0
2/02/2018 19:55,48,69.9,66,65.3,114,67.2,2,0,0
2/02/2018 20:00,42,69.1,59,64.5,101,66.4,2,0,0
2/02/2018 20:05,55,68.3,73,63.7,128,65.7,2,0,0
2/02/2018 20:10,43,68.7,60,64,103,66,2,0,0
2/02/2018 20:15,43,69.6,60,65,103,67,2,0,0
2/02/2018 20:20,33,68.9,50,64.2,83,66.1,2,0,0
2/02/2018 20:25,37,69.6,53,65,90,66.9,2,0,0
2/02/2018 20:30,41,69.7,59,65.1,100,67,2,0,0
2/02/2018 20:35,36,69.2,53,64.6,89,66.4,2,0,0
2/02/2018 20:40,43,70.1,60,65.5,103,67.4,2,0,0
2/02/2018 20:45,33,70,49,65.5,82,67.3,2,0,0
2/02/2018 20:50,23,69.6,39,65,62,66.7,2,0,0
2/02/2018 20:55,28,69.8,43,65.2,71,67,2,0,0
2/02/2018 21:00,25,69.7,41,65.2,66,66.9,2,0,0
2/02/2018 21:05,26,69.5,42,65,68,66.7,2,0,0
2/02/2018 21:10,31,68.6,48,63.8,79,65.7,2,0,0
2/02/2018 21:15,31,68.8,48,64.1,79,66,2,0,0
2/02/2018 21:20,32,67.6,48,62.9,80,64.8,2,0,0
2/02/2018 21:25,32,68.1,48,63.4,80,65.3,2,0,0
2/02/2018 21:30,36,68.5,53,63.9,89,65.8,2,0,0
2/02/2018 21:35,28,68.9,45,64.2,73,66,2,0,0
2/02/2018 21:40,28,69.1,44,64.4,72,66.2,2,0,0
2/02/2018 21:45,27,69.1,43,64.4,70,66.2,2,0,0
2/02/2018 21:50,34,69.3,50,64.7,84,66.6,2,0,0
2/02/2018 21:55,34,69.6,52,65,86,66.8,2,0,0
2/02/2018 22:00,32,69.3,48,64.7,80,66.5,2,0,0
2/02/2018 22:05,25,69.1,42,64.5,67,66.2,2,0,0
2/02/2018 22:10,33,68.3,49,63.7,82,65.5,2,0,0
2/02/2018 22:15,25,68.8,40,64.1,65,65.9,2,0,0
2/02/2018 22:20,27,68.8,43,64.1,70,65.9,2,0,0
2/02/2018 22:25,31,68.5,47,63.9,78,65.7,2,0,0
2/02/2018 22:30,25,68.7,41,64.1,66,65.8,2,0,0
2/02/2018 22:35,36,69.2,52,64.6,88,66.5,2,0,0
2/02/2018 22:40,27,69.1,43,64.4,70,66.2,2,0,0
2/02/2018 22:45,22,69.5,38,64.9,60,66.5,2,0,0
2/02/2018 22:50,21,69.4,37,64.8,58,66.5,2,0,0
2/02/2018 22:55,22,68.9,38,64.2,60,65.9,2,0,0
2/02/2018 23:00,19,69.3,35,64.7,54,66.3,2,0,0
2/02/2018 23:05,17,69.4,32,64.8,49,66.4,2,0,0
2/02/2018 23:10,21,69,37,64.4,58,66,2,0,0
2/02/2018 23:15,19,69.1,34,64.4,53,66.1,2,0,0
2/02/2018 23:20,18,68.6,33,64,51,65.6,2,0,0
2/02/2018 23:25,19,68.5,34,63.9,53,65.5,2,0,0
2/02/2018 23:30,19,68.9,35,64.2,54,65.8,2,0,0
2/02/2018 23:35,16,69,32,64.4,48,65.9,2,0,0
2/02/2018 23:40,21,68.6,36,63.9,57,65.7,2,0,0
2/02/2018 23:45,14,69,29,64.3,43,65.8,2,0,0
2/02/2018 23:50,16,69.3,32,64.7,48,66.2,2,0,0
2/02/2018 23:55,16,69.3,32,64.7,48,66.2,2,0,0
2/03/2018 0:00,15,69.3,31,64.7,46,66.2,2,0,0
2/03/2018 0:05,15,69.4,30,64.8,45,66.3,2,0,0
2/03/2018 0:10,14,69.4,30,64.8,44,66.2,2,0,0
2/03/2018 0:15,13,69.4,28,64.8,41,66.3,2,0,0
2/03/2018 0:20,15,69,31,64.4,46,65.9,2,0,0
2/03/2018 0:25,12,68.9,28,64.3,40,65.7,2,0,0
2/03/2018 0:30,12,68.9,27,64.2,39,65.7,2,0,0
2/03/2018 0:35,12,69.1,27,64.5,39,65.9,2,0,0
2/03/2018 0:40,11,69.2,26,64.6,37,66,2,0,0
2/03/2018 0:45,13,69.3,28,64.7,41,66.2,2,0,0
2/03/2018 0:50,10,69.4,25,64.8,35,66.1,2,0,0
2/03/2018 0:55,15,69.2,30,64.6,45,66.1,2,0,0
2/03/2018 1:00,10,69.3,25,64.7,35,66,2,0,0
2/03/2018 1:05,11,69.4,27,64.8,38,66.1,2,0,0
2/03/2018 1:10,9,69.4,24,64.8,33,66,2,0,0
2/03/2018 1:15,8,69.3,23,64.7,31,65.9,2,0,0
2/03/2018 1:20,9,69.2,24,64.5,33,65.8,2,0,0
2/03/2018 1:25,9,69.3,24,64.7,33,66,2,0,0
2/03/2018 1:30,11,69.4,26,64.8,37,66.1,2,0,0
2/03/2018 1:35,9,69.3,25,64.7,34,65.9,2,0,0
2/03/2018 1:40,12,69.4,27,64.8,39,66.3,2,0,0
2/03/2018 1:45,7,69.4,22,64.8,29,65.9,2,0,0
2/03/2018 1:50,7,69.5,22,64.9,29,66,2,0,0
2/03/2018 1:55,9,69.5,24,64.9,33,66.2,2,0,0
2/03/2018 2:00,10,69.5,25,65,35,66.3,2,0,0
2/03/2018 2:05,8,69.4,24,64.8,32,66,2,0,0
2/03/2018 2:10,12,69.5,27,64.9,39,66.3,2,0,0
2/03/2018 2:15,8,69.4,24,64.8,32,65.9,2,0,0
2/03/2018 2:20,9,69.4,24,64.8,33,66.1,2,0,0
2/03/2018 2:25,8,69.4,23,64.8,31,66,2,0,0
2/03/2018 2:30,15,69.5,22,64.9,37,66.8,2,0,0
2/03/2018 2:35,6,69.4,21,64.8,27,65.9,2,0,0
2/03/2018 2:40,9,69.4,25,64.8,34,66,2,0,0
2/03/2018 2:45,9,69.2,24,64.5,33,65.8,2,0,0
2/03/2018 2:50,7,69.2,22,64.5,29,65.7,2,0,0
2/03/2018 2:55,9,69,24,64.4,33,65.7,2,0,0
2/03/2018 3:00,7,69.2,23,64.6,30,65.7,2,0,0
2/03/2018 3:05,9,69.3,24,64.7,33,66,2,0,0
2/03/2018 3:10,9,69.3,24,64.7,33,65.9,2,0,0
2/03/2018 3:15,7,69.3,22,64.7,29,65.8,2,0,0
2/03/2018 3:20,6,69.3,21,64.7,27,65.7,2,0,0
2/03/2018 3:25,9,69.4,24,64.8,33,66.1,2,0,0
2/03/2018 3:30,9,69.4,24,64.8,33,66.1,2,0,0
2/03/2018 3:35,7,69.2,22,64.6,29,65.7,2,0,0
2/03/2018 3:40,9,69.2,25,64.6,34,65.8,2,0,0
2/03/2018 3:45,11,69.1,26,64.4,37,65.8,2,0,0
2/03/2018 3:50,8,69.3,23,64.7,31,65.9,2,0,0
2/03/2018 3:55,7,69.3,22,64.7,29,65.8,2,0,0
2/03/2018 4:00,9,69.4,24,64.7,33,66,2,0,0
2/03/2018 4:05,15,69.2,30,64.6,45,66.2,2,0,0
2/03/2018 4:10,8,69.3,24,64.7,32,65.8,2,0,0
2/03/2018 4:15,10,69.3,26,64.7,36,65.9,2,0,0
2/03/2018 4:20,14,69.3,29,64.7,43,66.2,2,0,0
2/03/2018 4:25,14,69.3,29,64.7,43,66.2,2,0,0
2/03/2018 4:30,14,69.4,29,64.8,43,66.3,2,0,0
2/03/2018 4:35,14,69.4,30,64.8,44,66.3,2,0,0
2/03/2018 4:40,18,69.4,34,64.8,52,66.4,2,0,0
2/03/2018 4:45,20,69.4,36,64.8,56,66.4,2,0,0
2/03/2018 4:50,15,68.9,31,64.3,46,65.8,2,0,0
2/03/2018 4:55,15,68.9,30,64.3,45,65.8,2,0,0
2/03/2018 5:00,15,69,31,64.4,46,65.9,2,0,0
2/03/2018 5:05,15,69.3,30,64.7,45,66.2,2,0,0
2/03/2018 5:10,12,69.4,28,64.8,40,66.2,2,0,0
2/03/2018 5:15,17,69.5,33,64.9,50,66.5,2,0,0
2/03/2018 5:20,14,69,29,64.4,43,65.9,2,0,0
2/03/2018 5:25,17,69.2,33,64.6,50,66.1,2,0,0
2/03/2018 5:30,19,69.3,36,64.7,55,66.3,2,0,0
2/03/2018 5:35,18,69.1,34,64.5,52,66.1,2,0,0
2/03/2018 5:40,20,69.4,36,64.8,56,66.4,2,0,0
2/03/2018 5:45,19,68.4,34,63.7,53,65.4,2,0,0
2/03/2018 5:50,20,68.5,36,63.9,56,65.6,2,0,0
2/03/2018 5:55,18,69.3,34,64.7,52,66.3,2,0,0
2/03/2018 6:00,21,69.6,37,65,58,66.6,2,0,0
2/03/2018 6:05,19,69.4,35,64.8,54,66.4,2,0,0
2/03/2018 6:10,23,69.1,40,64.5,63,66.2,2,0,0
2/03/2018 6:15,20,69.3,37,64.7,57,66.3,2,0,0
2/03/2018 6:20,25,69.3,42,64.7,67,66.4,2,0,0
2/03/2018 6:25,24,69,41,64.4,65,66.1,2,0,0
2/03/2018 6:30,21,68.2,38,63.5,59,65.2,2,0,0
2/03/2018 6:35,26,69.1,43,64.5,69,66.2,2,0,0
2/03/2018 6:40,27,68.9,44,64.3,71,66.1,2,0,0
2/03/2018 6:45,28,68.9,44,64.2,72,66,2,0,0
2/03/2018 6:50,28,69.1,44,64.5,72,66.3,2,0,0
2/03/2018 6:55,29,69.5,46,64.9,75,66.6,2,0,0
2/03/2018 7:00,28,68.8,45,64.1,73,65.9,2,0,0
2/03/2018 7:05,26,69.3,42,64.6,68,66.4,2,0,0
2/03/2018 7:10,28,69.1,45,64.4,73,66.2,2,0,0
2/03/2018 7:15,27,69.4,43,64.8,70,66.6,2,0,0
2/03/2018 7:20,30,68.6,47,63.9,77,65.8,2,0,0
2/03/2018 7:25,32,68.7,49,64.1,81,65.9,2,0,0
2/03/2018 7:30,35,68,52,63.3,87,65.2,2,0,0
2/03/2018 7:35,36,67.3,53,62.6,89,64.5,2,0,0
2/03/2018 7:40,45,68.9,62,64.2,107,66.2,2,0,0
2/03/2018 7:45,36,69.7,54,65.1,90,67,2,0,0
2/03/2018 7:50,41,69.7,59,65.1,100,67,2,0,0
2/03/2018 7:55,36,70.1,52,65.6,88,67.4,2,0,0
2/03/2018 8:00,34,69.9,51,65.4,85,67.2,2,0,0
2/03/2018 8:05,44,68.3,61,63.6,105,65.6,2,0,0
2/03/2018 8:10,40,68.6,58,64,98,65.9,2,0,0
2/03/2018 8:15,46,68.8,64,64.2,110,66.1,2,0,0
2/03/2018 8:20,39,68.6,55,63.9,94,65.8,2,0,0
2/03/2018 8:25,44,68.8,61,64.2,105,66.2,2,0,0
2/03/2018 8:30,51,68.4,68,63.8,119,65.8,2,0,0
2/03/2018 8:35,50,69,69,64.4,119,66.3,2,0,0
2/03/2018 8:40,60,67.9,80,63.3,140,65.3,2,0,0
2/03/2018 8:45,55,68.3,74,63.6,129,65.6,2,0,0
2/03/2018 8:50,64,68.7,83,64.1,147,66.1,2,0,0
2/03/2018 8:55,59,69.3,77,64.7,136,66.7,2,0,0
2/03/2018 9:00,59,68.5,77,63.8,136,65.8,2,0,0
2/03/2018 9:05,57,68.8,76,64.1,133,66.1,2,0,0
2/03/2018 9:10,58,68.1,77,63.3,135,65.4,2,0,0
2/03/2018 9:15,63,68.7,82,64.1,145,66.1,2,0,0
2/03/2018 9:20,59,69,77,64.4,136,66.4,2,0,0
2/03/2018 9:25,67,68.6,86,64,153,66,2,0,0
2/03/2018 9:30,54,68.4,73,63.7,127,65.7,2,0,0
2/03/2018 9:35,72,68.9,92,64.3,164,66.3,2,0,0
2/03/2018 9:40,84,67.9,105,63.1,189,65.3,2,0,0
2/03/2018 9:45,82,68.4,102,63.7,184,65.8,2,0,0
2/03/2018 9:50,83,68.8,104,64.1,187,66.2,2,0,0
2/03/2018 9:55,81,68.6,101,64,182,66,2,0,0
2/03/2018 10:00,67,68.8,87,64.1,154,66.1,2,0,0
2/03/2018 10:05,79,67.4,100,62.6,179,64.7,2,0,0
2/03/2018 10:10,72,67.9,92,63.2,164,65.3,2,0,0
2/03/2018 10:15,83,68,104,63.2,187,65.3,2,0,0
2/03/2018 10:20,69,68,89,63.3,158,65.3,2,0,0
2/03/2018 10:25,76,67.6,97,62.9,173,65,2,0,0
2/03/2018 10:30,79,67.7,100,62.9,179,65,2,0,0
2/03/2018 10:35,78,68.1,99,63.4,177,65.5,2,0,0
2/03/2018 10:40,71,68.7,91,64.1,162,66.1,2,0,0
2/03/2018 10:45,79,68.7,100,64,179,66.1,2,0,0
2/03/2018 10:50,78,68.4,98,63.7,176,65.8,2,0,0
2/03/2018 10:55,75,68.8,96,64.1,171,66.1,2,0,0
2/03/2018 11:00,76,67.3,97,62.5,173,64.6,2,0,0
2/03/2018 11:05,85,67.3,107,62.5,192,64.6,2,0,0
2/03/2018 11:10,93,66.7,114,61.9,207,64.1,2,0,0
2/03/2018 11:15,103,67.3,126,62.4,229,64.6,2,0,0
2/03/2018 11:20,85,68.1,106,63.3,191,65.4,2,0,0
2/03/2018 11:25,67,67.5,88,62.8,155,64.8,2,0,0
2/03/2018 11:30,79,68.3,100,63.7,179,65.7,2,0,0
2/03/2018 11:35,70,68.8,91,64.1,161,66.1,2,0,0
2/03/2018 11:40,71,68.8,90,64.2,161,66.2,2,0,0
2/03/2018 11:45,69,67.4,89,62.6,158,64.7,2,0,0
2/03/2018 11:50,73,68.3,94,63.6,167,65.7,2,0,0
2/03/2018 11:55,74,68.4,94,63.6,168,65.7,2,0,0
2/03/2018 12:00,81,67.8,103,63,184,65.1,2,0,0
2/03/2018 12:05,78,67.9,98,63.2,176,65.3,2,0,0
2/03/2018 12:10,75,68.2,95,63.5,170,65.5,2,0,0
2/03/2018 12:15,79,68.4,99,63.8,178,65.8,2,0,0
2/03/2018 12:20,70,68.3,90,63.6,160,65.6,2,0,0
2/03/2018 12:25,69,68.4,88,63.7,157,65.8,2,0,0
2/03/2018 12:30,72,68.6,92,64,164,66,2,0,0
2/03/2018 12:35,70,68.1,91,63.5,161,65.5,2,0,0
2/03/2018 12:40,69,67.9,89,63.1,158,65.2,2,0,0
2/03/2018 12:45,79,68.6,98,64,177,66.1,2,0,0
2/03/2018 12:50,63,68.7,83,64,146,66,2,0,0
2/03/2018 12:55,80,67.5,102,62.8,182,64.9,2,0,0
2/03/2018 13:00,69,67.7,89,62.9,158,65,2,0,0
2/03/2018 13:05,74,67.5,94,62.7,168,64.8,2,0,0
2/03/2018 13:10,64,67.3,84,62.4,148,64.5,2,0,0
2/03/2018 13:15,71,66.9,91,62,162,64.2,2,0,0
2/03/2018 13:20,75,68,95,63.2,170,65.3,2,0,0
2/03/2018 13:25,70,68.9,89,64.2,159,66.3,2,0,0
2/03/2018 13:30,63,68.7,81,64,144,66.1,2,0,0
2/03/2018 13:35,65,68.9,85,64.2,150,66.3,2,0,0
2/03/2018 13:40,73,68.3,93,63.6,166,65.7,2,0,0
2/03/2018 13:45,67,69.5,87,64.9,154,66.9,2,0,0
2/03/2018 13:50,67,69.6,86,65,153,67,2,0,0
2/03/2018 13:55,66,69.6,85,65.1,151,67.1,2,0,0
2/03/2018 14:00,70,68.7,90,64.1,160,66.1,2,0,0
2/03/2018 14:05,61,69,80,64.5,141,66.4,2,0,0
2/03/2018 14:10,70,69.3,89,64.8,159,66.8,2,0,0
2/03/2018 14:15,63,69.7,83,65.2,146,67.1,2,0,0
2/03/2018 14:20,65,69.2,85,64.6,150,66.6,2,0,0
2/03/2018 14:25,69,69,88,64.4,157,66.4,2,0,0
2/03/2018 14:30,68,68.8,87,64.2,155,66.2,2,0,0
2/03/2018 14:35,64,68.9,83,64.4,147,66.4,2,0,0
2/03/2018 14:40,68,69.6,87,65.1,155,67.1,2,0,0
2/03/2018 14:45,64,70,83,65.5,147,67.5,2,0,0
2/03/2018 14:50,63,69.8,82,65.3,145,67.3,2,0,0
2/03/2018 14:55,64,69.9,83,65.4,147,67.4,2,0,0
2/03/2018 15:00,67,69.9,87,65.4,154,67.4,2,0,0
2/03/2018 15:05,63,69.9,80,65.5,143,67.4,2,0,0
2/03/2018 15:10,65,69.5,85,64.9,150,66.9,2,0,0
2/03/2018 15:15,72,68.6,91,64,163,66.1,2,0,0
2/03/2018 15:20,54,68.7,72,64.1,126,66.1,2,0,0
2/03/2018 15:25,52,68.7,71,64,123,66,2,0,0
2/03/2018 15:30,59,69.7,78,65.1,137,67.1,2,0,0
2/03/2018 15:35,60,69.5,78,65,138,66.9,2,0,0
2/03/2018 15:40,61,69.6,79,65.1,140,67.1,2,0,0
2/03/2018 15:45,60,69.2,79,64.7,139,66.6,2,0,0
2/03/2018 15:50,60,69.5,79,65,139,67,2,0,0
2/03/2018 15:55,54,70,73,65.5,127,67.4,2,0,0
2/03/2018 16:00,65,69.4,84,64.9,149,66.8,2,0,0
2/03/2018 16:05,60,69.7,78,65.2,138,67.2,2,0,0
2/03/2018 16:10,58,69.4,77,64.8,135,66.8,2,0,0
2/03/2018 16:15,55,69.4,74,64.8,129,66.8,2,0,0
2/03/2018 16:20,55,69.7,73,65.2,128,67.1,2,0,0
2/03/2018 16:25,65,69.5,83,65,148,67,2,0,0
2/03/2018 16:30,56,68.8,74,64.3,130,66.2,2,0,0
2/03/2018 16:35,65,67.8,84,63.2,149,65.2,2,0,0
2/03/2018 16:40,56,67.9,74,63.2,130,65.2,2,0,0
2/03/2018 16:45,63,68.3,82,63.7,145,65.7,2,0,0
2/03/2018 16:50,56,68.6,74,64,130,65.9,2,0,0
2/03/2018 16:55,58,69.5,76,65,134,67,2,0,0
2/03/2018 17:00,62,68.6,81,64,143,66,2,0,0
2/03/2018 17:05,51,69.3,69,64.7,120,66.7,2,0,0
2/03/2018 17:10,52,69.7,71,65.1,123,67,2,0,0
2/03/2018 17:15,55,69.9,73,65.3,128,67.3,2,0,0
2/03/2018 17:20,65,69.9,83,65.3,148,67.4,2,0,0
2/03/2018 17:25,61,70.5,80,65.9,141,67.9,2,0,0
2/03/2018 17:30,50,71.3,68,66.9,118,68.8,2,0,0
2/03/2018 17:35,66,70.7,85,66.2,151,68.1,2,0,0
2/03/2018 17:40,57,70.5,76,66.1,133,68,2,0,0
2/03/2018 17:45,60,69.5,79,64.9,139,66.9,2,0,0
2/03/2018 17:50,55,69.9,73,65.4,128,67.3,2,0,0
2/03/2018 17:55,58,69.8,77,65.2,135,67.2,2,0,0
2/03/2018 18:00,61,69.3,80,64.7,141,66.7,2,0,0
2/03/2018 18:05,49,69.1,67,64.5,116,66.4,2,0,0
2/03/2018 18:10,54,68.7,73,64,127,66,2,0,0
2/03/2018 18:15,54,68.6,73,64,127,66,2,0,0
2/03/2018 18:20,47,68.7,64,64.1,111,66.1,2,0,0
2/03/2018 18:25,47,69.2,65,64.6,112,66.5,2,0,0
2/03/2018 18:30,48,69.6,66,65,114,66.9,2,0,0
2/03/2018 18:35,47,69.7,64,65.1,111,67,2,0,0
2/03/2018 18:40,47,69.3,64,64.8,111,66.7,2,0,0
2/03/2018 18:45,42,69,59,64.4,101,66.3,2,0,0
2/03/2018 18:50,39,69,55,64.4,94,66.3,2,0,0
2/03/2018 18:55,53,68.6,71,63.9,124,65.9,2,0,0
2/03/2018 19:00,43,69.1,60,64.5,103,66.4,2,0,0
2/03/2018 19:05,50,69.8,67,65.2,117,67.2,2,0,0
2/03/2018 19:10,49,70.3,66,65.8,115,67.7,2,0,0
2/03/2018 19:15,43,69.7,60,65.2,103,67.1,2,0,0
2/03/2018 19:20,45,69.4,61,64.8,106,66.8,2,0,0
2/03/2018 19:25,39,69.3,56,64.7,95,66.6,2,0,0
2/03/2018 19:30,39,69.1,56,64.5,95,66.4,2,0,0
2/03/2018 19:35,40,69.7,57,65.2,97,67,2,0,0
2/03/2018 19:40,42,70,58,65.5,100,67.4,2,0,0
2/03/2018 19:45,42,69.5,58,65,100,66.9,2,0,0
2/03/2018 19:50,35,68.9,51,64.3,86,66.2,2,0,0
2/03/2018 19:55,39,69.4,56,64.8,95,66.7,2,0,0
2/03/2018 20:00,42,69.8,59,65.2,101,67.1,2,0,0
2/03/2018 20:05,30,69.6,46,65,76,66.8,2,0,0
2/03/2018 20:10,37,69.2,54,64.6,91,66.5,2,0,0
2/03/2018 20:15,31,69.2,48,64.6,79,66.4,2,0,0
2/03/2018 20:20,37,69.3,53,64.7,90,66.6,2,0,0
2/03/2018 20:25,33,68.8,49,64.2,82,66.1,2,0,0
2/03/2018 20:30,32,69,48,64.4,80,66.3,2,0,0
2/03/2018 20:35,40,69.5,56,65,96,66.9,2,0,0
2/03/2018 20:40,29,69,44,64.3,73,66.2,2,0,0
2/03/2018 20:45,32,68.7,47,64.1,79,66,2,0,0
2/03/2018 20:50,36,69.3,52,64.7,88,66.6,2,0,0
2/03/2018 20:55,32,69.6,47,65,79,66.9,2,0,0
2/03/2018 21:00,26,69.6,41,65,67,66.8,2,0,0
2/03/2018 21:05,36,69.5,53,64.9,89,66.8,2,0,0
2/03/2018 21:10,34,69.9,51,65.3,85,67.1,2,0,0
2/03/2018 21:15,33,69.6,49,65,82,66.9,2,0,0
2/03/2018 21:20,32,69.8,49,65.2,81,67,2,0,0
2/03/2018 21:25,39,69.9,55,65.3,94,67.2,2,0,0
2/03/2018 21:30,34,69.5,50,64.9,84,66.7,2,0,0
2/03/2018 21:35,36,69.2,52,64.5,88,66.4,2,0,0
2/03/2018 21:40,34,69.4,51,64.8,85,66.6,2,0,0
2/03/2018 21:45,39,68.9,55,64.3,94,66.2,2,0,0
2/03/2018 21:50,29,69.2,45,64.6,74,66.4,2,0,0
2/03/2018 21:55,31,69.5,48,65,79,66.7,2,0,0
2/03/2018 22:00,37,68.9,53,64.2,90,66.1,2,0,0
2/03/2018 22:05,31,68.9,47,64.3,78,66.1,2,0,0
2/03/2018 22:10,29,69.2,45,64.6,74,66.4,2,0,0
2/03/2018 22:15,32,68.7,49,64,81,65.9,2,0,0
2/03/2018 22:20,29,69,46,64.4,75,66.2,2,0,0
2/03/2018 22:25,34,68.9,51,64.3,85,66.2,2,0,0
2/03/2018 22:30,32,69.1,47,64.5,79,66.4,2,0,0
2/03/2018 22:35,23,69.1,39,64.4,62,66.2,2,0,0
2/03/2018 22:40,24,69.4,39,64.8,63,66.5,2,0,0
2/03/2018 22:45,22,69.4,38,64.8,60,66.5,2,0,0
2/03/2018 22:50,21,68.8,37,64.2,58,65.9,2,0,0
2/03/2018 22:55,21,69.2,37,64.5,58,66.2,2,0,0
2/03/2018 23:00,22,69.3,38,64.7,60,66.4,2,0,0
2/03/2018 23:05,22,69.4,37,64.8,59,66.6,2,0,0
2/03/2018 23:10,19,68.9,35,64.3,54,65.9,2,0,0
2/03/2018 23:15,22,69,38,64.4,60,66.1,2,0,0
2/03/2018 23:20,19,69.3,34,64.7,53,66.4,2,0,0
2/03/2018 23:25,22,69.6,37,65,59,66.7,2,0,0
2/03/2018 23:30,19,69.6,35,65,54,66.6,2,0,0
2/03/2018 23:35,25,69.7,41,65.1,66,66.8,2,0,0
2/03/2018 23:40,16,69.5,32,64.9,48,66.4,2,0,0
2/03/2018 23:45,21,69.7,37,65.1,58,66.7,2,0,0
2/03/2018 23:50,13,69.4,28,64.8,41,66.3,2,0,0
2/03/2018 23:55,18,69.5,33,64.9,51,66.5,2,0,0
2/04/2018 0:00,16,69.3,32,64.7,48,66.3,2,0,0
2/04/2018 0:05,15,69.4,30,64.8,45,66.3,2,0,0
2/04/2018 0:10,17,69.6,32,65,49,66.6,2,0,0
2/04/2018 0:15,16,69.3,31,64.7,47,66.3,2,0,0
2/04/2018 0:20,17,69.3,33,64.7,50,66.3,2,0,0
2/04/2018 0:25,13,69.4,28,64.8,41,66.3,2,0,0
2/04/2018 0:30,13,69.4,28,64.8,41,66.3,2,0,0
2/04/2018 0:35,13,69.4,28,64.8,41,66.3,2,0,0
2/04/2018 0:40,12,69.4,27,64.8,39,66.2,2,0,0
2/04/2018 0:45,13,69.5,29,64.9,42,66.3,2,0,0
2/04/2018 0:50,13,69.4,28,64.8,41,66.2,2,0,0
2/04/2018 0:55,12,69.4,28,64.8,40,66.2,2,0,0
2/04/2018 1:00,12,69.3,27,64.7,39,66.1,2,0,0
2/04/2018 1:05,11,69.3,26,64.7,37,66.1,2,0,0
2/04/2018 1:10,9,69.3,24,64.7,33,65.9,2,0,0
2/04/2018 1:15,11,69.1,26,64.5,37,65.8,2,0,0
2/04/2018 1:20,7,69.2,22,64.6,29,65.7,2,0,0
2/04/2018 1:25,11,69.3,26,64.7,37,66.1,2,0,0
2/04/2018 1:30,10,69.2,25,64.6,35,65.9,2,0,0
2/04/2018 1:35,8,69.3,23,64.7,31,65.9,2,0,0
2/04/2018 1:40,13,69.2,21,64.6,34,66.3,2,0,0
2/04/2018 1:45,13,69.1,29,64.5,42,65.9,2,0,0
2/04/2018 1:50,8,69.2,23,64.6,31,65.8,2,0,0
2/04/2018 1:55,9,69.2,24,64.5,33,65.8,2,0,0
2/04/2018 2:00,9,69.3,24,64.7,33,65.9,2,0,0
2/04/2018 2:05,8,69.3,23,64.7,31,65.9,2,0,0
2/04/2018 2:10,12,69.3,27,64.7,39,66.1,2,0,0
2/04/2018 2:15,10,69.2,26,64.6,36,65.9,2,0,0
2/04/2018 2:20,16,69.2,23,64.6,39,66.5,2,0,0
2/04/2018 2:25,12,69,27,64.4,39,65.8,2,0,0
2/04/2018 2:30,10,69,25,64.4,35,65.7,2,0,0
2/04/2018 2:35,8,69.2,23,64.5,31,65.7,2,0,0
2/04/2018 2:40,8,69.3,23,64.7,31,65.8,2,0,0
2/04/2018 2:45,6,69.3,21,64.7,27,65.7,2,0,0
2/04/2018 2:50,8,69.3,23,64.7,31,65.9,2,0,0
2/04/2018 2:55,6,69.3,21,64.7,27,65.8,2,0,0
2/04/2018 3:00,7,69.3,23,64.7,30,65.8,2,0,0
2/04/2018 3:05,8,69.4,24,64.8,32,66,2,0,0
2/04/2018 3:10,6,69.4,21,64.8,27,65.9,2,0,0
2/04/2018 3:15,6,69.5,21,64.9,27,65.9,2,0,0
2/04/2018 3:20,7,69.4,22,64.8,29,66,2,0,0
2/04/2018 3:25,8,69.5,23,64.9,31,66.1,2,0,0
2/04/2018 3:30,9,69.4,24,64.8,33,66.1,2,0,0
2/04/2018 3:35,10,69.4,25,64.8,35,66.1,2,0,0
2/04/2018 3:40,6,69.4,21,64.8,27,65.8,2,0,0
2/04/2018 3:45,9,69.5,24,64.9,33,66.1,2,0,0
2/04/2018 3:50,13,69.5,21,64.9,34,66.6,2,0,0
2/04/2018 3:55,9,69.5,19,64.9,28,66.4,2,0,0
2/04/2018 4:00,7,69.4,23,64.8,30,65.9,2,0,0
2/04/2018 4:05,7,69.4,23,64.8,30,65.9,2,0,0
2/04/2018 4:10,8,69.3,24,64.7,32,65.9,2,0,0
2/04/2018 4:15,7,69.4,22,64.8,29,65.9,2,0,0
2/04/2018 4:20,7,69.4,23,64.8,30,65.8,2,0,0
2/04/2018 4:25,11,69.3,27,64.7,38,66,2,0,0
2/04/2018 4:30,11,69.3,26,64.7,37,66.1,2,0,0
2/04/2018 4:35,7,69.3,23,64.7,30,65.8,2,0,0
2/04/2018 4:40,10,69.4,25,64.8,35,66.2,2,0,0
2/04/2018 4:45,8,69.5,24,64.9,32,66,2,0,0
2/04/2018 4:50,10,69.5,26,64.9,36,66.2,2,0,0
2/04/2018 4:55,8,69.4,23,64.8,31,66,2,0,0
2/04/2018 5:00,10,69.3,26,64.7,36,66,2,0,0
2/04/2018 5:05,7,69.2,22,64.6,29,65.7,2,0,0
2/04/2018 5:10,10,69.3,26,64.7,36,65.9,2,0,0
2/04/2018 5:15,7,69,22,64.4,29,65.5,2,0,0
2/04/2018 5:20,7,69.3,22,64.7,29,65.8,2,0,0
2/04/2018 5:25,12,69.3,28,64.7,40,66.1,2,0,0
2/04/2018 5:30,8,69.4,24,64.8,32,66,2,0,0
2/04/2018 5:35,13,69.4,29,64.8,42,66.3,2,0,0
2/04/2018 5:40,14,69.4,29,64.8,43,66.3,2,0,0
2/04/2018 5:45,13,69.3,28,64.7,41,66.2,2,0,0
2/04/2018 5:50,15,69.3,30,64.7,45,66.2,2,0,0
2/04/2018 5:55,12,69.2,27,64.6,39,66,2,0,0
2/04/2018 6:00,11,69.2,26,64.6,37,66,2,0,0
2/04/2018 6:05,13,69.2,29,64.6,42,66.1,2,0,0
2/04/2018 6:10,11,69.4,27,64.7,38,66.1,2,0,0
2/04/2018 6:15,15,69.4,31,64.8,46,66.3,2,0,0
2/04/2018 6:20,14,69.4,29,64.8,43,66.3,2,0,0
2/04/2018 6:25,16,69.3,31,64.6,47,66.2,2,0,0
2/04/2018 6:30,15,69.4,30,64.7,45,66.3,2,0,0
2/04/2018 6:35,18,69,33,64.4,51,66.1,2,0,0
2/04/2018 6:40,14,69.2,30,64.5,44,66,2,0,0
2/04/2018 6:45,18,69.2,34,64.6,52,66.2,2,0,0
2/04/2018 6:50,20,69.3,36,64.7,56,66.3,2,0,0
2/04/2018 6:55,22,69.2,37,64.6,59,66.3,2,0,0
2/04/2018 7:00,18,69.1,34,64.5,52,66.1,2,0,0
2/04/2018 7:05,21,68.8,37,64.1,58,65.8,2,0,0
2/04/2018 7:10,17,68.9,33,64.3,50,65.9,2,0,0
2/04/2018 7:15,19,68.9,35,64.2,54,65.9,2,0,0
2/04/2018 7:20,19,68.9,34,64.2,53,65.9,2,0,0
2/04/2018 7:25,18,69.1,34,64.5,52,66.1,2,0,0
2/04/2018 7:30,25,69.3,41,64.7,66,66.4,2,0,0
2/04/2018 7:35,24,69.3,41,64.7,65,66.4,2,0,0
2/04/2018 7:40,29,69.6,46,65,75,66.8,2,0,0
2/04/2018 7:45,28,69.2,45,64.6,73,66.4,2,0,0
2/04/2018 7:50,25,69.1,41,64.4,66,66.2,2,0,0
2/04/2018 7:55,25,69.3,41,64.7,66,66.5,2,0,0
2/04/2018 8:00,22,69.2,38,64.6,60,66.3,2,0,0
2/04/2018 8:05,20,69.2,36,64.5,56,66.2,2,0,0
2/04/2018 8:10,27,69.2,43,64.6,70,66.4,2,0,0
2/04/2018 8:15,28,69.1,44,64.4,72,66.2,2,0,0
2/04/2018 8:20,33,69.1,50,64.5,83,66.3,2,0,0
2/04/2018 8:25,27,69.3,43,64.7,70,66.5,2,0,0
2/04/2018 8:30,29,69,46,64.4,75,66.2,2,0,0
2/04/2018 8:35,32,69.1,48,64.5,80,66.3,2,0,0
2/04/2018 8:40,35,69.5,52,64.9,87,66.8,2,0,0
2/04/2018 8:45,32,69.5,49,65,81,66.8,2,0,0
2/04/2018 8:50,27,69.1,43,64.5,70,66.2,2,0,0
2/04/2018 8:55,30,69.2,47,64.6,77,66.4,2,0,0
2/04/2018 9:00,37,69.4,53,64.8,90,66.7,2,0,0
2/04/2018 9:05,34,69.3,51,64.7,85,66.5,2,0,0
2/04/2018 9:10,32,69,49,64.4,81,66.3,2,0,0
2/04/2018 9:15,39,69,55,64.4,94,66.3,2,0,0
2/04/2018 9:20,38,69.1,55,64.5,93,66.4,2,0,0
2/04/2018 9:25,32,69.1,49,64.5,81,66.3,2,0,0
2/04/2018 9:30,36,69,54,64.4,90,66.2,2,0,0
2/04/2018 9:35,41,69.6,58,65,99,66.9,2,0,0
2/04/2018 9:40,46,69.7,64,65.2,110,67.1,2,0,0
2/04/2018 9:45,47,69.3,63,64.7,110,66.7,2,0,0
2/04/2018 9:50,48,69.2,65,64.6,113,66.5,2,0,0
2/04/2018 9:55,51,69.4,69,64.7,120,66.7,2,0,0
2/04/2018 10:00,47,69.5,65,64.9,112,66.8,2,0,0
2/04/2018 10:05,47,69.8,65,65.3,112,67.2,2,0,0
2/04/2018 10:10,54,68.4,71,63.6,125,65.7,2,0,0
2/04/2018 10:15,51,69.2,67,64.5,118,66.5,2,0,0
2/04/2018 10:20,56,69.3,73,64.6,129,66.6,2,0,0
2/04/2018 10:25,51,69.7,69,65.2,120,67.1,2,0,0
2/04/2018 10:30,50,69.1,68,64.4,118,66.4,2,0,0
2/04/2018 10:35,54,68.5,72,63.8,126,65.8,2,0,0
2/04/2018 10:40,54,69.1,73,64.5,127,66.4,2,0,0
2/04/2018 10:45,53,69,71,64.3,124,66.3,2,0,0
2/04/2018 10:50,58,69.3,76,64.7,134,66.6,2,0,0
2/04/2018 10:55,67,69.9,87,65.4,154,67.3,2,0,0
2/04/2018 11:00,52,69.5,69,64.9,121,66.9,2,0,0
2/04/2018 11:05,56,69.3,74,64.8,130,66.7,2,0,0
2/04/2018 11:10,58,69.3,76,64.8,134,66.7,2,0,0
2/04/2018 11:15,60,69.3,79,64.7,139,66.7,2,0,0
2/04/2018 11:20,58,69.4,77,64.8,135,66.8,2,0,0
2/04/2018 11:25,56,69.5,74,64.9,130,66.9,2,0,0
2/04/2018 11:30,54,70.2,73,65.6,127,67.6,2,0,0
2/04/2018 11:35,65,70,84,65.5,149,67.4,2,0,0
2/04/2018 11:40,57,68.9,75,64.2,132,66.2,2,0,0
2/04/2018 11:45,57,69.4,75,64.8,132,66.8,2,0,0
2/04/2018 11:50,54,70.5,71,66,125,68,2,0,0
2/04/2018 11:55,45,69.5,63,64.9,108,66.8,2,0,0
2/04/2018 12:00,59,68.6,76,63.9,135,66,2,0,0
2/04/2018 12:05,23,69.1,40,64.4,63,66.1,2,0,0
2/04/2018 12:10,53,69.3,71,64.6,124,66.6,2,0,0
2/04/2018 12:15,51,70.2,68,65.6,119,67.6,2,0,0
2/04/2018 12:20,55,70.1,73,65.6,128,67.5,2,0,0
2/04/2018 12:25,45,70.1,63,65.6,108,67.5,2,0,0
2/04/2018 12:30,55,70,73,65.4,128,67.4,2,0,0
2/04/2018 12:35,51,70.1,67,65.6,118,67.6,2,0,0
2/04/2018 12:40,53,68.7,70,64.1,123,66.1,2,0,0
2/04/2018 12:45,58,69.5,77,64.9,135,66.9,2,0,0
2/04/2018 12:50,58,69.3,76,64.7,134,66.7,2,0,0
2/04/2018 12:55,59,69.9,77,65.4,136,67.3,2,0,0
2/04/2018 13:00,57,69.5,75,65,132,66.9,2,0,0
2/04/2018 13:05,51,69.5,68,64.9,119,66.8,2,0,0
2/04/2018 13:10,56,68.7,74,64.1,130,66.1,2,0,0
2/04/2018 13:15,62,69.7,81,65.1,143,67.1,2,0,0
2/04/2018 13:20,60,69.9,78,65.4,138,67.4,2,0,0
2/04/2018 13:25,61,70.5,79,66,140,68,2,0,0
2/04/2018 13:30,52,70,70,65.4,122,67.4,2,0,0
2/04/2018 13:35,54,69.9,72,65.4,126,67.3,2,0,0
2/04/2018 13:40,60,69.7,78,65.2,138,67.1,2,0,0
2/04/2018 13:45,64,70,83,65.5,147,67.4,2,0,0
2/04/2018 13:50,66,69.5,84,64.9,150,66.9,2,0,0
2/04/2018 13:55,58,69.3,76,64.7,134,66.7,2,0,0
2/04/2018 14:00,68,69.1,88,64.5,156,66.5,2,0,0
2/04/2018 14:05,65,69.6,84,65,149,67,2,0,0
2/04/2018 14:10,50,69.9,67,65.4,117,67.3,2,0,0
2/04/2018 14:15,66,69.8,85,65.3,151,67.2,2,0,0
2/04/2018 14:20,59,70,77,65.5,136,67.4,2,0,0
2/04/2018 14:25,62,70.5,81,66,143,68,2,0,0
2/04/2018 14:30,56,70.1,74,65.6,130,67.5,2,0,0
2/04/2018 14:35,56,69.9,74,65.3,130,67.3,2,0,0
2/04/2018 14:40,64,69.3,83,64.6,147,66.7,2,0,0
2/04/2018 14:45,71,68.8,91,64.1,162,66.1,2,0,0
2/04/2018 14:50,61,69.2,80,64.5,141,66.5,2,0,0
2/04/2018 14:55,51,69.5,69,64.9,120,66.9,2,0,0
2/04/2018 15:00,64,70.2,82,65.7,146,67.7,2,0,0
2/04/2018 15:05,62,68.8,80,64.1,142,66.1,2,0,0
2/04/2018 15:10,65,69.6,83,65.1,148,67.1,2,0,0
2/04/2018 15:15,62,69,80,64.5,142,66.4,2,0,0
2/04/2018 15:20,53,69.5,71,64.9,124,66.8,2,0,0
2/04/2018 15:25,59,70.2,77,65.8,136,67.7,2,0,0
2/04/2018 15:30,56,69.7,75,65.1,131,67.1,2,0,0
2/04/2018 15:35,56,69.1,74,64.5,130,66.5,2,0,0
2/04/2018 15:40,61,69.2,80,64.6,141,66.6,2,0,0
2/04/2018 15:45,50,69.6,69,65,119,66.9,2,0,0
2/04/2018 15:50,57,70.4,75,65.8,132,67.8,2,0,0
2/04/2018 15:55,54,69.5,73,64.9,127,66.9,2,0,0
2/04/2018 16:00,48,70.2,65,65.7,113,67.6,2,0,0
2/04/2018 16:05,54,70.4,71,65.9,125,67.8,2,0,0
2/04/2018 16:10,46,70.4,63,65.9,109,67.8,2,0,0
2/04/2018 16:15,47,70.2,64,65.7,111,67.7,2,0,0
2/04/2018 16:20,47,70,65,65.4,112,67.4,2,0,0
2/04/2018 16:25,42,69.5,59,65,101,66.9,2,0,0
2/04/2018 16:30,45,69.8,62,65.2,107,67.1,2,0,0
2/04/2018 16:35,36,69.7,52,65.1,88,67,2,0,0
2/04/2018 16:40,45,69.7,62,65.2,107,67.1,2,0,0
2/04/2018 16:45,42,69.6,58,65.1,100,67,2,0,0
2/04/2018 16:50,36,69.9,53,65.4,89,67.2,2,0,0
2/04/2018 16:55,34,69.3,51,64.7,85,66.5,2,0,0
2/04/2018 17:00,42,70.2,59,65.7,101,67.6,2,0,0
2/04/2018 17:05,44,69.9,61,65.3,105,67.2,2,0,0
2/04/2018 17:10,37,70,54,65.4,91,67.3,2,0,0
2/04/2018 17:15,47,70.3,64,65.8,111,67.7,2,0,0
2/04/2018 17:20,35,70.3,51,65.8,86,67.6,2,0,0
2/04/2018 17:25,47,69.1,64,64.5,111,66.4,2,0,0
2/04/2018 17:30,33,69.6,50,65,83,66.8,2,0,0
2/04/2018 17:35,45,68.5,62,63.8,107,65.8,2,0,0
2/04/2018 17:40,42,68.3,59,63.7,101,65.6,2,0,0
2/04/2018 17:45,43,69,59,64.5,102,66.4,2,0,0
2/04/2018 17:50,35,69.3,52,64.7,87,66.6,2,0,0
2/04/2018 17:55,36,69.5,53,64.9,89,66.7,2,0,0
2/04/2018 18:00,40,69.6,57,65,97,66.9,2,0,0
2/04/2018 18:05,35,69.6,52,65.1,87,66.9,2,0,0
2/04/2018 18:10,39,69.3,55,64.8,94,66.7,2,0,0
2/04/2018 18:15,39,68.9,56,64.2,95,66.1,2,0,0
2/04/2018 18:20,38,69.3,54,64.7,92,66.6,2,0,0
2/04/2018 18:25,36,69.6,53,65,89,66.8,2,0,0
2/04/2018 18:30,29,69.8,46,65.2,75,67,2,0,0
2/04/2018 18:35,36,69.2,52,64.7,88,66.5,2,0,0
2/04/2018 18:40,36,69.4,52,64.8,88,66.7,2,0,0
2/04/2018 18:45,37,68.9,54,64.2,91,66.1,2,0,0
2/04/2018 18:50,34,69.3,50,64.7,84,66.6,2,0,0
2/04/2018 18:55,31,68.8,46,64.2,77,66,2,0,0
2/04/2018 19:00,36,68.4,52,63.8,88,65.7,2,0,0
2/04/2018 19:05,29,69.6,44,65,73,66.8,2,0,0
2/04/2018 19:10,27,69.6,42,65,69,66.8,2,0,0
2/04/2018 19:15,29,69.3,45,64.7,74,66.5,2,0,0
2/04/2018 19:20,29,68.8,45,64.2,74,66,2,0,0
2/04/2018 19:25,30,69.3,46,64.7,76,66.5,2,0,0
2/04/2018 19:30,43,69.3,59,64.7,102,66.7,2,0,0
2/04/2018 19:35,43,69.7,59,65.2,102,67.1,2,0,0
2/04/2018 19:40,38,69.6,55,65,93,66.9,2,0,0
2/04/2018 19:45,45,69.7,62,65.2,107,67.1,2,0,0
2/04/2018 19:50,47,69.8,65,65.2,112,67.1,2,0,0
2/04/2018 19:55,45,68.8,63,64.2,108,66.1,2,0,0
2/04/2018 20:00,50,68.9,67,64.2,117,66.2,2,0,0
2/04/2018 20:05,47,69,65,64.3,112,66.3,2,0,0
2/04/2018 20:10,49,69.4,68,64.8,117,66.7,2,0,0
2/04/2018 20:15,52,68.4,70,63.7,122,65.7,2,0,0
2/04/2018 20:20,50,68.5,68,63.7,118,65.7,2,0,0
2/04/2018 20:25,47,69.1,66,64.4,113,66.3,2,0,0
2/04/2018 20:30,48,68.8,66,64.1,114,66.1,2,0,0
2/04/2018 20:35,47,68.6,65,64,112,65.9,2,0,0
2/04/2018 20:40,38,69.3,55,64.7,93,66.6,2,0,0
2/04/2018 20:45,37,69.5,54,64.9,91,66.8,2,0,0
2/04/2018 20:50,36,69,52,64.4,88,66.3,2,0,0
2/04/2018 20:55,38,69.9,54,65.3,92,67.2,2,0,0
2/04/2018 21:00,36,69.5,52,64.9,88,66.8,2,0,0
2/04/2018 21:05,39,69.8,56,65.2,95,67.1,2,0,0
2/04/2018 21:10,35,70,52,65.5,87,67.3,2,0,0
2/04/2018 21:15,31,69.9,47,65.4,78,67.2,2,0,0
2/04/2018 21:20,37,70.1,54,65.5,91,67.4,2,0,0
2/04/2018 21:25,27,69.9,43,65.4,70,67.1,2,0,0
2/04/2018 21:30,29,69,44,64.4,73,66.2,2,0,0
2/04/2018 21:35,35,68.8,51,64.1,86,66,2,0,0
2/04/2018 21:40,38,68.8,55,64.1,93,66.1,2,0,0
2/04/2018 21:45,24,69.3,39,64.7,63,66.5,2,0,0
2/04/2018 21:50,30,69.8,45,65.3,75,67.1,2,0,0
2/04/2018 21:55,25,69.6,41,65,66,66.8,2,0,0
2/04/2018 22:00,23,69.4,39,64.8,62,66.5,2,0,0
2/04/2018 22:05,26,69.5,42,64.9,68,66.7,2,0,0
2/04/2018 22:10,24,69.6,39,65,63,66.8,2,0,0
2/04/2018 22:15,21,69.7,37,65.1,58,66.8,2,0,0
2/04/2018 22:20,18,69.6,33,65,51,66.7,2,0,0
2/04/2018 22:25,19,69.5,34,64.9,53,66.5,2,0,0
2/04/2018 22:30,17,69.4,32,64.8,49,66.4,2,0,0
2/04/2018 22:35,20,69.5,36,64.9,56,66.6,2,0,0
2/04/2018 22:40,15,69.5,30,64.9,45,66.4,2,0,0
2/04/2018 22:45,18,69.3,34,64.7,52,66.3,2,0,0
2/04/2018 22:50,18,69.3,33,64.7,51,66.3,2,0,0
2/04/2018 22:55,21,69.3,37,64.7,58,66.4,2,0,0
2/04/2018 23:00,17,69.4,32,64.8,49,66.4,2,0,0
2/04/2018 23:05,13,69.3,28,64.7,41,66.2,2,0,0
2/04/2018 23:10,15,69.4,30,64.8,45,66.3,2,0,0
2/04/2018 23:15,11,69.1,27,64.5,38,65.8,2,0,0
2/04/2018 23:20,16,69.2,31,64.6,47,66.2,2,0,0
2/04/2018 23:25,14,69.3,29,64.7,43,66.2,2,0,0
2/04/2018 23:30,14,69.3,29,64.7,43,66.2,2,0,0
2/04/2018 23:35,14,69.3,29,64.7,43,66.2,2,0,0
2/04/2018 23:40,16,69.2,31,64.6,47,66.2,2,0,0
2/04/2018 23:45,12,69.3,27,64.7,39,66.1,2,0,0
2/04/2018 23:50,10,69.4,26,64.8,36,66.1,2,0,0
2/04/2018 23:55,13,69.3,29,64.7,42,66.1,2,0,0
