5 Minutes,Lane 1 Flow (Veh/5 Minutes),Lane 1 Speed (mph),Lane 2 Flow (Veh/5 Minutes),Lane 2 Speed (mph),Flow (Veh/5 Minutes),Speed (mph),# Lane Points,% Observed,Holiday
2/05/2018 0:00,9,69.3,24,64.7,33,66,2,0,0
2/05/2018 0:05,10,69.4,26,64.8,36,66.1,2,0,0
2/05/2018 0:10,8,69.3,24,64.7,32,65.9,2,0,0
2/05/2018 0:15,11,69.4,26,64.8,37,66.2,2,0,0
2/05/2018 0:20,8,69.3,24,64.7,32,65.8,2,0,0
2/05/2018 0:25,13,69.3,21,64.7,34,66.4,2,0,0
2/05/2018 0:30,8,69.3,23,64.7,31,65.9,2,0,0
2/05/2018 0:35,8,69.1,23,64.5,31,65.7,2,0,0
2/05/2018 0:40,9,69.2,24,64.6,33,65.9,2,0,0
2/05/2018 0:45,7,69.3,22,64.7,29,65.8,2,0,0
2/05/2018 0:50,8,69.4,23,64.7,31,65.9,2,0,0
2/05/2018 0:55,6,69.3,21,64.7,27,65.7,2,0,0
2/05/2018 1:00,7,69.4,22,64.8,29,65.9,2,0,0
2/05/2018 1:05,10,69.4,20,64.8,30,66.3,2,0,0
2/05/2018 1:10,9,69.2,24,64.6,33,65.9,2,0,0
2/05/2018 1:15,6,69.3,21,64.7,27,65.7,2,0,0
2/05/2018 1:20,5,69.3,21,64.7,26,65.5,2,0,0
2/05/2018 1:25,7,69.3,22,64.7,29,65.8,2,0,0
2/05/2018 1:30,6,69.3,21,64.7,27,65.7,2,0,0
2/05/2018 1:35,5,69.3,20,64.7,25,65.7,2,0,0
2/05/2018 1:40,4,69.3,19,64.7,23,65.5,2,0,0
2/05/2018 1:45,8,69.4,24,64.8,32,65.9,2,0,0
2/05/2018 1:50,6,69.2,21,64.6,27,65.6,2,0,0
2/05/2018 1:55,10,69.1,20,64.4,30,66,2,0,0
2/05/2018 2:00,11,69,21,64.4,32,66,2,0,0
2/05/2018 2:05,5,69.1,21,64.5,26,65.4,2,0,0
2/05/2018 2:10,8,69.1,23,64.5,31,65.7,2,0,0
2/05/2018 2:15,6,69,21,64.4,27,65.4,2,0,0
2/05/2018 2:20,6,69.1,21,64.5,27,65.5,2,0,0
2/05/2018 2:25,8,69.3,23,64.7,31,65.8,2,0,0
2/05/2018 2:30,7,69.2,22,64.6,29,65.7,2,0,0
2/05/2018 2:35,7,69.2,22,64.6,29,65.7,2,0,0
2/05/2018 2:40,9,69.3,24,64.7,33,66,2,0,0
2/05/2018 2:45,11,69.4,26,64.8,37,66.2,2,0,0
2/05/2018 2:50,7,69.4,22,64.8,29,65.9,2,0,0
2/05/2018 2:55,8,69.3,23,64.7,31,65.9,2,0,0
2/05/2018 3:00,8,69.4,24,64.8,32,65.9,2,0,0
2/05/2018 3:05,9,69.4,25,64.8,34,66,2,0,0
2/05/2018 3:10,10,69.1,26,64.5,36,65.8,2,0,0
2/05/2018 3:15,5,69.3,21,64.7,26,65.6,2,0,0
2/05/2018 3:20,6,69.4,21,64.8,27,65.8,2,0,0
2/05/2018 3:25,8,69.3,24,64.7,32,65.8,2,0,0
2/05/2018 3:30,12,69.3,27,64.7,39,66.2,2,0,0
2/05/2018 3:35,13,69.5,28,64.9,41,66.3,2,0,0
2/05/2018 3:40,12,69.5,28,64.9,40,66.2,2,0,0
2/05/2018 3:45,14,69.5,30,64.9,44,66.3,2,0,0
2/05/2018 3:50,15,69.4,31,64.8,46,66.3,2,0,0
2/05/2018 3:55,13,69.3,29,64.7,42,66.1,2,0,0
2/05/2018 4:00,15,69.3,31,64.7,46,66.2,2,0,0
2/05/2018 4:05,15,69.3,31,64.7,46,66.2,2,0,0
2/05/2018 4:10,22,69.4,38,64.8,60,66.5,2,0,0
2/05/2018 4:15,21,69.5,38,64.9,59,66.6,2,0,0
2/05/2018 4:20,21,69.6,37,65,58,66.7,2,0,0
2/05/2018 4:25,31,68.7,49,64,80,65.8,2,0,0
2/05/2018 4:30,27,69.1,43,64.4,70,66.2,2,0,0
2/05/2018 4:35,32,68.8,49,64.1,81,66,2,0,0
2/05/2018 4:40,39,69.7,56,65.2,95,67,2,0,0
2/05/2018 4:45,39,69.4,58,64.8,97,66.7,2,0,0
2/05/2018 4:50,40,70.1,58,65.6,98,67.5,2,0,0
2/05/2018 4:55,36,70.4,55,65.8,91,67.6,2,0,0
2/05/2018 5:00,43,69.3,61,64.7,104,66.6,2,0,0
2/05/2018 5:05,40,70,58,65.4,98,67.3,2,0,0
2/05/2018 5:10,45,69.5,64,64.9,109,66.8,2,0,0
2/05/2018 5:15,51,69.4,71,64.9,122,66.8,2,0,0
2/05/2018 5:20,58,69,78,64.4,136,66.3,2,0,0
2/05/2018 5:25,60,69.7,81,65.1,141,67,2,0,0
2/05/2018 5:30,57,69.3,78,64.7,135,66.7,2,0,0
2/05/2018 5:35,60,69.2,81,64.5,141,66.5,2,0,0
2/05/2018 5:40,72,69.3,94,64.6,166,66.7,2,0,0
2/05/2018 5:45,61,69,82,64.4,143,66.4,2,0,0
2/05/2018 5:50,65,68.7,87,64,152,66,2,0,0
2/05/2018 5:55,63,68.8,84,64.1,147,66.1,2,0,0
2/05/2018 6:00,64,68,86,63.3,150,65.3,2,0,0
2/05/2018 6:05,52,68.8,71,64.1,123,66.1,2,0,0
2/05/2018 6:10,71,68.6,93,63.9,164,66,2,0,0
2/05/2018 6:15,73,66.3,96,61.4,169,63.5,2,0,0
2/05/2018 6:20,69,66.3,89,61.4,158,63.5,2,0,0
2/05/2018 6:25,69,67.8,91,63,160,65.1,2,0,0
2/05/2018 6:30,68,67.1,91,62.3,159,64.4,2,0,0
2/05/2018 6:35,76,66.9,99,62.1,175,64.2,2,0,0
2/05/2018 6:40,67,68.8,89,64.1,156,66.1,2,0,0
2/05/2018 6:45,84,68,106,63.2,190,65.3,2,0,0
2/05/2018 6:50,78,67.2,102,62.5,180,64.5,2,0,0
2/05/2018 6:55,67,68.3,87,63.6,154,65.6,2,0,0
2/05/2018 7:00,76,68.4,97,63.6,173,65.7,2,0,0
2/05/2018 7:05,74,69.5,96,64.9,170,66.9,2,0,0
2/05/2018 7:10,83,69.9,106,65.3,189,67.3,2,0,0
2/05/2018 7:15,81,70,103,65.5,184,67.5,2,0,0
2/05/2018 7:20,86,69.9,109,65.3,195,67.4,2,0,0
2/05/2018 7:25,76,69.4,98,64.7,174,66.8,2,0,0
2/05/2018 7:30,78,67.9,101,63.2,179,65.2,2,0,0
2/05/2018 7:35,77,68.1,99,63.4,176,65.5,2,0,0
2/05/2018 7:40,81,68.6,104,63.9,185,66,2,0,0
2/05/2018 7:45,75,67.4,97,62.6,172,64.7,2,0,0
2/05/2018 7:50,76,69.1,97,64.4,173,66.5,2,0,0
2/05/2018 7:55,55,68.4,75,63.7,130,65.7,2,0,0
2/05/2018 8:00,79,67.7,103,63,182,65,2,0,0
2/05/2018 8:05,78,68,100,63.3,178,65.4,2,0,0
2/05/2018 8:10,74,67.5,96,62.8,170,64.8,2,0,0
2/05/2018 8:15,78,67.5,100,62.8,178,64.8,2,0,0
2/05/2018 8:20,76,66.8,99,61.9,175,64,2,0,0
2/05/2018 8:25,73,67.6,94,62.7,167,64.9,2,0,0
2/05/2018 8:30,83,66.4,105,61.5,188,63.7,2,0,0
2/05/2018 8:35,85,67.1,107,62.2,192,64.4,2,0,0
2/05/2018 8:40,78,67,100,62.2,178,64.3,2,0,0
2/05/2018 8:45,77,67.1,99,62.3,176,64.4,2,0,0
2/05/2018 8:50,81,66.6,105,61.7,186,63.9,2,0,0
2/05/2018 8:55,70,67.4,90,62.6,160,64.7,2,0,0
2/05/2018 9:00,66,69.4,86,64.8,152,66.8,2,0,0
2/05/2018 9:05,63,67.4,84,62.6,147,64.7,2,0,0
2/05/2018 9:10,70,68.4,90,63.6,160,65.7,2,0,0
2/05/2018 9:15,73,68.4,94,63.7,167,65.8,2,0,0
2/05/2018 9:20,63,68.2,84,63.4,147,65.5,2,0,0
2/05/2018 9:25,64,68.8,84,64.1,148,66.1,2,0,0
2/05/2018 9:30,65,68.5,84,63.8,149,65.8,2,0,0
2/05/2018 9:35,59,68.4,78,63.7,137,65.7,2,0,0
2/05/2018 9:40,63,68.7,83,64,146,66,2,0,0
2/05/2018 9:45,55,68.9,74,64.2,129,66.2,2,0,0
2/05/2018 9:50,66,69.5,84,64.8,150,66.9,2,0,0
2/05/2018 9:55,68,68.7,87,64,155,66,2,0,0
2/05/2018 10:00,70,67.9,89,63.2,159,65.3,2,0,0
2/05/2018 10:05,59,69.2,78,64.6,137,66.6,2,0,0
2/05/2018 10:10,55,69.3,73,64.7,128,66.7,2,0,0
2/05/2018 10:15,56,69.1,75,64.4,131,66.5,2,0,0
2/05/2018 10:20,58,69.2,78,64.5,136,66.5,2,0,0
2/05/2018 10:25,49,68,68,63.4,117,65.3,2,0,0
2/05/2018 10:30,47,68.9,65,64.3,112,66.2,2,0,0
2/05/2018 10:35,49,67.7,67,63,116,65,2,0,0
2/05/2018 10:40,54,68,72,63.3,126,65.3,2,0,0
2/05/2018 10:45,57,67.3,76,62.7,133,64.7,2,0,0
2/05/2018 10:50,40,68.8,57,64.3,97,66.1,2,0,0
2/05/2018 10:55,43,68.5,60,63.9,103,65.9,2,0,0
2/05/2018 11:00,35,69.2,53,64.6,88,66.4,2,0,0
2/05/2018 11:05,42,68.1,59,63.4,101,65.3,2,0,0
2/05/2018 11:10,46,68.3,63,63.7,109,65.6,2,0,0
2/05/2018 11:15,41,68,58,63.4,99,65.3,2,0,0
2/05/2018 11:20,49,68.5,66,63.9,115,65.8,2,0,0
2/05/2018 11:25,48,68.6,67,63.9,115,65.9,2,0,0
2/05/2018 11:30,56,67.8,76,63.1,132,65.1,2,0,0
2/05/2018 11:35,53,69.7,71,65.1,124,67.1,2,0,0
2/05/2018 11:40,42,68.2,60,63.5,102,65.5,2,0,0
2/05/2018 11:45,55,67.8,74,63.1,129,65.1,2,0,0
2/05/2018 11:50,54,69.4,73,64.7,127,66.7,2,0,0
2/05/2018 11:55,55,70.3,72,65.7,127,67.7,2,0,0
2/05/2018 12:00,43,70.6,60,66.1,103,68,2,0,0
2/05/2018 12:05,55,69.5,74,65,129,66.9,2,0,0
2/05/2018 12:10,55,69.3,73,64.8,128,66.7,2,0,0
2/05/2018 12:15,56,69.9,74,65.4,130,67.3,2,0,0
2/05/2018 12:20,54,69.2,72,64.7,126,66.6,2,0,0
2/05/2018 12:25,54,69.1,72,64.5,126,66.4,2,0,0
2/05/2018 12:30,47,69.2,64,64.6,111,66.6,2,0,0
2/05/2018 12:35,51,69,69,64.4,120,66.4,2,0,0
2/05/2018 12:40,43,69.3,60,64.7,103,66.6,2,0,0
2/05/2018 12:45,48,68.1,65,63.4,113,65.4,2,0,0
2/05/2018 12:50,51,69,69,64.5,120,66.4,2,0,0
2/05/2018 12:55,49,69.9,67,65.4,116,67.3,2,0,0
2/05/2018 13:00,45,69.3,63,64.7,108,66.6,2,0,0
2/05/2018 13:05,46,69.6,63,65,109,67,2,0,0
2/05/2018 13:10,43,69.5,60,64.9,103,66.8,2,0,0
2/05/2018 13:15,42,70.6,59,66.2,101,68,2,0,0
2/05/2018 13:20,38,70.6,56,66.1,94,68,2,0,0
2/05/2018 13:25,58,69.2,77,64.6,135,66.6,2,0,0
2/05/2018 13:30,44,69.4,62,64.9,106,66.8,2,0,0
2/05/2018 13:35,51,69.2,69,64.7,120,66.6,2,0,0
2/05/2018 13:40,49,69.6,67,65,116,67,2,0,0
2/05/2018 13:45,44,69.5,61,65,105,66.9,2,0,0
2/05/2018 13:50,49,68.2,67,63.5,116,65.5,2,0,0
2/05/2018 13:55,47,69.1,64,64.5,111,66.5,2,0,0
2/05/2018 14:00,45,68.5,62,63.9,107,65.8,2,0,0
2/05/2018 14:05,51,67.9,70,63.2,121,65.2,2,0,0
2/05/2018 14:10,54,66.5,73,61.7,127,63.8,2,0,0
2/05/2018 14:15,54,68.7,72,64.1,126,66.1,2,0,0
2/05/2018 14:20,39,69.4,56,64.8,95,66.7,2,0,0
2/05/2018 14:25,43,68.6,60,63.9,103,65.8,2,0,0
2/05/2018 14:30,42,68.3,59,63.7,101,65.6,2,0,0
2/05/2018 14:35,45,68.3,62,63.6,107,65.6,2,0,0
2/05/2018 14:40,43,67.5,60,62.9,103,64.8,2,0,0
2/05/2018 14:45,50,68.6,68,64.1,118,66,2,0,0
2/05/2018 14:50,39,69.3,55,64.7,94,66.6,2,0,0
2/05/2018 14:55,48,69.1,65,64.5,113,66.4,2,0,0
2/05/2018 15:00,42,68.9,59,64.3,101,66.2,2,0,0
2/05/2018 15:05,44,69.4,61,64.8,105,66.7,2,0,0
2/05/2018 15:10,49,68.3,67,63.5,116,65.5,2,0,0
2/05/2018 15:15,55,68.5,73,63.7,128,65.7,2,0,0
2/05/2018 15:20,53,69.1,71,64.4,124,66.4,2,0,0
2/05/2018 15:25,46,69.6,63,65.1,109,67,2,0,0
2/05/2018 15:30,53,67.7,72,63,125,65,2,0,0
2/05/2018 15:35,50,68.4,67,63.7,117,65.7,2,0,0
2/05/2018 15:40,64,69.8,82,65.3,146,67.3,2,0,0
2/05/2018 15:45,53,70.3,71,65.8,124,67.7,2,0,0
2/05/2018 15:50,51,69,68,64.5,119,66.4,2,0,0
2/05/2018 15:55,59,69.7,77,65.2,136,67.1,2,0,0
2/05/2018 16:00,47,69.4,65,64.9,112,66.8,2,0,0
2/05/2018 16:05,51,70.4,69,66,120,67.9,2,0,0
2/05/2018 16:10,50,69.8,67,65.3,117,67.2,2,0,0
2/05/2018 16:15,48,67.2,67,62.2,115,64.3,2,0,0
2/05/2018 16:20,61,67.9,79,63.1,140,65.2,2,0,0
2/05/2018 16:25,55,69.5,73,64.9,128,66.9,2,0,0
2/05/2018 16:30,46,70.1,64,65.6,110,67.5,2,0,0
2/05/2018 16:35,51,70.9,70,66.5,121,68.3,2,0,0
2/05/2018 16:40,48,70.5,65,66.1,113,68,2,0,0
2/05/2018 16:45,55,70.7,72,66.3,127,68.2,2,0,0
2/05/2018 16:50,43,70.6,61,66.2,104,68,2,0,0
2/05/2018 16:55,50,70.9,68,66.5,118,68.4,2,0,0
2/05/2018 17:00,38,69.5,54,65,92,66.8,2,0,0
2/05/2018 17:05,54,69.5,72,65,126,66.9,2,0,0
2/05/2018 17:10,53,70,71,65.5,124,67.4,2,0,0
2/05/2018 17:15,56,70.3,75,65.8,131,67.7,2,0,0
2/05/2018 17:20,45,69,63,64.3,108,66.3,2,0,0
2/05/2018 17:25,53,69.8,71,65.2,124,67.2,2,0,0
2/05/2018 17:30,45,69.3,64,64.7,109,66.6,2,0,0
2/05/2018 17:35,45,70.2,63,65.7,108,67.5,2,0,0
2/05/2018 17:40,42,70.2,59,65.7,101,67.6,2,0,0
2/05/2018 17:45,43,69,61,64.5,104,66.4,2,0,0
2/05/2018 17:50,42,69.2,59,64.7,101,66.6,2,0,0
2/05/2018 17:55,42,68.2,59,63.4,101,65.4,2,0,0
2/05/2018 18:00,46,68.8,64,64.1,110,66.1,2,0,0
2/05/2018 18:05,42,69.2,59,64.5,101,66.5,2,0,0
2/05/2018 18:10,38,69.4,55,64.8,93,66.6,2,0,0
2/05/2018 18:15,41,67.8,58,63.1,99,65,2,0,0
2/05/2018 18:20,44,66.8,61,61.9,105,64,2,0,0
2/05/2018 18:25,45,67.6,62,62.8,107,64.8,2,0,0
2/05/2018 18:30,39,68.2,56,63.5,95,65.4,2,0,0
2/05/2018 18:35,41,68,58,63.3,99,65.3,2,0,0
2/05/2018 18:40,39,68.2,56,63.4,95,65.4,2,0,0
2/05/2018 18:45,33,68.6,50,63.9,83,65.8,2,0,0
2/05/2018 18:50,34,68.8,51,64.2,85,66,2,0,0
2/05/2018 18:55,40,68.3,57,63.6,97,65.5,2,0,0
2/05/2018 19:00,35,68,51,63.3,86,65.2,2,0,0
2/05/2018 19:05,31,67.5,48,62.7,79,64.6,2,0,0
2/05/2018 19:10,36,67.9,54,63.2,90,65.1,2,0,0
2/05/2018 19:15,40,67.6,58,62.8,98,64.8,2,0,0
2/05/2018 19:20,34,68.8,50,64.2,84,66.1,2,0,0
2/05/2018 19:25,44,68.3,61,63.5,105,65.5,2,0,0
2/05/2018 19:30,39,68.2,56,63.5,95,65.4,2,0,0
2/05/2018 19:35,30,68.8,46,64.1,76,65.9,2,0,0
2/05/2018 19:40,29,69.2,44,64.6,73,66.4,2,0,0
2/05/2018 19:45,33,69.6,49,65,82,66.9,2,0,0
2/05/2018 19:50,26,69.3,42,64.7,68,66.4,2,0,0
2/05/2018 19:55,31,68.9,48,64.3,79,66.1,2,0,0
2/05/2018 20:00,32,67.7,48,63,80,64.9,2,0,0
2/05/2018 20:05,28,68.8,45,64.2,73,66,2,0,0
2/05/2018 20:10,30,69.1,45,64.5,75,66.3,2,0,0
2/05/2018 20:15,31,68.3,47,63.6,78,65.5,2,0,0
2/05/2018 20:20,29,68.6,45,63.9,74,65.8,2,0,0
2/05/2018 20:25,28,68.5,44,63.8,72,65.6,2,0,0
2/05/2018 20:30,32,68.9,48,64.2,80,66.1,2,0,0
2/05/2018 20:35,27,68.9,43,64.2,70,66,2,0,0
2/05/2018 20:40,28,69.2,44,64.5,72,66.3,2,0,0
2/05/2018 20:45,23,69,40,64.4,63,66.1,2,0,0
2/05/2018 20:50,25,69.2,41,64.5,66,66.3,2,0,0
2/05/2018 20:55,25,69.5,41,64.9,66,66.6,2,0,0
2/05/2018 21:00,23,69.3,38,64.7,61,66.4,2,0,0
2/05/2018 21:05,27,68.8,43,64.1,70,65.9,2,0,0
2/05/2018 21:10,28,68.5,44,63.9,72,65.7,2,0,0
2/05/2018 21:15,23,69,39,64.4,62,66.1,2,0,0
2/05/2018 21:20,25,68,41,63.4,66,65.1,2,0,0
2/05/2018 21:25,24,68.8,40,64.2,64,65.9,2,0,0
2/05/2018 21:30,20,68.6,36,63.9,56,65.6,2,0,0
2/05/2018 21:35,19,69,35,64.3,54,66,2,0,0
2/05/2018 21:40,20,69.1,36,64.5,56,66.2,2,0,0
2/05/2018 21:45,21,69.4,36,64.8,57,66.5,2,0,0
2/05/2018 21:50,24,69.2,40,64.6,64,66.3,2,0,0
2/05/2018 21:55,23,69,39,64.4,62,66.1,2,0,0
2/05/2018 22:00,16,69.2,32,64.6,48,66.2,2,0,0
2/05/2018 22:05,22,69.3,38,64.7,60,66.4,2,0,0
2/05/2018 22:10,14,69.4,30,64.8,44,66.2,2,0,0
2/05/2018 22:15,16,69.3,31,64.7,47,66.3,2,0,0
2/05/2018 22:20,18,69.4,34,64.8,52,66.4,2,0,0
2/05/2018 22:25,16,69.5,31,64.9,47,66.5,2,0,0
2/05/2018 22:30,20,69.4,37,64.8,57,66.4,2,0,0
2/05/2018 22:35,15,69.4,31,64.7,46,66.2,2,0,0
2/05/2018 22:40,16,69.2,32,64.6,48,66.1,2,0,0
2/05/2018 22:45,16,69.3,32,64.6,48,66.2,2,0,0
2/05/2018 22:50,13,69.3,28,64.7,41,66.1,2,0,0
2/05/2018 22:55,12,69.4,28,64.8,40,66.2,2,0,0
2/05/2018 23:00,13,69.4,28,64.8,41,66.3,2,0,0
2/05/2018 23:05,16,69.3,31,64.7,47,66.3,2,0,0
2/05/2018 23:10,14,69.2,29,64.6,43,66.1,2,0,0
2/05/2018 23:15,18,69.3,33,64.7,51,66.3,2,0,0
2/05/2018 23:20,14,69,29,64.4,43,65.9,2,0,0
2/05/2018 23:25,12,69.2,27,64.6,39,66,2,0,0
2/05/2018 23:30,14,69.1,29,64.5,43,66,2,0,0
2/05/2018 23:35,15,69.2,31,64.6,46,66.1,2,0,0
2/05/2018 23:40,14,68.9,30,64.2,44,65.7,2,0,0
2/05/2018 23:45,13,69.1,28,64.4,41,65.9,2,0,0
2/05/2018 23:50,8,69.2,24,64.5,32,65.7,2,0,0
2/05/2018 23:55,10,69.4,25,64.7,35,66.1,2,0,0
2/06/2018 0:00,10,69.3,25,64.7,35,66.1,2,0,0
2/06/2018 0:05,10,69.4,25,64.8,35,66.2,2,0,0
2/06/2018 0:10,10,69,26,64.3,36,65.6,2,0,0
2/06/2018 0:15,8,69.1,24,64.5,32,65.7,2,0,0
2/06/2018 0:20,8,69.3,23,64.7,31,65.9,2,0,0
2/06/2018 0:25,7,69.4,22,64.8,29,65.9,2,0,0
2/06/2018 0:30,8,69.3,23,64.7,31,65.9,2,0,0
2/06/2018 0:35,7,69.4,22,64.8,29,66,2,0,0
2/06/2018 0:40,9,69.4,24,64.8,33,66.1,2,0,0
2/06/2018 0:45,8,69.4,23,64.8,31,66,2,0,0
2/06/2018 0:50,7,69.4,23,64.8,30,65.9,2,0,0
2/06/2018 0:55,9,69.2,24,64.6,33,65.8,2,0,0
2/06/2018 1:00,7,69.3,22,64.7,29,65.8,2,0,0
2/06/2018 1:05,5,69.3,20,64.7,25,65.7,2,0,0
2/06/2018 1:10,7,69.4,23,64.8,30,65.9,2,0,0
2/06/2018 1:15,5,69.2,20,64.6,25,65.5,2,0,0
2/06/2018 1:20,7,69.4,22,64.8,29,66,2,0,0
2/06/2018 1:25,7,69.4,22,64.8,29,65.9,2,0,0
2/06/2018 1:30,8,69.4,24,64.8,32,66,2,0,0
2/06/2018 1:35,9,69.2,26,64.6,35,65.8,2,0,0
2/06/2018 1:40,9,69.3,19,64.7,28,66.2,2,0,0
2/06/2018 1:45,6,69.4,22,64.8,28,65.8,2,0,0
2/06/2018 1:50,6,69.4,21,64.8,27,65.8,2,0,0
2/06/2018 1:55,7,69.3,22,64.7,29,65.8,2,0,0
2/06/2018 2:00,5,69.3,20,64.7,25,65.6,2,0,0
2/06/2018 2:05,6,69.3,21,64.7,27,65.7,2,0,0
2/06/2018 2:10,6,69.4,21,64.8,27,65.8,2,0,0
2/06/2018 2:15,11,69.2,26,64.6,37,66,2,0,0
2/06/2018 2:20,14,69.2,22,64.5,36,66.3,2,0,0
2/06/2018 2:25,5,69.2,21,64.6,26,65.4,2,0,0
2/06/2018 2:30,8,69.2,24,64.6,32,65.7,2,0,0
2/06/2018 2:35,7,69.2,22,64.6,29,65.7,2,0,0
2/06/2018 2:40,10,69.3,25,64.6,35,65.9,2,0,0
2/06/2018 2:45,8,69.3,23,64.7,31,65.9,2,0,0
2/06/2018 2:50,7,69.3,23,64.7,30,65.8,2,0,0
2/06/2018 2:55,9,69.2,24,64.5,33,65.8,2,0,0
2/06/2018 3:00,9,69.2,24,64.6,33,65.9,2,0,0
2/06/2018 3:05,9,69.2,25,64.6,34,65.8,2,0,0
2/06/2018 3:10,8,69.2,23,64.6,31,65.8,2,0,0
2/06/2018 3:15,9,69.2,24,64.5,33,65.8,2,0,0
2/06/2018 3:20,8,69.3,23,64.7,31,65.8,2,0,0
2/06/2018 3:25,7,69.2,23,64.6,30,65.7,2,0,0
2/06/2018 3:30,14,69.2,30,64.6,44,66.1,2,0,0
2/06/2018 3:35,12,69.4,27,64.7,39,66.2,2,0,0
2/06/2018 3:40,11,69.4,27,64.8,38,66.1,2,0,0
2/06/2018 3:45,11,69.4,27,64.8,38,66.1,2,0,0
2/06/2018 3:50,11,69.4,27,64.8,38,66.1,2,0,0
2/06/2018 3:55,12,69.3,27,64.7,39,66.1,2,0,0
2/06/2018 4:00,18,69.3,34,64.7,52,66.3,2,0,0
2/06/2018 4:05,18,69.3,34,64.7,52,66.3,2,0,0
2/06/2018 4:10,20,68.8,36,64.1,56,65.8,2,0,0
2/06/2018 4:15,18,69.1,34,64.5,52,66.1,2,0,0
2/06/2018 4:20,24,69.3,40,64.7,64,66.5,2,0,0
2/06/2018 4:25,24,69.2,41,64.6,65,66.3,2,0,0
2/06/2018 4:30,22,69.4,39,64.7,61,66.4,2,0,0
2/06/2018 4:35,28,69.4,46,64.8,74,66.5,2,0,0
2/06/2018 4:40,38,69.4,55,64.8,93,66.7,2,0,0
2/06/2018 4:45,31,69.3,49,64.7,80,66.5,2,0,0
2/06/2018 4:50,39,69.3,56,64.7,95,66.6,2,0,0
2/06/2018 4:55,31,68.9,48,64.3,79,66.1,2,0,0
2/06/2018 5:00,41,69.2,60,64.7,101,66.5,2,0,0
2/06/2018 5:05,37,70,55,65.6,92,67.4,2,0,0
2/06/2018 5:10,43,70.5,61,66.1,104,67.9,2,0,0
2/06/2018 5:15,55,71.1,74,66.7,129,68.5,2,0,0
2/06/2018 5:20,50,70.2,69,65.7,119,67.6,2,0,0
2/06/2018 5:25,52,71.3,71,66.9,123,68.8,2,0,0
2/06/2018 5:30,62,70.5,84,66,146,67.9,2,0,0
2/06/2018 5:35,58,69.5,80,64.9,138,66.8,2,0,0
2/06/2018 5:40,53,69.1,73,64.5,126,66.5,2,0,0
2/06/2018 5:45,56,70.2,76,65.7,132,67.6,2,0,0
2/06/2018 5:50,66,69.4,88,64.8,154,66.8,2,0,0
2/06/2018 5:55,47,69.6,66,65.1,113,67,2,0,0
2/06/2018 6:00,53,68.8,73,64.1,126,66,2,0,0
2/06/2018 6:05,57,67.9,78,63.2,135,65.2,2,0,0
2/06/2018 6:10,55,67.7,77,62.9,132,64.9,2,0,0
2/06/2018 6:15,57,65.3,78,60.3,135,62.4,2,0,0
2/06/2018 6:20,65,65.6,86,60.7,151,62.8,2,0,0
2/06/2018 6:25,51,67,71,62.1,122,64.1,2,0,0
2/06/2018 6:30,60,66.4,81,61.5,141,63.6,2,0,0
2/06/2018 6:35,63,66.3,85,61.3,148,63.5,2,0,0
2/06/2018 6:40,78,66.3,100,61.3,178,63.5,2,0,0
2/06/2018 6:45,84,67,107,62.1,191,64.2,2,0,0
2/06/2018 6:50,82,67.2,105,62.2,187,64.4,2,0,0
2/06/2018 6:55,70,67.3,91,62.4,161,64.5,2,0,0
2/06/2018 7:00,78,67.4,100,62.6,178,64.7,2,0,0
2/06/2018 7:05,74,68,96,63.2,170,65.3,2,0,0
2/06/2018 7:10,84,68,108,63.2,192,65.3,2,0,0
2/06/2018 7:15,84,67.7,107,62.8,191,64.9,2,0,0
2/06/2018 7:20,82,68,105,63.2,187,65.3,2,0,0
2/06/2018 7:25,81,67.4,104,62.5,185,64.6,2,0,0
2/06/2018 7:30,78,67,101,62.1,179,64.2,2,0,0
2/06/2018 7:35,88,67.9,110,63,198,65.2,2,0,0
2/06/2018 7:40,84,66.9,106,62,190,64.2,2,0,0
2/06/2018 7:45,88,65.7,112,60.7,200,62.9,2,0,0
2/06/2018 7:50,65,66.4,86,61.4,151,63.6,2,0,0
2/06/2018 7:55,71,64.2,93,58.9,164,61.2,2,0,0
2/06/2018 8:00,69,62.1,90,56.6,159,59,2,0,0
2/06/2018 8:05,74,55.1,95,48.8,169,51.5,2,0,0
2/06/2018 8:10,73,48,94,41,167,44.1,2,0,0
2/06/2018 8:15,80,40.7,101,32.9,181,36.3,2,0,0
2/06/2018 8:20,83,39.9,104,32,187,35.5,2,0,0
2/06/2018 8:25,84,43.7,107,36.2,191,39.5,2,0,0
2/06/2018 8:30,84,47.2,106,40.1,190,43.2,2,0,0
2/06/2018 8:35,79,51.3,101,44.7,180,47.6,2,0,0
2/06/2018 8:40,80,57.9,102,52.1,182,54.6,2,0,0
2/06/2018 8:45,86,60,109,54.3,195,56.8,2,0,0
2/06/2018 8:50,85,58.4,108,52.6,193,55.2,2,0,0
2/06/2018 8:55,78,58,101,52.2,179,54.7,2,0,0
2/06/2018 9:00,76,59.6,99,54,175,56.4,2,0,0
2/06/2018 9:05,70,62.4,91,57.1,161,59.4,2,0,0
2/06/2018 9:10,74,63.1,95,57.9,169,60.2,2,0,0
2/06/2018 9:15,70,62.6,90,57.5,160,59.7,2,0,0
2/06/2018 9:20,72,65,93,59.9,165,62.1,2,0,0
2/06/2018 9:25,70,65.2,91,60.2,161,62.4,2,0,0
2/06/2018 9:30,74,63.6,96,58.4,170,60.7,2,0,0
2/06/2018 9:35,74,65.3,96,60.3,170,62.5,2,0,0
2/06/2018 9:40,74,66,95,61,169,63.2,2,0,0
2/06/2018 9:45,73,65.6,94,60.7,167,62.8,2,0,0
2/06/2018 9:50,72,66.7,91,61.8,163,64,2,0,0
2/06/2018 9:55,81,66.4,102,61.5,183,63.7,2,0,0
2/06/2018 10:00,72,66.5,93,61.7,165,63.8,2,0,0
2/06/2018 10:05,71,67.8,92,63,163,65.1,2,0,0
2/06/2018 10:10,67,67.6,86,62.8,153,64.9,2,0,0
2/06/2018 10:15,57,65.9,76,61,133,63.1,2,0,0
2/06/2018 10:20,65,65.5,84,60.6,149,62.7,2,0,0
2/06/2018 10:25,65,65.8,85,61,150,63.1,2,0,0
2/06/2018 10:30,68,66.4,87,61.6,155,63.7,2,0,0
2/06/2018 10:35,63,65.3,83,60.5,146,62.5,2,0,0
2/06/2018 10:40,56,66,76,61.2,132,63.2,2,0,0
2/06/2018 10:45,62,65.9,81,61.2,143,63.2,2,0,0
2/06/2018 10:50,60,67.1,79,62.4,139,64.4,2,0,0
2/06/2018 10:55,58,66.7,77,61.9,135,64,2,0,0
2/06/2018 11:00,56,66.8,74,62,130,64,2,0,0
2/06/2018 11:05,49,68,67,63.4,116,65.3,2,0,0
2/06/2018 11:10,54,68.6,72,64,126,66,2,0,0
2/06/2018 11:15,58,68.9,77,64.2,135,66.2,2,0,0
2/06/2018 11:20,54,70,72,65.5,126,67.4,2,0,0
2/06/2018 11:25,56,69.5,75,64.9,131,66.9,2,0,0
2/06/2018 11:30,54,68.1,73,63.4,127,65.4,2,0,0
2/06/2018 11:35,51,68.6,69,64,120,65.9,2,0,0
2/06/2018 11:40,55,66.8,74,62,129,64.1,2,0,0
2/06/2018 11:45,55,67.5,73,62.8,128,64.8,2,0,0
2/06/2018 11:50,57,68.1,76,63.5,133,65.5,2,0,0
2/06/2018 11:55,49,68.1,67,63.5,116,65.4,2,0,0
2/06/2018 12:00,43,67.1,60,62.4,103,64.4,2,0,0
2/06/2018 12:05,48,68.6,66,64,114,65.9,2,0,0
2/06/2018 12:10,48,69.1,65,64.5,113,66.5,2,0,0
2/06/2018 12:15,52,69.4,69,64.9,121,66.8,2,0,0
2/06/2018 12:20,44,69.1,61,64.5,105,66.4,2,0,0
2/06/2018 12:25,49,68.6,67,64,116,66,2,0,0
2/06/2018 12:30,46,67.5,63,62.7,109,64.7,2,0,0
2/06/2018 12:35,51,67,69,62.2,120,64.2,2,0,0
2/06/2018 12:40,52,68,69,63.3,121,65.3,2,0,0
2/06/2018 12:45,52,68.5,71,63.8,123,65.8,2,0,0
2/06/2018 12:50,57,68,75,63.3,132,65.3,2,0,0
2/06/2018 12:55,50,68.4,68,63.7,118,65.7,2,0,0
2/06/2018 13:00,42,69.2,58,64.5,100,66.5,2,0,0
2/06/2018 13:05,40,68.6,58,63.9,98,65.8,2,0,0
2/06/2018 13:10,62,68.4,81,63.7,143,65.7,2,0,0
2/06/2018 13:15,41,68.9,58,64.2,99,66.1,2,0,0
2/06/2018 13:20,53,67.3,71,62.6,124,64.6,2,0,0
2/06/2018 13:25,46,66.9,63,62.2,109,64.2,2,0,0
2/06/2018 13:30,46,67.5,63,62.8,109,64.8,2,0,0
2/06/2018 13:35,50,67.5,68,62.8,118,64.8,2,0,0
2/06/2018 13:40,48,67.5,66,62.8,114,64.8,2,0,0
2/06/2018 13:45,57,68.2,75,63.6,132,65.6,2,0,0
2/06/2018 13:50,48,67.6,65,62.9,113,64.9,2,0,0
2/06/2018 13:55,52,67.9,69,63.2,121,65.2,2,0,0
2/06/2018 14:00,43,67.8,61,63.1,104,65,2,0,0
2/06/2018 14:05,54,67.6,72,62.9,126,64.9,2,0,0
2/06/2018 14:10,49,68.3,66,63.7,115,65.7,2,0,0
2/06/2018 14:15,55,69,74,64.4,129,66.3,2,0,0
2/06/2018 14:20,49,67.6,67,62.9,116,64.9,2,0,0
2/06/2018 14:25,51,67.7,69,63,120,65,2,0,0
2/06/2018 14:30,52,68.8,69,64.2,121,66.1,2,0,0
2/06/2018 14:35,52,68.5,70,63.9,122,65.9,2,0,0
2/06/2018 14:40,52,66.3,70,61.5,122,63.6,2,0,0
2/06/2018 14:45,52,67.3,70,62.5,122,64.5,2,0,0
2/06/2018 14:50,55,68.1,73,63.4,128,65.4,2,0,0
2/06/2018 14:55,49,65.7,68,60.8,117,62.8,2,0,0
2/06/2018 15:00,51,67.3,68,62.5,119,64.6,2,0,0
2/06/2018 15:05,57,67.5,75,62.8,132,64.8,2,0,0
2/06/2018 15:10,55,66.7,73,62,128,64,2,0,0
2/06/2018 15:15,56,67,74,62.2,130,64.3,2,0,0
2/06/2018 15:20,59,68.5,77,63.8,136,65.8,2,0,0
2/06/2018 15:25,70,68,90,63.2,160,65.3,2,0,0
2/06/2018 15:30,51,67.5,69,62.8,120,64.8,2,0,0
2/06/2018 15:35,57,68.6,75,63.9,132,65.9,2,0,0
2/06/2018 15:40,69,69,88,64.3,157,66.4,2,0,0
2/06/2018 15:45,61,68.7,79,64,140,66,2,0,0
2/06/2018 15:50,53,70.3,70,65.8,123,67.7,2,0,0
2/06/2018 15:55,69,69.2,89,64.6,158,66.6,2,0,0
2/06/2018 16:00,67,69.7,87,65.1,154,67.1,2,0,0
2/06/2018 16:05,71,68.2,90,63.5,161,65.6,2,0,0
2/06/2018 16:10,68,68.5,87,63.9,155,65.9,2,0,0
2/06/2018 16:15,56,68.7,74,64,130,66,2,0,0
2/06/2018 16:20,64,68.7,83,64,147,66,2,0,0
2/06/2018 16:25,50,69.2,68,64.6,118,66.6,2,0,0
2/06/2018 16:30,52,67.7,71,62.9,123,64.9,2,0,0
2/06/2018 16:35,58,67.7,76,63.1,134,65.1,2,0,0
2/06/2018 16:40,56,68.3,74,63.6,130,65.6,2,0,0
2/06/2018 16:45,51,68,68,63.3,119,65.3,2,0,0
2/06/2018 16:50,53,67.4,70,62.7,123,64.7,2,0,0
2/06/2018 16:55,46,66.7,64,61.9,110,63.9,2,0,0
2/06/2018 17:00,45,68.4,63,63.8,108,65.7,2,0,0
2/06/2018 17:05,51,67.9,70,63.1,121,65.1,2,0,0
2/06/2018 17:10,54,68.9,73,64.2,127,66.2,2,0,0
2/06/2018 17:15,56,69.6,75,64.9,131,66.9,2,0,0
2/06/2018 17:20,55,69.2,74,64.6,129,66.6,2,0,0
2/06/2018 17:25,50,69.2,68,64.5,118,66.5,2,0,0
2/06/2018 17:30,48,65.1,67,59.8,115,62,2,0,0
2/06/2018 17:35,55,57.1,74,51,129,53.6,2,0,0
2/06/2018 17:40,46,54.4,64,48,110,50.7,2,0,0
2/06/2018 17:45,52,61,70,55.3,122,57.7,2,0,0
2/06/2018 17:50,51,63.6,70,58.3,121,60.6,2,0,0
2/06/2018 17:55,56,66.8,75,61.8,131,63.9,2,0,0
2/06/2018 18:00,53,67.2,72,62.3,125,64.4,2,0,0
2/06/2018 18:05,51,66.6,69,61.8,120,63.8,2,0,0
2/06/2018 18:10,55,65.6,74,60.6,129,62.8,2,0,0
2/06/2018 18:15,49,63,68,57.7,117,59.9,2,0,0
2/06/2018 18:20,52,62.3,70,56.9,122,59.2,2,0,0
2/06/2018 18:25,52,60.7,70,55.2,122,57.5,2,0,0
2/06/2018 18:30,52,59.5,70,53.8,122,56.2,2,0,0
2/06/2018 18:35,52,54,71,47.7,123,50.4,2,0,0
2/06/2018 18:40,46,52.4,65,46,111,48.7,2,0,0
2/06/2018 18:45,47,58.2,65,52.3,112,54.7,2,0,0
2/06/2018 18:50,46,63.1,64,57.8,110,60,2,0,0
2/06/2018 18:55,45,66.3,63,61.4,108,63.4,2,0,0
2/06/2018 19:00,38,67.7,55,63,93,64.9,2,0,0
2/06/2018 19:05,44,67.9,61,63.1,105,65.1,2,0,0
2/06/2018 19:10,47,67.3,64,62.6,111,64.6,2,0,0
2/06/2018 19:15,40,67.7,57,62.9,97,64.9,2,0,0
2/06/2018 19:20,35,68.2,52,63.5,87,65.4,2,0,0
2/06/2018 19:25,37,68.5,54,63.8,91,65.7,2,0,0
2/06/2018 19:30,37,68.8,53,64.1,90,66,2,0,0
2/06/2018 19:35,31,68.9,47,64.3,78,66.1,2,0,0
2/06/2018 19:40,34,69.1,51,64.5,85,66.3,2,0,0
2/06/2018 19:45,39,69.2,55,64.6,94,66.5,2,0,0
2/06/2018 19:50,33,69.4,50,64.7,83,66.6,2,0,0
2/06/2018 19:55,29,69.3,45,64.7,74,66.5,2,0,0
2/06/2018 20:00,31,69.7,48,65.1,79,66.9,2,0,0
2/06/2018 20:05,25,69.6,42,65,67,66.8,2,0,0
2/06/2018 20:10,32,68.3,49,63.6,81,65.5,2,0,0
2/06/2018 20:15,34,68.2,51,63.5,85,65.4,2,0,0
2/06/2018 20:20,33,68.5,49,63.9,82,65.7,2,0,0
2/06/2018 20:25,28,68.9,44,64.2,72,66.1,2,0,0
2/06/2018 20:30,23,69.1,39,64.5,62,66.2,2,0,0
2/06/2018 20:35,27,69.6,44,65,71,66.7,2,0,0
2/06/2018 20:40,34,68.1,51,63.5,85,65.3,2,0,0
2/06/2018 20:45,25,68.8,42,64.2,67,65.9,2,0,0
2/06/2018 20:50,28,68.4,44,63.7,72,65.6,2,0,0
2/06/2018 20:55,23,68.9,39,64.3,62,66,2,0,0
2/06/2018 21:00,18,69.2,33,64.5,51,66.2,2,0,0
2/06/2018 21:05,25,68.6,41,63.9,66,65.7,2,0,0
2/06/2018 21:10,26,69,43,64.4,69,66.2,2,0,0
2/06/2018 21:15,24,69,40,64.4,64,66.1,2,0,0
2/06/2018 21:20,30,69.2,45,64.5,75,66.4,2,0,0
2/06/2018 21:25,27,68.4,43,63.7,70,65.5,2,0,0
2/06/2018 21:30,34,69,51,64.4,85,66.2,2,0,0
2/06/2018 21:35,23,69.1,40,64.5,63,66.2,2,0,0
2/06/2018 21:40,26,69.3,42,64.7,68,66.5,2,0,0
2/06/2018 21:45,20,69.4,35,64.8,55,66.4,2,0,0
2/06/2018 21:50,26,69.4,42,64.8,68,66.6,2,0,0
2/06/2018 21:55,25,69.1,42,64.5,67,66.2,2,0,0
2/06/2018 22:00,23,69.3,40,64.7,63,66.3,2,0,0
2/06/2018 22:05,24,68.8,41,64.1,65,65.8,2,0,0
2/06/2018 22:10,26,69.3,41,64.6,67,66.4,2,0,0
2/06/2018 22:15,26,69.2,42,64.6,68,66.4,2,0,0
2/06/2018 22:20,23,69.5,40,64.9,63,66.5,2,0,0
2/06/2018 22:25,23,69.3,39,64.7,62,66.4,2,0,0
2/06/2018 22:30,17,69.3,33,64.7,50,66.3,2,0,0
2/06/2018 22:35,19,69,35,64.4,54,66,2,0,0
2/06/2018 22:40,18,69.1,34,64.5,52,66.1,2,0,0
2/06/2018 22:45,20,68.9,36,64.3,56,65.9,2,0,0
2/06/2018 22:50,18,69.2,34,64.6,52,66.2,2,0,0
2/06/2018 22:55,10,69.3,25,64.7,35,66,2,0,0
2/06/2018 23:00,15,69.3,30,64.7,45,66.3,2,0,0
2/06/2018 23:05,13,69.3,29,64.7,42,66.2,2,0,0
2/06/2018 23:10,19,68.8,35,64.1,54,65.8,2,0,0
2/06/2018 23:15,11,69.2,27,64.5,38,65.9,2,0,0
2/06/2018 23:20,12,69.3,27,64.7,39,66.1,2,0,0
2/06/2018 23:25,10,69.2,25,64.6,35,65.9,2,0,0
2/06/2018 23:30,20,69.2,36,64.6,56,66.2,2,0,0
2/06/2018 23:35,10,69.2,25,64.6,35,65.9,2,0,0
2/06/2018 23:40,13,69.3,29,64.7,42,66.1,2,0,0
2/06/2018 23:45,11,69,27,64.4,38,65.8,2,0,0
2/06/2018 23:50,14,69.2,29,64.5,43,66,2,0,0
2/06/2018 23:55,11,69.2,26,64.6,37,66,2,0,0
2/07/2018 0:00,10,69.3,26,64.7,36,66,2,0,0
2/07/2018 0:05,10,69.4,26,64.8,36,66.1,2,0,0
2/07/2018 0:10,7,69.4,22,64.8,29,65.9,2,0,0
2/07/2018 0:15,12,69.1,27,64.4,39,65.9,2,0,0
2/07/2018 0:20,10,69.3,25,64.6,35,65.9,2,0,0
2/07/2018 0:25,8,69.3,23,64.7,31,65.9,2,0,0
2/07/2018 0:30,9,69.2,24,64.6,33,65.8,2,0,0
2/07/2018 0:35,5,69.2,20,64.6,25,65.5,2,0,0
2/07/2018 0:40,6,69.3,21,64.7,27,65.7,2,0,0
2/07/2018 0:45,12,69.3,21,64.7,33,66.3,2,0,0
2/07/2018 0:50,7,69.2,22,64.6,29,65.7,2,0,0
2/07/2018 0:55,7,69.3,22,64.7,29,65.8,2,0,0
2/07/2018 1:00,6,69.4,21,64.8,27,65.8,2,0,0
2/07/2018 1:05,10,69.4,20,64.8,30,66.3,2,0,0
2/07/2018 1:10,6,69.5,21,64.9,27,65.9,2,0,0
2/07/2018 1:15,6,69.3,21,64.7,27,65.7,2,0,0
2/07/2018 1:20,7,69.2,22,64.6,29,65.7,2,0,0
2/07/2018 1:25,7,69.3,22,64.7,29,65.8,2,0,0
2/07/2018 1:30,7,69.4,23,64.8,30,65.9,2,0,0
2/07/2018 1:35,10,69.3,26,64.7,36,66,2,0,0
2/07/2018 1:40,6,69.4,21,64.8,27,65.8,2,0,0
2/07/2018 1:45,7,69.4,22,64.8,29,66,2,0,0
2/07/2018 1:50,5,69.3,21,64.7,26,65.6,2,0,0
2/07/2018 1:55,6,69.1,21,64.5,27,65.5,2,0,0
2/07/2018 2:00,7,69.3,22,64.7,29,65.8,2,0,0
2/07/2018 2:05,5,69.3,20,64.7,25,65.6,2,0,0
2/07/2018 2:10,9,69.1,24,64.4,33,65.7,2,0,0
2/07/2018 2:15,7,69.4,22,64.7,29,65.9,2,0,0
2/07/2018 2:20,5,69.3,21,64.7,26,65.6,2,0,0
2/07/2018 2:25,5,69.3,21,64.6,26,65.5,2,0,0
2/07/2018 2:30,10,69.1,25,64.5,35,65.8,2,0,0
2/07/2018 2:35,7,69.2,22,64.6,29,65.7,2,0,0
2/07/2018 2:40,11,69.3,27,64.7,38,66,2,0,0
2/07/2018 2:45,10,69.2,25,64.6,35,65.9,2,0,0
2/07/2018 2:50,9,69.3,24,64.7,33,66,2,0,0
2/07/2018 2:55,11,69.3,27,64.7,38,66,2,0,0
2/07/2018 3:00,8,69.3,24,64.7,32,65.9,2,0,0
2/07/2018 3:05,9,69.4,24,64.8,33,66,2,0,0
2/07/2018 3:10,9,69.2,24,64.5,33,65.8,2,0,0
2/07/2018 3:15,8,69.2,24,64.6,32,65.7,2,0,0
2/07/2018 3:20,9,69.3,24,64.7,33,65.9,2,0,0
2/07/2018 3:25,10,69.3,26,64.7,36,65.9,2,0,0
2/07/2018 3:30,12,69.2,28,64.6,40,66,2,0,0
2/07/2018 3:35,14,69.3,30,64.7,44,66.2,2,0,0
2/07/2018 3:40,12,69.1,27,64.5,39,65.9,2,0,0
2/07/2018 3:45,11,69.3,27,64.7,38,66.1,2,0,0
2/07/2018 3:50,18,69.4,33,64.8,51,66.4,2,0,0
2/07/2018 3:55,16,69.4,32,64.8,48,66.3,2,0,0
2/07/2018 4:00,14,69.6,30,65,44,66.4,2,0,0
2/07/2018 4:05,16,69.4,32,64.8,48,66.4,2,0,0
2/07/2018 4:10,21,69.4,37,64.8,58,66.5,2,0,0
2/07/2018 4:15,16,68.8,33,64.2,49,65.7,2,0,0
2/07/2018 4:20,24,69.3,40,64.6,64,66.4,2,0,0
2/07/2018 4:25,22,69.5,38,64.9,60,66.6,2,0,0
2/07/2018 4:30,27,68.3,44,63.6,71,65.4,2,0,0
2/07/2018 4:35,30,69,48,64.4,78,66.2,2,0,0
2/07/2018 4:40,35,69.2,53,64.6,88,66.4,2,0,0
2/07/2018 4:45,38,69.4,57,64.8,95,66.7,2,0,0
2/07/2018 4:50,39,69.4,56,64.7,95,66.6,2,0,0
2/07/2018 4:55,41,69.7,60,65.1,101,67,2,0,0
2/07/2018 5:00,39,69.2,57,64.5,96,66.4,2,0,0
2/07/2018 5:05,39,68.5,58,63.8,97,65.7,2,0,0
2/07/2018 5:10,44,69.1,63,64.4,107,66.3,2,0,0
2/07/2018 5:15,57,69.1,77,64.4,134,66.4,2,0,0
2/07/2018 5:20,53,68.6,74,63.9,127,65.9,2,0,0
2/07/2018 5:25,46,67.7,66,62.9,112,64.9,2,0,0
2/07/2018 5:30,65,68.1,87,63.3,152,65.3,2,0,0
2/07/2018 5:35,64,69.1,86,64.4,150,66.4,2,0,0
2/07/2018 5:40,64,68.9,85,64.3,149,66.2,2,0,0
2/07/2018 5:45,67,68.8,89,64.2,156,66.2,2,0,0
2/07/2018 5:50,66,68.2,88,63.5,154,65.5,2,0,0
2/07/2018 5:55,58,69.5,80,65,138,66.9,2,0,0
2/07/2018 6:00,57,68.1,78,63.3,135,65.3,2,0,0
2/07/2018 6:05,55,68.8,75,64.1,130,66.1,2,0,0
2/07/2018 6:10,58,69,79,64.3,137,66.3,2,0,0
2/07/2018 6:15,73,67.6,96,62.8,169,64.8,2,0,0
2/07/2018 6:20,69,67.5,91,62.7,160,64.7,2,0,0
2/07/2018 6:25,65,67.9,87,63.1,152,65.1,2,0,0
2/07/2018 6:30,64,67.9,85,63.1,149,65.2,2,0,0
2/07/2018 6:35,69,67.7,91,62.9,160,64.9,2,0,0
2/07/2018 6:40,69,66.8,92,61.9,161,64,2,0,0
2/07/2018 6:45,70,67,92,62.1,162,64.2,2,0,0
2/07/2018 6:50,83,68.3,105,63.5,188,65.6,2,0,0
2/07/2018 6:55,70,68.5,91,63.7,161,65.8,2,0,0
2/07/2018 7:00,76,68.5,98,63.7,174,65.8,2,0,0
2/07/2018 7:05,73,69.1,96,64.3,169,66.4,2,0,0
2/07/2018 7:10,72,68.6,93,63.8,165,65.9,2,0,0
2/07/2018 7:15,79,68.8,102,64,181,66.1,2,0,0
2/07/2018 7:20,84,68.4,107,63.6,191,65.7,2,0,0
2/07/2018 7:25,87,67.1,111,62.2,198,64.4,2,0,0
2/07/2018 7:30,85,67.7,109,62.8,194,64.9,2,0,0
2/07/2018 7:35,81,67.7,105,62.8,186,64.9,2,0,0
2/07/2018 7:40,82,68.2,104,63.4,186,65.5,2,0,0
2/07/2018 7:45,86,68.1,109,63.2,195,65.4,2,0,0
2/07/2018 7:50,81,66,104,61,185,63.2,2,0,0
2/07/2018 7:55,70,65.5,91,60.4,161,62.6,2,0,0
2/07/2018 8:00,78,66,101,61,179,63.2,2,0,0
2/07/2018 8:05,78,65.4,101,60.3,179,62.5,2,0,0
2/07/2018 8:10,78,65.3,101,60.3,179,62.5,2,0,0
2/07/2018 8:15,83,66.4,105,61.4,188,63.6,2,0,0
2/07/2018 8:20,83,65.1,105,59.9,188,62.2,2,0,0
2/07/2018 8:25,83,66,106,61,189,63.2,2,0,0
2/07/2018 8:30,74,66,97,61,171,63.1,2,0,0
2/07/2018 8:35,87,65,110,59.9,197,62.2,2,0,0
2/07/2018 8:40,87,65.6,109,60.6,196,62.8,2,0,0
2/07/2018 8:45,79,66,102,61,181,63.2,2,0,0
2/07/2018 8:50,79,66.2,101,61.2,180,63.4,2,0,0
2/07/2018 8:55,73,67.1,93,62.3,166,64.4,2,0,0
2/07/2018 9:00,81,67.8,102,63,183,65.1,2,0,0
2/07/2018 9:05,74,65.4,95,60.4,169,62.6,2,0,0
2/07/2018 9:10,74,65.3,96,60.3,170,62.5,2,0,0
2/07/2018 9:15,77,65.8,99,60.9,176,63,2,0,0
2/07/2018 9:20,76,65.7,96,60.8,172,63,2,0,0
2/07/2018 9:25,78,66.3,100,61.4,178,63.5,2,0,0
2/07/2018 9:30,73,66.8,93,62,166,64.2,2,0,0
2/07/2018 9:35,75,67.2,97,62.4,172,64.5,2,0,0
2/07/2018 9:40,80,66.4,101,61.6,181,63.7,2,0,0
2/07/2018 9:45,82,67.1,104,62.2,186,64.3,2,0,0
2/07/2018 9:50,79,66.6,100,61.7,179,63.9,2,0,0
2/07/2018 9:55,81,64.8,103,59.7,184,62,2,0,0
2/07/2018 10:00,59,66.2,78,61.4,137,63.4,2,0,0
2/07/2018 10:05,61,65.1,80,60.1,141,62.3,2,0,0
2/07/2018 10:10,68,64.8,88,59.8,156,62,2,0,0
2/07/2018 10:15,62,66.3,81,61.4,143,63.5,2,0,0
2/07/2018 10:20,58,67,78,62.2,136,64.3,2,0,0
2/07/2018 10:25,58,67.5,77,62.8,135,64.8,2,0,0
2/07/2018 10:30,60,67.9,79,63.2,139,65.3,2,0,0
2/07/2018 10:35,69,66.9,89,62.1,158,64.2,2,0,0
2/07/2018 10:40,55,67.7,75,63.1,130,65,2,0,0
2/07/2018 10:45,52,67.4,71,62.7,123,64.7,2,0,0
2/07/2018 10:50,46,67.6,64,62.9,110,64.8,2,0,0
2/07/2018 10:55,54,68,73,63.4,127,65.4,2,0,0
2/07/2018 11:00,51,67.7,69,63.2,120,65.1,2,0,0
2/07/2018 11:05,60,68.1,79,63.5,139,65.5,2,0,0
2/07/2018 11:10,57,68.6,76,64.1,133,66,2,0,0
2/07/2018 11:15,52,68.8,70,64.2,122,66.2,2,0,0
2/07/2018 11:20,58,65.6,77,60.7,135,62.8,2,0,0
2/07/2018 11:25,60,67,79,62.2,139,64.3,2,0,0
2/07/2018 11:30,55,66.3,73,61.5,128,63.6,2,0,0
2/07/2018 11:35,53,66.6,71,61.7,124,63.8,2,0,0
2/07/2018 11:40,52,66.6,70,61.8,122,63.9,2,0,0
2/07/2018 11:45,51,67.9,69,63.2,120,65.2,2,0,0
2/07/2018 11:50,49,67.6,68,62.9,117,64.8,2,0,0
2/07/2018 11:55,47,66.9,64,62.2,111,64.2,2,0,0
2/07/2018 12:00,37,67.2,54,62.5,91,64.4,2,0,0
2/07/2018 12:05,41,66.9,59,62.1,100,64.1,2,0,0
2/07/2018 12:10,42,66.5,60,61.7,102,63.7,2,0,0
2/07/2018 12:15,46,68,63,63.4,109,65.3,2,0,0
2/07/2018 12:20,50,67.4,67,62.6,117,64.7,2,0,0
2/07/2018 12:25,54,67.5,73,62.7,127,64.7,2,0,0
2/07/2018 12:30,58,67.4,76,62.6,134,64.7,2,0,0
2/07/2018 12:35,57,68,75,63.3,132,65.3,2,0,0
2/07/2018 12:40,45,66.9,63,62.1,108,64.1,2,0,0
2/07/2018 12:45,46,67.3,64,62.5,110,64.5,2,0,0
2/07/2018 12:50,49,66.8,67,62,116,64.1,2,0,0
2/07/2018 12:55,58,67.3,76,62.5,134,64.6,2,0,0
2/07/2018 13:00,38,68.8,55,64.2,93,66,2,0,0
2/07/2018 13:05,42,69.2,60,64.6,102,66.5,2,0,0
2/07/2018 13:10,64,69.8,83,65.3,147,67.2,2,0,0
2/07/2018 13:15,56,68.7,74,64.1,130,66.1,2,0,0
2/07/2018 13:20,48,68.7,65,64.1,113,66,2,0,0
2/07/2018 13:25,51,67.6,68,62.9,119,64.9,2,0,0
2/07/2018 13:30,41,68.9,58,64.3,99,66.2,2,0,0
2/07/2018 13:35,47,68.3,65,63.7,112,65.7,2,0,0
2/07/2018 13:40,42,68.2,60,63.6,102,65.5,2,0,0
2/07/2018 13:45,57,68.4,77,63.8,134,65.7,2,0,0
2/07/2018 13:50,56,67.2,74,62.5,130,64.6,2,0,0
2/07/2018 13:55,47,67.5,64,62.9,111,64.8,2,0,0
2/07/2018 14:00,44,68.7,61,64.1,105,66,2,0,0
2/07/2018 14:05,49,68.8,67,64.2,116,66.1,2,0,0
2/07/2018 14:10,44,68.7,60,64.1,104,66,2,0,0
2/07/2018 14:15,44,68.8,63,64.1,107,66,2,0,0
2/07/2018 14:20,52,68.8,70,64.2,122,66.2,2,0,0
2/07/2018 14:25,49,69.5,67,65,116,66.9,2,0,0
2/07/2018 14:30,49,68.5,67,63.9,116,65.9,2,0,0
2/07/2018 14:35,50,68.5,69,63.9,119,65.8,2,0,0
2/07/2018 14:40,54,68.1,72,63.5,126,65.4,2,0,0
2/07/2018 14:45,52,68.3,70,63.7,122,65.6,2,0,0
2/07/2018 14:50,49,68,67,63.3,116,65.3,2,0,0
2/07/2018 14:55,45,69.5,62,64.9,107,66.9,2,0,0
2/07/2018 15:00,49,67.8,66,63.1,115,65.1,2,0,0
2/07/2018 15:05,47,68.4,65,63.9,112,65.8,2,0,0
2/07/2018 15:10,57,70.1,75,65.6,132,67.5,2,0,0
2/07/2018 15:15,52,69.5,71,65,123,66.9,2,0,0
2/07/2018 15:20,51,68.3,69,63.7,120,65.6,2,0,0
2/07/2018 15:25,57,69.2,75,64.7,132,66.6,2,0,0
2/07/2018 15:30,66,71,85,66.7,151,68.5,2,0,0
2/07/2018 15:35,54,71.2,72,66.9,126,68.8,2,0,0
2/07/2018 15:40,68,71,87,66.6,155,68.5,2,0,0
2/07/2018 15:45,60,71.4,80,67.1,140,69,2,0,0
2/07/2018 15:50,58,71.2,76,66.8,134,68.7,2,0,0
2/07/2018 15:55,67,70.2,86,65.7,153,67.6,2,0,0
2/07/2018 16:00,56,69.4,75,64.7,131,66.7,2,0,0
2/07/2018 16:05,58,70.9,77,66.4,135,68.3,2,0,0
2/07/2018 16:10,61,71.4,80,67,141,68.9,2,0,0
2/07/2018 16:15,63,72,82,67.7,145,69.6,2,0,0
2/07/2018 16:20,63,71.9,81,67.6,144,69.5,2,0,0
2/07/2018 16:25,45,70.3,63,65.8,108,67.6,2,0,0
2/07/2018 16:30,56,70.1,76,65.7,132,67.6,2,0,0
2/07/2018 16:35,63,69.7,81,65.2,144,67.1,2,0,0
2/07/2018 16:40,49,70.3,66,65.8,115,67.7,2,0,0
2/07/2018 16:45,51,71.4,68,66.9,119,68.8,2,0,0
2/07/2018 16:50,55,69.9,74,65.4,129,67.3,2,0,0
2/07/2018 16:55,56,69.6,74,65.2,130,67.1,2,0,0
2/07/2018 17:00,49,70.3,66,65.9,115,67.8,2,0,0
2/07/2018 17:05,49,70.5,67,66.1,116,68,2,0,0
2/07/2018 17:10,48,70.9,66,66.6,114,68.4,2,0,0
2/07/2018 17:15,59,70.4,79,66,138,67.9,2,0,0
2/07/2018 17:20,49,69.7,67,65.2,116,67.1,2,0,0
2/07/2018 17:25,53,65,72,60,125,62.1,2,0,0
2/07/2018 17:30,42,65.4,59,60.3,101,62.4,2,0,0
2/07/2018 17:35,47,67.9,66,63.1,113,65.1,2,0,0
2/07/2018 17:40,43,68.2,61,63.4,104,65.4,2,0,0
2/07/2018 17:45,52,67.8,71,63,123,65.1,2,0,0
2/07/2018 17:50,47,69.9,64,65.3,111,67.2,2,0,0
2/07/2018 17:55,49,69.7,68,65.2,117,67.1,2,0,0
2/07/2018 18:00,56,70.3,75,65.8,131,67.7,2,0,0
2/07/2018 18:05,47,69.6,65,65,112,66.9,2,0,0
2/07/2018 18:10,58,69.8,76,65.3,134,67.3,2,0,0
2/07/2018 18:15,45,66.7,63,62,108,64,2,0,0
2/07/2018 18:20,41,67.6,59,62.9,100,64.8,2,0,0
2/07/2018 18:25,47,69.1,66,64.5,113,66.4,2,0,0
2/07/2018 18:30,41,69.1,58,64.6,99,66.4,2,0,0
2/07/2018 18:35,42,67.8,60,63.2,102,65.1,2,0,0
2/07/2018 18:40,45,69.1,62,64.5,107,66.4,2,0,0
2/07/2018 18:45,41,69.7,58,65.2,99,67.1,2,0,0
2/07/2018 18:50,42,69.6,59,65.1,101,67,2,0,0
2/07/2018 18:55,36,69.4,52,64.9,88,66.7,2,0,0
2/07/2018 19:00,35,70.2,52,65.7,87,67.5,2,0,0
2/07/2018 19:05,35,70,51,65.4,86,67.3,2,0,0
2/07/2018 19:10,39,68.3,55,63.6,94,65.6,2,0,0
2/07/2018 19:15,16,69,32,64.4,48,65.9,2,0,0
2/07/2018 19:20,20,69.5,36,64.9,56,66.5,2,0,0
2/07/2018 19:25,40,69.3,57,64.7,97,66.6,2,0,0
2/07/2018 19:30,44,69.9,62,65.3,106,67.3,2,0,0
2/07/2018 19:35,38,70.2,55,65.7,93,67.5,2,0,0
2/07/2018 19:40,40,69.1,58,64.4,98,66.3,2,0,0
2/07/2018 19:45,34,69.9,51,65.4,85,67.2,2,0,0
2/07/2018 19:50,43,70.4,59,65.9,102,67.8,2,0,0
2/07/2018 19:55,30,69.8,46,65.3,76,67.1,2,0,0
2/07/2018 20:00,36,69.6,52,65,88,66.8,2,0,0
2/07/2018 20:05,31,69.2,48,64.6,79,66.4,2,0,0
2/07/2018 20:10,30,69.5,46,64.9,76,66.7,2,0,0
2/07/2018 20:15,35,69.6,51,65,86,66.9,2,0,0
2/07/2018 20:20,28,69.3,45,64.8,73,66.5,2,0,0
2/07/2018 20:25,32,68.1,48,63.4,80,65.3,2,0,0
2/07/2018 20:30,28,68.6,45,64,73,65.8,2,0,0
2/07/2018 20:35,30,68.4,47,63.7,77,65.6,2,0,0
2/07/2018 20:40,24,69.2,41,64.7,65,66.3,2,0,0
2/07/2018 20:45,30,69.8,46,65.2,76,67,2,0,0
2/07/2018 20:50,33,69.7,49,65.1,82,67,2,0,0
2/07/2018 20:55,24,69.3,39,64.7,63,66.4,2,0,0
2/07/2018 21:00,33,69.3,49,64.7,82,66.5,2,0,0
2/07/2018 21:05,26,69.4,42,64.8,68,66.6,2,0,0
2/07/2018 21:10,29,69.9,45,65.3,74,67.1,2,0,0
2/07/2018 21:15,25,69.8,40,65.2,65,67,2,0,0
2/07/2018 21:20,30,69.7,46,65.1,76,66.9,2,0,0
2/07/2018 21:25,29,70.2,45,65.7,74,67.5,2,0,0
2/07/2018 21:30,24,69.8,40,65.2,64,66.9,2,0,0
2/07/2018 21:35,25,69.3,41,64.7,66,66.4,2,0,0
2/07/2018 21:40,28,69.3,44,64.7,72,66.4,2,0,0
2/07/2018 21:45,24,69.6,40,65,64,66.7,2,0,0
2/07/2018 21:50,27,69.9,43,65.3,70,67.1,2,0,0
2/07/2018 21:55,30,69.4,46,64.8,76,66.7,2,0,0
2/07/2018 22:00,25,69.8,41,65.3,66,67,2,0,0
2/07/2018 22:05,29,69,46,64.4,75,66.2,2,0,0
2/07/2018 22:10,22,69.1,38,64.5,60,66.2,2,0,0
2/07/2018 22:15,26,69.5,42,64.9,68,66.7,2,0,0
2/07/2018 22:20,20,69.6,36,65,56,66.6,2,0,0
2/07/2018 22:25,17,69.5,33,64.9,50,66.4,2,0,0
2/07/2018 22:30,20,69.5,36,64.9,56,66.6,2,0,0
2/07/2018 22:35,17,69.2,32,64.5,49,66.1,2,0,0
2/07/2018 22:40,21,69.3,38,64.6,59,66.3,2,0,0
2/07/2018 22:45,21,69.5,36,64.9,57,66.6,2,0,0
2/07/2018 22:50,17,69.8,32,65.2,49,66.8,2,0,0
2/07/2018 22:55,15,69.6,30,65,45,66.6,2,0,0
2/07/2018 23:00,16,69.7,31,65.2,47,66.7,2,0,0
2/07/2018 23:05,13,69.6,28,65,41,66.5,2,0,0
2/07/2018 23:10,10,69.5,25,64.9,35,66.2,2,0,0
2/07/2018 23:15,11,69.4,26,64.8,37,66.1,2,0,0
2/07/2018 23:20,14,69.4,29,64.8,43,66.3,2,0,0
2/07/2018 23:25,11,69.4,27,64.8,38,66.1,2,0,0
2/07/2018 23:30,16,69.2,31,64.5,47,66.1,2,0,0
2/07/2018 23:35,16,69.5,32,64.9,48,66.4,2,0,0
2/07/2018 23:40,15,69.4,31,64.8,46,66.3,2,0,0
2/07/2018 23:45,9,69.3,26,64.7,35,65.9,2,0,0
2/07/2018 23:50,11,69.4,27,64.8,38,66.2,2,0,0
2/07/2018 23:55,10,69.2,26,64.6,36,65.9,2,0,0
2/08/2018 0:00,11,69.3,26,64.7,37,66.1,2,0,0
2/08/2018 0:05,9,69.4,24,64.8,33,66.1,2,0,0
2/08/2018 0:10,10,69.1,25,64.4,35,65.8,2,0,0
2/08/2018 0:15,9,69.1,24,64.5,33,65.7,2,0,0
2/08/2018 0:20,8,69.2,23,64.6,31,65.8,2,0,0
2/08/2018 0:25,7,69.3,22,64.7,29,65.8,2,0,0
2/08/2018 0:30,5,69.2,21,64.6,26,65.5,2,0,0
2/08/2018 0:35,6,69.4,22,64.8,28,65.8,2,0,0
2/08/2018 0:40,8,69.5,23,64.9,31,66.1,2,0,0
2/08/2018 0:45,5,69.4,21,64.8,26,65.7,2,0,0
2/08/2018 0:50,6,69.3,21,64.7,27,65.8,2,0,0
2/08/2018 0:55,7,69.3,22,64.7,29,65.8,2,0,0
2/08/2018 1:00,4,69.3,20,64.7,24,65.5,2,0,0
2/08/2018 1:05,6,69.4,22,64.8,28,65.8,2,0,0
2/08/2018 1:10,6,69.3,21,64.7,27,65.8,2,0,0
2/08/2018 1:15,7,69.3,23,64.7,30,65.7,2,0,0
2/08/2018 1:20,13,69.3,21,64.7,34,66.4,2,0,0
2/08/2018 1:25,14,69.3,22,64.7,36,66.5,2,0,0
2/08/2018 1:30,8,69.4,23,64.8,31,66,2,0,0
2/08/2018 1:35,9,69.4,24,64.8,33,66.1,2,0,0
2/08/2018 1:40,9,69.4,24,64.8,33,66,2,0,0
2/08/2018 1:45,6,69.4,21,64.8,27,65.8,2,0,0
2/08/2018 1:50,5,69.4,20,64.8,25,65.8,2,0,0
2/08/2018 1:55,5,69.4,21,64.8,26,65.7,2,0,0
2/08/2018 2:00,6,68.9,21,64.2,27,65.3,2,0,0
2/08/2018 2:05,11,69.2,27,64.6,38,65.9,2,0,0
2/08/2018 2:10,7,69.2,23,64.6,30,65.7,2,0,0
2/08/2018 2:15,6,69.2,22,64.6,28,65.6,2,0,0
2/08/2018 2:20,7,69.3,22,64.7,29,65.8,2,0,0
2/08/2018 2:25,13,69.3,21,64.7,34,66.4,2,0,0
2/08/2018 2:30,6,69.3,21,64.7,27,65.7,2,0,0
2/08/2018 2:35,7,69.4,22,64.7,29,65.9,2,0,0
2/08/2018 2:40,11,69.3,26,64.7,37,66.1,2,0,0
2/08/2018 2:45,10,69.4,26,64.8,36,66.1,2,0,0
2/08/2018 2:50,10,69.4,26,64.8,36,66.1,2,0,0
2/08/2018 2:55,10,69.3,25,64.7,35,66,2,0,0
2/08/2018 3:00,6,69.3,22,64.7,28,65.7,2,0,0
2/08/2018 3:05,8,69.3,23,64.7,31,65.8,2,0,0
2/08/2018 3:10,11,69,26,64.4,37,65.8,2,0,0
2/08/2018 3:15,8,68.9,24,64.3,32,65.4,2,0,0
2/08/2018 3:20,8,69.2,24,64.6,32,65.7,2,0,0
2/08/2018 3:25,10,69.3,26,64.7,36,65.9,2,0,0
2/08/2018 3:30,11,69.2,27,64.6,38,65.9,2,0,0
2/08/2018 3:35,11,69.1,26,64.4,37,65.8,2,0,0
2/08/2018 3:40,11,69.3,26,64.7,37,66.1,2,0,0
2/08/2018 3:45,16,69.3,31,64.7,47,66.3,2,0,0
2/08/2018 3:50,13,69.3,28,64.7,41,66.1,2,0,0
2/08/2018 3:55,19,69.4,35,64.8,54,66.4,2,0,0
2/08/2018 4:00,12,69.6,27,65,39,66.4,2,0,0
2/08/2018 4:05,19,69.3,35,64.6,54,66.3,2,0,0
2/08/2018 4:10,20,69.3,37,64.7,57,66.3,2,0,0
2/08/2018 4:15,21,69.1,38,64.5,59,66.1,2,0,0
2/08/2018 4:20,22,69.5,38,64.9,60,66.5,2,0,0
2/08/2018 4:25,17,69.2,34,64.5,51,66.1,2,0,0
2/08/2018 4:30,31,69.3,48,64.7,79,66.5,2,0,0
2/08/2018 4:35,27,69.1,44,64.5,71,66.2,2,0,0
2/08/2018 4:40,37,69.8,55,65.2,92,67.1,2,0,0
2/08/2018 4:45,32,69.3,49,64.8,81,66.6,2,0,0
2/08/2018 4:50,35,69.5,53,65,88,66.8,2,0,0
2/08/2018 4:55,35,69.3,53,64.7,88,66.6,2,0,0
2/08/2018 5:00,40,70.2,59,65.6,99,67.4,2,0,0
2/08/2018 5:05,33,70,51,65.4,84,67.2,2,0,0
2/08/2018 5:10,47,70.6,66,66.1,113,68,2,0,0
2/08/2018 5:15,46,70.6,64,66,110,67.9,2,0,0
2/08/2018 5:20,46,70.1,65,65.6,111,67.4,2,0,0
2/08/2018 5:25,58,70.5,80,66.1,138,67.9,2,0,0
2/08/2018 5:30,50,70.1,69,65.5,119,67.4,2,0,0
2/08/2018 5:35,60,70.1,80,65.6,140,67.5,2,0,0
2/08/2018 5:40,61,69.5,81,64.9,142,66.9,2,0,0
2/08/2018 5:45,74,68.5,98,63.9,172,65.9,2,0,0
2/08/2018 5:50,66,69.8,88,65.3,154,67.2,2,0,0
2/08/2018 5:55,60,70.1,79,65.5,139,67.5,2,0,0
2/08/2018 6:00,67,68.5,88,63.8,155,65.8,2,0,0
2/08/2018 6:05,52,69.4,71,64.9,123,66.8,2,0,0
2/08/2018 6:10,69,68.6,91,64,160,66,2,0,0
2/08/2018 6:15,71,67.9,93,63.1,164,65.2,2,0,0
2/08/2018 6:20,35,67.8,54,63,89,64.9,2,0,0
2/08/2018 6:25,46,68.5,66,63.8,112,65.7,2,0,0
2/08/2018 6:30,46,68.6,66,63.9,112,65.8,2,0,0
2/08/2018 6:35,43,68.1,62,63.3,105,65.3,2,0,0
2/08/2018 6:40,56,67.7,76,62.9,132,65,2,0,0
2/08/2018 6:45,56,68,77,63.2,133,65.2,2,0,0
2/08/2018 6:50,57,68.7,78,63.9,135,65.9,2,0,0
2/08/2018 6:55,61,68.4,81,63.6,142,65.7,2,0,0
2/08/2018 7:00,45,68.7,64,63.9,109,65.9,2,0,0
2/08/2018 7:05,50,67.7,71,62.9,121,64.9,2,0,0
2/08/2018 7:10,57,68.3,77,63.6,134,65.6,2,0,0
2/08/2018 7:15,58,69.4,79,64.8,137,66.7,2,0,0
2/08/2018 7:20,51,68.5,71,63.8,122,65.7,2,0,0
2/08/2018 7:25,50,68.8,70,64,120,66,2,0,0
2/08/2018 7:30,52,67.7,72,62.9,124,64.9,2,0,0
2/08/2018 7:35,62,67.8,83,62.9,145,65,2,0,0
2/08/2018 7:40,64,67.8,85,63,149,65.1,2,0,0
2/08/2018 7:45,70,66.5,93,61.5,163,63.6,2,0,0
2/08/2018 7:50,57,66.5,77,61.5,134,63.6,2,0,0
2/08/2018 7:55,48,66.1,67,61.1,115,63.2,2,0,0
2/08/2018 8:00,61,66.5,82,61.5,143,63.7,2,0,0
2/08/2018 8:05,55,66.6,76,61.6,131,63.7,2,0,0
2/08/2018 8:10,61,67,81,62.1,142,64.2,2,0,0
2/08/2018 8:15,57,68.1,77,63.2,134,65.3,2,0,0
2/08/2018 8:20,53,67.4,72,62.5,125,64.6,2,0,0
2/08/2018 8:25,58,66.9,79,62,137,64.1,2,0,0
2/08/2018 8:30,50,66.3,70,61.4,120,63.4,2,0,0
2/08/2018 8:35,59,66.5,78,61.6,137,63.7,2,0,0
2/08/2018 8:40,53,67.2,73,62.2,126,64.3,2,0,0
2/08/2018 8:45,57,65.3,77,60.2,134,62.4,2,0,0
2/08/2018 8:50,64,63.6,85,58.4,149,60.6,2,0,0
2/08/2018 8:55,56,65.2,76,60,132,62.2,2,0,0
2/08/2018 9:00,45,64.4,64,59.4,109,61.5,2,0,0
2/08/2018 9:05,79,66.2,102,61.3,181,63.5,2,0,0
2/08/2018 9:10,71,66.7,91,61.9,162,64,2,0,0
2/08/2018 9:15,67,66.4,87,61.6,154,63.7,2,0,0
2/08/2018 9:20,84,66.3,107,61.5,191,63.6,2,0,0
2/08/2018 9:25,72,68.4,93,63.8,165,65.8,2,0,0
2/08/2018 9:30,71,67.8,92,63.1,163,65.1,2,0,0
2/08/2018 9:35,74,65.5,96,60.7,170,62.8,2,0,0
2/08/2018 9:40,72,65.3,94,60.5,166,62.6,2,0,0
2/08/2018 9:45,84,65.2,107,60.3,191,62.5,2,0,0
2/08/2018 9:50,79,67.2,101,62.5,180,64.6,2,0,0
2/08/2018 9:55,77,66.9,98,62.2,175,64.3,2,0,0
2/08/2018 10:00,72,68.4,92,63.7,164,65.8,2,0,0
2/08/2018 10:05,74,68,96,63.3,170,65.3,2,0,0
2/08/2018 10:10,62,67.7,81,62.9,143,65,2,0,0
2/08/2018 10:15,62,67.9,82,63.1,144,65.2,2,0,0
2/08/2018 10:20,56,66.1,75,61.2,131,63.3,2,0,0
2/08/2018 10:25,55,66.8,73,62,128,64.1,2,0,0
2/08/2018 10:30,48,67.8,66,63.2,114,65.2,2,0,0
2/08/2018 10:35,52,66.7,71,62,123,64,2,0,0
2/08/2018 10:40,50,66,68,61.2,118,63.3,2,0,0
2/08/2018 10:45,55,67.7,73,63,128,65,2,0,0
2/08/2018 10:50,56,66.9,75,62.2,131,64.2,2,0,0
2/08/2018 10:55,49,67.3,67,62.6,116,64.6,2,0,0
2/08/2018 11:00,60,67.4,79,62.8,139,64.8,2,0,0
2/08/2018 11:05,53,66.3,71,61.5,124,63.6,2,0,0
2/08/2018 11:10,73,66,93,61.2,166,63.3,2,0,0
2/08/2018 11:15,58,65.8,77,61,135,63.1,2,0,0
2/08/2018 11:20,62,66.1,80,61.3,142,63.4,2,0,0
2/08/2018 11:25,53,66.2,70,61.4,123,63.5,2,0,0
2/08/2018 11:30,51,67.1,69,62.4,120,64.4,2,0,0
2/08/2018 11:35,52,68.2,70,63.5,122,65.5,2,0,0
2/08/2018 11:40,55,68.7,73,64.1,128,66.1,2,0,0
2/08/2018 11:45,60,66.7,80,61.9,140,63.9,2,0,0
2/08/2018 11:50,60,68.2,79,63.5,139,65.5,2,0,0
2/08/2018 11:55,63,68,83,63.3,146,65.3,2,0,0
2/08/2018 12:00,55,67.8,72,63.2,127,65.2,2,0,0
2/08/2018 12:05,56,67.3,74,62.6,130,64.6,2,0,0
2/08/2018 12:10,56,66.3,74,61.4,130,63.5,2,0,0
2/08/2018 12:15,58,65.4,77,60.5,135,62.6,2,0,0
2/08/2018 12:20,60,65,79,60,139,62.2,2,0,0
2/08/2018 12:25,43,66.1,61,61.3,104,63.3,2,0,0
2/08/2018 12:30,50,67.1,69,62.4,119,64.4,2,0,0
2/08/2018 12:35,48,68,65,63.3,113,65.3,2,0,0
2/08/2018 12:40,50,69.6,67,65.1,117,67,2,0,0
2/08/2018 12:45,51,69.1,68,64.6,119,66.5,2,0,0
2/08/2018 12:50,47,66.4,64,61.6,111,63.6,2,0,0
2/08/2018 12:55,53,65.3,71,60.5,124,62.5,2,0,0
2/08/2018 13:00,48,64.9,65,60,113,62.1,2,0,0
2/08/2018 13:05,46,65.6,63,60.7,109,62.8,2,0,0
2/08/2018 13:10,36,68.1,53,63.3,89,65.2,2,0,0
2/08/2018 13:15,49,67.6,66,62.8,115,64.8,2,0,0
2/08/2018 13:20,46,67.9,64,63.2,110,65.2,2,0,0
2/08/2018 13:25,54,66.8,72,62,126,64.1,2,0,0
2/08/2018 13:30,46,68.3,63,63.6,109,65.6,2,0,0
2/08/2018 13:35,52,67.5,70,62.7,122,64.8,2,0,0
2/08/2018 13:40,45,68.2,63,63.6,108,65.5,2,0,0
2/08/2018 13:45,43,67.9,60,63.2,103,65.2,2,0,0
2/08/2018 13:50,50,68.2,67,63.5,117,65.5,2,0,0
2/08/2018 13:55,45,67.7,63,62.9,108,64.9,2,0,0
2/08/2018 14:00,53,68.1,72,63.4,125,65.3,2,0,0
2/08/2018 14:05,47,69,64,64.3,111,66.3,2,0,0
2/08/2018 14:10,43,69.6,60,65.1,103,67,2,0,0
2/08/2018 14:15,40,69.1,58,64.5,98,66.4,2,0,0
2/08/2018 14:20,51,68.4,69,63.8,120,65.7,2,0,0
2/08/2018 14:25,44,69.1,62,64.5,106,66.4,2,0,0
2/08/2018 14:30,59,69.2,77,64.6,136,66.6,2,0,0
2/08/2018 14:35,45,69.5,62,64.9,107,66.8,2,0,0
2/08/2018 14:40,50,67.5,68,62.9,118,64.8,2,0,0
2/08/2018 14:45,50,67,68,62.4,118,64.3,2,0,0
2/08/2018 14:50,46,67.9,64,63.2,110,65.2,2,0,0
2/08/2018 14:55,52,69.1,70,64.5,122,66.5,2,0,0
2/08/2018 15:00,57,66.9,76,62.1,133,64.2,2,0,0
2/08/2018 15:05,49,67,67,62.3,116,64.3,2,0,0
2/08/2018 15:10,46,67.1,65,62.3,111,64.3,2,0,0
2/08/2018 15:15,66,67.6,84,62.9,150,64.9,2,0,0
2/08/2018 15:20,61,67.3,81,62.6,142,64.6,2,0,0
2/08/2018 15:25,58,67.3,76,62.6,134,64.6,2,0,0
2/08/2018 15:30,65,67.3,83,62.6,148,64.6,2,0,0
2/08/2018 15:35,60,68.6,80,64,140,66,2,0,0
2/08/2018 15:40,59,68.2,77,63.5,136,65.5,2,0,0
2/08/2018 15:45,62,68.9,80,64.3,142,66.3,2,0,0
2/08/2018 15:50,57,68.5,76,63.9,133,65.9,2,0,0
2/08/2018 15:55,56,68.4,74,63.8,130,65.7,2,0,0
2/08/2018 16:00,59,69.1,76,64.5,135,66.5,2,0,0
2/08/2018 16:05,67,68.8,86,64.2,153,66.2,2,0,0
2/08/2018 16:10,60,68.4,79,63.7,139,65.8,2,0,0
2/08/2018 16:15,54,67.9,72,63.2,126,65.2,2,0,0
2/08/2018 16:20,56,68.4,75,63.8,131,65.8,2,0,0
2/08/2018 16:25,54,68.7,72,64.1,126,66.1,2,0,0
2/08/2018 16:30,51,67.3,69,62.5,120,64.6,2,0,0
2/08/2018 16:35,57,68.3,77,63.6,134,65.6,2,0,0
2/08/2018 16:40,57,67.9,76,63.2,133,65.2,2,0,0
2/08/2018 16:45,54,68.8,73,64.1,127,66.1,2,0,0
2/08/2018 16:50,51,69.5,69,65,120,66.9,2,0,0
2/08/2018 16:55,50,68.5,68,64,118,65.9,2,0,0
2/08/2018 17:00,50,68.6,68,64.1,118,66,2,0,0
2/08/2018 17:05,50,68.9,67,64.3,117,66.2,2,0,0
2/08/2018 17:10,54,68.4,73,63.8,127,65.8,2,0,0
2/08/2018 17:15,60,68.6,79,64,139,66,2,0,0
2/08/2018 17:20,54,68,72,63.3,126,65.3,2,0,0
2/08/2018 17:25,50,62,69,56.6,119,58.9,2,0,0
2/08/2018 17:30,56,55.5,75,49.3,131,51.9,2,0,0
2/08/2018 17:35,52,53.2,70,46.8,122,49.5,2,0,0
2/08/2018 17:40,61,55.8,80,49.7,141,52.4,2,0,0
2/08/2018 17:45,55,55.2,73,49,128,51.7,2,0,0
2/08/2018 17:50,47,60,66,54.3,113,56.7,2,0,0
2/08/2018 17:55,57,60.3,75,54.5,132,57,2,0,0
2/08/2018 18:00,58,56.8,77,50.8,135,53.4,2,0,0
2/08/2018 18:05,56,58,74,52.1,130,54.7,2,0,0
2/08/2018 18:10,53,62.1,72,56.8,125,59,2,0,0
2/08/2018 18:15,53,61,72,55.6,125,57.9,2,0,0
2/08/2018 18:20,42,58.5,60,52.8,102,55.1,2,0,0
2/08/2018 18:25,55,62.1,73,56.7,128,59,2,0,0
2/08/2018 18:30,44,65.3,61,60.3,105,62.4,2,0,0
2/08/2018 18:35,54,67.2,73,62.3,127,64.4,2,0,0
2/08/2018 18:40,64,67.3,83,62.5,147,64.6,2,0,0
2/08/2018 18:45,52,68.6,69,64,121,66,2,0,0
2/08/2018 18:50,48,69.3,66,64.7,114,66.6,2,0,0
2/08/2018 18:55,55,68.5,74,63.8,129,65.8,2,0,0
2/08/2018 19:00,48,68.5,65,63.9,113,65.9,2,0,0
2/08/2018 19:05,47,69.5,64,64.9,111,66.8,2,0,0
2/08/2018 19:10,51,69.7,69,65.1,120,67.1,2,0,0
2/08/2018 19:15,47,69.9,64,65.4,111,67.3,2,0,0
2/08/2018 19:20,57,68.5,74,63.8,131,65.9,2,0,0
2/08/2018 19:25,41,67.9,58,63.1,99,65.1,2,0,0
2/08/2018 19:30,38,67.9,54,63.2,92,65.1,2,0,0
2/08/2018 19:35,41,68.9,59,64.3,100,66.2,2,0,0
2/08/2018 19:40,39,69.9,56,65.4,95,67.3,2,0,0
2/08/2018 19:45,33,69.7,49,65.2,82,67,2,0,0
2/08/2018 19:50,37,69.7,54,65.1,91,67,2,0,0
2/08/2018 19:55,30,69.8,47,65.2,77,67,2,0,0
2/08/2018 20:00,30,69.5,47,64.8,77,66.6,2,0,0
2/08/2018 20:05,32,69,48,64.3,80,66.2,2,0,0
2/08/2018 20:10,33,69.8,49,65.2,82,67,2,0,0
2/08/2018 20:15,29,69.7,45,65,74,66.9,2,0,0
2/08/2018 20:20,33,69.8,49,65.2,82,67,2,0,0
2/08/2018 20:25,29,69.6,45,65,74,66.8,2,0,0
2/08/2018 20:30,29,69.7,45,65.1,74,66.9,2,0,0
2/08/2018 20:35,25,69.1,42,64.5,67,66.2,2,0,0
2/08/2018 20:40,33,69.3,50,64.7,83,66.5,2,0,0
2/08/2018 20:45,31,69.6,47,65,78,66.9,2,0,0
2/08/2018 20:50,31,69.7,47,65.1,78,66.9,2,0,0
2/08/2018 20:55,35,69.3,51,64.7,86,66.6,2,0,0
2/08/2018 21:00,32,69.6,48,65.1,80,66.9,2,0,0
2/08/2018 21:05,28,69.8,44,65.3,72,67,2,0,0
2/08/2018 21:10,32,69.7,49,65.2,81,67,2,0,0
2/08/2018 21:15,27,69.3,44,64.7,71,66.4,2,0,0
2/08/2018 21:20,32,68.6,48,63.9,80,65.8,2,0,0
2/08/2018 21:25,34,69,51,64.3,85,66.2,2,0,0
2/08/2018 21:30,32,69,49,64.4,81,66.2,2,0,0
2/08/2018 21:35,35,69.8,52,65.2,87,67.1,2,0,0
2/08/2018 21:40,32,69.4,48,64.8,80,66.7,2,0,0
2/08/2018 21:45,28,68.9,44,64.3,72,66.1,2,0,0
2/08/2018 21:50,28,70,44,65.5,72,67.2,2,0,0
2/08/2018 21:55,32,69.6,48,65,80,66.8,2,0,0
2/08/2018 22:00,30,69.2,46,64.6,76,66.5,2,0,0
2/08/2018 22:05,27,69.4,42,64.8,69,66.6,2,0,0
2/08/2018 22:10,27,69.5,43,65,70,66.7,2,0,0
2/08/2018 22:15,30,69.5,46,64.9,76,66.7,2,0,0
2/08/2018 22:20,30,69.2,47,64.6,77,66.4,2,0,0
2/08/2018 22:25,40,68.7,57,64.1,97,66,2,0,0
2/08/2018 22:30,23,68.7,39,64.1,62,65.8,2,0,0
2/08/2018 22:35,28,69.1,45,64.5,73,66.2,2,0,0
2/08/2018 22:40,23,69.3,39,64.8,62,66.5,2,0,0
2/08/2018 22:45,23,69.2,39,64.7,62,66.4,2,0,0
2/08/2018 22:50,23,69.3,39,64.7,62,66.4,2,0,0
2/08/2018 22:55,14,69.4,30,64.8,44,66.2,2,0,0
2/08/2018 23:00,18,69.5,34,64.9,52,66.5,2,0,0
2/08/2018 23:05,17,69,33,64.4,50,66,2,0,0
2/08/2018 23:10,17,69.1,33,64.5,50,66.1,2,0,0
2/08/2018 23:15,18,69.2,34,64.6,52,66.2,2,0,0
2/08/2018 23:20,13,69.2,28,64.6,41,66.1,2,0,0
2/08/2018 23:25,16,69.4,32,64.8,48,66.3,2,0,0
2/08/2018 23:30,20,69.5,35,64.9,55,66.6,2,0,0
2/08/2018 23:35,16,69.4,31,64.8,47,66.4,2,0,0
2/08/2018 23:40,17,69.4,32,64.8,49,66.4,2,0,0
2/08/2018 23:45,11,69.4,27,64.8,38,66.2,2,0,0
2/08/2018 23:50,11,69.4,27,64.8,38,66.1,2,0,0
2/08/2018 23:55,12,69.4,27,64.8,39,66.2,2,0,0
2/09/2018 0:00,13,69.3,28,64.7,41,66.2,2,0,0
2/09/2018 0:05,12,69.4,28,64.8,40,66.2,2,0,0
2/09/2018 0:10,14,69.2,29,64.6,43,66.1,2,0,0
2/09/2018 0:15,10,69.4,26,64.8,36,66.1,2,0,0
2/09/2018 0:20,10,69.3,25,64.7,35,66,2,0,0
2/09/2018 0:25,9,68.7,24,64,33,65.3,2,0,0
2/09/2018 0:30,10,68.9,25,64.2,35,65.5,2,0,0
2/09/2018 0:35,10,68.9,25,64.2,35,65.6,2,0,0
2/09/2018 0:40,8,69.2,24,64.6,32,65.7,2,0,0
2/09/2018 0:45,10,69.2,26,64.5,36,65.8,2,0,0
2/09/2018 0:50,9,69.2,24,64.6,33,65.8,2,0,0
2/09/2018 0:55,7,69.3,22,64.7,29,65.8,2,0,0
2/09/2018 1:00,9,69.3,24,64.6,33,65.9,2,0,0
2/09/2018 1:05,10,69.4,26,64.8,36,66.1,2,0,0
2/09/2018 1:10,8,69.3,23,64.7,31,65.9,2,0,0
2/09/2018 1:15,7,69.1,22,64.5,29,65.6,2,0,0
2/09/2018 1:20,7,69.3,22,64.7,29,65.8,2,0,0
2/09/2018 1:25,9,69.4,24,64.8,33,66,2,0,0
2/09/2018 1:30,9,69.3,24,64.7,33,66,2,0,0
2/09/2018 1:35,8,69.2,23,64.6,31,65.8,2,0,0
2/09/2018 1:40,6,69.2,22,64.6,28,65.6,2,0,0
2/09/2018 1:45,5,69.4,21,64.8,26,65.7,2,0,0
2/09/2018 1:50,8,69.4,24,64.8,32,66,2,0,0
2/09/2018 1:55,7,69.3,23,64.7,30,65.7,2,0,0
2/09/2018 2:00,12,69.4,21,64.8,33,66.4,2,0,0
2/09/2018 2:05,7,69.2,23,64.6,30,65.7,2,0,0
2/09/2018 2:10,10,69.3,25,64.7,35,66,2,0,0
2/09/2018 2:15,7,69.4,22,64.8,29,65.9,2,0,0
2/09/2018 2:20,9,69.4,24,64.8,33,66,2,0,0
2/09/2018 2:25,9,69.3,24,64.7,33,66,2,0,0
2/09/2018 2:30,8,69.4,24,64.8,32,65.9,2,0,0
2/09/2018 2:35,5,69.3,20,64.7,25,65.7,2,0,0
2/09/2018 2:40,10,69.3,26,64.7,36,66,2,0,0
2/09/2018 2:45,13,69.1,28,64.5,41,66,2,0,0
2/09/2018 2:50,6,69.3,21,64.7,27,65.7,2,0,0
2/09/2018 2:55,8,69.2,23,64.6,31,65.8,2,0,0
2/09/2018 3:00,11,69,26,64.4,37,65.7,2,0,0
2/09/2018 3:05,9,68.9,25,64.2,34,65.5,2,0,0
2/09/2018 3:10,11,69.1,27,64.5,38,65.8,2,0,0
2/09/2018 3:15,9,69.2,25,64.6,34,65.8,2,0,0
2/09/2018 3:20,8,69.3,24,64.7,32,65.9,2,0,0
2/09/2018 3:25,14,69.4,30,64.8,44,66.3,2,0,0
2/09/2018 3:30,12,69.4,28,64.8,40,66.2,2,0,0
2/09/2018 3:35,12,69.3,27,64.7,39,66.1,2,0,0
2/09/2018 3:40,12,69.3,27,64.7,39,66.1,2,0,0
2/09/2018 3:45,14,69.4,29,64.8,43,66.3,2,0,0
2/09/2018 3:50,14,68.9,29,64.3,43,65.8,2,0,0
2/09/2018 3:55,15,69.1,30,64.4,45,66,2,0,0
2/09/2018 4:00,13,69.4,28,64.8,41,66.2,2,0,0
2/09/2018 4:05,25,69.4,42,64.8,67,66.6,2,0,0
2/09/2018 4:10,18,69.5,34,64.9,52,66.5,2,0,0
2/09/2018 4:15,16,69.6,32,65,48,66.5,2,0,0
2/09/2018 4:20,22,69.6,39,65,61,66.7,2,0,0
2/09/2018 4:25,25,69.2,42,64.5,67,66.3,2,0,0
2/09/2018 4:30,27,69.4,44,64.8,71,66.6,2,0,0
2/09/2018 4:35,29,69.6,46,65,75,66.8,2,0,0
2/09/2018 4:40,35,70.4,52,65.9,87,67.7,2,0,0
2/09/2018 4:45,34,70.1,53,65.6,87,67.4,2,0,0
2/09/2018 4:50,29,69.1,46,64.5,75,66.2,2,0,0
2/09/2018 4:55,35,69.8,52,65.2,87,67.1,2,0,0
2/09/2018 5:00,38,71.1,56,66.7,94,68.4,2,0,0
2/09/2018 5:05,31,70.3,49,65.8,80,67.6,2,0,0
2/09/2018 5:10,42,70.5,61,66,103,67.8,2,0,0
2/09/2018 5:15,41,70.7,60,66.2,101,68.1,2,0,0
2/09/2018 5:20,52,68.6,72,63.9,124,65.8,2,0,0
2/09/2018 5:25,59,69,80,64.4,139,66.3,2,0,0
2/09/2018 5:30,61,67.4,82,62.7,143,64.7,2,0,0
2/09/2018 5:35,58,68.8,77,64.2,135,66.2,2,0,0
2/09/2018 5:40,54,69.7,74,65.1,128,67.1,2,0,0
2/09/2018 5:45,61,68.5,80,63.9,141,65.9,2,0,0
2/09/2018 5:50,57,67.6,78,62.8,135,64.8,2,0,0
2/09/2018 5:55,72,68.8,94,64,166,66.1,2,0,0
2/09/2018 6:00,51,69.3,71,64.6,122,66.6,2,0,0
2/09/2018 6:05,55,67.6,76,62.8,131,64.8,2,0,0
2/09/2018 6:10,64,67.5,87,62.6,151,64.6,2,0,0
2/09/2018 6:15,62,66.9,83,61.9,145,64.1,2,0,0
2/09/2018 6:20,69,67,91,62,160,64.1,2,0,0
2/09/2018 6:25,67,67.9,89,63,156,65.1,2,0,0
2/09/2018 6:30,75,67,98,62.1,173,64.3,2,0,0
2/09/2018 6:35,63,67,84,62,147,64.1,2,0,0
2/09/2018 6:40,71,66.1,92,61.1,163,63.3,2,0,0
2/09/2018 6:45,79,66.3,101,61.3,180,63.5,2,0,0
2/09/2018 6:50,69,67.3,91,62.4,160,64.5,2,0,0
2/09/2018 6:55,71,67.6,94,62.7,165,64.8,2,0,0
2/09/2018 7:00,69,67.1,91,62.1,160,64.3,2,0,0
2/09/2018 7:05,73,67.6,96,62.7,169,64.8,2,0,0
2/09/2018 7:10,85,66.1,109,61.2,194,63.4,2,0,0
2/09/2018 7:15,83,66.4,106,61.6,189,63.7,2,0,0
2/09/2018 7:20,80,66.4,103,61.4,183,63.6,2,0,0
2/09/2018 7:25,77,66.7,99,61.7,176,63.9,2,0,0
2/09/2018 7:30,76,66.8,99,61.9,175,64,2,0,0
2/09/2018 7:35,80,66.9,103,61.9,183,64.1,2,0,0
2/09/2018 7:40,79,66.8,102,61.9,181,64,2,0,0
2/09/2018 7:45,89,65.8,112,60.7,201,63,2,0,0
2/09/2018 7:50,75,65.9,98,60.9,173,63.1,2,0,0
2/09/2018 7:55,75,67.1,97,62.2,172,64.3,2,0,0
2/09/2018 8:00,72,67.1,94,62.3,166,64.4,2,0,0
2/09/2018 8:05,76,67.4,98,62.5,174,64.6,2,0,0
2/09/2018 8:10,86,66.8,109,61.9,195,64,2,0,0
2/09/2018 8:15,84,66.8,106,61.9,190,64.1,2,0,0
2/09/2018 8:20,77,66.9,98,62.1,175,64.2,2,0,0
2/09/2018 8:25,71,66.5,92,61.6,163,63.7,2,0,0
2/09/2018 8:30,77,65.3,99,60.3,176,62.5,2,0,0
2/09/2018 8:35,78,65.2,100,60.2,178,62.4,2,0,0
2/09/2018 8:40,75,66.1,96,61.2,171,63.4,2,0,0
2/09/2018 8:45,81,65.8,104,60.8,185,63,2,0,0
2/09/2018 8:50,77,65.5,98,60.5,175,62.7,2,0,0
2/09/2018 8:55,77,65.4,98,60.3,175,62.5,2,0,0
2/09/2018 9:00,76,64.9,97,59.8,173,62.1,2,0,0
2/09/2018 9:05,59,64.2,79,59.1,138,61.3,2,0,0
2/09/2018 9:10,72,63.8,93,58.6,165,60.9,2,0,0
2/09/2018 9:15,76,64.2,97,59.1,173,61.3,2,0,0
2/09/2018 9:20,71,64,92,58.9,163,61.1,2,0,0
2/09/2018 9:25,84,64,107,58.8,191,61.1,2,0,0
2/09/2018 9:30,86,64.6,107,59.5,193,61.8,2,0,0
2/09/2018 9:35,79,64.4,100,59.3,179,61.6,2,0,0
2/09/2018 9:40,76,64.5,97,59.4,173,61.6,2,0,0
2/09/2018 9:45,78,64.7,98,59.6,176,61.9,2,0,0
2/09/2018 9:50,73,65.9,93,61,166,63.2,2,0,0
2/09/2018 9:55,74,65.3,94,60.3,168,62.5,2,0,0
2/09/2018 10:00,67,66.7,86,61.9,153,64,2,0,0
2/09/2018 10:05,65,65.8,85,60.9,150,63,2,0,0
2/09/2018 10:10,68,66.4,86,61.5,154,63.7,2,0,0
2/09/2018 10:15,68,66.3,86,61.5,154,63.6,2,0,0
2/09/2018 10:20,68,67,89,62.2,157,64.3,2,0,0
2/09/2018 10:25,66,67.1,87,62.4,153,64.4,2,0,0
2/09/2018 10:30,63,66.5,82,61.8,145,63.8,2,0,0
2/09/2018 10:35,68,64.9,88,60.1,156,62.2,2,0,0
2/09/2018 10:40,65,65.7,85,60.8,150,62.9,2,0,0
2/09/2018 10:45,64,67.5,84,62.8,148,64.8,2,0,0
2/09/2018 10:50,52,68.1,70,63.5,122,65.5,2,0,0
2/09/2018 10:55,53,67,71,62.3,124,64.3,2,0,0
2/09/2018 11:00,60,67,79,62.2,139,64.3,2,0,0
2/09/2018 11:05,53,65.9,72,61,125,63.1,2,0,0
2/09/2018 11:10,57,65.7,75,60.9,132,63,2,0,0
2/09/2018 11:15,69,66.1,89,61.3,158,63.4,2,0,0
2/09/2018 11:20,56,67.6,74,62.9,130,64.9,2,0,0
2/09/2018 11:25,51,67.8,69,63.2,120,65.1,2,0,0
2/09/2018 11:30,52,68.1,70,63.4,122,65.4,2,0,0
2/09/2018 11:35,68,67.7,87,63,155,65,2,0,0
2/09/2018 11:40,54,67.3,72,62.6,126,64.6,2,0,0
2/09/2018 11:45,63,67.3,82,62.6,145,64.6,2,0,0
2/09/2018 11:50,53,67,72,62.3,125,64.3,2,0,0
2/09/2018 11:55,50,66.5,68,61.8,118,63.8,2,0,0
2/09/2018 12:00,56,66.4,74,61.7,130,63.7,2,0,0
2/09/2018 12:05,60,68,80,63.3,140,65.3,2,0,0
2/09/2018 12:10,51,69.4,69,64.9,120,66.8,2,0,0
2/09/2018 12:15,60,67.9,78,63.3,138,65.3,2,0,0
2/09/2018 12:20,54,68.1,72,63.5,126,65.5,2,0,0
2/09/2018 12:25,53,69,70,64.5,123,66.4,2,0,0
2/09/2018 12:30,58,68.2,76,63.6,134,65.6,2,0,0
2/09/2018 12:35,57,67.6,75,62.8,132,64.9,2,0,0
2/09/2018 12:40,53,67.8,71,63,124,65,2,0,0
2/09/2018 12:45,53,68.5,71,63.9,124,65.8,2,0,0
2/09/2018 12:50,58,67,76,62.3,134,64.4,2,0,0
2/09/2018 12:55,46,68.6,63,64,109,66,2,0,0
2/09/2018 13:00,54,67.6,72,62.9,126,64.9,2,0,0
2/09/2018 13:05,51,67.8,70,63.1,121,65.1,2,0,0
2/09/2018 13:10,48,67.7,65,63,113,65,2,0,0
2/09/2018 13:15,50,67.9,68,63.3,118,65.3,2,0,0
2/09/2018 13:20,56,66.4,74,61.5,130,63.6,2,0,0
2/09/2018 13:25,51,67.1,70,62.3,121,64.4,2,0,0
2/09/2018 13:30,56,66.3,75,61.5,131,63.5,2,0,0
2/09/2018 13:35,51,66.5,70,61.8,121,63.8,2,0,0
2/09/2018 13:40,62,65.7,81,60.9,143,63,2,0,0
2/09/2018 13:45,52,66.7,71,61.9,123,63.9,2,0,0
2/09/2018 13:50,50,66.8,68,62,118,64.1,2,0,0
2/09/2018 13:55,51,67.5,69,62.8,120,64.8,2,0,0
2/09/2018 14:00,49,68,67,63.3,116,65.3,2,0,0
2/09/2018 14:05,50,67.6,67,63,117,65,2,0,0
2/09/2018 14:10,52,67.7,71,63.1,123,65,2,0,0
2/09/2018 14:15,53,66.6,71,61.9,124,63.9,2,0,0
2/09/2018 14:20,59,67.7,78,63,137,65,2,0,0
2/09/2018 14:25,59,67.6,77,63,136,65,2,0,0
2/09/2018 14:30,58,67.8,76,63.2,134,65.2,2,0,0
2/09/2018 14:35,51,65.8,70,61,121,63,2,0,0
2/09/2018 14:40,52,65.6,70,60.8,122,62.8,2,0,0
2/09/2018 14:45,56,66.2,74,61.3,130,63.4,2,0,0
2/09/2018 14:50,45,67.4,63,62.7,108,64.6,2,0,0
2/09/2018 14:55,60,68,78,63.4,138,65.4,2,0,0
2/09/2018 15:00,63,69.9,82,65.5,145,67.4,2,0,0
2/09/2018 15:05,70,68.8,90,64.2,160,66.2,2,0,0
2/09/2018 15:10,67,67.8,87,63.1,154,65.1,2,0,0
2/09/2018 15:15,61,68.4,80,63.8,141,65.7,2,0,0
2/09/2018 15:20,70,67.5,90,62.9,160,64.9,2,0,0
2/09/2018 15:25,64,67.9,84,63.2,148,65.2,2,0,0
2/09/2018 15:30,65,67.4,83,62.6,148,64.7,2,0,0
2/09/2018 15:35,69,67.5,89,62.8,158,64.9,2,0,0
2/09/2018 15:40,63,67.5,82,62.8,145,64.8,2,0,0
2/09/2018 15:45,61,67.6,80,62.9,141,65,2,0,0
2/09/2018 15:50,63,68,83,63.4,146,65.4,2,0,0
2/09/2018 15:55,53,69,72,64.4,125,66.4,2,0,0
2/09/2018 16:00,60,69.2,78,64.7,138,66.7,2,0,0
2/09/2018 16:05,54,69.6,71,65.1,125,67,2,0,0
2/09/2018 16:10,52,69.9,70,65.3,122,67.3,2,0,0
2/09/2018 16:15,62,68.1,82,63.4,144,65.4,2,0,0
2/09/2018 16:20,57,67.6,75,62.9,132,64.9,2,0,0
2/09/2018 16:25,55,68.8,73,64.1,128,66.1,2,0,0
2/09/2018 16:30,55,69.3,72,64.7,127,66.7,2,0,0
2/09/2018 16:35,62,69.7,81,65.2,143,67.2,2,0,0
2/09/2018 16:40,60,69.5,78,64.9,138,66.9,2,0,0
2/09/2018 16:45,50,68.8,68,64.1,118,66.1,2,0,0
2/09/2018 16:50,49,69.4,67,64.8,116,66.8,2,0,0
2/09/2018 16:55,50,68,68,63.3,118,65.3,2,0,0
2/09/2018 17:00,57,68.5,76,63.8,133,65.8,2,0,0
2/09/2018 17:05,54,69.3,73,64.7,127,66.6,2,0,0
2/09/2018 17:10,51,69.2,69,64.6,120,66.6,2,0,0
2/09/2018 17:15,57,68.3,75,63.6,132,65.7,2,0,0
2/09/2018 17:20,53,68.3,71,63.7,124,65.7,2,0,0
2/09/2018 17:25,52,68.4,70,63.8,122,65.8,2,0,0
2/09/2018 17:30,44,68.4,63,63.7,107,65.7,2,0,0
2/09/2018 17:35,51,69,70,64.3,121,66.3,2,0,0
2/09/2018 17:40,56,69.2,75,64.5,131,66.5,2,0,0
2/09/2018 17:45,47,68.3,65,63.5,112,65.5,2,0,0
2/09/2018 17:50,55,68.8,72,64.1,127,66.1,2,0,0
2/09/2018 17:55,67,67.3,86,62.6,153,64.7,2,0,0
2/09/2018 18:00,55,68.2,73,63.4,128,65.5,2,0,0
2/09/2018 18:05,61,68.1,80,63.3,141,65.4,2,0,0
2/09/2018 18:10,63,66.9,82,62.1,145,64.2,2,0,0
2/09/2018 18:15,54,67.6,72,62.8,126,64.9,2,0,0
2/09/2018 18:20,61,67.1,80,62.2,141,64.3,2,0,0
2/09/2018 18:25,52,66.4,70,61.4,122,63.6,2,0,0
2/09/2018 18:30,57,66.8,76,61.9,133,64,2,0,0
2/09/2018 18:35,47,67.8,63,63,110,65,2,0,0
2/09/2018 18:40,56,67.2,74,62.4,130,64.4,2,0,0
2/09/2018 18:45,51,68.6,69,63.9,120,65.9,2,0,0
2/09/2018 18:50,51,68.6,69,63.9,120,65.9,2,0,0
2/09/2018 18:55,59,68.9,78,64.3,137,66.3,2,0,0
2/09/2018 19:00,51,68.8,69,64.2,120,66.2,2,0,0
2/09/2018 19:05,41,68.9,58,64.3,99,66.2,2,0,0
2/09/2018 19:10,44,69.1,62,64.5,106,66.4,2,0,0
2/09/2018 19:15,49,69.2,67,64.6,116,66.5,2,0,0
2/09/2018 19:20,45,68.8,63,64.2,108,66.1,2,0,0
2/09/2018 19:25,41,69.5,58,64.8,99,66.7,2,0,0
2/09/2018 19:30,58,69.3,77,64.7,135,66.7,2,0,0
2/09/2018 19:35,45,68.9,63,64.3,108,66.2,2,0,0
2/09/2018 19:40,41,68.9,59,64.3,100,66.2,2,0,0
2/09/2018 19:45,50,69.3,67,64.7,117,66.7,2,0,0
2/09/2018 19:50,45,69.9,63,65.4,108,67.3,2,0,0
2/09/2018 19:55,39,70.4,56,65.8,95,67.7,2,0,0
2/09/2018 20:00,43,69.2,60,64.5,103,66.5,2,0,0
2/09/2018 20:05,37,69.8,54,65.2,91,67.1,2,0,0
2/09/2018 20:10,32,69.5,49,64.9,81,66.7,2,0,0
2/09/2018 20:15,41,69.4,59,64.8,100,66.7,2,0,0
2/09/2018 20:20,34,69.5,51,65,85,66.8,2,0,0
2/09/2018 20:25,34,69.8,51,65.2,85,67,2,0,0
2/09/2018 20:30,37,69.9,54,65.3,91,67.2,2,0,0
2/09/2018 20:35,28,69.3,44,64.7,72,66.5,2,0,0
2/09/2018 20:40,30,69.5,46,64.9,76,66.7,2,0,0
2/09/2018 20:45,26,69.4,41,64.8,67,66.6,2,0,0
2/09/2018 20:50,29,69.1,45,64.5,74,66.3,2,0,0
2/09/2018 20:55,30,69.1,46,64.4,76,66.3,2,0,0
2/09/2018 21:00,35,69.3,51,64.7,86,66.6,2,0,0
2/09/2018 21:05,35,69.6,51,65,86,66.8,2,0,0
2/09/2018 21:10,34,69.3,50,64.7,84,66.6,2,0,0
2/09/2018 21:15,29,68.2,44,63.5,73,65.3,2,0,0
2/09/2018 21:20,32,67.6,49,62.9,81,64.8,2,0,0
2/09/2018 21:25,36,69,53,64.4,89,66.3,2,0,0
2/09/2018 21:30,34,69.2,50,64.6,84,66.4,2,0,0
2/09/2018 21:35,32,69.1,48,64.5,80,66.3,2,0,0
2/09/2018 21:40,28,69.3,44,64.7,72,66.5,2,0,0
2/09/2018 21:45,34,69.8,50,65.2,84,67,2,0,0
2/09/2018 21:50,32,69.7,48,65.1,80,66.9,2,0,0
2/09/2018 21:55,33,69.3,49,64.6,82,66.5,2,0,0
2/09/2018 22:00,29,69.4,45,64.8,74,66.6,2,0,0
2/09/2018 22:05,29,69.7,45,65.1,74,66.9,2,0,0
2/09/2018 22:10,27,69.4,43,64.8,70,66.5,2,0,0
2/09/2018 22:15,30,69.6,47,65,77,66.8,2,0,0
2/09/2018 22:20,28,68.4,45,63.7,73,65.5,2,0,0
2/09/2018 22:25,29,68.6,45,63.9,74,65.8,2,0,0
2/09/2018 22:30,23,68.8,39,64.2,62,65.9,2,0,0
2/09/2018 22:35,24,69,39,64.4,63,66.1,2,0,0
2/09/2018 22:40,22,69.3,38,64.7,60,66.4,2,0,0
2/09/2018 22:45,22,69,38,64.4,60,66,2,0,0
2/09/2018 22:50,18,69.2,34,64.6,52,66.2,2,0,0
2/09/2018 22:55,16,69.1,31,64.5,47,66.1,2,0,0
2/09/2018 23:00,17,69.4,33,64.8,50,66.4,2,0,0
2/09/2018 23:05,17,69.4,32,64.8,49,66.4,2,0,0
2/09/2018 23:10,23,68.9,39,64.2,62,65.9,2,0,0
2/09/2018 23:15,15,69.1,30,64.5,45,66,2,0,0
2/09/2018 23:20,16,69.2,32,64.6,48,66.2,2,0,0
2/09/2018 23:25,15,69.4,30,64.8,45,66.3,2,0,0
2/09/2018 23:30,17,69.4,33,64.8,50,66.3,2,0,0
2/09/2018 23:35,14,69.4,30,64.8,44,66.3,2,0,0
2/09/2018 23:40,18,69.3,34,64.6,52,66.2,2,0,0
2/09/2018 23:45,20,69.4,37,64.8,57,66.4,2,0,0
2/09/2018 23:50,15,69.5,30,64.9,45,66.4,2,0,0
2/09/2018 23:55,17,69.4,33,64.8,50,66.4,2,0,0
2/10/2018 0:00,13,69.3,29,64.7,42,66.2,2,0,0
2/10/2018 0:05,15,68.9,30,64.3,45,65.8,2,0,0
2/10/2018 0:10,12,69.2,27,64.6,39,66,2,0,0
2/10/2018 0:15,16,69.2,32,64.5,48,66.1,2,0,0
2/10/2018 0:20,13,69.3,29,64.7,42,66.1,2,0,0
2/10/2018 0:25,10,69.2,25,64.5,35,65.9,2,0,0
2/10/2018 0:30,15,68.8,30,64.2,45,65.7,2,0,0
2/10/2018 0:35,17,68.4,33,63.7,50,65.3,2,0,0
2/10/2018 0:40,11,68.8,27,64.2,38,65.5,2,0,0
2/10/2018 0:45,13,68.9,28,64.2,41,65.7,2,0,0
2/10/2018 0:50,10,69.1,26,64.5,36,65.8,2,0,0
2/10/2018 0:55,12,69.2,27,64.6,39,66,2,0,0
2/10/2018 1:00,12,69.3,28,64.7,40,66.1,2,0,0
2/10/2018 1:05,12,69.4,27,64.8,39,66.3,2,0,0
2/10/2018 1:10,13,69.4,28,64.8,41,66.2,2,0,0
2/10/2018 1:15,10,69.2,25,64.6,35,65.9,2,0,0
2/10/2018 1:20,11,69.3,27,64.7,38,66,2,0,0
2/10/2018 1:25,10,69,26,64.4,36,65.7,2,0,0
2/10/2018 1:30,7,69.2,23,64.6,30,65.7,2,0,0
2/10/2018 1:35,13,69.3,29,64.7,42,66.2,2,0,0
2/10/2018 1:40,10,69.4,25,64.8,35,66.1,2,0,0
2/10/2018 1:45,9,69.3,24,64.7,33,66,2,0,0
2/10/2018 1:50,18,69.4,23,64.8,41,66.9,2,0,0
2/10/2018 1:55,8,69.2,23,64.6,31,65.8,2,0,0
2/10/2018 2:00,13,69.2,21,64.6,34,66.3,2,0,0
2/10/2018 2:05,11,69,26,64.4,37,65.7,2,0,0
2/10/2018 2:10,10,69.2,25,64.6,35,65.9,2,0,0
2/10/2018 2:15,10,69.3,26,64.7,36,65.9,2,0,0
2/10/2018 2:20,10,69.4,25,64.8,35,66.1,2,0,0
2/10/2018 2:25,10,69.1,25,64.5,35,65.8,2,0,0
2/10/2018 2:30,8,69.3,23,64.7,31,65.9,2,0,0
2/10/2018 2:35,6,69.2,21,64.6,27,65.7,2,0,0
2/10/2018 2:40,10,69.2,26,64.6,36,65.9,2,0,0
2/10/2018 2:45,9,69.1,24,64.5,33,65.7,2,0,0
2/10/2018 2:50,5,69.2,21,64.6,26,65.5,2,0,0
2/10/2018 2:55,11,69,26,64.4,37,65.7,2,0,0
2/10/2018 3:00,9,69.2,24,64.6,33,65.9,2,0,0
2/10/2018 3:05,6,69.2,22,64.6,28,65.6,2,0,0
2/10/2018 3:10,9,69.3,24,64.7,33,66,2,0,0
2/10/2018 3:15,7,69.3,23,64.7,30,65.7,2,0,0
2/10/2018 3:20,6,69.3,21,64.7,27,65.7,2,0,0
2/10/2018 3:25,15,69.3,22,64.7,37,66.6,2,0,0
2/10/2018 3:30,10,69.5,25,64.9,35,66.2,2,0,0
2/10/2018 3:35,9,69.5,24,64.9,33,66.1,2,0,0
2/10/2018 3:40,10,69.4,26,64.8,36,66.1,2,0,0
2/10/2018 3:45,10,69.4,26,64.8,36,66.1,2,0,0
2/10/2018 3:50,10,69.1,26,64.5,36,65.8,2,0,0
2/10/2018 3:55,11,69.2,26,64.5,37,65.9,2,0,0
2/10/2018 4:00,11,69.2,26,64.5,37,65.9,2,0,0
2/10/2018 4:05,10,69.2,26,64.5,36,65.8,2,0,0
2/10/2018 4:10,10,69.3,25,64.7,35,66,2,0,0
2/10/2018 4:15,11,69.4,27,64.8,38,66.1,2,0,0
2/10/2018 4:20,10,69.4,25,64.8,35,66.1,2,0,0
2/10/2018 4:25,13,69.3,28,64.7,41,66.2,2,0,0
2/10/2018 4:30,15,69.4,31,64.8,46,66.3,2,0,0
2/10/2018 4:35,21,69.3,36,64.7,57,66.4,2,0,0
2/10/2018 4:40,14,69.2,29,64.6,43,66.1,2,0,0
2/10/2018 4:45,13,69.4,29,64.8,42,66.2,2,0,0
2/10/2018 4:50,18,69.4,34,64.8,52,66.4,2,0,0
2/10/2018 4:55,12,69.3,28,64.7,40,66.1,2,0,0
2/10/2018 5:00,16,69.4,31,64.8,47,66.4,2,0,0
2/10/2018 5:05,20,68.5,36,63.9,56,65.5,2,0,0
2/10/2018 5:10,13,68.9,28,64.3,41,65.7,2,0,0
2/10/2018 5:15,19,69.2,35,64.5,54,66.2,2,0,0
2/10/2018 5:20,16,69.3,32,64.7,48,66.2,2,0,0
2/10/2018 5:25,15,69.4,31,64.8,46,66.3,2,0,0
2/10/2018 5:30,24,69.4,41,64.8,65,66.5,2,0,0
2/10/2018 5:35,19,69.1,36,64.5,55,66.1,2,0,0
2/10/2018 5:40,19,69.3,35,64.7,54,66.4,2,0,0
2/10/2018 5:45,26,68.7,43,64,69,65.8,2,0,0
2/10/2018 5:50,24,69.1,40,64.5,64,66.2,2,0,0
2/10/2018 5:55,20,69.4,36,64.8,56,66.4,2,0,0
2/10/2018 6:00,20,69.7,37,65.1,57,66.7,2,0,0
2/10/2018 6:05,25,69.5,41,65,66,66.7,2,0,0
2/10/2018 6:10,23,69.2,40,64.5,63,66.2,2,0,0
2/10/2018 6:15,26,69.2,43,64.6,69,66.3,2,0,0
2/10/2018 6:20,30,69.4,47,64.8,77,66.6,2,0,0
2/10/2018 6:25,22,69.1,38,64.5,60,66.2,2,0,0
2/10/2018 6:30,30,69.7,46,65.1,76,67,2,0,0
2/10/2018 6:35,32,69.1,50,64.5,82,66.3,2,0,0
2/10/2018 6:40,36,69.6,53,65,89,66.9,2,0,0
2/10/2018 6:45,34,68.7,52,64.1,86,65.9,2,0,0
2/10/2018 6:50,34,68.8,51,64.2,85,66,2,0,0
2/10/2018 6:55,28,69.2,45,64.6,73,66.4,2,0,0
2/10/2018 7:00,31,69,48,64.4,79,66.2,2,0,0
2/10/2018 7:05,33,69.3,49,64.7,82,66.6,2,0,0
2/10/2018 7:10,35,69.3,52,64.7,87,66.5,2,0,0
2/10/2018 7:15,31,69.3,48,64.8,79,66.6,2,0,0
2/10/2018 7:20,34,70,50,65.5,84,67.3,2,0,0
2/10/2018 7:25,34,69.1,50,64.6,84,66.4,2,0,0
2/10/2018 7:30,29,69.5,46,64.9,75,66.7,2,0,0
2/10/2018 7:35,38,70.1,56,65.6,94,67.4,2,0,0
2/10/2018 7:40,37,70.7,54,66.3,91,68.1,2,0,0
2/10/2018 7:45,44,70.8,61,66.3,105,68.2,2,0,0
2/10/2018 7:50,45,69.7,63,65.1,108,67,2,0,0
2/10/2018 7:55,39,69.7,56,65.1,95,67,2,0,0
2/10/2018 8:00,42,69.4,59,64.7,101,66.6,2,0,0
2/10/2018 8:05,40,69.5,56,64.9,96,66.8,2,0,0
2/10/2018 8:10,44,69.7,61,65.1,105,67,2,0,0
2/10/2018 8:15,46,68.1,64,63.4,110,65.4,2,0,0
2/10/2018 8:20,44,68.8,62,64.2,106,66.1,2,0,0
2/10/2018 8:25,44,69.2,62,64.6,106,66.5,2,0,0
2/10/2018 8:30,45,69.2,62,64.5,107,66.5,2,0,0
2/10/2018 8:35,49,69.3,67,64.7,116,66.6,2,0,0
2/10/2018 8:40,47,69.7,64,65.2,111,67.1,2,0,0
2/10/2018 8:45,63,68.6,82,63.9,145,65.9,2,0,0
2/10/2018 8:50,52,69,71,64.4,123,66.4,2,0,0
2/10/2018 8:55,53,70,71,65.5,124,67.4,2,0,0
2/10/2018 9:00,49,69.9,66,65.4,115,67.3,2,0,0
2/10/2018 9:05,46,70.4,63,65.9,109,67.8,2,0,0
2/10/2018 9:10,55,69.1,74,64.5,129,66.4,2,0,0
2/10/2018 9:15,54,69.6,73,65,127,66.9,2,0,0
2/10/2018 9:20,65,70.3,84,65.7,149,67.7,2,0,0
2/10/2018 9:25,57,69,74,64.4,131,66.4,2,0,0
2/10/2018 9:30,57,69.8,75,65.3,132,67.2,2,0,0
2/10/2018 9:35,64,68.9,83,64.2,147,66.2,2,0,0
2/10/2018 9:40,66,68.9,86,64.2,152,66.2,2,0,0
2/10/2018 9:45,69,68.8,89,64.1,158,66.2,2,0,0
2/10/2018 9:50,78,68.3,99,63.6,177,65.7,2,0,0
2/10/2018 9:55,63,69.6,82,65,145,67,2,0,0
2/10/2018 10:00,64,70,83,65.4,147,67.4,2,0,0
2/10/2018 10:05,60,69.3,79,64.7,139,66.7,2,0,0
2/10/2018 10:10,70,69,90,64.4,160,66.4,2,0,0
2/10/2018 10:15,64,68.1,84,63.3,148,65.4,2,0,0
2/10/2018 10:20,62,67.7,82,62.9,144,65,2,0,0
2/10/2018 10:25,65,69.2,83,64.6,148,66.6,2,0,0
2/10/2018 10:30,61,69.2,80,64.5,141,66.5,2,0,0
2/10/2018 10:35,66,68.5,86,63.8,152,65.9,2,0,0
2/10/2018 10:40,64,68.2,84,63.5,148,65.5,2,0,0
2/10/2018 10:45,71,67.6,92,62.9,163,65,2,0,0
2/10/2018 10:50,72,68,92,63.3,164,65.3,2,0,0
2/10/2018 10:55,75,68.3,96,63.6,171,65.6,2,0,0
2/10/2018 11:00,62,68.6,79,63.9,141,66,2,0,0
2/10/2018 11:05,61,69,79,64.4,140,66.4,2,0,0
2/10/2018 11:10,63,69.3,82,64.8,145,66.8,2,0,0
2/10/2018 11:15,74,69.2,95,64.6,169,66.6,2,0,0
2/10/2018 11:20,68,69,87,64.4,155,66.4,2,0,0
2/10/2018 11:25,59,69.4,78,64.8,137,66.8,2,0,0
2/10/2018 11:30,76,69,96,64.3,172,66.4,2,0,0
2/10/2018 11:35,80,68.9,101,64.3,181,66.3,2,0,0
2/10/2018 11:40,67,69.8,87,65.3,154,67.3,2,0,0
2/10/2018 11:45,72,68.5,93,63.9,165,65.9,2,0,0
2/10/2018 11:50,75,69.2,96,64.6,171,66.6,2,0,0
2/10/2018 11:55,76,69.4,97,64.8,173,66.8,2,0,0
2/10/2018 12:00,72,68.5,92,63.9,164,65.9,2,0,0
2/10/2018 12:05,68,69.1,88,64.5,156,66.5,2,0,0
2/10/2018 12:10,71,68.8,91,64.1,162,66.2,2,0,0
2/10/2018 12:15,76,69,95,64.4,171,66.5,2,0,0
2/10/2018 12:20,71,69,90,64.3,161,66.4,2,0,0
2/10/2018 12:25,62,69,81,64.4,143,66.4,2,0,0
2/10/2018 12:30,73,68.9,93,64.2,166,66.3,2,0,0
2/10/2018 12:35,60,69.1,79,64.4,139,66.4,2,0,0
2/10/2018 12:40,64,69.9,83,65.3,147,67.3,2,0,0
2/10/2018 12:45,82,69.3,102,64.7,184,66.7,2,0,0
2/10/2018 12:50,59,69.8,79,65.2,138,67.2,2,0,0
2/10/2018 12:55,57,68.7,76,64.1,133,66.1,2,0,0
2/10/2018 13:00,53,69.3,71,64.7,124,66.6,2,0,0
2/10/2018 13:05,67,69.2,85,64.5,152,66.6,2,0,0
2/10/2018 13:10,55,69.4,72,64.8,127,66.8,2,0,0
2/10/2018 13:15,70,69.3,89,64.6,159,66.7,2,0,0
2/10/2018 13:20,66,69.3,85,64.7,151,66.7,2,0,0
2/10/2018 13:25,75,68.8,95,64.1,170,66.2,2,0,0
2/10/2018 13:30,66,68.5,87,63.8,153,65.8,2,0,0
2/10/2018 13:35,70,68.4,89,63.8,159,65.8,2,0,0
2/10/2018 13:40,70,68.9,89,64.2,159,66.3,2,0,0
2/10/2018 13:45,70,68.8,89,64.1,159,66.2,2,0,0
2/10/2018 13:50,66,68.5,85,63.8,151,65.8,2,0,0
2/10/2018 13:55,74,68.9,94,64.2,168,66.3,2,0,0
2/10/2018 14:00,65,69.2,84,64.6,149,66.6,2,0,0
2/10/2018 14:05,60,68.2,78,63.4,138,65.5,2,0,0
2/10/2018 14:10,49,69.3,66,64.7,115,66.7,2,0,0
2/10/2018 14:15,62,69.7,81,65.1,143,67.1,2,0,0
2/10/2018 14:20,61,70.3,78,65.8,139,67.8,2,0,0
2/10/2018 14:25,63,69.7,80,65.1,143,67.1,2,0,0
2/10/2018 14:30,59,69.7,77,65.1,136,67.1,2,0,0
2/10/2018 14:35,68,68.5,87,63.8,155,65.9,2,0,0
2/10/2018 14:40,60,69,79,64.4,139,66.4,2,0,0
2/10/2018 14:45,69,68.9,89,64.2,158,66.3,2,0,0
2/10/2018 14:50,55,68.9,74,64.2,129,66.2,2,0,0
2/10/2018 14:55,68,69.1,88,64.4,156,66.5,2,0,0
2/10/2018 15:00,66,68.5,85,63.8,151,65.9,2,0,0
2/10/2018 15:05,57,68.4,76,63.6,133,65.7,2,0,0
2/10/2018 15:10,51,67.4,68,62.6,119,64.7,2,0,0
2/10/2018 15:15,55,68.2,74,63.4,129,65.5,2,0,0
2/10/2018 15:20,60,69,78,64.4,138,66.4,2,0,0
2/10/2018 15:25,47,68.7,65,64.1,112,66,2,0,0
2/10/2018 15:30,66,69,85,64.4,151,66.4,2,0,0
2/10/2018 15:35,54,70.1,73,65.6,127,67.5,2,0,0
2/10/2018 15:40,61,69.9,80,65.4,141,67.3,2,0,0
2/10/2018 15:45,65,69.1,84,64.4,149,66.4,2,0,0
2/10/2018 15:50,68,69.1,86,64.4,154,66.4,2,0,0
2/10/2018 15:55,57,69.2,76,64.6,133,66.5,2,0,0
2/10/2018 16:00,69,68.8,88,64.2,157,66.2,2,0,0
2/10/2018 16:05,69,68.6,89,64,158,66,2,0,0
2/10/2018 16:10,64,68.9,83,64.2,147,66.2,2,0,0
2/10/2018 16:15,70,68.6,89,63.9,159,66,2,0,0
2/10/2018 16:20,74,68.7,94,64,168,66.1,2,0,0
2/10/2018 16:25,71,68.1,91,63.4,162,65.4,2,0,0
2/10/2018 16:30,67,68,87,63.3,154,65.4,2,0,0
2/10/2018 16:35,78,67.8,98,63,176,65.2,2,0,0
2/10/2018 16:40,70,67.1,91,62.3,161,64.4,2,0,0
2/10/2018 16:45,64,67.8,84,63,148,65.1,2,0,0
2/10/2018 16:50,63,68.5,82,63.8,145,65.8,2,0,0
2/10/2018 16:55,63,68.1,81,63.3,144,65.4,2,0,0
2/10/2018 17:00,64,68.8,83,64.2,147,66.2,2,0,0
2/10/2018 17:05,48,69,67,64.4,115,66.3,2,0,0
2/10/2018 17:10,49,68.9,66,64.3,115,66.3,2,0,0
2/10/2018 17:15,55,70.6,74,66.1,129,68,2,0,0
2/10/2018 17:20,57,70.8,76,66.4,133,68.3,2,0,0
2/10/2018 17:25,58,70,77,65.5,135,67.4,2,0,0
2/10/2018 17:30,46,69.7,64,65.2,110,67.1,2,0,0
2/10/2018 17:35,59,69.1,77,64.5,136,66.5,2,0,0
2/10/2018 17:40,54,70.2,72,65.7,126,67.6,2,0,0
2/10/2018 17:45,52,69,70,64.4,122,66.3,2,0,0
2/10/2018 17:50,55,68.7,73,64,128,66.1,2,0,0
2/10/2018 17:55,50,68.4,67,63.7,117,65.7,2,0,0
2/10/2018 18:00,60,68.7,79,64,139,66,2,0,0
2/10/2018 18:05,50,68.2,69,63.5,119,65.5,2,0,0
2/10/2018 18:10,50,68.4,68,63.6,118,65.6,2,0,0
2/10/2018 18:15,60,67.4,79,62.6,139,64.7,2,0,0
2/10/2018 18:20,59,68.1,77,63.4,136,65.5,2,0,0
2/10/2018 18:25,52,68.8,70,64.2,122,66.2,2,0,0
2/10/2018 18:30,47,67.1,65,62.3,112,64.3,2,0,0
2/10/2018 18:35,61,67.8,80,63,141,65,2,0,0
2/10/2018 18:40,51,67.9,69,63.2,120,65.2,2,0,0
2/10/2018 18:45,56,68.2,73,63.5,129,65.5,2,0,0
2/10/2018 18:50,49,68.7,66,64,115,66,2,0,0
2/10/2018 18:55,53,68.2,71,63.5,124,65.5,2,0,0
2/10/2018 19:00,51,68.1,69,63.4,120,65.4,2,0,0
2/10/2018 19:05,51,69,69,64.3,120,66.3,2,0,0
2/10/2018 19:10,51,69.1,69,64.5,120,66.4,2,0,0
2/10/2018 19:15,44,68.9,61,64.2,105,66.2,2,0,0
2/10/2018 19:20,44,68.3,61,63.6,105,65.6,2,0,0
2/10/2018 19:25,38,69,55,64.4,93,66.3,2,0,0
2/10/2018 19:30,41,69.2,58,64.6,99,66.5,2,0,0
2/10/2018 19:35,46,69.3,64,64.7,110,66.6,2,0,0
2/10/2018 19:40,42,69.3,60,64.7,102,66.6,2,0,0
2/10/2018 19:45,39,69.3,55,64.7,94,66.6,2,0,0
2/10/2018 19:50,37,69.6,52,65,89,66.9,2,0,0
2/10/2018 19:55,40,69.3,57,64.8,97,66.6,2,0,0
2/10/2018 20:00,35,69.8,52,65.2,87,67,2,0,0
2/10/2018 20:05,35,69.6,51,65,86,66.9,2,0,0
2/10/2018 20:10,34,69.7,51,65.1,85,66.9,2,0,0
2/10/2018 20:15,33,69.8,49,65.2,82,67.1,2,0,0
2/10/2018 20:20,31,70,48,65.5,79,67.2,2,0,0
2/10/2018 20:25,33,69.6,48,65,81,66.8,2,0,0
2/10/2018 20:30,32,69.7,48,65.1,80,67,2,0,0
2/10/2018 20:35,23,69.6,40,65,63,66.7,2,0,0
2/10/2018 20:40,30,69.3,45,64.7,75,66.5,2,0,0
2/10/2018 20:45,26,69.3,42,64.7,68,66.4,2,0,0
2/10/2018 20:50,24,69.3,40,64.7,64,66.5,2,0,0
2/10/2018 20:55,26,69.7,41,65.1,67,66.9,2,0,0
2/10/2018 21:00,31,69.3,46,64.7,77,66.6,2,0,0
2/10/2018 21:05,39,69.3,56,64.7,95,66.6,2,0,0
2/10/2018 21:10,31,70,48,65.4,79,67.2,2,0,0
2/10/2018 21:15,31,70.3,47,65.7,78,67.5,2,0,0
2/10/2018 21:20,35,69.7,50,65,85,67,2,0,0
2/10/2018 21:25,32,69.2,48,64.5,80,66.4,2,0,0
2/10/2018 21:30,39,68.7,55,64,94,65.9,2,0,0
2/10/2018 21:35,27,69.1,44,64.5,71,66.3,2,0,0
2/10/2018 21:40,30,69.2,46,64.5,76,66.4,2,0,0
2/10/2018 21:45,33,69,49,64.4,82,66.3,2,0,0
2/10/2018 21:50,32,69.2,48,64.6,80,66.5,2,0,0
2/10/2018 21:55,32,69.4,48,64.8,80,66.7,2,0,0
2/10/2018 22:00,30,69.5,46,64.9,76,66.7,2,0,0
2/10/2018 22:05,26,69.5,42,64.9,68,66.7,2,0,0
2/10/2018 22:10,30,69.5,46,64.9,76,66.7,2,0,0
2/10/2018 22:15,31,69.3,48,64.7,79,66.5,2,0,0
2/10/2018 22:20,29,69.2,45,64.6,74,66.4,2,0,0
2/10/2018 22:25,29,69.4,46,64.8,75,66.5,2,0,0
2/10/2018 22:30,27,69.4,43,64.8,70,66.6,2,0,0
2/10/2018 22:35,25,69.5,41,64.9,66,66.6,2,0,0
2/10/2018 22:40,26,69.5,42,64.9,68,66.7,2,0,0
2/10/2018 22:45,30,68.9,47,64.2,77,66.1,2,0,0
2/10/2018 22:50,25,69.1,40,64.5,65,66.2,2,0,0
2/10/2018 22:55,20,68.9,35,64.3,55,66,2,0,0
2/10/2018 23:00,19,69.2,34,64.6,53,66.2,2,0,0
2/10/2018 23:05,21,69.3,36,64.7,57,66.4,2,0,0
2/10/2018 23:10,18,69.5,33,64.9,51,66.5,2,0,0
2/10/2018 23:15,25,69.3,40,64.7,65,66.5,2,0,0
2/10/2018 23:20,22,69.3,37,64.7,59,66.5,2,0,0
2/10/2018 23:25,21,69,36,64.4,57,66.1,2,0,0
2/10/2018 23:30,22,69.2,38,64.6,60,66.3,2,0,0
2/10/2018 23:35,26,69.1,41,64.4,67,66.2,2,0,0
2/10/2018 23:40,21,68.6,36,64,57,65.7,2,0,0
2/10/2018 23:45,22,68.7,37,64,59,65.8,2,0,0
2/10/2018 23:50,21,69.1,36,64.5,57,66.2,2,0,0
2/10/2018 23:55,16,69.1,32,64.5,48,66.1,2,0,0
2/11/2018 0:00,15,69.3,31,64.7,46,66.2,2,0,0
2/11/2018 0:05,15,69.4,29,64.8,44,66.3,2,0,0
2/11/2018 0:10,16,69.3,31,64.7,47,66.3,2,0,0
2/11/2018 0:15,13,69.3,29,64.7,42,66.1,2,0,0
2/11/2018 0:20,11,69.4,26,64.8,37,66.1,2,0,0
2/11/2018 0:25,12,69.3,27,64.7,39,66.1,2,0,0
2/11/2018 0:30,12,69.4,27,64.8,39,66.2,2,0,0
2/11/2018 0:35,11,69.4,26,64.8,37,66.1,2,0,0
2/11/2018 0:40,16,69.1,32,64.5,48,66,2,0,0
2/11/2018 0:45,15,69.2,30,64.6,45,66.2,2,0,0
2/11/2018 0:50,11,69.3,27,64.7,38,66.1,2,0,0
2/11/2018 0:55,12,69.2,26,64.6,38,66,2,0,0
2/11/2018 1:00,9,69.2,25,64.6,34,65.8,2,0,0
2/11/2018 1:05,11,69.2,26,64.6,37,66,2,0,0
2/11/2018 1:10,9,69.2,24,64.6,33,65.9,2,0,0
2/11/2018 1:15,8,69.2,23,64.6,31,65.8,2,0,0
2/11/2018 1:20,8,69.2,23,64.6,31,65.8,2,0,0
2/11/2018 1:25,13,69.1,28,64.5,41,65.9,2,0,0
2/11/2018 1:30,10,69.2,25,64.6,35,65.9,2,0,0
2/11/2018 1:35,10,69.3,26,64.7,36,65.9,2,0,0
2/11/2018 1:40,7,69.3,22,64.7,29,65.8,2,0,0
2/11/2018 1:45,12,69.3,27,64.7,39,66.1,2,0,0
2/11/2018 1:50,10,69.4,26,64.8,36,66,2,0,0
2/11/2018 1:55,8,69.3,23,64.7,31,65.9,2,0,0
2/11/2018 2:00,7,69.3,23,64.7,30,65.8,2,0,0
2/11/2018 2:05,10,69.3,25,64.7,35,66.1,2,0,0
2/11/2018 2:10,10,69.3,25,64.7,35,66,2,0,0
2/11/2018 2:15,11,69.3,26,64.7,37,66.1,2,0,0
2/11/2018 2:20,8,69.3,24,64.7,32,65.8,2,0,0
2/11/2018 2:25,8,69.3,23,64.7,31,65.8,2,0,0
2/11/2018 2:30,7,69.3,22,64.7,29,65.8,2,0,0
2/11/2018 2:35,11,69.4,27,64.8,38,66.1,2,0,0
2/11/2018 2:40,11,69.3,27,64.7,38,66.1,2,0,0
2/11/2018 2:45,8,69.3,23,64.7,31,65.9,2,0,0
2/11/2018 2:50,15,69.3,22,64.7,37,66.6,2,0,0
2/11/2018 2:55,8,69.2,23,64.6,31,65.8,2,0,0
2/11/2018 3:00,7,69.1,22,64.5,29,65.6,2,0,0
2/11/2018 3:05,9,69.2,24,64.6,33,65.8,2,0,0
2/11/2018 3:10,5,69.2,20,64.6,25,65.5,2,0,0
2/11/2018 3:15,7,69.2,22,64.6,29,65.7,2,0,0
2/11/2018 3:20,13,69.1,21,64.5,34,66.3,2,0,0
2/11/2018 3:25,7,69,23,64.4,30,65.5,2,0,0
2/11/2018 3:30,8,69.2,23,64.6,31,65.8,2,0,0
2/11/2018 3:35,7,69.4,22,64.8,29,65.9,2,0,0
2/11/2018 3:40,9,69.2,24,64.6,33,65.9,2,0,0
2/11/2018 3:45,7,69.3,22,64.7,29,65.8,2,0,0
2/11/2018 3:50,8,69.3,24,64.7,32,65.9,2,0,0
2/11/2018 3:55,10,69.1,20,64.5,30,66,2,0,0
2/11/2018 4:00,12,69.3,27,64.7,39,66.1,2,0,0
2/11/2018 4:05,6,69.2,21,64.6,27,65.6,2,0,0
2/11/2018 4:10,8,69.2,23,64.6,31,65.8,2,0,0
2/11/2018 4:15,7,69.3,23,64.7,30,65.8,2,0,0
2/11/2018 4:20,9,69.2,24,64.6,33,65.9,2,0,0
2/11/2018 4:25,8,69.3,23,64.6,31,65.8,2,0,0
2/11/2018 4:30,8,69.3,24,64.6,32,65.8,2,0,0
2/11/2018 4:35,12,69.4,28,64.8,40,66.2,2,0,0
2/11/2018 4:40,9,69.4,24,64.8,33,66.1,2,0,0
2/11/2018 4:45,10,69.4,25,64.8,35,66.1,2,0,0
2/11/2018 4:50,10,69.3,25,64.7,35,66,2,0,0
2/11/2018 4:55,10,69.3,25,64.7,35,66.1,2,0,0
2/11/2018 5:00,7,69.4,22,64.8,29,65.9,2,0,0
2/11/2018 5:05,11,69.4,26,64.8,37,66.2,2,0,0
2/11/2018 5:10,10,69.2,25,64.6,35,65.9,2,0,0
2/11/2018 5:15,12,69.4,27,64.8,39,66.2,2,0,0
2/11/2018 5:20,13,69.3,29,64.7,42,66.2,2,0,0
2/11/2018 5:25,14,69.4,30,64.8,44,66.3,2,0,0
2/11/2018 5:30,12,69.5,28,64.9,40,66.3,2,0,0
2/11/2018 5:35,16,69.4,31,64.8,47,66.4,2,0,0
2/11/2018 5:40,14,69.4,29,64.8,43,66.3,2,0,0
2/11/2018 5:45,15,69.4,30,64.8,45,66.4,2,0,0
2/11/2018 5:50,16,69.5,32,64.9,48,66.5,2,0,0
2/11/2018 5:55,14,69.2,30,64.6,44,66.1,2,0,0
2/11/2018 6:00,14,69.1,29,64.5,43,66,2,0,0
2/11/2018 6:05,16,69.2,32,64.6,48,66.2,2,0,0
2/11/2018 6:10,20,68.8,36,64.2,56,65.9,2,0,0
2/11/2018 6:15,17,69.1,32,64.5,49,66.1,2,0,0
2/11/2018 6:20,20,69,36,64.4,56,66.1,2,0,0
2/11/2018 6:25,14,69.1,30,64.5,44,66,2,0,0
2/11/2018 6:30,20,69.2,36,64.6,56,66.2,2,0,0
2/11/2018 6:35,21,69.3,37,64.7,58,66.3,2,0,0
2/11/2018 6:40,23,69.4,39,64.8,62,66.6,2,0,0
2/11/2018 6:45,19,69.4,35,64.8,54,66.5,2,0,0
2/11/2018 6:50,24,69.5,40,64.9,64,66.6,2,0,0
2/11/2018 6:55,17,69.4,33,64.8,50,66.4,2,0,0
2/11/2018 7:00,14,69.3,30,64.7,44,66.1,2,0,0
2/11/2018 7:05,17,69.2,32,64.5,49,66.2,2,0,0
2/11/2018 7:10,20,69.2,36,64.6,56,66.2,2,0,0
2/11/2018 7:15,22,69.3,38,64.7,60,66.3,2,0,0
2/11/2018 7:20,25,69.3,41,64.7,66,66.4,2,0,0
2/11/2018 7:25,22,69.3,38,64.7,60,66.4,2,0,0
2/11/2018 7:30,25,69,41,64.4,66,66.2,2,0,0
2/11/2018 7:35,26,69.4,42,64.8,68,66.6,2,0,0
2/11/2018 7:40,29,69.5,45,64.9,74,66.7,2,0,0
2/11/2018 7:45,25,69.5,41,64.9,66,66.7,2,0,0
2/11/2018 7:50,26,69.4,42,64.8,68,66.5,2,0,0
2/11/2018 7:55,32,69.2,48,64.5,80,66.4,2,0,0
2/11/2018 8:00,24,69.2,40,64.6,64,66.3,2,0,0
2/11/2018 8:05,27,69.2,43,64.5,70,66.3,2,0,0
2/11/2018 8:10,30,69,46,64.4,76,66.2,2,0,0
2/11/2018 8:15,35,69.3,51,64.7,86,66.6,2,0,0
2/11/2018 8:20,30,69.2,47,64.5,77,66.4,2,0,0
2/11/2018 8:25,28,69.2,45,64.6,73,66.3,2,0,0
2/11/2018 8:30,33,68.8,50,64.1,83,66,2,0,0
2/11/2018 8:35,31,68.8,47,64.1,78,66,2,0,0
2/11/2018 8:40,35,68.8,51,64.1,86,66,2,0,0
2/11/2018 8:45,37,68.5,54,63.8,91,65.7,2,0,0
2/11/2018 8:50,27,68.8,43,64.1,70,65.9,2,0,0
2/11/2018 8:55,36,68.5,53,63.8,89,65.7,2,0,0
2/11/2018 9:00,25,69.2,41,64.6,66,66.3,2,0,0
2/11/2018 9:05,29,69.3,45,64.7,74,66.5,2,0,0
2/11/2018 9:10,31,69.1,48,64.4,79,66.3,2,0,0
2/11/2018 9:15,33,69,50,64.3,83,66.2,2,0,0
2/11/2018 9:20,35,69.3,52,64.7,87,66.6,2,0,0
2/11/2018 9:25,35,69.2,51,64.6,86,66.5,2,0,0
2/11/2018 9:30,40,69.8,58,65.2,98,67.1,2,0,0
2/11/2018 9:35,39,70,56,65.4,95,67.3,2,0,0
2/11/2018 9:40,44,69.1,61,64.5,105,66.4,2,0,0
2/11/2018 9:45,51,68.4,68,63.7,119,65.7,2,0,0
2/11/2018 9:50,49,68.3,67,63.5,116,65.5,2,0,0
2/11/2018 9:55,48,68.2,65,63.5,113,65.5,2,0,0
2/11/2018 10:00,48,68.1,67,63.3,115,65.3,2,0,0
2/11/2018 10:05,49,68.1,67,63.4,116,65.4,2,0,0
2/11/2018 10:10,60,68.4,77,63.6,137,65.7,2,0,0
2/11/2018 10:15,50,68.6,68,63.9,118,65.9,2,0,0
2/11/2018 10:20,60,68.6,78,63.9,138,65.9,2,0,0
2/11/2018 10:25,53,68.7,72,64,125,66,2,0,0
2/11/2018 10:30,53,69,72,64.5,125,66.4,2,0,0
2/11/2018 10:35,58,68.6,77,63.9,135,65.9,2,0,0
2/11/2018 10:40,55,68.8,75,64.2,130,66.1,2,0,0
2/11/2018 10:45,62,71.5,83,67.3,145,69.1,2,0,0
2/11/2018 10:50,59,70.4,53,64.4,112,67.6,2,0,0
2/11/2018 10:55,57,70.4,52,64.4,109,67.5,2,0,0
2/11/2018 11:00,57,70.5,51,64.5,108,67.7,2,0,0
2/11/2018 11:05,55,70.4,50,64.4,105,67.5,2,0,0
2/11/2018 11:10,53,68.6,69,63.9,122,65.9,2,0,0
2/11/2018 11:15,75,68.1,94,63.4,169,65.5,2,0,0
2/11/2018 11:20,53,68.4,70,63.7,123,65.8,2,0,0
2/11/2018 11:25,50,69.1,68,64.5,118,66.5,2,0,0
2/11/2018 11:30,53,68.6,71,63.8,124,65.9,2,0,0
2/11/2018 11:35,61,68,79,63.2,140,65.3,2,0,0
2/11/2018 11:40,50,68.4,67,63.7,117,65.7,2,0,0
2/11/2018 11:45,67,67.9,85,63.1,152,65.2,2,0,0
2/11/2018 11:50,51,67.1,69,62.2,120,64.3,2,0,0
2/11/2018 11:55,52,67.9,70,63.1,122,65.1,2,0,0
2/11/2018 12:00,60,68.4,78,63.7,138,65.8,2,0,0
2/11/2018 12:05,52,68.4,70,63.7,122,65.7,2,0,0
2/11/2018 12:10,56,68.3,73,63.6,129,65.7,2,0,0
2/11/2018 12:15,53,68.7,71,64.1,124,66.1,2,0,0
2/11/2018 12:20,57,68.9,76,64.2,133,66.2,2,0,0
2/11/2018 12:25,56,68.9,73,64.3,129,66.3,2,0,0
2/11/2018 12:30,65,68.1,85,63.3,150,65.3,2,0,0
2/11/2018 12:35,62,68,81,63.2,143,65.3,2,0,0
2/11/2018 12:40,55,68.5,72,63.8,127,65.8,2,0,0
2/11/2018 12:45,60,68.4,78,63.7,138,65.7,2,0,0
2/11/2018 12:50,58,68.4,76,63.6,134,65.7,2,0,0
2/11/2018 12:55,67,68.3,86,63.6,153,65.7,2,0,0
2/11/2018 13:00,53,68.9,70,64.3,123,66.3,2,0,0
2/11/2018 13:05,68,68.7,88,64,156,66.1,2,0,0
2/11/2018 13:10,53,67.3,72,62.5,125,64.6,2,0,0
2/11/2018 13:15,55,67.9,73,63.1,128,65.1,2,0,0
2/11/2018 13:20,56,67.6,74,62.7,130,64.8,2,0,0
2/11/2018 13:25,50,68.5,68,63.8,118,65.8,2,0,0
2/11/2018 13:30,54,67.8,72,62.9,126,65,2,0,0
2/11/2018 13:35,59,68.1,77,63.3,136,65.4,2,0,0
2/11/2018 13:40,67,68.4,86,63.7,153,65.7,2,0,0
2/11/2018 13:45,52,68.4,69,63.7,121,65.7,2,0,0
2/11/2018 13:50,62,67.8,80,63,142,65.1,2,0,0
2/11/2018 13:55,65,67.4,84,62.5,149,64.6,2,0,0
2/11/2018 14:00,59,67.6,77,62.7,136,64.8,2,0,0
2/11/2018 14:05,52,67.7,70,62.9,122,64.9,2,0,0
2/11/2018 14:10,61,68.4,80,63.6,141,65.7,2,0,0
2/11/2018 14:15,52,68.3,70,63.5,122,65.6,2,0,0
2/11/2018 14:20,54,68,71,63.1,125,65.2,2,0,0
2/11/2018 14:25,49,67.9,67,63,116,65.1,2,0,0
2/11/2018 14:30,50,68.6,67,63.8,117,65.9,2,0,0
2/11/2018 14:35,52,68,70,63.2,122,65.2,2,0,0
2/11/2018 14:40,48,68.7,65,64.1,113,66,2,0,0
2/11/2018 14:45,55,68.3,73,63.6,128,65.6,2,0,0
2/11/2018 14:50,55,68.9,73,64.2,128,66.2,2,0,0
2/11/2018 14:55,52,68.6,71,63.9,123,65.9,2,0,0
2/11/2018 15:00,52,68.7,70,64,122,66,2,0,0
2/11/2018 15:05,54,68.6,73,63.9,127,65.9,2,0,0
2/11/2018 15:10,48,68.4,65,63.6,113,65.6,2,0,0
2/11/2018 15:15,51,68.5,68,63.8,119,65.8,2,0,0
2/11/2018 15:20,43,68.6,60,63.9,103,65.9,2,0,0
2/11/2018 15:25,54,69.3,73,64.6,127,66.6,2,0,0
2/11/2018 15:30,50,69.1,68,64.4,118,66.4,2,0,0
2/11/2018 15:35,54,69.3,72,64.7,126,66.7,2,0,0
2/11/2018 15:40,52,69.8,70,65.2,122,67.2,2,0,0
2/11/2018 15:45,51,69.2,69,64.5,120,66.5,2,0,0
2/11/2018 15:50,55,68.4,73,63.6,128,65.7,2,0,0
2/11/2018 15:55,62,67.3,81,62.4,143,64.5,2,0,0
2/11/2018 16:00,51,68.1,69,63.3,120,65.4,2,0,0
2/11/2018 16:05,67,68.2,86,63.5,153,65.5,2,0,0
2/11/2018 16:10,55,68,74,63.3,129,65.3,2,0,0
2/11/2018 16:15,66,68.5,84,63.9,150,65.9,2,0,0
2/11/2018 16:20,61,68.6,79,63.9,140,65.9,2,0,0
2/11/2018 16:25,63,69.1,82,64.5,145,66.5,2,0,0
2/11/2018 16:30,53,68.8,71,64.1,124,66.2,2,0,0
2/11/2018 16:35,64,68.5,83,63.8,147,65.8,2,0,0
2/11/2018 16:40,56,67.5,75,62.7,131,64.8,2,0,0
2/11/2018 16:45,54,68.2,73,63.4,127,65.5,2,0,0
2/11/2018 16:50,50,68,68,63.2,118,65.2,2,0,0
2/11/2018 16:55,50,68.7,68,64,118,66,2,0,0
2/11/2018 17:00,50,68.5,68,63.8,118,65.8,2,0,0
2/11/2018 17:05,49,68.5,66,63.7,115,65.7,2,0,0
2/11/2018 17:10,55,68.4,73,63.6,128,65.6,2,0,0
2/11/2018 17:15,52,68.2,70,63.5,122,65.5,2,0,0
2/11/2018 17:20,63,68.7,81,64,144,66,2,0,0
2/11/2018 17:25,52,69,71,64.3,123,66.3,2,0,0
2/11/2018 17:30,53,68.2,71,63.4,124,65.5,2,0,0
2/11/2018 17:35,50,68,68,63.2,118,65.2,2,0,0
2/11/2018 17:40,56,68.2,75,63.4,131,65.4,2,0,0
2/11/2018 17:45,49,68.3,66,63.5,115,65.6,2,0,0
2/11/2018 17:50,60,68.1,78,63.3,138,65.4,2,0,0
2/11/2018 17:55,48,68.9,65,64.2,113,66.2,2,0,0
2/11/2018 18:00,52,69.2,69,64.6,121,66.6,2,0,0
2/11/2018 18:05,54,67.9,72,63.1,126,65.2,2,0,0
2/11/2018 18:10,68,68.1,87,63.4,155,65.5,2,0,0
2/11/2018 18:15,59,68.4,77,63.7,136,65.7,2,0,0
2/11/2018 18:20,55,68,73,63.2,128,65.3,2,0,0
2/11/2018 18:25,52,68.1,71,63.3,123,65.3,2,0,0
2/11/2018 18:30,48,68,65,63.2,113,65.2,2,0,0
2/11/2018 18:35,60,68.1,79,63.4,139,65.4,2,0,0
2/11/2018 18:40,53,68.3,72,63.6,125,65.6,2,0,0
2/11/2018 18:45,53,69.3,72,64.7,125,66.7,2,0,0
2/11/2018 18:50,50,68.6,67,63.8,117,65.9,2,0,0
2/11/2018 18:55,40,68.7,57,64,97,66,2,0,0
2/11/2018 19:00,39,68.8,55,64.1,94,66,2,0,0
2/11/2018 19:05,44,69.2,60,64.6,104,66.5,2,0,0
2/11/2018 19:10,41,70,58,65.5,99,67.3,2,0,0
2/11/2018 19:15,41,69.1,57,64.5,98,66.4,2,0,0
2/11/2018 19:20,41,69.7,58,65.2,99,67.1,2,0,0
2/11/2018 19:25,36,68.7,52,64.1,88,66,2,0,0
2/11/2018 19:30,45,69.2,63,64.6,108,66.5,2,0,0
2/11/2018 19:35,44,69.1,60,64.5,104,66.5,2,0,0
2/11/2018 19:40,41,69.9,57,65.3,98,67.2,2,0,0
2/11/2018 19:45,37,69.8,53,65.2,90,67.1,2,0,0
2/11/2018 19:50,33,69.8,49,65.3,82,67.1,2,0,0
2/11/2018 19:55,38,70,54,65.4,92,67.3,2,0,0
2/11/2018 20:00,26,68.9,42,64.2,68,66,2,0,0
2/11/2018 20:05,28,69.3,44,64.7,72,66.5,2,0,0
2/11/2018 20:10,25,69.1,42,64.5,67,66.2,2,0,0
2/11/2018 20:15,23,69.1,39,64.5,62,66.2,2,0,0
2/11/2018 20:20,26,69,41,64.3,67,66.1,2,0,0
2/11/2018 20:25,30,69.2,46,64.6,76,66.4,2,0,0
2/11/2018 20:30,24,69.2,40,64.5,64,66.3,2,0,0
2/11/2018 20:35,22,68.9,39,64.2,61,65.9,2,0,0
2/11/2018 20:40,29,69.1,45,64.5,74,66.3,2,0,0
2/11/2018 20:45,17,68.8,33,64.1,50,65.7,2,0,0
2/11/2018 20:50,26,68.4,42,63.8,68,65.6,2,0,0
2/11/2018 20:55,28,68.3,44,63.6,72,65.4,2,0,0
2/11/2018 21:00,20,68.3,36,63.6,56,65.3,2,0,0
2/11/2018 21:05,24,68.5,40,63.8,64,65.6,2,0,0
2/11/2018 21:10,20,69,36,64.4,56,66,2,0,0
2/11/2018 21:15,28,69.2,44,64.6,72,66.4,2,0,0
2/11/2018 21:20,22,69.1,38,64.4,60,66.1,2,0,0
2/11/2018 21:25,24,69.2,40,64.6,64,66.3,2,0,0
2/11/2018 21:30,26,69.2,42,64.5,68,66.3,2,0,0
2/11/2018 21:35,26,69.3,41,64.7,67,66.5,2,0,0
2/11/2018 21:40,17,69.2,33,64.6,50,66.2,2,0,0
2/11/2018 21:45,21,69.4,37,64.8,58,66.4,2,0,0
2/11/2018 21:50,25,69.5,41,64.9,66,66.6,2,0,0
2/11/2018 21:55,21,69.2,36,64.6,57,66.3,2,0,0
2/11/2018 22:00,20,69.2,37,64.6,57,66.2,2,0,0
2/11/2018 22:05,21,69.1,37,64.5,58,66.2,2,0,0
2/11/2018 22:10,18,69.1,33,64.5,51,66.1,2,0,0
2/11/2018 22:15,19,69.1,35,64.5,54,66.1,2,0,0
2/11/2018 22:20,16,69.2,32,64.5,48,66.1,2,0,0
2/11/2018 22:25,17,69.4,33,64.8,50,66.3,2,0,0
2/11/2018 22:30,18,69.4,33,64.8,51,66.4,2,0,0
2/11/2018 22:35,17,69.1,32,64.4,49,66,2,0,0
2/11/2018 22:40,13,69.2,29,64.6,42,66,2,0,0
2/11/2018 22:45,18,69.3,33,64.7,51,66.3,2,0,0
2/11/2018 22:50,22,69.5,38,65,60,66.6,2,0,0
2/11/2018 22:55,15,69.4,31,64.8,46,66.3,2,0,0
2/11/2018 23:00,17,69.6,32,65,49,66.6,2,0,0
2/11/2018 23:05,18,69.7,34,65.2,52,66.7,2,0,0
2/11/2018 23:10,13,69.7,29,65.1,42,66.5,2,0,0
2/11/2018 23:15,15,69.5,30,64.9,45,66.5,2,0,0
2/11/2018 23:20,13,69.5,28,64.9,41,66.4,2,0,0
2/11/2018 23:25,14,69.6,29,65,43,66.5,2,0,0
2/11/2018 23:30,14,69.5,30,64.9,44,66.3,2,0,0
2/11/2018 23:35,19,69.3,34,64.7,53,66.4,2,0,0
2/11/2018 23:40,12,69.4,28,64.8,40,66.2,2,0,0
2/11/2018 23:45,11,69.4,27,64.8,38,66.1,2,0,0
2/11/2018 23:50,12,69.3,28,64.7,40,66.1,2,0,0
2/11/2018 23:55,6,69.3,21,64.7,27,65.7,2,0,0
