5 Minutes,Lane 1 Flow (Veh/5 Minutes),Lane 1 Speed (mph),Lane 2 Flow (Veh/5 Minutes),Lane 2 Speed (mph),Flow (Veh/5 Minutes),Speed (mph),# Lane Points,% Observed,Holiday
2/12/2018 0:00,11,69.3,26,64.7,37,66.1,2,0,0
2/12/2018 0:05,9,69.3,24,64.7,33,66,2,0,0
2/12/2018 0:10,11,69.3,27,64.7,38,66.1,2,0,0
2/12/2018 0:15,12,69.3,28,64.7,40,66.1,2,0,0
2/12/2018 0:20,9,69.2,25,64.5,34,65.8,2,0,0
2/12/2018 0:25,6,69.3,22,64.7,28,65.6,2,0,0
2/12/2018 0:30,11,69.1,27,64.5,38,65.8,2,0,0
2/12/2018 0:35,11,69.3,26,64.7,37,66.1,2,0,0
2/12/2018 0:40,12,69.4,21,64.8,33,66.5,2,0,0
2/12/2018 0:45,12,69.4,21,64.8,33,66.4,2,0,0
2/12/2018 0:50,11,69.3,21,64.7,32,66.3,2,0,0
2/12/2018 0:55,8,69.3,23,64.7,31,65.9,2,0,0
2/12/2018 1:00,8,69.4,23,64.8,31,66,2,0,0
2/12/2018 1:05,5,69.3,21,64.7,26,65.5,2,0,0
2/12/2018 1:10,9,69.4,25,64.8,34,66.1,2,0,0
2/12/2018 1:15,5,69.4,21,64.8,26,65.7,2,0,0
2/12/2018 1:20,10,69.3,20,64.7,30,66.2,2,0,0
2/12/2018 1:25,8,69.3,19,64.7,27,66.1,2,0,0
2/12/2018 1:30,9,69.3,24,64.7,33,66,2,0,0
2/12/2018 1:35,11,69,27,64.4,38,65.8,2,0,0
2/12/2018 1:40,5,69.2,20,64.6,25,65.5,2,0,0
2/12/2018 1:45,5,69.5,20,65,25,65.9,2,0,0
2/12/2018 1:50,11,69.5,21,65,32,66.6,2,0,0
2/12/2018 1:55,8,69.3,23,64.7,31,65.9,2,0,0
2/12/2018 2:00,7,69.3,22,64.7,29,65.8,2,0,0
2/12/2018 2:05,10,69.4,20,64.8,30,66.3,2,0,0
2/12/2018 2:10,5,69.4,21,64.8,26,65.7,2,0,0
2/12/2018 2:15,10,69.4,20,64.8,30,66.3,2,0,0
2/12/2018 2:20,7,69.4,22,64.8,29,66,2,0,0
2/12/2018 2:25,6,69.3,21,64.7,27,65.8,2,0,0
2/12/2018 2:30,8,69.2,23,64.6,31,65.8,2,0,0
2/12/2018 2:35,8,69.3,23,64.7,31,65.9,2,0,0
2/12/2018 2:40,10,69.4,25,64.8,35,66.1,2,0,0
2/12/2018 2:45,11,69.4,26,64.8,37,66.2,2,0,0
2/12/2018 2:50,9,69.4,24,64.8,33,66.1,2,0,0
2/12/2018 2:55,7,69.5,23,64.9,30,66,2,0,0
2/12/2018 3:00,9,69.4,24,64.8,33,66,2,0,0
2/12/2018 3:05,12,69.4,28,64.8,40,66.2,2,0,0
2/12/2018 3:10,7,69.3,22,64.7,29,65.8,2,0,0
2/12/2018 3:15,7,69.3,22,64.7,29,65.8,2,0,0
2/12/2018 3:20,9,69.2,25,64.6,34,65.8,2,0,0
2/12/2018 3:25,9,69.3,24,64.7,33,66,2,0,0
2/12/2018 3:30,14,69.4,30,64.8,44,66.3,2,0,0
2/12/2018 3:35,13,69.4,29,64.8,42,66.2,2,0,0
2/12/2018 3:40,12,69.4,27,64.8,39,66.3,2,0,0
2/12/2018 3:45,10,69.3,26,64.7,36,66,2,0,0
2/12/2018 3:50,15,68.9,30,64.3,45,65.9,2,0,0
2/12/2018 3:55,11,69.1,27,64.4,38,65.8,2,0,0
2/12/2018 4:00,15,69.1,31,64.5,46,66,2,0,0
2/12/2018 4:05,20,69.2,37,64.5,57,66.2,2,0,0
2/12/2018 4:10,21,68.8,37,64.2,58,65.8,2,0,0
2/12/2018 4:15,17,68.8,33,64.2,50,65.7,2,0,0
2/12/2018 4:20,28,69.3,45,64.8,73,66.5,2,0,0
2/12/2018 4:25,23,69.2,40,64.6,63,66.3,2,0,0
2/12/2018 4:30,25,69.6,42,65,67,66.7,2,0,0
2/12/2018 4:35,25,69.4,42,64.9,67,66.6,2,0,0
2/12/2018 4:40,39,69.9,57,65.4,96,67.2,2,0,0
2/12/2018 4:45,40,70.3,58,65.8,98,67.6,2,0,0
2/12/2018 4:50,38,70,56,65.5,94,67.3,2,0,0
2/12/2018 4:55,44,70.5,63,66.1,107,68,2,0,0
2/12/2018 5:00,42,71.2,60,66.9,102,68.7,2,0,0
2/12/2018 5:05,42,71.2,59,66.8,101,68.6,2,0,0
2/12/2018 5:10,48,70.4,66,66,114,67.8,2,0,0
2/12/2018 5:15,53,70.1,73,65.6,126,67.4,2,0,0
2/12/2018 5:20,52,70.2,73,65.7,125,67.5,2,0,0
2/12/2018 5:25,60,68.4,81,63.8,141,65.8,2,0,0
2/12/2018 5:30,54,69.8,74,65.3,128,67.2,2,0,0
2/12/2018 5:35,59,70.2,80,65.6,139,67.6,2,0,0
2/12/2018 5:40,65,69.5,85,64.8,150,66.8,2,0,0
2/12/2018 5:45,68,69.4,91,64.7,159,66.7,2,0,0
2/12/2018 5:50,62,69.9,83,65.3,145,67.3,2,0,0
2/12/2018 5:55,67,70,88,65.5,155,67.4,2,0,0
2/12/2018 6:00,59,69.4,79,64.7,138,66.7,2,0,0
2/12/2018 6:05,61,69.6,82,64.9,143,66.9,2,0,0
2/12/2018 6:10,75,68,97,63.1,172,65.2,2,0,0
2/12/2018 6:15,63,67.2,85,62.3,148,64.4,2,0,0
2/12/2018 6:20,77,66.3,100,61.3,177,63.4,2,0,0
2/12/2018 6:25,63,67.5,84,62.5,147,64.7,2,0,0
2/12/2018 6:30,74,67.5,96,62.5,170,64.7,2,0,0
2/12/2018 6:35,67,67.5,89,62.6,156,64.7,2,0,0
2/12/2018 6:40,75,68,97,63.1,172,65.2,2,0,0
2/12/2018 6:45,77,67.2,100,62.3,177,64.5,2,0,0
2/12/2018 6:50,82,66.6,106,61.6,188,63.8,2,0,0
2/12/2018 6:55,69,67.4,90,62.5,159,64.6,2,0,0
2/12/2018 7:00,80,66.4,103,61.5,183,63.6,2,0,0
2/12/2018 7:05,73,66.9,95,62,168,64.1,2,0,0
2/12/2018 7:10,91,67.2,114,62.3,205,64.5,2,0,0
2/12/2018 7:15,69,67.5,92,62.7,161,64.7,2,0,0
2/12/2018 7:20,86,67.1,110,62.2,196,64.3,2,0,0
2/12/2018 7:25,88,67.3,111,62.5,199,64.6,2,0,0
2/12/2018 7:30,71,67.9,93,63.1,164,65.2,2,0,0
2/12/2018 7:35,83,67,107,62.1,190,64.2,2,0,0
2/12/2018 7:40,77,67.4,99,62.6,176,64.7,2,0,0
2/12/2018 7:45,76,68,98,63.1,174,65.2,2,0,0
2/12/2018 7:50,97,67.3,121,62.4,218,64.6,2,0,0
2/12/2018 7:55,88,65.9,111,60.9,199,63.1,2,0,0
2/12/2018 8:00,85,66.2,107,61.2,192,63.4,2,0,0
2/12/2018 8:05,79,65.6,101,60.6,180,62.8,2,0,0
2/12/2018 8:10,79,64.7,101,59.6,180,61.8,2,0,0
2/12/2018 8:15,78,63.7,101,58.5,179,60.8,2,0,0
2/12/2018 8:20,66,65,87,59.9,153,62.1,2,0,0
2/12/2018 8:25,64,65.5,86,60.5,150,62.6,2,0,0
2/12/2018 8:30,65,65.9,86,61,151,63.1,2,0,0
2/12/2018 8:35,71,68.7,64,62.9,135,66,2,0,0
2/12/2018 8:40,73,68.7,65,62.9,138,66,2,0,0
2/12/2018 8:45,76,70.5,99,66,175,68,2,0,0
2/12/2018 8:50,83,68,104,63.2,187,65.4,2,0,0
2/12/2018 8:55,78,66.3,100,61.3,178,63.5,2,0,0
2/12/2018 9:00,66,64.9,87,59.9,153,62,2,0,0
2/12/2018 9:05,71,64,92,58.8,163,61.1,2,0,0
2/12/2018 9:10,75,63.7,96,58.6,171,60.8,2,0,0
2/12/2018 9:15,72,65,92,60,164,62.2,2,0,0
2/12/2018 9:20,64,66.2,83,61.3,147,63.4,2,0,0
2/12/2018 9:25,68,66.5,88,61.6,156,63.8,2,0,0
2/12/2018 9:30,69,66.2,89,61.2,158,63.4,2,0,0
2/12/2018 9:35,67,67.1,86,62.2,153,64.3,2,0,0
2/12/2018 9:40,65,66.7,85,61.8,150,63.9,2,0,0
2/12/2018 9:45,66,66.6,86,61.7,152,63.9,2,0,0
2/12/2018 9:50,56,66.9,75,62,131,64.1,2,0,0
2/12/2018 9:55,64,66.5,84,61.6,148,63.7,2,0,0
2/12/2018 10:00,67,65.5,87,60.5,154,62.7,2,0,0
2/12/2018 10:05,62,64.4,81,59.3,143,61.5,2,0,0
2/12/2018 10:10,55,64,74,59,129,61.2,2,0,0
2/12/2018 10:15,69,66.3,88,61.5,157,63.6,2,0,0
2/12/2018 10:20,62,66.4,81,61.5,143,63.6,2,0,0
2/12/2018 10:25,66,65.9,87,61.1,153,63.2,2,0,0
2/12/2018 10:30,58,65.9,77,61.1,135,63.2,2,0,0
2/12/2018 10:35,58,67,75,62.2,133,64.3,2,0,0
2/12/2018 10:40,54,66.2,73,61.4,127,63.4,2,0,0
2/12/2018 10:45,44,67.7,62,63.1,106,65,2,0,0
2/12/2018 10:50,61,68.4,79,63.8,140,65.8,2,0,0
2/12/2018 10:55,56,66.9,74,62.1,130,64.2,2,0,0
2/12/2018 11:00,48,68.1,66,63.4,114,65.4,2,0,0
2/12/2018 11:05,51,68.6,69,64,120,66,2,0,0
2/12/2018 11:10,53,68.2,71,63.6,124,65.5,2,0,0
2/12/2018 11:15,54,67.2,72,62.5,126,64.5,2,0,0
2/12/2018 11:20,56,68,73,63.2,129,65.3,2,0,0
2/12/2018 11:25,49,67,67,62.2,116,64.3,2,0,0
2/12/2018 11:30,54,66.5,73,61.7,127,63.8,2,0,0
2/12/2018 11:35,53,67.7,72,63,125,65,2,0,0
2/12/2018 11:40,58,67.4,78,62.6,136,64.7,2,0,0
2/12/2018 11:45,57,68.3,75,63.6,132,65.6,2,0,0
2/12/2018 11:50,56,69,73,64.3,129,66.3,2,0,0
2/12/2018 11:55,43,68.2,60,63.4,103,65.4,2,0,0
2/12/2018 12:00,54,68.6,73,63.9,127,65.9,2,0,0
2/12/2018 12:05,54,68.9,71,64.2,125,66.2,2,0,0
2/12/2018 12:10,51,68.9,69,64.2,120,66.2,2,0,0
2/12/2018 12:15,51,68.9,68,64.2,119,66.2,2,0,0
2/12/2018 12:20,54,69.7,73,65.1,127,67.1,2,0,0
2/12/2018 12:25,48,68.8,65,64.1,113,66.1,2,0,0
2/12/2018 12:30,62,68.4,82,63.7,144,65.8,2,0,0
2/12/2018 12:35,54,68.5,73,63.8,127,65.8,2,0,0
2/12/2018 12:40,50,68.6,67,63.9,117,65.9,2,0,0
2/12/2018 12:45,50,68.5,68,63.8,118,65.8,2,0,0
2/12/2018 12:50,52,66.6,71,61.8,123,63.8,2,0,0
2/12/2018 12:55,48,65.9,65,61,113,63.1,2,0,0
2/12/2018 13:00,45,65.5,63,60.5,108,62.6,2,0,0
2/12/2018 13:05,52,68.2,71,63.5,123,65.5,2,0,0
2/12/2018 13:10,48,67.7,65,62.8,113,64.9,2,0,0
2/12/2018 13:15,54,68.5,72,63.8,126,65.8,2,0,0
2/12/2018 13:20,55,68.5,74,63.8,129,65.8,2,0,0
2/12/2018 13:25,48,69.2,66,64.5,114,66.5,2,0,0
2/12/2018 13:30,54,67.7,71,62.9,125,64.9,2,0,0
2/12/2018 13:35,51,69.3,68,64.6,119,66.6,2,0,0
2/12/2018 13:40,50,69.7,67,65.1,117,67.1,2,0,0
2/12/2018 13:45,50,69.3,68,64.7,118,66.6,2,0,0
2/12/2018 13:50,49,68.1,67,63.4,116,65.3,2,0,0
2/12/2018 13:55,54,66.8,73,62,127,64.1,2,0,0
2/12/2018 14:00,44,68.6,61,63.9,105,65.9,2,0,0
2/12/2018 14:05,48,68.5,66,63.8,114,65.8,2,0,0
2/12/2018 14:10,45,69.5,62,64.9,107,66.8,2,0,0
2/12/2018 14:15,44,69.6,61,65,105,66.9,2,0,0
2/12/2018 14:20,50,68.1,68,63.3,118,65.4,2,0,0
2/12/2018 14:25,56,68.7,74,64,130,66.1,2,0,0
2/12/2018 14:30,52,69.9,69,65.2,121,67.2,2,0,0
2/12/2018 14:35,52,69.3,69,64.6,121,66.6,2,0,0
2/12/2018 14:40,46,69.2,63,64.5,109,66.5,2,0,0
2/12/2018 14:45,53,68.5,71,63.7,124,65.8,2,0,0
2/12/2018 14:50,48,69.4,65,64.7,113,66.7,2,0,0
2/12/2018 14:55,54,69.5,71,64.8,125,66.8,2,0,0
2/12/2018 15:00,50,68.6,67,63.8,117,65.9,2,0,0
2/12/2018 15:05,52,68,71,63.2,123,65.3,2,0,0
2/12/2018 15:10,55,68.2,74,63.5,129,65.5,2,0,0
2/12/2018 15:15,45,68.2,63,63.3,108,65.3,2,0,0
2/12/2018 15:20,48,68.7,66,64,114,66,2,0,0
2/12/2018 15:25,53,69.5,71,64.8,124,66.8,2,0,0
2/12/2018 15:30,56,67.9,75,63.1,131,65.2,2,0,0
2/12/2018 15:35,51,68.5,69,63.8,120,65.8,2,0,0
2/12/2018 15:40,63,67.5,82,62.7,145,64.8,2,0,0
2/12/2018 15:45,66,67.6,85,62.8,151,64.9,2,0,0
2/12/2018 15:50,56,68.7,74,64,130,66,2,0,0
2/12/2018 15:55,54,69.6,72,64.9,126,66.9,2,0,0
2/12/2018 16:00,49,69.6,66,64.9,115,66.9,2,0,0
2/12/2018 16:05,58,69.8,77,65.2,135,67.2,2,0,0
2/12/2018 16:10,54,69.5,71,64.9,125,66.9,2,0,0
2/12/2018 16:15,50,69.8,67,65.2,117,67.2,2,0,0
2/12/2018 16:20,53,67.6,71,62.9,124,64.9,2,0,0
2/12/2018 16:25,53,68.5,71,63.8,124,65.8,2,0,0
2/12/2018 16:30,57,67.2,75,62.5,132,64.5,2,0,0
2/12/2018 16:35,51,66.4,69,61.6,120,63.6,2,0,0
2/12/2018 16:40,52,68.2,70,63.5,122,65.5,2,0,0
2/12/2018 16:45,51,69.6,69,65,120,67,2,0,0
2/12/2018 16:50,51,69.5,68,64.9,119,66.9,2,0,0
2/12/2018 16:55,56,69.8,74,65.3,130,67.2,2,0,0
2/12/2018 17:00,53,70.1,70,65.5,123,67.5,2,0,0
2/12/2018 17:05,57,70.5,74,66.1,131,68,2,0,0
2/12/2018 17:10,50,69.9,69,65.4,119,67.3,2,0,0
2/12/2018 17:15,58,69.8,76,65.3,134,67.2,2,0,0
2/12/2018 17:20,62,70.2,80,65.7,142,67.6,2,0,0
2/12/2018 17:25,55,69.7,74,65.1,129,67.1,2,0,0
2/12/2018 17:30,56,69.5,75,64.8,131,66.8,2,0,0
2/12/2018 17:35,53,68.5,72,63.7,125,65.7,2,0,0
2/12/2018 17:40,55,69.6,74,64.9,129,66.9,2,0,0
2/12/2018 17:45,63,69.4,81,64.8,144,66.8,2,0,0
2/12/2018 17:50,48,70,67,65.5,115,67.4,2,0,0
2/12/2018 17:55,54,69.3,73,64.7,127,66.6,2,0,0
2/12/2018 18:00,48,69.1,66,64.5,114,66.4,2,0,0
2/12/2018 18:05,52,67.7,70,62.9,122,65,2,0,0
2/12/2018 18:10,56,68.1,74,63.3,130,65.4,2,0,0
2/12/2018 18:15,53,67.6,72,62.8,125,64.8,2,0,0
2/12/2018 18:20,52,67.6,70,62.8,122,64.8,2,0,0
2/12/2018 18:25,50,68.4,68,63.6,118,65.6,2,0,0
2/12/2018 18:30,54,67.7,73,62.9,127,65,2,0,0
2/12/2018 18:35,54,67.6,73,62.8,127,64.8,2,0,0
2/12/2018 18:40,50,67.9,67,63.2,117,65.2,2,0,0
2/12/2018 18:45,50,66.6,68,61.8,118,63.8,2,0,0
2/12/2018 18:50,47,67.4,65,62.6,112,64.6,2,0,0
2/12/2018 18:55,47,67.6,64,62.9,111,64.9,2,0,0
2/12/2018 19:00,42,67.5,60,62.8,102,64.8,2,0,0
2/12/2018 19:05,48,67.8,66,63.1,114,65.1,2,0,0
2/12/2018 19:10,44,67.9,61,63.2,105,65.2,2,0,0
2/12/2018 19:15,42,68.2,58,63.5,100,65.5,2,0,0
2/12/2018 19:20,45,68.8,62,64.2,107,66.2,2,0,0
2/12/2018 19:25,45,67,63,62.1,108,64.2,2,0,0
2/12/2018 19:30,36,67.7,53,62.9,89,64.9,2,0,0
2/12/2018 19:35,38,68,55,63.2,93,65.1,2,0,0
2/12/2018 19:40,28,68.8,44,64.1,72,65.9,2,0,0
2/12/2018 19:45,38,69.1,55,64.3,93,66.3,2,0,0
2/12/2018 19:50,27,69.4,43,64.8,70,66.5,2,0,0
2/12/2018 19:55,32,68.9,49,64.2,81,66,2,0,0
2/12/2018 20:00,29,69.5,45,64.9,74,66.7,2,0,0
2/12/2018 20:05,30,69.6,47,65,77,66.8,2,0,0
2/12/2018 20:10,28,69.4,45,64.7,73,66.5,2,0,0
2/12/2018 20:15,32,69.7,49,65.2,81,67,2,0,0
2/12/2018 20:20,31,69.8,47,65.2,78,67,2,0,0
2/12/2018 20:25,30,69.1,47,64.5,77,66.3,2,0,0
2/12/2018 20:30,30,69.8,47,65.3,77,67.1,2,0,0
2/12/2018 20:35,27,69.7,43,65.1,70,66.9,2,0,0
2/12/2018 20:40,23,69.5,39,64.9,62,66.6,2,0,0
2/12/2018 20:45,22,69.4,38,64.8,60,66.5,2,0,0
2/12/2018 20:50,28,68.3,45,63.7,73,65.4,2,0,0
2/12/2018 20:55,23,68.9,39,64.2,62,65.9,2,0,0
2/12/2018 21:00,22,68.9,38,64.2,60,65.9,2,0,0
2/12/2018 21:05,25,69.1,42,64.5,67,66.2,2,0,0
2/12/2018 21:10,30,69.7,47,65.1,77,66.9,2,0,0
2/12/2018 21:15,29,69.5,45,64.9,74,66.7,2,0,0
2/12/2018 21:20,25,69.3,41,64.7,66,66.4,2,0,0
2/12/2018 21:25,26,68.8,42,64.2,68,65.9,2,0,0
2/12/2018 21:30,27,69.2,43,64.6,70,66.4,2,0,0
2/12/2018 21:35,25,69,41,64.3,66,66.1,2,0,0
2/12/2018 21:40,26,68.7,41,64.1,67,65.9,2,0,0
2/12/2018 21:45,13,69.1,29,64.5,42,65.9,2,0,0
2/12/2018 21:50,24,69.3,40,64.7,64,66.5,2,0,0
2/12/2018 21:55,22,69.2,37,64.6,59,66.3,2,0,0
2/12/2018 22:00,21,68.5,36,63.8,57,65.5,2,0,0
2/12/2018 22:05,22,69,38,64.4,60,66,2,0,0
2/12/2018 22:10,19,69.2,35,64.6,54,66.2,2,0,0
2/12/2018 22:15,15,69.3,31,64.7,46,66.2,2,0,0
2/12/2018 22:20,18,69.3,33,64.7,51,66.4,2,0,0
2/12/2018 22:25,25,68.9,42,64.3,67,66,2,0,0
2/12/2018 22:30,14,69.2,30,64.6,44,66,2,0,0
2/12/2018 22:35,18,69.3,33,64.7,51,66.4,2,0,0
2/12/2018 22:40,21,69.5,37,64.9,58,66.5,2,0,0
2/12/2018 22:45,15,69.4,30,64.8,45,66.3,2,0,0
2/12/2018 22:50,20,69.6,36,65,56,66.6,2,0,0
2/12/2018 22:55,15,69.5,30,65,45,66.5,2,0,0
2/12/2018 23:00,16,69.4,32,64.8,48,66.4,2,0,0
2/12/2018 23:05,14,69.3,29,64.7,43,66.2,2,0,0
2/12/2018 23:10,13,69.3,28,64.7,41,66.2,2,0,0
2/12/2018 23:15,18,69.1,34,64.5,52,66.1,2,0,0
2/12/2018 23:20,9,69.2,25,64.6,34,65.8,2,0,0
2/12/2018 23:25,12,69.4,27,64.7,39,66.2,2,0,0
2/12/2018 23:30,11,69.4,26,64.7,37,66.1,2,0,0
2/12/2018 23:35,12,69.4,27,64.8,39,66.3,2,0,0
2/12/2018 23:40,11,69.4,26,64.8,37,66.2,2,0,0
2/12/2018 23:45,12,69.5,27,64.9,39,66.3,2,0,0
2/12/2018 23:50,12,69.5,27,64.9,39,66.3,2,0,0
2/12/2018 23:55,8,69.4,24,64.8,32,65.9,2,0,0
2/13/2018 0:00,9,69.3,24,64.7,33,66,2,0,0
2/13/2018 0:05,8,69.4,23,64.8,31,66,2,0,0
2/13/2018 0:10,9,69.2,24,64.6,33,65.9,2,0,0
2/13/2018 0:15,8,69,24,64.3,32,65.5,2,0,0
2/13/2018 0:20,7,69,22,64.4,29,65.5,2,0,0
2/13/2018 0:25,8,69.2,24,64.6,32,65.7,2,0,0
2/13/2018 0:30,7,68.9,22,64.3,29,65.4,2,0,0
2/13/2018 0:35,5,69.2,21,64.6,26,65.5,2,0,0
2/13/2018 0:40,10,69.3,20,64.7,30,66.2,2,0,0
2/13/2018 0:45,6,69.2,21,64.5,27,65.6,2,0,0
2/13/2018 0:50,8,69.3,24,64.7,32,65.8,2,0,0
2/13/2018 0:55,6,69.4,21,64.8,27,65.8,2,0,0
2/13/2018 1:00,8,69.4,23,64.8,31,66,2,0,0
2/13/2018 1:05,8,69.3,23,64.7,31,65.8,2,0,0
2/13/2018 1:10,5,69.3,20,64.7,25,65.6,2,0,0
2/13/2018 1:15,7,69.2,22,64.5,29,65.7,2,0,0
2/13/2018 1:20,9,69,19,64.4,28,65.9,2,0,0
2/13/2018 1:25,10,69.3,20,64.7,30,66.2,2,0,0
2/13/2018 1:30,6,69.3,21,64.7,27,65.8,2,0,0
2/13/2018 1:35,11,69.2,27,64.6,38,66,2,0,0
2/13/2018 1:40,7,69.3,22,64.7,29,65.8,2,0,0
2/13/2018 1:45,7,69.4,22,64.8,29,65.9,2,0,0
2/13/2018 1:50,9,69.6,24,65,33,66.2,2,0,0
2/13/2018 1:55,6,69.5,21,64.9,27,65.9,2,0,0
2/13/2018 2:00,9,69.4,19,64.8,28,66.3,2,0,0
2/13/2018 2:05,8,69.4,24,64.8,32,65.9,2,0,0
2/13/2018 2:10,10,69.4,20,64.8,30,66.3,2,0,0
2/13/2018 2:15,7,69.2,22,64.6,29,65.7,2,0,0
2/13/2018 2:20,7,68.8,22,64.2,29,65.3,2,0,0
2/13/2018 2:25,8,68.8,23,64.2,31,65.4,2,0,0
2/13/2018 2:30,7,69,22,64.4,29,65.5,2,0,0
2/13/2018 2:35,7,69.1,23,64.4,30,65.5,2,0,0
2/13/2018 2:40,11,69.1,27,64.5,38,65.8,2,0,0
2/13/2018 2:45,8,69.3,23,64.7,31,65.8,2,0,0
2/13/2018 2:50,7,69.3,22,64.7,29,65.8,2,0,0
2/13/2018 2:55,7,69.2,23,64.6,30,65.7,2,0,0
2/13/2018 3:00,10,69.1,26,64.5,36,65.8,2,0,0
2/13/2018 3:05,12,69.1,28,64.4,40,65.8,2,0,0
2/13/2018 3:10,9,69,24,64.4,33,65.7,2,0,0
2/13/2018 3:15,11,69.3,26,64.7,37,66.1,2,0,0
2/13/2018 3:20,10,69.4,26,64.8,36,66,2,0,0
2/13/2018 3:25,8,69.3,24,64.7,32,65.9,2,0,0
2/13/2018 3:30,11,69.3,27,64.7,38,66,2,0,0
2/13/2018 3:35,13,69.1,29,64.5,42,65.9,2,0,0
2/13/2018 3:40,14,69.3,30,64.6,44,66.1,2,0,0
2/13/2018 3:45,15,68.9,31,64.3,46,65.8,2,0,0
2/13/2018 3:50,13,69.2,28,64.6,41,66,2,0,0
2/13/2018 3:55,15,69.4,31,64.8,46,66.3,2,0,0
2/13/2018 4:00,14,69.4,29,64.8,43,66.3,2,0,0
2/13/2018 4:05,15,69.2,31,64.6,46,66.1,2,0,0
2/13/2018 4:10,16,69.1,31,64.5,47,66.1,2,0,0
2/13/2018 4:15,17,68.9,33,64.3,50,65.9,2,0,0
2/13/2018 4:20,19,69.1,35,64.5,54,66.1,2,0,0
2/13/2018 4:25,20,68.8,37,64.1,57,65.8,2,0,0
2/13/2018 4:30,28,69.4,45,64.7,73,66.5,2,0,0
2/13/2018 4:35,30,69.3,47,64.7,77,66.5,2,0,0
2/13/2018 4:40,33,69.1,51,64.4,84,66.2,2,0,0
2/13/2018 4:45,41,69.1,59,64.4,100,66.3,2,0,0
2/13/2018 4:50,35,68.9,52,64.3,87,66.2,2,0,0
2/13/2018 4:55,28,68.2,45,63.5,73,65.3,2,0,0
2/13/2018 5:00,36,68.5,54,63.8,90,65.7,2,0,0
2/13/2018 5:05,37,68.2,55,63.5,92,65.4,2,0,0
2/13/2018 5:10,47,67.4,66,62.6,113,64.6,2,0,0
2/13/2018 5:15,55,68.2,75,63.4,130,65.5,2,0,0
2/13/2018 5:20,51,68.4,71,63.6,122,65.6,2,0,0
2/13/2018 5:25,56,67.9,76,63,132,65.1,2,0,0
2/13/2018 5:30,51,66.8,72,61.9,123,63.9,2,0,0
2/13/2018 5:35,61,67.6,82,62.8,143,64.8,2,0,0
2/13/2018 5:40,62,65.8,84,60.8,146,62.9,2,0,0
2/13/2018 5:45,62,68.2,85,63.5,147,65.5,2,0,0
2/13/2018 5:50,73,68.6,95,63.9,168,65.9,2,0,0
2/13/2018 5:55,56,68,76,63.1,132,65.2,2,0,0
2/13/2018 6:00,59,66.6,80,61.6,139,63.7,2,0,0
2/13/2018 6:05,58,66.7,78,61.8,136,63.9,2,0,0
2/13/2018 6:10,66,66.2,87,61.2,153,63.3,2,0,0
2/13/2018 6:15,65,66.3,88,61.3,153,63.4,2,0,0
2/13/2018 6:20,72,62.2,94,56.8,166,59.1,2,0,0
2/13/2018 6:25,66,64.9,88,59.8,154,62,2,0,0
2/13/2018 6:30,68,66.1,91,61.1,159,63.2,2,0,0
2/13/2018 6:35,74,67.3,98,62.4,172,64.5,2,0,0
2/13/2018 6:40,72,67,94,62,166,64.2,2,0,0
2/13/2018 6:45,78,67.7,101,62.9,179,65,2,0,0
2/13/2018 6:50,74,66.2,97,61.2,171,63.4,2,0,0
2/13/2018 6:55,81,67.7,104,62.8,185,65,2,0,0
2/13/2018 7:00,77,66.7,100,61.7,177,63.9,2,0,0
2/13/2018 7:05,74,67.2,97,62.3,171,64.5,2,0,0
2/13/2018 7:10,78,67,101,62.1,179,64.2,2,0,0
2/13/2018 7:15,85,67.7,109,62.9,194,65,2,0,0
2/13/2018 7:20,88,67.8,112,63,200,65.1,2,0,0
2/13/2018 7:25,74,67.8,97,62.9,171,65.1,2,0,0
2/13/2018 7:30,89,67.2,112,62.2,201,64.4,2,0,0
2/13/2018 7:35,89,66.4,112,61.4,201,63.6,2,0,0
2/13/2018 7:40,87,65.7,111,60.7,198,62.9,2,0,0
2/13/2018 7:45,86,65.9,110,60.8,196,63.1,2,0,0
2/13/2018 7:50,79,66.6,103,61.6,182,63.8,2,0,0
2/13/2018 7:55,78,66.7,101,61.7,179,63.9,2,0,0
2/13/2018 8:00,82,65.8,104,60.8,186,63,2,0,0
2/13/2018 8:05,82,66,106,61.1,188,63.2,2,0,0
2/13/2018 8:10,86,65.6,110,60.5,196,62.7,2,0,0
2/13/2018 8:15,79,65.5,101,60.4,180,62.6,2,0,0
2/13/2018 8:20,78,64.9,100,59.8,178,62,2,0,0
2/13/2018 8:25,83,65.6,106,60.6,189,62.8,2,0,0
2/13/2018 8:30,75,65.9,98,60.8,173,63,2,0,0
2/13/2018 8:35,87,65.1,110,59.9,197,62.2,2,0,0
2/13/2018 8:40,84,65.1,107,59.9,191,62.2,2,0,0
2/13/2018 8:45,93,65.7,117,60.6,210,62.8,2,0,0
2/13/2018 8:50,71,65.2,92,60.1,163,62.3,2,0,0
2/13/2018 8:55,92,64.3,116,59.2,208,61.4,2,0,0
2/13/2018 9:00,89,63.3,112,58,201,60.4,2,0,0
2/13/2018 9:05,74,64.7,96,59.6,170,61.8,2,0,0
2/13/2018 9:10,80,64.9,101,59.8,181,62,2,0,0
2/13/2018 9:15,76,65.7,97,60.7,173,62.9,2,0,0
2/13/2018 9:20,75,65.4,97,60.4,172,62.6,2,0,0
2/13/2018 9:25,69,66.8,90,61.9,159,64,2,0,0
2/13/2018 9:30,79,67.3,102,62.5,181,64.6,2,0,0
2/13/2018 9:35,79,66.8,99,62,178,64.1,2,0,0
2/13/2018 9:40,81,67.2,102,62.3,183,64.5,2,0,0
2/13/2018 9:45,82,66.2,103,61.2,185,63.4,2,0,0
2/13/2018 9:50,92,65.7,114,60.7,206,62.9,2,0,0
2/13/2018 9:55,72,65.3,92,60.3,164,62.5,2,0,0
2/13/2018 10:00,70,63.8,91,58.7,161,60.9,2,0,0
2/13/2018 10:05,71,65.1,92,60.1,163,62.3,2,0,0
2/13/2018 10:10,73,65.3,94,60.4,167,62.5,2,0,0
2/13/2018 10:15,68,65.8,88,60.9,156,63.1,2,0,0
2/13/2018 10:20,65,65.7,86,60.8,151,62.9,2,0,0
2/13/2018 10:25,56,67.7,74,63,130,65,2,0,0
2/13/2018 10:30,57,66.3,76,61.5,133,63.5,2,0,0
2/13/2018 10:35,65,66.5,84,61.7,149,63.8,2,0,0
2/13/2018 10:40,66,66.7,86,61.9,152,64,2,0,0
2/13/2018 10:45,55,67.4,74,62.7,129,64.7,2,0,0
2/13/2018 10:50,50,69.2,68,64.7,118,66.6,2,0,0
2/13/2018 10:55,56,70.1,74,65.6,130,67.5,2,0,0
2/13/2018 11:00,50,69.8,68,65.3,118,67.2,2,0,0
2/13/2018 11:05,57,69.4,75,64.9,132,66.8,2,0,0
2/13/2018 11:10,56,68.4,74,63.8,130,65.8,2,0,0
2/13/2018 11:15,57,66.5,75,61.8,132,63.8,2,0,0
2/13/2018 11:20,51,66.4,70,61.6,121,63.6,2,0,0
2/13/2018 11:25,48,67.7,66,63,114,65,2,0,0
2/13/2018 11:30,49,66,67,61.1,116,63.2,2,0,0
2/13/2018 11:35,50,66.8,68,62,118,64.1,2,0,0
2/13/2018 11:40,48,68.1,66,63.4,114,65.4,2,0,0
2/13/2018 11:45,52,66.6,70,61.8,122,63.8,2,0,0
2/13/2018 11:50,55,68,73,63.3,128,65.3,2,0,0
2/13/2018 11:55,53,67.8,70,63,123,65.1,2,0,0
2/13/2018 12:00,46,68,64,63.3,110,65.2,2,0,0
2/13/2018 12:05,51,66,70,61.1,121,63.1,2,0,0
2/13/2018 12:10,50,68.3,67,63.5,117,65.6,2,0,0
2/13/2018 12:15,41,68.9,58,64.2,99,66.2,2,0,0
2/13/2018 12:20,50,67.7,69,62.9,119,64.9,2,0,0
2/13/2018 12:25,49,68.5,67,63.8,116,65.8,2,0,0
2/13/2018 12:30,50,67.5,68,62.7,118,64.7,2,0,0
2/13/2018 12:35,55,69.4,72,64.7,127,66.8,2,0,0
2/13/2018 12:40,49,69.5,66,64.8,115,66.8,2,0,0
2/13/2018 12:45,54,69.1,72,64.5,126,66.5,2,0,0
2/13/2018 12:50,60,69,78,64.5,138,66.4,2,0,0
2/13/2018 12:55,49,70,67,65.5,116,67.4,2,0,0
2/13/2018 13:00,51,69.6,69,65,120,66.9,2,0,0
2/13/2018 13:05,54,70,72,65.4,126,67.4,2,0,0
2/13/2018 13:10,45,69.8,63,65.3,108,67.2,2,0,0
2/13/2018 13:15,46,69.7,64,65.1,110,67,2,0,0
2/13/2018 13:20,43,70,59,65.5,102,67.4,2,0,0
2/13/2018 13:25,54,69.2,72,64.6,126,66.6,2,0,0
2/13/2018 13:30,52,68,70,63.3,122,65.3,2,0,0
2/13/2018 13:35,45,68.3,63,63.7,108,65.6,2,0,0
2/13/2018 13:40,51,67.5,68,62.7,119,64.7,2,0,0
2/13/2018 13:45,47,68.2,65,63.5,112,65.5,2,0,0
2/13/2018 13:50,52,67.5,70,62.8,122,64.8,2,0,0
2/13/2018 13:55,49,67.4,67,62.7,116,64.7,2,0,0
2/13/2018 14:00,45,67.4,63,62.6,108,64.6,2,0,0
2/13/2018 14:05,50,68.2,67,63.5,117,65.5,2,0,0
2/13/2018 14:10,45,68.2,63,63.5,108,65.5,2,0,0
2/13/2018 14:15,58,68.7,75,64,133,66,2,0,0
2/13/2018 14:20,50,68,68,63.4,118,65.3,2,0,0
2/13/2018 14:25,52,68.7,70,64,122,66,2,0,0
2/13/2018 14:30,43,65.5,62,60.6,105,62.6,2,0,0
2/13/2018 14:35,51,66.1,68,61.2,119,63.3,2,0,0
2/13/2018 14:40,52,67.6,70,62.9,122,64.9,2,0,0
2/13/2018 14:45,53,68.4,71,63.8,124,65.8,2,0,0
2/13/2018 14:50,41,68.8,58,64.1,99,66,2,0,0
2/13/2018 14:55,40,69.8,58,65.2,98,67.1,2,0,0
2/13/2018 15:00,53,70.6,71,66.1,124,68,2,0,0
2/13/2018 15:05,47,69.1,64,64.5,111,66.4,2,0,0
2/13/2018 15:10,62,69.6,82,65.1,144,67.1,2,0,0
2/13/2018 15:15,65,69.2,83,64.6,148,66.6,2,0,0
2/13/2018 15:20,55,69.3,73,64.7,128,66.7,2,0,0
2/13/2018 15:25,60,69.3,79,64.7,139,66.7,2,0,0
2/13/2018 15:30,64,69.4,83,64.8,147,66.8,2,0,0
2/13/2018 15:35,58,69,77,64.4,135,66.4,2,0,0
2/13/2018 15:40,66,68.7,84,64.1,150,66.1,2,0,0
2/13/2018 15:45,69,68.9,89,64.2,158,66.2,2,0,0
2/13/2018 15:50,57,69.7,75,65.1,132,67.1,2,0,0
2/13/2018 15:55,54,70.6,71,66.1,125,68.1,2,0,0
2/13/2018 16:00,65,70.2,83,65.7,148,67.7,2,0,0
2/13/2018 16:05,58,70.5,76,66.1,134,68,2,0,0
2/13/2018 16:10,55,70.9,73,66.4,128,68.3,2,0,0
2/13/2018 16:15,54,69.3,71,64.7,125,66.7,2,0,0
2/13/2018 16:20,56,68.7,73,64.1,129,66.1,2,0,0
2/13/2018 16:25,51,68.8,69,64.2,120,66.1,2,0,0
2/13/2018 16:30,58,69.1,77,64.7,135,66.6,2,0,0
2/13/2018 16:35,61,70,79,65.6,140,67.5,2,0,0
2/13/2018 16:40,61,69.8,79,65.3,140,67.3,2,0,0
2/13/2018 16:45,63,69.2,82,64.6,145,66.6,2,0,0
2/13/2018 16:50,56,69.9,73,65.4,129,67.4,2,0,0
2/13/2018 16:55,54,68.5,72,63.9,126,65.9,2,0,0
2/13/2018 17:00,50,69.7,69,65.2,119,67.1,2,0,0
2/13/2018 17:05,44,70.7,62,66.3,106,68.1,2,0,0
2/13/2018 17:10,49,71,67,66.5,116,68.4,2,0,0
2/13/2018 17:15,54,70.3,74,65.9,128,67.8,2,0,0
2/13/2018 17:20,53,71,71,66.6,124,68.5,2,0,0
2/13/2018 17:25,51,72,68,67.7,119,69.6,2,0,0
2/13/2018 17:30,61,71.3,79,67,140,68.9,2,0,0
2/13/2018 17:35,60,71.2,78,66.8,138,68.7,2,0,0
2/13/2018 17:40,56,71.6,74,67.3,130,69.2,2,0,0
2/13/2018 17:45,46,70.5,64,66.1,110,68,2,0,0
2/13/2018 17:50,50,70,70,65.4,120,67.3,2,0,0
2/13/2018 17:55,45,68.7,63,64.2,108,66.1,2,0,0
2/13/2018 18:00,35,69.4,53,64.8,88,66.6,2,0,0
2/13/2018 18:05,40,69.2,56,64.6,96,66.5,2,0,0
2/13/2018 18:10,45,67.8,62,62.9,107,65,2,0,0
2/13/2018 18:15,45,69.5,62,64.9,107,66.8,2,0,0
2/13/2018 18:20,35,68.6,52,63.8,87,65.7,2,0,0
2/13/2018 18:25,38,67.7,55,63,93,64.9,2,0,0
2/13/2018 18:30,44,69,61,64.3,105,66.3,2,0,0
2/13/2018 18:35,40,69,58,64.4,98,66.3,2,0,0
2/13/2018 18:40,46,68.9,64,64.2,110,66.1,2,0,0
2/13/2018 18:45,51,69.1,69,64.4,120,66.4,2,0,0
2/13/2018 18:50,44,69.9,61,65.3,105,67.2,2,0,0
2/13/2018 18:55,48,69.3,65,64.6,113,66.6,2,0,0
2/13/2018 19:00,50,68.5,68,63.8,118,65.8,2,0,0
2/13/2018 19:05,38,69.2,54,64.5,92,66.5,2,0,0
2/13/2018 19:10,45,69.3,63,64.7,108,66.6,2,0,0
2/13/2018 19:15,40,69.1,57,64.5,97,66.4,2,0,0
2/13/2018 19:20,41,68.4,59,63.6,100,65.6,2,0,0
2/13/2018 19:25,41,67.4,59,62.5,100,64.5,2,0,0
2/13/2018 19:30,32,68.7,49,64,81,65.8,2,0,0
2/13/2018 19:35,31,69.1,48,64.5,79,66.3,2,0,0
2/13/2018 19:40,33,69.4,49,64.8,82,66.7,2,0,0
2/13/2018 19:45,40,69.9,58,65.4,98,67.2,2,0,0
2/13/2018 19:50,35,69.9,51,65.3,86,67.2,2,0,0
2/13/2018 19:55,29,68.6,46,64,75,65.7,2,0,0
2/13/2018 20:00,33,68.8,49,64.2,82,66.1,2,0,0
2/13/2018 20:05,25,69.3,41,64.8,66,66.5,2,0,0
2/13/2018 20:10,33,69.3,49,64.7,82,66.5,2,0,0
2/13/2018 20:15,35,68.1,52,63.4,87,65.3,2,0,0
2/13/2018 20:20,29,69.1,46,64.4,75,66.2,2,0,0
2/13/2018 20:25,29,69.5,45,64.9,74,66.7,2,0,0
2/13/2018 20:30,37,69.3,54,64.7,91,66.6,2,0,0
2/13/2018 20:35,24,69.7,39,65.1,63,66.8,2,0,0
2/13/2018 20:40,27,69.1,43,64.5,70,66.3,2,0,0
2/13/2018 20:45,29,69.5,45,64.9,74,66.7,2,0,0
2/13/2018 20:50,29,68.1,46,63.4,75,65.2,2,0,0
2/13/2018 20:55,24,68.6,40,64,64,65.7,2,0,0
2/13/2018 21:00,24,68.8,40,64.2,64,65.9,2,0,0
2/13/2018 21:05,25,69,41,64.4,66,66.1,2,0,0
2/13/2018 21:10,29,68.8,46,64.1,75,65.9,2,0,0
2/13/2018 21:15,27,68.4,43,63.7,70,65.5,2,0,0
2/13/2018 21:20,24,69,40,64.4,64,66.1,2,0,0
2/13/2018 21:25,27,69,43,64.4,70,66.2,2,0,0
2/13/2018 21:30,30,69.1,46,64.4,76,66.3,2,0,0
2/13/2018 21:35,24,69.4,40,64.8,64,66.6,2,0,0
2/13/2018 21:40,26,69.6,42,65,68,66.7,2,0,0
2/13/2018 21:45,26,69.6,42,65,68,66.8,2,0,0
2/13/2018 21:50,25,69.8,41,65.2,66,66.9,2,0,0
2/13/2018 21:55,24,69,39,64.4,63,66.2,2,0,0
2/13/2018 22:00,18,69.2,34,64.6,52,66.2,2,0,0
2/13/2018 22:05,21,69.3,36,64.7,57,66.4,2,0,0
2/13/2018 22:10,19,69.3,34,64.7,53,66.4,2,0,0
2/13/2018 22:15,22,69.5,38,64.9,60,66.5,2,0,0
2/13/2018 22:20,19,69.5,35,64.9,54,66.5,2,0,0
2/13/2018 22:25,21,69.6,36,65,57,66.7,2,0,0
2/13/2018 22:30,26,69.5,42,64.9,68,66.6,2,0,0
2/13/2018 22:35,23,69.3,40,64.7,63,66.4,2,0,0
2/13/2018 22:40,19,69.2,35,64.6,54,66.2,2,0,0
2/13/2018 22:45,17,69.3,33,64.7,50,66.3,2,0,0
2/13/2018 22:50,19,69.2,34,64.6,53,66.3,2,0,0
2/13/2018 22:55,14,69.3,29,64.7,43,66.2,2,0,0
2/13/2018 23:00,11,69.3,27,64.7,38,66,2,0,0
2/13/2018 23:05,15,69.4,31,64.8,46,66.3,2,0,0
2/13/2018 23:10,18,68.9,34,64.3,52,65.9,2,0,0
2/13/2018 23:15,13,69.2,28,64.6,41,66,2,0,0
2/13/2018 23:20,13,69.3,28,64.7,41,66.1,2,0,0
2/13/2018 23:25,15,69.3,30,64.7,45,66.2,2,0,0
2/13/2018 23:30,15,69.3,30,64.7,45,66.2,2,0,0
2/13/2018 23:35,12,69.3,27,64.7,39,66.1,2,0,0
2/13/2018 23:40,15,69.4,30,64.8,45,66.3,2,0,0
2/13/2018 23:45,12,69.4,27,64.8,39,66.2,2,0,0
2/13/2018 23:50,9,69.3,24,64.7,33,66,2,0,0
2/13/2018 23:55,13,69.4,28,64.8,41,66.3,2,0,0
2/14/2018 0:00,10,69.3,25,64.7,35,66.1,2,0,0
2/14/2018 0:05,13,69.5,28,64.9,41,66.4,2,0,0
2/14/2018 0:10,9,69.3,24,64.7,33,66,2,0,0
2/14/2018 0:15,12,69.2,27,64.5,39,65.9,2,0,0
2/14/2018 0:20,9,69,24,64.4,33,65.6,2,0,0
2/14/2018 0:25,8,69.2,24,64.5,32,65.7,2,0,0
2/14/2018 0:30,8,69.1,23,64.4,31,65.6,2,0,0
2/14/2018 0:35,8,69.1,23,64.4,31,65.6,2,0,0
2/14/2018 0:40,8,69.3,23,64.7,31,65.9,2,0,0
2/14/2018 0:45,8,69.4,23,64.8,31,66,2,0,0
2/14/2018 0:50,5,69.4,21,64.8,26,65.7,2,0,0
2/14/2018 0:55,4,69.2,19,64.6,23,65.4,2,0,0
2/14/2018 1:00,5,69.3,20,64.7,25,65.6,2,0,0
2/14/2018 1:05,8,69.4,24,64.8,32,66,2,0,0
2/14/2018 1:10,7,69.4,22,64.8,29,65.9,2,0,0
2/14/2018 1:15,7,69.4,23,64.8,30,65.9,2,0,0
2/14/2018 1:20,7,69.3,22,64.7,29,65.8,2,0,0
2/14/2018 1:25,7,69.4,22,64.8,29,65.9,2,0,0
2/14/2018 1:30,9,69.1,24,64.5,33,65.8,2,0,0
2/14/2018 1:35,8,69.3,23,64.7,31,65.9,2,0,0
2/14/2018 1:40,4,69.4,19,64.8,23,65.6,2,0,0
2/14/2018 1:45,6,69.2,22,64.6,28,65.6,2,0,0
2/14/2018 1:50,6,69.4,21,64.8,27,65.8,2,0,0
2/14/2018 1:55,10,69.4,20,64.8,30,66.3,2,0,0
2/14/2018 2:00,7,69.3,23,64.7,30,65.8,2,0,0
2/14/2018 2:05,6,69.2,22,64.6,28,65.6,2,0,0
2/14/2018 2:10,6,69.4,22,64.8,28,65.8,2,0,0
2/14/2018 2:15,7,69.4,22,64.7,29,65.9,2,0,0
2/14/2018 2:20,5,69.3,21,64.7,26,65.6,2,0,0
2/14/2018 2:25,10,69.3,20,64.7,30,66.2,2,0,0
2/14/2018 2:30,9,69.3,24,64.7,33,65.9,2,0,0
2/14/2018 2:35,7,69.3,23,64.7,30,65.8,2,0,0
2/14/2018 2:40,8,69.3,24,64.7,32,65.8,2,0,0
2/14/2018 2:45,11,69.2,26,64.5,37,65.9,2,0,0
2/14/2018 2:50,11,69.5,26,64.9,37,66.3,2,0,0
2/14/2018 2:55,7,69.5,23,64.9,30,66,2,0,0
2/14/2018 3:00,8,69.4,24,64.8,32,65.9,2,0,0
2/14/2018 3:05,9,69.3,25,64.7,34,65.9,2,0,0
2/14/2018 3:10,10,69.3,25,64.7,35,66,2,0,0
2/14/2018 3:15,6,69.3,22,64.7,28,65.6,2,0,0
2/14/2018 3:20,12,69.2,28,64.6,40,66,2,0,0
2/14/2018 3:25,10,69.3,25,64.7,35,66,2,0,0
2/14/2018 3:30,10,69.3,26,64.7,36,65.9,2,0,0
2/14/2018 3:35,11,69.3,27,64.7,38,66,2,0,0
2/14/2018 3:40,10,69.3,26,64.7,36,66,2,0,0
2/14/2018 3:45,12,69.4,27,64.8,39,66.2,2,0,0
2/14/2018 3:50,15,69.1,30,64.4,45,66,2,0,0
2/14/2018 3:55,15,68.6,31,64,46,65.5,2,0,0
2/14/2018 4:00,15,68.6,31,63.9,46,65.5,2,0,0
2/14/2018 4:05,15,68.9,31,64.2,46,65.7,2,0,0
2/14/2018 4:10,15,68.9,31,64.3,46,65.8,2,0,0
2/14/2018 4:15,17,68.9,33,64.2,50,65.8,2,0,0
2/14/2018 4:20,15,69.3,31,64.7,46,66.2,2,0,0
2/14/2018 4:25,20,69.3,37,64.7,57,66.3,2,0,0
2/14/2018 4:30,26,69,43,64.3,69,66.1,2,0,0
2/14/2018 4:35,26,69.4,43,64.7,69,66.5,2,0,0
2/14/2018 4:40,32,69.2,49,64.6,81,66.4,2,0,0
2/14/2018 4:45,32,69.5,50,64.9,82,66.7,2,0,0
2/14/2018 4:50,40,70.2,58,65.6,98,67.5,2,0,0
2/14/2018 4:55,36,69.1,54,64.4,90,66.3,2,0,0
2/14/2018 5:00,38,69.1,57,64.5,95,66.3,2,0,0
2/14/2018 5:05,40,69.9,58,65.4,98,67.3,2,0,0
2/14/2018 5:10,54,69.4,74,64.8,128,66.7,2,0,0
2/14/2018 5:15,48,69.8,66,65.3,114,67.2,2,0,0
2/14/2018 5:20,56,69.6,76,65,132,67,2,0,0
2/14/2018 5:25,54,68.1,73,63.4,127,65.4,2,0,0
2/14/2018 5:30,58,68.5,79,63.9,137,65.9,2,0,0
2/14/2018 5:35,66,68.6,87,64,153,66,2,0,0
2/14/2018 5:40,54,68,75,63.3,129,65.2,2,0,0
2/14/2018 5:45,60,69,80,64.3,140,66.3,2,0,0
2/14/2018 5:50,70,68.4,92,63.7,162,65.7,2,0,0
2/14/2018 5:55,59,67.8,80,63.1,139,65.1,2,0,0
2/14/2018 6:00,55,67.5,75,62.7,130,64.7,2,0,0
2/14/2018 6:05,58,67.7,79,62.8,137,64.9,2,0,0
2/14/2018 6:10,57,67.6,78,62.7,135,64.8,2,0,0
2/14/2018 6:15,57,68.8,78,64,135,66,2,0,0
2/14/2018 6:20,72,67.4,95,62.5,167,64.6,2,0,0
2/14/2018 6:25,65,68.3,86,63.4,151,65.5,2,0,0
2/14/2018 6:30,64,66.6,87,61.6,151,63.7,2,0,0
2/14/2018 6:35,55,68,76,63.2,131,65.2,2,0,0
2/14/2018 6:40,83,66.5,107,61.5,190,63.7,2,0,0
2/14/2018 6:45,71,67.9,93,63.1,164,65.2,2,0,0
2/14/2018 6:50,68,68.9,89,64.1,157,66.2,2,0,0
2/14/2018 6:55,76,68.9,97,64.1,173,66.2,2,0,0
2/14/2018 7:00,77,68.3,100,63.5,177,65.6,2,0,0
2/14/2018 7:05,76,67.4,98,62.5,174,64.6,2,0,0
2/14/2018 7:10,83,67.2,106,62.3,189,64.5,2,0,0
2/14/2018 7:15,75,67.9,98,63.1,173,65.2,2,0,0
2/14/2018 7:20,78,67.4,102,62.5,180,64.6,2,0,0
2/14/2018 7:25,80,66.7,103,61.7,183,63.8,2,0,0
2/14/2018 7:30,99,66.2,124,61.1,223,63.4,2,0,0
2/14/2018 7:35,89,65.9,113,60.9,202,63.1,2,0,0
2/14/2018 7:40,88,66.8,111,61.8,199,64,2,0,0
2/14/2018 7:45,84,66.1,108,61,192,63.2,2,0,0
2/14/2018 7:50,73,66.9,94,61.9,167,64.1,2,0,0
2/14/2018 7:55,78,66.6,100,61.6,178,63.8,2,0,0
2/14/2018 8:00,83,65.6,107,60.4,190,62.7,2,0,0
2/14/2018 8:05,79,65.3,102,60.1,181,62.4,2,0,0
2/14/2018 8:10,75,65.7,97,60.7,172,62.9,2,0,0
2/14/2018 8:15,79,66.4,102,61.4,181,63.6,2,0,0
2/14/2018 8:20,79,65.5,103,60.5,182,62.7,2,0,0
2/14/2018 8:25,83,66,105,60.9,188,63.2,2,0,0
2/14/2018 8:30,79,65.3,101,60.2,180,62.4,2,0,0
2/14/2018 8:35,84,65,107,59.9,191,62.1,2,0,0
2/14/2018 8:40,86,65.3,110,60.2,196,62.5,2,0,0
2/14/2018 8:45,86,65.2,109,60.2,195,62.4,2,0,0
2/14/2018 8:50,78,65.2,100,60.2,178,62.4,2,0,0
2/14/2018 8:55,88,65.4,110,60.4,198,62.6,2,0,0
2/14/2018 9:00,80,64.2,102,59.1,182,61.3,2,0,0
2/14/2018 9:05,74,65.2,95,60.1,169,62.3,2,0,0
2/14/2018 9:10,78,64.6,100,59.4,178,61.7,2,0,0
2/14/2018 9:15,73,64.4,95,59.2,168,61.4,2,0,0
2/14/2018 9:20,79,64.9,100,59.9,179,62.1,2,0,0
2/14/2018 9:25,73,65.5,94,60.4,167,62.6,2,0,0
2/14/2018 9:30,66,67.1,87,62.2,153,64.3,2,0,0
2/14/2018 9:35,81,65.9,103,61,184,63.2,2,0,0
2/14/2018 9:40,78,65.9,101,60.9,179,63.1,2,0,0
2/14/2018 9:45,70,65.9,91,60.9,161,63.1,2,0,0
2/14/2018 9:50,71,65.4,92,60.4,163,62.5,2,0,0
2/14/2018 9:55,72,65.9,93,61,165,63.1,2,0,0
2/14/2018 10:00,71,66.1,91,61.2,162,63.3,2,0,0
2/14/2018 10:05,77,65.9,98,61.1,175,63.2,2,0,0
2/14/2018 10:10,75,66.9,95,62.2,170,64.3,2,0,0
2/14/2018 10:15,68,66.5,87,61.8,155,63.9,2,0,0
2/14/2018 10:20,68,66.5,87,61.8,155,63.9,2,0,0
2/14/2018 10:25,57,66.7,75,62,132,64,2,0,0
2/14/2018 10:30,68,68.2,88,63.6,156,65.6,2,0,0
2/14/2018 10:35,66,68.6,84,64,150,66,2,0,0
2/14/2018 10:40,70,67.4,89,62.8,159,64.8,2,0,0
2/14/2018 10:45,59,65.6,79,60.8,138,62.8,2,0,0
2/14/2018 10:50,66,64.4,86,59.4,152,61.6,2,0,0
2/14/2018 10:55,62,67.1,81,62.4,143,64.4,2,0,0
2/14/2018 11:00,63,68,82,63.2,145,65.3,2,0,0
2/14/2018 11:05,52,68.4,69,63.8,121,65.8,2,0,0
2/14/2018 11:10,54,67.1,73,62.5,127,64.5,2,0,0
2/14/2018 11:15,45,68.3,63,63.7,108,65.7,2,0,0
2/14/2018 11:20,54,67.3,72,62.6,126,64.6,2,0,0
2/14/2018 11:25,46,67.3,64,62.6,110,64.6,2,0,0
2/14/2018 11:30,48,66.1,65,61.2,113,63.3,2,0,0
2/14/2018 11:35,54,66.9,72,62.2,126,64.2,2,0,0
2/14/2018 11:40,48,66.8,66,62.1,114,64.1,2,0,0
2/14/2018 11:45,52,68.4,69,63.7,121,65.7,2,0,0
2/14/2018 11:50,58,69.2,76,64.6,134,66.6,2,0,0
2/14/2018 11:55,51,70.1,69,65.6,120,67.5,2,0,0
2/14/2018 12:00,51,69.5,68,64.9,119,66.9,2,0,0
2/14/2018 12:05,51,67.7,69,63,120,65,2,0,0
2/14/2018 12:10,49,68.6,66,64,115,66,2,0,0
2/14/2018 12:15,57,69.7,75,65.2,132,67.1,2,0,0
2/14/2018 12:20,47,69.6,66,65.1,113,67,2,0,0
2/14/2018 12:25,40,68.9,57,64.3,97,66.2,2,0,0
2/14/2018 12:30,49,69.9,66,65.4,115,67.3,2,0,0
2/14/2018 12:35,53,68.5,70,63.8,123,65.8,2,0,0
2/14/2018 12:40,55,69.5,72,65,127,66.9,2,0,0
2/14/2018 12:45,54,68.7,72,64.1,126,66.1,2,0,0
2/14/2018 12:50,51,69,68,64.5,119,66.4,2,0,0
2/14/2018 12:55,59,69.8,77,65.2,136,67.2,2,0,0
2/14/2018 13:00,53,69.6,71,65.1,124,67,2,0,0
2/14/2018 13:05,49,68.7,67,64.1,116,66,2,0,0
2/14/2018 13:10,61,69.3,80,64.7,141,66.7,2,0,0
2/14/2018 13:15,55,69.2,74,64.7,129,66.6,2,0,0
2/14/2018 13:20,52,68.6,69,64,121,66,2,0,0
2/14/2018 13:25,45,68.5,63,63.9,108,65.8,2,0,0
2/14/2018 13:30,45,68.7,63,64.1,108,66,2,0,0
2/14/2018 13:35,64,69.1,83,64.6,147,66.6,2,0,0
2/14/2018 13:40,58,68.1,78,63.4,136,65.4,2,0,0
2/14/2018 13:45,55,68.7,72,64,127,66,2,0,0
2/14/2018 13:50,50,67.1,68,62.3,118,64.3,2,0,0
2/14/2018 13:55,44,65.9,61,61,105,63.1,2,0,0
2/14/2018 14:00,47,67.7,63,62.9,110,64.9,2,0,0
2/14/2018 14:05,51,67.2,69,62.4,120,64.4,2,0,0
2/14/2018 14:10,40,68.2,58,63.5,98,65.4,2,0,0
2/14/2018 14:15,46,67.4,64,62.7,110,64.7,2,0,0
2/14/2018 14:20,47,68.1,64,63.5,111,65.4,2,0,0
2/14/2018 14:25,47,68.4,65,63.7,112,65.7,2,0,0
2/14/2018 14:30,50,67.7,69,62.9,119,64.9,2,0,0
2/14/2018 14:35,55,68.6,73,63.9,128,66,2,0,0
2/14/2018 14:40,51,68.6,68,63.9,119,65.9,2,0,0
2/14/2018 14:45,41,69.1,60,64.5,101,66.4,2,0,0
2/14/2018 14:50,44,69,62,64.4,106,66.3,2,0,0
2/14/2018 14:55,47,68.9,64,64.2,111,66.2,2,0,0
2/14/2018 15:00,49,67.2,68,62.5,117,64.4,2,0,0
2/14/2018 15:05,50,68.4,68,63.7,118,65.7,2,0,0
2/14/2018 15:10,58,68.8,77,64.1,135,66.2,2,0,0
2/14/2018 15:15,58,67.1,76,62.3,134,64.4,2,0,0
2/14/2018 15:20,55,65.3,73,60.3,128,62.4,2,0,0
2/14/2018 15:25,55,67.4,73,62.6,128,64.6,2,0,0
2/14/2018 15:30,56,67.8,74,63.1,130,65.1,2,0,0
2/14/2018 15:35,58,68.6,77,63.9,135,65.9,2,0,0
2/14/2018 15:40,56,68.6,74,64,130,66,2,0,0
2/14/2018 15:45,70,67.9,90,63.2,160,65.3,2,0,0
2/14/2018 15:50,54,68.3,71,63.5,125,65.6,2,0,0
2/14/2018 15:55,49,69.6,67,65,116,67,2,0,0
2/14/2018 16:00,53,69.8,70,65.2,123,67.2,2,0,0
2/14/2018 16:05,49,68.3,67,63.6,116,65.6,2,0,0
2/14/2018 16:10,63,68.4,81,63.7,144,65.8,2,0,0
2/14/2018 16:15,57,68.9,76,64.2,133,66.2,2,0,0
2/14/2018 16:20,55,67.5,73,62.6,128,64.7,2,0,0
2/14/2018 16:25,51,68.1,68,63.4,119,65.4,2,0,0
2/14/2018 16:30,59,67.7,76,62.8,135,64.9,2,0,0
2/14/2018 16:35,56,68.1,74,63.3,130,65.3,2,0,0
2/14/2018 16:40,62,68,81,63.2,143,65.3,2,0,0
2/14/2018 16:45,48,68.4,65,63.7,113,65.7,2,0,0
2/14/2018 16:50,61,67.8,79,63,140,65.1,2,0,0
2/14/2018 16:55,60,67,80,62.1,140,64.2,2,0,0
2/14/2018 17:00,44,68.8,61,64.2,105,66.1,2,0,0
2/14/2018 17:05,53,67.7,73,62.9,126,64.9,2,0,0
2/14/2018 17:10,57,69.2,76,64.6,133,66.6,2,0,0
2/14/2018 17:15,56,69,75,64.4,131,66.3,2,0,0
2/14/2018 17:20,59,68,79,63.3,138,65.3,2,0,0
2/14/2018 17:25,54,67.6,73,62.7,127,64.8,2,0,0
2/14/2018 17:30,52,68.5,72,63.8,124,65.7,2,0,0
2/14/2018 17:35,63,67.1,82,62.2,145,64.3,2,0,0
2/14/2018 17:40,59,66,78,61,137,63.2,2,0,0
2/14/2018 17:45,46,65.8,65,60.8,111,62.8,2,0,0
2/14/2018 17:50,48,67,66,62.1,114,64.1,2,0,0
2/14/2018 17:55,52,66.9,71,61.9,123,64,2,0,0
2/14/2018 18:00,48,68.5,66,63.8,114,65.8,2,0,0
2/14/2018 18:05,51,68.8,68,64.2,119,66.2,2,0,0
2/14/2018 18:10,45,67.8,63,63.1,108,65.1,2,0,0
2/14/2018 18:15,56,67.6,74,62.9,130,64.9,2,0,0
2/14/2018 18:20,51,67.5,70,62.8,121,64.8,2,0,0
2/14/2018 18:25,53,67.4,71,62.6,124,64.6,2,0,0
2/14/2018 18:30,42,67.4,59,62.5,101,64.6,2,0,0
2/14/2018 18:35,47,67.2,65,62.4,112,64.4,2,0,0
2/14/2018 18:40,45,67.7,62,62.9,107,64.9,2,0,0
2/14/2018 18:45,35,67.8,52,63,87,64.9,2,0,0
2/14/2018 18:50,47,68.6,65,63.8,112,65.8,2,0,0
2/14/2018 18:55,50,68.8,67,64.1,117,66.1,2,0,0
2/14/2018 19:00,42,67.6,60,62.8,102,64.8,2,0,0
2/14/2018 19:05,40,67.1,57,62.3,97,64.3,2,0,0
2/14/2018 19:10,40,68.2,56,63.6,96,65.5,2,0,0
2/14/2018 19:15,35,68.9,52,64.2,87,66.1,2,0,0
2/14/2018 19:20,32,68.8,48,64.1,80,66,2,0,0
2/14/2018 19:25,36,68,53,63.3,89,65.2,2,0,0
2/14/2018 19:30,34,68.6,50,63.9,84,65.8,2,0,0
2/14/2018 19:35,37,69,54,64.3,91,66.2,2,0,0
2/14/2018 19:40,33,68.7,49,64,82,65.9,2,0,0
2/14/2018 19:45,33,69.2,50,64.5,83,66.4,2,0,0
2/14/2018 19:50,30,69.9,45,65.2,75,67.1,2,0,0
2/14/2018 19:55,27,69.5,43,64.9,70,66.7,2,0,0
2/14/2018 20:00,32,69.1,49,64.4,81,66.3,2,0,0
2/14/2018 20:05,30,69.5,45,64.9,75,66.7,2,0,0
2/14/2018 20:10,33,69.5,49,64.9,82,66.8,2,0,0
2/14/2018 20:15,32,69,49,64.3,81,66.2,2,0,0
2/14/2018 20:20,28,69,45,64.4,73,66.1,2,0,0
2/14/2018 20:25,27,69.5,43,64.9,70,66.7,2,0,0
2/14/2018 20:30,27,68.9,44,64.2,71,66,2,0,0
2/14/2018 20:35,25,69.4,41,64.8,66,66.6,2,0,0
2/14/2018 20:40,30,69.2,47,64.5,77,66.3,2,0,0
2/14/2018 20:45,28,69.6,44,65,72,66.8,2,0,0
2/14/2018 20:50,21,69.7,36,65.1,57,66.8,2,0,0
2/14/2018 20:55,29,69.6,46,65,75,66.8,2,0,0
2/14/2018 21:00,27,69.5,43,64.9,70,66.7,2,0,0
2/14/2018 21:05,25,69.1,41,64.5,66,66.2,2,0,0
2/14/2018 21:10,36,68.8,53,64.1,89,66,2,0,0
2/14/2018 21:15,33,69.5,49,64.8,82,66.7,2,0,0
2/14/2018 21:20,27,69.3,43,64.7,70,66.4,2,0,0
2/14/2018 21:25,24,69.4,40,64.8,64,66.5,2,0,0
2/14/2018 21:30,31,68.9,47,64.2,78,66.1,2,0,0
2/14/2018 21:35,24,69,40,64.4,64,66.1,2,0,0
2/14/2018 21:40,23,69.2,40,64.5,63,66.2,2,0,0
2/14/2018 21:45,29,68.8,46,64.1,75,65.9,2,0,0
2/14/2018 21:50,22,68.8,38,64.1,60,65.8,2,0,0
2/14/2018 21:55,23,68.7,39,64,62,65.7,2,0,0
2/14/2018 22:00,21,69,37,64.4,58,66.1,2,0,0
2/14/2018 22:05,18,69.4,34,64.8,52,66.4,2,0,0
2/14/2018 22:10,19,68.7,35,64.1,54,65.7,2,0,0
2/14/2018 22:15,20,68.7,37,64,57,65.6,2,0,0
2/14/2018 22:20,21,68.5,37,63.9,58,65.5,2,0,0
2/14/2018 22:25,22,68.8,38,64.2,60,65.9,2,0,0
2/14/2018 22:30,19,69,34,64.4,53,66,2,0,0
2/14/2018 22:35,16,69.1,32,64.5,48,66,2,0,0
2/14/2018 22:40,22,68.8,37,64.2,59,65.9,2,0,0
2/14/2018 22:45,18,69.1,34,64.5,52,66.1,2,0,0
2/14/2018 22:50,18,69.2,34,64.6,52,66.2,2,0,0
2/14/2018 22:55,17,69.4,33,64.8,50,66.3,2,0,0
2/14/2018 23:00,19,69.3,35,64.7,54,66.3,2,0,0
2/14/2018 23:05,19,69.3,34,64.7,53,66.4,2,0,0
2/14/2018 23:10,23,69.7,39,65.1,62,66.8,2,0,0
2/14/2018 23:15,17,69.6,33,65,50,66.6,2,0,0
2/14/2018 23:20,14,69.6,30,65,44,66.4,2,0,0
2/14/2018 23:25,17,69.6,32,65,49,66.6,2,0,0
2/14/2018 23:30,15,69.4,30,64.8,45,66.3,2,0,0
2/14/2018 23:35,16,69.3,32,64.7,48,66.2,2,0,0
2/14/2018 23:40,14,69.4,29,64.8,43,66.3,2,0,0
2/14/2018 23:45,14,69.4,29,64.7,43,66.2,2,0,0
2/14/2018 23:50,12,69.2,28,64.5,40,65.9,2,0,0
2/14/2018 23:55,11,69.3,26,64.7,37,66.1,2,0,0
2/15/2018 0:00,14,69.3,30,64.7,44,66.2,2,0,0
2/15/2018 0:05,11,69.4,27,64.8,38,66.1,2,0,0
2/15/2018 0:10,14,69.4,29,64.8,43,66.3,2,0,0
2/15/2018 0:15,13,69.3,28,64.7,41,66.1,2,0,0
2/15/2018 0:20,10,69.3,26,64.7,36,66,2,0,0
2/15/2018 0:25,8,69.1,23,64.5,31,65.7,2,0,0
2/15/2018 0:30,8,69.3,23,64.7,31,65.9,2,0,0
2/15/2018 0:35,11,69.3,26,64.7,37,66,2,0,0
2/15/2018 0:40,8,69.4,23,64.8,31,66,2,0,0
2/15/2018 0:45,7,69.4,23,64.8,30,65.8,2,0,0
2/15/2018 0:50,6,69.4,21,64.8,27,65.8,2,0,0
2/15/2018 0:55,7,69.1,23,64.5,30,65.6,2,0,0
2/15/2018 1:00,9,69,24,64.4,33,65.7,2,0,0
2/15/2018 1:05,11,69.2,21,64.6,32,66.2,2,0,0
2/15/2018 1:10,9,69.3,24,64.7,33,66,2,0,0
2/15/2018 1:15,7,69.3,22,64.7,29,65.8,2,0,0
2/15/2018 1:20,7,69.4,22,64.8,29,65.9,2,0,0
2/15/2018 1:25,9,69.1,24,64.5,33,65.7,2,0,0
2/15/2018 1:30,8,69.2,23,64.6,31,65.8,2,0,0
2/15/2018 1:35,9,69.4,25,64.8,34,66,2,0,0
2/15/2018 1:40,6,69.4,22,64.8,28,65.8,2,0,0
2/15/2018 1:45,6,69.4,21,64.8,27,65.8,2,0,0
2/15/2018 1:50,8,69.4,23,64.8,31,66,2,0,0
2/15/2018 1:55,5,69.4,20,64.8,25,65.8,2,0,0
2/15/2018 2:00,8,69.2,24,64.6,32,65.8,2,0,0
2/15/2018 2:05,8,69.3,23,64.7,31,65.9,2,0,0
2/15/2018 2:10,9,69.1,25,64.4,34,65.7,2,0,0
2/15/2018 2:15,7,69.2,22,64.5,29,65.7,2,0,0
2/15/2018 2:20,7,69.3,22,64.7,29,65.8,2,0,0
2/15/2018 2:25,6,69.3,21,64.7,27,65.8,2,0,0
2/15/2018 2:30,7,69.3,22,64.7,29,65.8,2,0,0
2/15/2018 2:35,7,69.3,22,64.7,29,65.8,2,0,0
2/15/2018 2:40,8,69.3,24,64.7,32,65.9,2,0,0
2/15/2018 2:45,8,69.3,23,64.7,31,65.9,2,0,0
2/15/2018 2:50,10,69.4,25,64.8,35,66.1,2,0,0
2/15/2018 2:55,9,69.3,24,64.7,33,66,2,0,0
2/15/2018 3:00,7,69.2,23,64.6,30,65.7,2,0,0
2/15/2018 3:05,11,69.4,26,64.7,37,66.1,2,0,0
2/15/2018 3:10,10,69.3,26,64.7,36,66,2,0,0
2/15/2018 3:15,11,69.4,27,64.7,38,66.1,2,0,0
2/15/2018 3:20,8,69.3,24,64.7,32,65.9,2,0,0
2/15/2018 3:25,11,69.3,27,64.7,38,66.1,2,0,0
2/15/2018 3:30,11,69.3,26,64.7,37,66,2,0,0
2/15/2018 3:35,12,69.3,28,64.7,40,66.1,2,0,0
2/15/2018 3:40,15,69.4,31,64.8,46,66.3,2,0,0
2/15/2018 3:45,15,69.2,30,64.6,45,66.2,2,0,0
2/15/2018 3:50,16,69.4,32,64.8,48,66.3,2,0,0
2/15/2018 3:55,24,68.7,40,64,64,65.8,2,0,0
2/15/2018 4:00,14,68.9,29,64.3,43,65.8,2,0,0
2/15/2018 4:05,20,69,36,64.4,56,66,2,0,0
2/15/2018 4:10,22,69,39,64.4,61,66.1,2,0,0
2/15/2018 4:15,25,69.2,41,64.5,66,66.3,2,0,0
2/15/2018 4:20,25,69.6,41,64.9,66,66.7,2,0,0
2/15/2018 4:25,23,69.5,39,64.9,62,66.6,2,0,0
2/15/2018 4:30,30,69,47,64.3,77,66.1,2,0,0
2/15/2018 4:35,34,69.3,51,64.7,85,66.6,2,0,0
2/15/2018 4:40,38,69.2,56,64.5,94,66.4,2,0,0
2/15/2018 4:45,47,69.9,65,65.3,112,67.3,2,0,0
2/15/2018 4:50,39,70.5,57,66,96,67.8,2,0,0
2/15/2018 4:55,32,70.1,50,65.5,82,67.3,2,0,0
2/15/2018 5:00,38,69.6,57,65,95,66.9,2,0,0
2/15/2018 5:05,43,69.4,62,64.8,105,66.7,2,0,0
2/15/2018 5:10,53,69.5,73,64.8,126,66.8,2,0,0
2/15/2018 5:15,51,68.9,70,64.2,121,66.2,2,0,0
2/15/2018 5:20,51,68.3,72,63.5,123,65.5,2,0,0
2/15/2018 5:25,51,68.5,72,63.6,123,65.6,2,0,0
2/15/2018 5:30,52,69,73,64.3,125,66.2,2,0,0
2/15/2018 5:35,69,67.6,91,62.8,160,64.9,2,0,0
2/15/2018 5:40,72,67.2,94,62.3,166,64.4,2,0,0
2/15/2018 5:45,61,68.5,81,63.8,142,65.8,2,0,0
2/15/2018 5:50,66,68.9,87,64.2,153,66.2,2,0,0
2/15/2018 5:55,59,69.3,79,64.7,138,66.7,2,0,0
2/15/2018 6:00,62,69,82,64.3,144,66.3,2,0,0
2/15/2018 6:05,66,67.6,87,62.8,153,64.8,2,0,0
2/15/2018 6:10,63,66.9,84,62,147,64.1,2,0,0
2/15/2018 6:15,66,66.7,88,61.8,154,63.9,2,0,0
2/15/2018 6:20,68,66.1,90,61.2,158,63.3,2,0,0
2/15/2018 6:25,44,68,63,63.2,107,65.2,2,0,0
2/15/2018 6:30,58,67.6,79,62.8,137,64.8,2,0,0
2/15/2018 6:35,59,69,80,64.3,139,66.3,2,0,0
2/15/2018 6:40,62,68.4,83,63.7,145,65.7,2,0,0
2/15/2018 6:45,55,68.8,74,64,129,66,2,0,0
2/15/2018 6:50,76,69.5,98,64.8,174,66.9,2,0,0
2/15/2018 6:55,61,69.3,81,64.6,142,66.7,2,0,0
2/15/2018 7:00,77,69.3,100,64.6,177,66.6,2,0,0
2/15/2018 7:05,74,69.4,96,64.7,170,66.8,2,0,0
2/15/2018 7:10,70,70.4,93,65.8,163,67.8,2,0,0
2/15/2018 7:15,78,70,100,65.3,178,67.4,2,0,0
2/15/2018 7:20,80,68.4,102,63.5,182,65.6,2,0,0
2/15/2018 7:25,84,68.1,107,63.2,191,65.4,2,0,0
2/15/2018 7:30,76,68.5,99,63.6,175,65.7,2,0,0
2/15/2018 7:35,92,66.9,116,61.9,208,64.1,2,0,0
2/15/2018 7:40,90,67.3,114,62.4,204,64.5,2,0,0
2/15/2018 7:45,89,67.2,113,62.2,202,64.4,2,0,0
2/15/2018 7:50,81,66.6,104,61.6,185,63.8,2,0,0
2/15/2018 7:55,84,66.9,106,62,190,64.2,2,0,0
2/15/2018 8:00,83,66.9,106,62,189,64.2,2,0,0
2/15/2018 8:05,77,66.9,99,61.9,176,64.1,2,0,0
2/15/2018 8:10,84,67.1,107,62.2,191,64.4,2,0,0
2/15/2018 8:15,75,68,98,63.3,173,65.3,2,0,0
2/15/2018 8:20,68,69.8,89,65.1,157,67.2,2,0,0
2/15/2018 8:25,79,69.2,100,64.5,179,66.6,2,0,0
2/15/2018 8:30,83,69.5,106,64.7,189,66.8,2,0,0
2/15/2018 8:35,75,68.6,98,63.8,173,65.8,2,0,0
2/15/2018 8:40,77,68.2,99,63.4,176,65.5,2,0,0
2/15/2018 8:45,79,67.2,100,62.3,179,64.5,2,0,0
2/15/2018 8:50,75,67.9,98,63,173,65.1,2,0,0
2/15/2018 8:55,78,67.8,98,63,176,65.1,2,0,0
2/15/2018 9:00,81,67.4,104,62.6,185,64.7,2,0,0
2/15/2018 9:05,80,66.6,101,61.7,181,63.9,2,0,0
2/15/2018 9:10,78,66.2,100,61.4,178,63.5,2,0,0
2/15/2018 9:15,75,67.1,97,62.4,172,64.4,2,0,0
2/15/2018 9:20,71,68.2,92,63.5,163,65.6,2,0,0
2/15/2018 9:25,74,67.2,95,62.4,169,64.5,2,0,0
2/15/2018 9:30,74,68.1,95,63.3,169,65.4,2,0,0
2/15/2018 9:35,71,68,92,63.2,163,65.3,2,0,0
2/15/2018 9:40,72,68.1,93,63.4,165,65.5,2,0,0
2/15/2018 9:45,87,67.7,109,62.9,196,65,2,0,0
2/15/2018 9:50,77,67.9,98,63.2,175,65.3,2,0,0
2/15/2018 9:55,87,66.3,109,61.4,196,63.6,2,0,0
2/15/2018 10:00,77,66.3,97,61.4,174,63.5,2,0,0
2/15/2018 10:05,79,66.5,100,61.7,179,63.8,2,0,0
2/15/2018 10:10,75,67.2,96,62.4,171,64.5,2,0,0
2/15/2018 10:15,76,68.3,97,63.7,173,65.7,2,0,0
2/15/2018 10:20,66,68.3,86,63.7,152,65.7,2,0,0
2/15/2018 10:25,63,69.4,83,64.8,146,66.7,2,0,0
2/15/2018 10:30,70,68.7,89,64,159,66.1,2,0,0
2/15/2018 10:35,69,68.7,88,64,157,66.1,2,0,0
2/15/2018 10:40,66,69.2,84,64.6,150,66.6,2,0,0
2/15/2018 10:45,64,69.2,83,64.6,147,66.6,2,0,0
2/15/2018 10:50,60,69.3,79,64.7,139,66.7,2,0,0
2/15/2018 10:55,54,68.8,71,64.1,125,66.2,2,0,0
2/15/2018 11:00,59,68,78,63.3,137,65.3,2,0,0
2/15/2018 11:05,55,67.4,73,62.7,128,64.7,2,0,0
2/15/2018 11:10,47,66.1,65,61.3,112,63.3,2,0,0
2/15/2018 11:15,59,66.1,78,61.3,137,63.4,2,0,0
2/15/2018 11:20,47,66.5,65,61.7,112,63.7,2,0,0
2/15/2018 11:25,52,66.7,71,61.9,123,63.9,2,0,0
2/15/2018 11:30,40,67.9,57,63.1,97,65.1,2,0,0
2/15/2018 11:35,48,66.1,65,61.3,113,63.4,2,0,0
2/15/2018 11:40,62,66.6,83,61.8,145,63.8,2,0,0
2/15/2018 11:45,54,66.7,73,62,127,64,2,0,0
2/15/2018 11:50,63,67.3,82,62.6,145,64.6,2,0,0
2/15/2018 11:55,61,66.3,80,61.5,141,63.6,2,0,0
2/15/2018 12:00,54,66.5,72,61.8,126,63.8,2,0,0
2/15/2018 12:05,57,66.1,75,61.2,132,63.3,2,0,0
2/15/2018 12:10,54,66.8,73,62,127,64,2,0,0
2/15/2018 12:15,53,66.9,71,62.2,124,64.2,2,0,0
2/15/2018 12:20,48,66.1,66,61.3,114,63.4,2,0,0
2/15/2018 12:25,59,65.7,77,60.8,136,63,2,0,0
2/15/2018 12:30,45,66.5,62,61.7,107,63.7,2,0,0
2/15/2018 12:35,57,66.7,75,61.9,132,64,2,0,0
2/15/2018 12:40,53,66.7,70,61.9,123,63.9,2,0,0
2/15/2018 12:45,49,67.4,66,62.6,115,64.6,2,0,0
2/15/2018 12:50,65,67.4,83,62.6,148,64.7,2,0,0
2/15/2018 12:55,64,67.1,83,62.3,147,64.4,2,0,0
2/15/2018 13:00,57,68.3,76,63.6,133,65.6,2,0,0
2/15/2018 13:05,60,69.4,79,64.8,139,66.8,2,0,0
2/15/2018 13:10,52,68.6,70,63.9,122,65.9,2,0,0
2/15/2018 13:15,56,68.1,74,63.4,130,65.4,2,0,0
2/15/2018 13:20,60,67.2,79,62.4,139,64.5,2,0,0
2/15/2018 13:25,50,68,69,63.3,119,65.2,2,0,0
2/15/2018 13:30,52,68.4,69,63.7,121,65.7,2,0,0
2/15/2018 13:35,51,69.5,69,64.9,120,66.9,2,0,0
2/15/2018 13:40,49,70.6,67,66.1,116,68,2,0,0
2/15/2018 13:45,55,70.6,74,66.1,129,68,2,0,0
2/15/2018 13:50,55,69.9,72,65.3,127,67.3,2,0,0
2/15/2018 13:55,59,69.5,77,64.9,136,66.9,2,0,0
2/15/2018 14:00,38,69.5,55,64.9,93,66.8,2,0,0
2/15/2018 14:05,55,69.3,72,64.6,127,66.6,2,0,0
2/15/2018 14:10,43,69.2,60,64.5,103,66.5,2,0,0
2/15/2018 14:15,45,67.9,62,63.1,107,65.1,2,0,0
2/15/2018 14:20,53,69.1,70,64.5,123,66.5,2,0,0
2/15/2018 14:25,52,69.2,70,64.6,122,66.5,2,0,0
2/15/2018 14:30,52,69.4,70,64.7,122,66.7,2,0,0
2/15/2018 14:35,54,70.1,72,65.5,126,67.4,2,0,0
2/15/2018 14:40,46,69.5,63,64.9,109,66.8,2,0,0
2/15/2018 14:45,44,70.8,61,66.3,105,68.2,2,0,0
2/15/2018 14:50,54,69.7,72,65.1,126,67.1,2,0,0
2/15/2018 14:55,57,70.4,76,65.9,133,67.8,2,0,0
2/15/2018 15:00,49,69.3,67,64.7,116,66.7,2,0,0
2/15/2018 15:05,48,68.2,65,63.5,113,65.5,2,0,0
2/15/2018 15:10,51,69,69,64.3,120,66.3,2,0,0
2/15/2018 15:15,52,69.1,71,64.4,123,66.4,2,0,0
2/15/2018 15:20,59,68.1,78,63.4,137,65.4,2,0,0
2/15/2018 15:25,62,68.2,80,63.5,142,65.6,2,0,0
2/15/2018 15:30,63,68,81,63.3,144,65.4,2,0,0
2/15/2018 15:35,56,68.2,76,63.5,132,65.5,2,0,0
2/15/2018 15:40,63,67.1,82,62.2,145,64.3,2,0,0
2/15/2018 15:45,61,68.3,80,63.5,141,65.6,2,0,0
2/15/2018 15:50,68,68.2,88,63.5,156,65.5,2,0,0
2/15/2018 15:55,57,68.5,76,63.9,133,65.9,2,0,0
2/15/2018 16:00,54,67.6,72,62.9,126,64.9,2,0,0
2/15/2018 16:05,56,68.2,74,63.5,130,65.5,2,0,0
2/15/2018 16:10,56,68.6,73,64,129,66,2,0,0
2/15/2018 16:15,51,67.1,69,62.3,120,64.4,2,0,0
2/15/2018 16:20,57,67.8,75,63.1,132,65.2,2,0,0
2/15/2018 16:25,47,68.6,64,64,111,65.9,2,0,0
2/15/2018 16:30,57,68.8,76,64.2,133,66.2,2,0,0
2/15/2018 16:35,47,68.3,65,63.6,112,65.6,2,0,0
2/15/2018 16:40,49,68.2,65,63.4,114,65.5,2,0,0
2/15/2018 16:45,58,67.3,77,62.4,135,64.5,2,0,0
2/15/2018 16:50,49,67.4,67,62.5,116,64.6,2,0,0
2/15/2018 16:55,45,67.2,63,62.4,108,64.4,2,0,0
2/15/2018 17:00,43,68.6,61,64,104,65.9,2,0,0
2/15/2018 17:05,51,68.4,70,63.7,121,65.7,2,0,0
2/15/2018 17:10,55,67.3,73,62.4,128,64.5,2,0,0
2/15/2018 17:15,48,62.2,67,56.7,115,59,2,0,0
2/15/2018 17:20,54,58.8,73,52.9,127,55.4,2,0,0
2/15/2018 17:25,56,53.9,75,47.5,131,50.2,2,0,0
2/15/2018 17:30,41,50.8,59,44.1,100,46.9,2,0,0
2/15/2018 17:35,44,55.7,62,49.5,106,52,2,0,0
2/15/2018 17:40,43,61.3,60,55.7,103,58,2,0,0
2/15/2018 17:45,45,64.2,62,58.9,107,61.1,2,0,0
2/15/2018 17:50,52,67.3,71,62.4,123,64.5,2,0,0
2/15/2018 17:55,48,67.9,66,63.1,114,65.1,2,0,0
2/15/2018 18:00,54,67.4,72,62.5,126,64.6,2,0,0
2/15/2018 18:05,48,66.6,66,61.8,114,63.9,2,0,0
2/15/2018 18:10,51,67.4,68,62.6,119,64.6,2,0,0
2/15/2018 18:15,53,67.1,71,62.2,124,64.3,2,0,0
2/15/2018 18:20,48,67.2,66,62.4,114,64.5,2,0,0
2/15/2018 18:25,51,68.4,69,63.7,120,65.7,2,0,0
2/15/2018 18:30,47,68.8,63,64.2,110,66.2,2,0,0
2/15/2018 18:35,48,68.1,66,63.3,114,65.3,2,0,0
2/15/2018 18:40,50,68,67,63.3,117,65.3,2,0,0
2/15/2018 18:45,44,68,61,63.3,105,65.3,2,0,0
2/15/2018 18:50,50,69.1,68,64.5,118,66.5,2,0,0
2/15/2018 18:55,39,68.5,56,63.9,95,65.8,2,0,0
2/15/2018 19:00,38,68.4,54,63.7,92,65.6,2,0,0
2/15/2018 19:05,38,68.6,55,64,93,65.9,2,0,0
2/15/2018 19:10,40,68.3,57,63.7,97,65.6,2,0,0
2/15/2018 19:15,36,69.6,52,65.1,88,66.9,2,0,0
2/15/2018 19:20,34,69.1,51,64.5,85,66.3,2,0,0
2/15/2018 19:25,51,67.9,68,63.2,119,65.2,2,0,0
2/15/2018 19:30,36,68.8,53,64.2,89,66.1,2,0,0
2/15/2018 19:35,38,67.9,56,63.2,94,65.1,2,0,0
2/15/2018 19:40,38,69.5,55,64.9,93,66.8,2,0,0
2/15/2018 19:45,38,69,55,64.4,93,66.3,2,0,0
2/15/2018 19:50,44,68.1,61,63.4,105,65.4,2,0,0
2/15/2018 19:55,38,69.3,55,64.7,93,66.6,2,0,0
2/15/2018 20:00,34,69.5,51,64.9,85,66.7,2,0,0
2/15/2018 20:05,34,70.1,51,65.5,85,67.4,2,0,0
2/15/2018 20:10,44,69.3,60,64.7,104,66.7,2,0,0
2/15/2018 20:15,28,68.9,45,64.2,73,66,2,0,0
2/15/2018 20:20,39,69.4,55,64.8,94,66.7,2,0,0
2/15/2018 20:25,39,69.4,56,64.7,95,66.6,2,0,0
2/15/2018 20:30,33,69.5,49,65,82,66.8,2,0,0
2/15/2018 20:35,31,69,47,64.3,78,66.2,2,0,0
2/15/2018 20:40,24,69.4,39,64.8,63,66.5,2,0,0
2/15/2018 20:45,29,69.2,45,64.6,74,66.4,2,0,0
2/15/2018 20:50,29,69.4,45,64.8,74,66.6,2,0,0
2/15/2018 20:55,32,69.6,48,65,80,66.9,2,0,0
2/15/2018 21:00,20,69.5,35,64.9,55,66.6,2,0,0
2/15/2018 21:05,24,69.5,39,64.9,63,66.6,2,0,0
2/15/2018 21:10,16,69.6,32,65,48,66.5,2,0,0
2/15/2018 21:15,21,69.5,36,64.9,57,66.6,2,0,0
2/15/2018 21:20,35,69.8,51,65.2,86,67.1,2,0,0
2/15/2018 21:25,24,69.9,40,65.3,64,67,2,0,0
2/15/2018 21:30,20,69.5,36,64.9,56,66.6,2,0,0
2/15/2018 21:35,27,69.7,44,65.1,71,66.8,2,0,0
2/15/2018 21:40,17,69.7,33,65.1,50,66.6,2,0,0
2/15/2018 21:45,24,69.8,39,65.2,63,66.9,2,0,0
2/15/2018 21:50,16,69.6,31,65,47,66.5,2,0,0
2/15/2018 21:55,22,69.1,38,64.5,60,66.2,2,0,0
2/15/2018 22:00,21,69,37,64.3,58,66,2,0,0
2/15/2018 22:05,19,69.2,34,64.6,53,66.3,2,0,0
2/15/2018 22:10,21,69.4,37,64.8,58,66.4,2,0,0
2/15/2018 22:15,29,69.4,45,64.8,74,66.6,2,0,0
2/15/2018 22:20,24,69.3,40,64.7,64,66.4,2,0,0
2/15/2018 22:25,20,69.3,36,64.7,56,66.3,2,0,0
2/15/2018 22:30,15,69.1,30,64.5,45,66,2,0,0
2/15/2018 22:35,19,69.3,35,64.7,54,66.3,2,0,0
2/15/2018 22:40,17,69.1,33,64.4,50,66,2,0,0
2/15/2018 22:45,21,69.3,37,64.7,58,66.4,2,0,0
2/15/2018 22:50,15,69.4,31,64.8,46,66.3,2,0,0
2/15/2018 22:55,10,69.4,26,64.7,36,66,2,0,0
2/15/2018 23:00,14,69.4,29,64.7,43,66.2,2,0,0
2/15/2018 23:05,17,69.2,33,64.6,50,66.2,2,0,0
2/15/2018 23:10,11,69.3,27,64.7,38,66,2,0,0
2/15/2018 23:15,11,69.3,27,64.7,38,66.1,2,0,0
2/15/2018 23:20,11,69,26,64.4,37,65.8,2,0,0
2/15/2018 23:25,13,69.1,28,64.5,41,66,2,0,0
2/15/2018 23:30,11,69.3,26,64.7,37,66.1,2,0,0
2/15/2018 23:35,12,69.3,28,64.7,40,66.1,2,0,0
2/15/2018 23:40,15,69.1,30,64.5,45,66,2,0,0
2/15/2018 23:45,11,69.3,27,64.7,38,66,2,0,0
2/15/2018 23:50,9,69.3,24,64.7,33,65.9,2,0,0
2/15/2018 23:55,10,69.3,25,64.7,35,66,2,0,0
2/16/2018 0:00,10,69.3,25,64.7,35,66.1,2,0,0
2/16/2018 0:05,11,69.3,26,64.7,37,66,2,0,0
2/16/2018 0:10,12,69.1,27,64.5,39,65.9,2,0,0
2/16/2018 0:15,10,69.1,26,64.5,36,65.8,2,0,0
2/16/2018 0:20,7,69.3,22,64.6,29,65.7,2,0,0
2/16/2018 0:25,8,69.3,24,64.7,32,65.8,2,0,0
2/16/2018 0:30,8,69.2,23,64.6,31,65.8,2,0,0
2/16/2018 0:35,11,69,27,64.3,38,65.7,2,0,0
2/16/2018 0:40,10,69.3,25,64.7,35,66,2,0,0
2/16/2018 0:45,8,69.1,24,64.5,32,65.7,2,0,0
2/16/2018 0:50,9,69.3,24,64.7,33,66,2,0,0
2/16/2018 0:55,8,69.4,23,64.8,31,66,2,0,0
2/16/2018 1:00,7,69.5,22,64.9,29,66,2,0,0
2/16/2018 1:05,7,69.5,23,64.9,30,66,2,0,0
2/16/2018 1:10,6,69.4,21,64.8,27,65.8,2,0,0
2/16/2018 1:15,7,69.3,23,64.7,30,65.7,2,0,0
2/16/2018 1:20,6,69.4,21,64.8,27,65.8,2,0,0
2/16/2018 1:25,5,69.4,20,64.8,25,65.7,2,0,0
2/16/2018 1:30,6,69.4,22,64.8,28,65.8,2,0,0
2/16/2018 1:35,8,69.3,23,64.7,31,65.9,2,0,0
2/16/2018 1:40,6,69.4,21,64.8,27,65.8,2,0,0
2/16/2018 1:45,8,69.4,24,64.8,32,66,2,0,0
2/16/2018 1:50,7,69.5,22,64.9,29,66,2,0,0
2/16/2018 1:55,6,69.4,21,64.8,27,65.9,2,0,0
2/16/2018 2:00,8,69.5,23,64.9,31,66.1,2,0,0
2/16/2018 2:05,8,69.4,23,64.8,31,66,2,0,0
2/16/2018 2:10,12,69.3,28,64.6,40,66,2,0,0
2/16/2018 2:15,5,69.3,21,64.7,26,65.6,2,0,0
2/16/2018 2:20,8,68.6,23,63.9,31,65.2,2,0,0
2/16/2018 2:25,7,69,22,64.3,29,65.4,2,0,0
2/16/2018 2:30,8,69.1,23,64.5,31,65.7,2,0,0
2/16/2018 2:35,11,68.8,26,64.2,37,65.6,2,0,0
2/16/2018 2:40,8,69.1,23,64.5,31,65.7,2,0,0
2/16/2018 2:45,10,69.3,25,64.7,35,66.1,2,0,0
2/16/2018 2:50,9,69.3,24,64.7,33,66,2,0,0
2/16/2018 2:55,11,69.3,27,64.7,38,66,2,0,0
2/16/2018 3:00,10,69.3,26,64.7,36,66,2,0,0
2/16/2018 3:05,10,69.2,26,64.5,36,65.8,2,0,0
2/16/2018 3:10,9,69.1,25,64.5,34,65.7,2,0,0
2/16/2018 3:15,9,69.3,24,64.7,33,65.9,2,0,0
2/16/2018 3:20,11,69.3,26,64.7,37,66.1,2,0,0
2/16/2018 3:25,14,69.2,30,64.5,44,66,2,0,0
2/16/2018 3:30,10,69.3,26,64.7,36,66,2,0,0
2/16/2018 3:35,13,69.3,28,64.7,41,66.2,2,0,0
2/16/2018 3:40,16,69.4,32,64.8,48,66.3,2,0,0
2/16/2018 3:45,17,69.3,34,64.7,51,66.2,2,0,0
2/16/2018 3:50,13,69.3,29,64.7,42,66.1,2,0,0
2/16/2018 3:55,18,69.1,33,64.5,51,66.1,2,0,0
2/16/2018 4:00,15,69.3,30,64.7,45,66.2,2,0,0
2/16/2018 4:05,16,68.8,31,64.2,47,65.7,2,0,0
2/16/2018 4:10,23,69,39,64.3,62,66.1,2,0,0
2/16/2018 4:15,22,69.2,38,64.5,60,66.2,2,0,0
2/16/2018 4:20,20,69.3,36,64.7,56,66.3,2,0,0
2/16/2018 4:25,24,68.8,40,64.2,64,65.9,2,0,0
2/16/2018 4:30,24,69.2,40,64.6,64,66.3,2,0,0
2/16/2018 4:35,28,68.8,45,64.2,73,66,2,0,0
2/16/2018 4:40,33,68.7,51,64,84,65.8,2,0,0
2/16/2018 4:45,33,68.6,51,64,84,65.8,2,0,0
2/16/2018 4:50,41,69,59,64.4,100,66.3,2,0,0
2/16/2018 4:55,36,69,54,64.5,90,66.3,2,0,0
2/16/2018 5:00,33,68.8,50,64.2,83,66,2,0,0
2/16/2018 5:05,34,69.1,52,64.5,86,66.4,2,0,0
2/16/2018 5:10,47,69.8,66,65.2,113,67.1,2,0,0
2/16/2018 5:15,52,69.7,71,65.2,123,67.1,2,0,0
2/16/2018 5:20,53,69.8,74,65.3,127,67.2,2,0,0
2/16/2018 5:25,50,70,69,65.5,119,67.4,2,0,0
2/16/2018 5:30,46,69.7,65,65.1,111,67,2,0,0
2/16/2018 5:35,62,70.5,83,66,145,67.9,2,0,0
2/16/2018 5:40,54,70.8,75,66.3,129,68.1,2,0,0
2/16/2018 5:45,55,69.2,76,64.6,131,66.5,2,0,0
2/16/2018 5:50,58,70.8,78,66.3,136,68.2,2,0,0
2/16/2018 5:55,51,69.3,71,64.7,122,66.6,2,0,0
2/16/2018 6:00,49,69.5,69,64.9,118,66.8,2,0,0
2/16/2018 6:05,51,69.4,71,64.7,122,66.7,2,0,0
2/16/2018 6:10,57,67.7,77,62.8,134,64.9,2,0,0
2/16/2018 6:15,56,66.8,77,61.9,133,63.9,2,0,0
2/16/2018 6:20,60,66.3,81,61.3,141,63.4,2,0,0
2/16/2018 6:25,60,66.1,82,61.1,142,63.2,2,0,0
2/16/2018 6:30,64,66.4,84,61.4,148,63.6,2,0,0
2/16/2018 6:35,55,67.5,76,62.6,131,64.7,2,0,0
2/16/2018 6:40,70,66.9,92,61.9,162,64.1,2,0,0
2/16/2018 6:45,67,68,88,63.1,155,65.2,2,0,0
2/16/2018 6:50,62,68.1,84,63.3,146,65.3,2,0,0
2/16/2018 6:55,65,69.2,84,64.5,149,66.5,2,0,0
2/16/2018 7:00,68,67.6,90,62.8,158,64.9,2,0,0
2/16/2018 7:05,63,65.7,83,60.8,146,62.9,2,0,0
2/16/2018 7:10,61,67,83,62.2,144,64.3,2,0,0
2/16/2018 7:15,62,68.1,81,63.3,143,65.4,2,0,0
2/16/2018 7:20,66,67.2,88,62.3,154,64.4,2,0,0
2/16/2018 7:25,70,65.7,91,60.7,161,62.9,2,0,0
2/16/2018 7:30,81,66.8,105,61.9,186,64,2,0,0
2/16/2018 7:35,80,67.7,102,62.9,182,65,2,0,0
2/16/2018 7:40,78,67.5,99,62.6,177,64.8,2,0,0
2/16/2018 7:45,79,67.3,100,62.4,179,64.6,2,0,0
2/16/2018 7:50,68,67.2,90,62.3,158,64.4,2,0,0
2/16/2018 7:55,70,67.8,90,62.9,160,65.1,2,0,0
2/16/2018 8:00,69,67.5,90,62.6,159,64.8,2,0,0
2/16/2018 8:05,72,67.9,93,63.2,165,65.3,2,0,0
2/16/2018 8:10,65,68,85,63.3,150,65.3,2,0,0
2/16/2018 8:15,79,66.7,102,61.9,181,64,2,0,0
2/16/2018 8:20,74,67.2,95,62.4,169,64.5,2,0,0
2/16/2018 8:25,78,67.2,99,62.4,177,64.5,2,0,0
2/16/2018 8:30,67,67.1,87,62.2,154,64.4,2,0,0
2/16/2018 8:35,74,66.7,96,61.8,170,63.9,2,0,0
2/16/2018 8:40,83,66.8,105,61.8,188,64,2,0,0
2/16/2018 8:45,63,66.2,83,61.2,146,63.4,2,0,0
2/16/2018 8:50,66,67.2,85,62.3,151,64.5,2,0,0
2/16/2018 8:55,75,65.2,96,60.1,171,62.4,2,0,0
2/16/2018 9:00,72,66.4,93,61.4,165,63.6,2,0,0
2/16/2018 9:05,62,65.9,81,60.9,143,63.1,2,0,0
2/16/2018 9:10,69,65,91,59.9,160,62.1,2,0,0
2/16/2018 9:15,66,64.7,86,59.7,152,61.9,2,0,0
2/16/2018 9:20,65,65,85,59.9,150,62.1,2,0,0
2/16/2018 9:25,65,65.5,85,60.5,150,62.7,2,0,0
2/16/2018 9:30,62,65.7,82,60.7,144,62.8,2,0,0
2/16/2018 9:35,67,65.3,86,60.2,153,62.4,2,0,0
2/16/2018 9:40,74,64.6,95,59.6,169,61.8,2,0,0
2/16/2018 9:45,73,66.4,94,61.5,167,63.7,2,0,0
2/16/2018 9:50,76,66.2,96,61.2,172,63.4,2,0,0
2/16/2018 9:55,74,65.8,94,60.8,168,63,2,0,0
2/16/2018 10:00,59,67.1,77,62.3,136,64.4,2,0,0
2/16/2018 10:05,63,66.2,83,61.3,146,63.4,2,0,0
2/16/2018 10:10,69,66.2,89,61.3,158,63.4,2,0,0
2/16/2018 10:15,68,66.6,87,61.8,155,63.9,2,0,0
2/16/2018 10:20,55,66.6,74,61.9,129,63.9,2,0,0
2/16/2018 10:25,70,66.2,90,61.3,160,63.4,2,0,0
2/16/2018 10:30,63,67.3,81,62.5,144,64.6,2,0,0
2/16/2018 10:35,74,67.4,95,62.7,169,64.7,2,0,0
2/16/2018 10:40,73,67.2,94,62.5,167,64.5,2,0,0
2/16/2018 10:45,80,66.5,101,61.8,181,63.9,2,0,0
2/16/2018 10:50,70,67.6,90,62.9,160,65,2,0,0
2/16/2018 10:55,59,67.3,78,62.6,137,64.6,2,0,0
2/16/2018 11:00,64,67.3,84,62.5,148,64.6,2,0,0
2/16/2018 11:05,57,68.1,76,63.4,133,65.4,2,0,0
2/16/2018 11:10,66,66.6,85,61.8,151,63.9,2,0,0
2/16/2018 11:15,61,67.2,80,62.4,141,64.4,2,0,0
2/16/2018 11:20,66,66.8,86,61.9,152,64.1,2,0,0
2/16/2018 11:25,67,67.1,85,62.3,152,64.4,2,0,0
2/16/2018 11:30,57,69.1,76,64.5,133,66.4,2,0,0
2/16/2018 11:35,51,68.1,69,63.5,120,65.5,2,0,0
2/16/2018 11:40,55,69.1,74,64.5,129,66.5,2,0,0
2/16/2018 11:45,56,67.8,74,63.1,130,65.1,2,0,0
2/16/2018 11:50,56,67.7,74,62.9,130,65,2,0,0
2/16/2018 11:55,60,67.6,79,62.9,139,64.9,2,0,0
2/16/2018 12:00,53,66.3,73,61.5,126,63.5,2,0,0
2/16/2018 12:05,68,65.9,86,61,154,63.2,2,0,0
2/16/2018 12:10,57,67.2,75,62.4,132,64.5,2,0,0
2/16/2018 12:15,63,68.8,82,64.1,145,66.1,2,0,0
2/16/2018 12:20,50,69.3,69,64.8,119,66.7,2,0,0
2/16/2018 12:25,47,68.9,65,64.3,112,66.2,2,0,0
2/16/2018 12:30,57,69.4,76,64.8,133,66.8,2,0,0
2/16/2018 12:35,68,69.7,87,65.1,155,67.2,2,0,0
2/16/2018 12:40,53,69.3,72,64.7,125,66.7,2,0,0
2/16/2018 12:45,45,69.5,63,64.9,108,66.8,2,0,0
2/16/2018 12:50,52,65.8,71,61,123,63.1,2,0,0
2/16/2018 12:55,57,67.5,76,62.8,133,64.8,2,0,0
2/16/2018 13:00,55,68.2,72,63.5,127,65.6,2,0,0
2/16/2018 13:05,61,68.6,81,64,142,66,2,0,0
2/16/2018 13:10,50,67,68,62.3,118,64.3,2,0,0
2/16/2018 13:15,54,67,73,62.3,127,64.3,2,0,0
2/16/2018 13:20,51,67,68,62.3,119,64.3,2,0,0
2/16/2018 13:25,46,67.1,63,62.4,109,64.4,2,0,0
2/16/2018 13:30,53,67.9,72,63.2,125,65.2,2,0,0
2/16/2018 13:35,55,67.2,73,62.4,128,64.5,2,0,0
2/16/2018 13:40,55,69.4,73,64.9,128,66.8,2,0,0
2/16/2018 13:45,42,68.7,59,64.1,101,66,2,0,0
2/16/2018 13:50,51,68.9,68,64.3,119,66.3,2,0,0
2/16/2018 13:55,55,67.9,73,63.2,128,65.2,2,0,0
2/16/2018 14:00,49,68,66,63.2,115,65.3,2,0,0
2/16/2018 14:05,55,69.2,73,64.5,128,66.5,2,0,0
2/16/2018 14:10,56,68.4,74,63.7,130,65.7,2,0,0
2/16/2018 14:15,57,69.1,76,64.4,133,66.4,2,0,0
2/16/2018 14:20,57,67.3,74,62.5,131,64.6,2,0,0
2/16/2018 14:25,50,67.6,68,62.8,118,64.8,2,0,0
2/16/2018 14:30,47,68.8,63,64.1,110,66.1,2,0,0
2/16/2018 14:35,57,68.3,75,63.6,132,65.6,2,0,0
2/16/2018 14:40,54,68.3,72,63.6,126,65.6,2,0,0
2/16/2018 14:45,60,69,77,64.4,137,66.4,2,0,0
2/16/2018 14:50,51,69.2,68,64.6,119,66.6,2,0,0
2/16/2018 14:55,48,69,65,64.5,113,66.4,2,0,0
2/16/2018 15:00,50,68.3,68,63.6,118,65.6,2,0,0
2/16/2018 15:05,60,67.4,80,62.7,140,64.7,2,0,0
2/16/2018 15:10,57,67,76,62.1,133,64.2,2,0,0
2/16/2018 15:15,56,67.9,74,63.1,130,65.2,2,0,0
2/16/2018 15:20,58,67.7,78,63,136,65,2,0,0
2/16/2018 15:25,62,67.4,81,62.6,143,64.7,2,0,0
2/16/2018 15:30,61,66.3,80,61.4,141,63.5,2,0,0
2/16/2018 15:35,61,66.4,81,61.5,142,63.6,2,0,0
2/16/2018 15:40,63,66.1,81,61.2,144,63.3,2,0,0
2/16/2018 15:45,68,67.3,87,62.5,155,64.6,2,0,0
2/16/2018 15:50,60,67.5,79,62.7,139,64.8,2,0,0
2/16/2018 15:55,58,69.4,76,64.8,134,66.8,2,0,0
2/16/2018 16:00,60,68.9,78,64.3,138,66.3,2,0,0
2/16/2018 16:05,63,69.6,81,65,144,67,2,0,0
2/16/2018 16:10,57,70.6,74,66,131,68,2,0,0
2/16/2018 16:15,51,70.9,69,66.4,120,68.4,2,0,0
2/16/2018 16:20,57,69.3,76,64.7,133,66.7,2,0,0
2/16/2018 16:25,52,69.6,70,65.1,122,67,2,0,0
2/16/2018 16:30,60,70.6,78,66.2,138,68.1,2,0,0
2/16/2018 16:35,55,69.1,73,64.6,128,66.5,2,0,0
2/16/2018 16:40,51,67.9,69,63.1,120,65.2,2,0,0
2/16/2018 16:45,46,67.7,63,62.9,109,65,2,0,0
2/16/2018 16:50,57,68.2,75,63.4,132,65.4,2,0,0
2/16/2018 16:55,46,68,64,63.3,110,65.3,2,0,0
2/16/2018 17:00,49,66.6,68,61.7,117,63.7,2,0,0
2/16/2018 17:05,33,65.3,50,60.3,83,62.3,2,0,0
2/16/2018 17:10,30,67.3,47,62.5,77,64.4,2,0,0
2/16/2018 17:15,48,67.6,66,62.7,114,64.7,2,0,0
2/16/2018 17:20,39,68.7,56,64,95,66,2,0,0
2/16/2018 17:25,48,69.3,66,64.7,114,66.6,2,0,0
2/16/2018 17:30,51,69.2,69,64.5,120,66.5,2,0,0
2/16/2018 17:35,50,68.7,68,63.9,118,66,2,0,0
2/16/2018 17:40,61,67.5,80,62.7,141,64.8,2,0,0
2/16/2018 17:45,65,68,84,63.3,149,65.4,2,0,0
2/16/2018 17:50,47,69.2,64,64.5,111,66.5,2,0,0
2/16/2018 17:55,53,69.5,71,64.9,124,66.9,2,0,0
2/16/2018 18:00,54,70.6,71,66.1,125,68.1,2,0,0
2/16/2018 18:05,44,70,60,65.4,104,67.4,2,0,0
2/16/2018 18:10,49,70.2,66,65.7,115,67.6,2,0,0
2/16/2018 18:15,56,70.3,75,65.8,131,67.7,2,0,0
2/16/2018 18:20,49,69.6,67,65,116,66.9,2,0,0
2/16/2018 18:25,53,69.2,71,64.6,124,66.5,2,0,0
2/16/2018 18:30,65,69.4,83,64.7,148,66.8,2,0,0
2/16/2018 18:35,43,68.1,61,63.3,104,65.3,2,0,0
2/16/2018 18:40,49,68.8,66,64.1,115,66.1,2,0,0
2/16/2018 18:45,49,69.4,66,64.8,115,66.7,2,0,0
2/16/2018 18:50,51,68.8,68,64.2,119,66.2,2,0,0
2/16/2018 18:55,50,68.9,68,64.3,118,66.2,2,0,0
2/16/2018 19:00,51,66.9,68,62.2,119,64.2,2,0,0
2/16/2018 19:05,42,67,59,62.2,101,64.2,2,0,0
2/16/2018 19:10,51,68.5,68,63.9,119,65.9,2,0,0
2/16/2018 19:15,47,67.7,65,62.9,112,64.9,2,0,0
2/16/2018 19:20,46,68.2,64,63.5,110,65.5,2,0,0
2/16/2018 19:25,48,67.4,65,62.7,113,64.7,2,0,0
2/16/2018 19:30,53,67,70,62.1,123,64.2,2,0,0
2/16/2018 19:35,54,67.2,72,62.4,126,64.5,2,0,0
2/16/2018 19:40,36,68.6,53,63.9,89,65.8,2,0,0
2/16/2018 19:45,46,69.2,63,64.6,109,66.5,2,0,0
2/16/2018 19:50,41,70.2,58,65.6,99,67.5,2,0,0
2/16/2018 19:55,40,69.9,58,65.3,98,67.2,2,0,0
2/16/2018 20:00,36,70,52,65.4,88,67.3,2,0,0
2/16/2018 20:05,41,67.6,59,62.9,100,64.8,2,0,0
2/16/2018 20:10,42,67.6,59,62.9,101,64.8,2,0,0
2/16/2018 20:15,34,68.6,51,64,85,65.8,2,0,0
2/16/2018 20:20,35,68.3,52,63.6,87,65.5,2,0,0
2/16/2018 20:25,35,68.4,52,63.7,87,65.6,2,0,0
2/16/2018 20:30,39,68.7,56,64.1,95,66,2,0,0
2/16/2018 20:35,41,68.9,58,64.3,99,66.2,2,0,0
2/16/2018 20:40,37,69.4,54,64.8,91,66.7,2,0,0
2/16/2018 20:45,30,69.2,46,64.6,76,66.4,2,0,0
2/16/2018 20:50,29,69.6,45,65.1,74,66.9,2,0,0
2/16/2018 20:55,28,69.7,44,65.1,72,66.9,2,0,0
2/16/2018 21:00,29,68.9,46,64.1,75,66,2,0,0
2/16/2018 21:05,34,69.3,51,64.6,85,66.5,2,0,0
2/16/2018 21:10,33,68.9,50,64.2,83,66.1,2,0,0
2/16/2018 21:15,28,69.5,44,64.9,72,66.7,2,0,0
2/16/2018 21:20,33,69.4,50,64.8,83,66.7,2,0,0
2/16/2018 21:25,33,69.2,49,64.6,82,66.4,2,0,0
2/16/2018 21:30,31,69.4,47,64.7,78,66.6,2,0,0
2/16/2018 21:35,37,69.7,54,65.1,91,67,2,0,0
2/16/2018 21:40,32,69.5,49,64.9,81,66.8,2,0,0
2/16/2018 21:45,25,69.1,41,64.4,66,66.2,2,0,0
2/16/2018 21:50,30,68.5,46,63.9,76,65.7,2,0,0
2/16/2018 21:55,27,69,43,64.4,70,66.2,2,0,0
2/16/2018 22:00,26,69.3,42,64.7,68,66.5,2,0,0
2/16/2018 22:05,27,69.1,42,64.5,69,66.3,2,0,0
2/16/2018 22:10,27,69.1,42,64.5,69,66.3,2,0,0
2/16/2018 22:15,26,69.5,42,64.9,68,66.7,2,0,0
2/16/2018 22:20,30,69.1,46,64.4,76,66.3,2,0,0
2/16/2018 22:25,29,69.9,44,65.3,73,67.1,2,0,0
2/16/2018 22:30,28,69.3,44,64.7,72,66.5,2,0,0
2/16/2018 22:35,25,69.2,42,64.6,67,66.3,2,0,0
2/16/2018 22:40,32,69.3,49,64.7,81,66.5,2,0,0
2/16/2018 22:45,24,69.6,40,65,64,66.8,2,0,0
2/16/2018 22:50,23,69.4,38,64.8,61,66.5,2,0,0
2/16/2018 22:55,20,69.5,35,64.9,55,66.6,2,0,0
2/16/2018 23:00,27,69.1,43,64.4,70,66.2,2,0,0
2/16/2018 23:05,23,69.1,40,64.5,63,66.2,2,0,0
2/16/2018 23:10,22,68.5,38,63.9,60,65.6,2,0,0
2/16/2018 23:15,21,69.1,37,64.5,58,66.1,2,0,0
2/16/2018 23:20,17,69,32,64.4,49,66,2,0,0
2/16/2018 23:25,20,69.2,36,64.5,56,66.2,2,0,0
2/16/2018 23:30,19,69.4,35,64.8,54,66.4,2,0,0
2/16/2018 23:35,26,69.6,42,65,68,66.8,2,0,0
2/16/2018 23:40,24,69.5,40,64.9,64,66.6,2,0,0
2/16/2018 23:45,21,69.3,36,64.7,57,66.4,2,0,0
2/16/2018 23:50,13,69.3,29,64.7,42,66.2,2,0,0
2/16/2018 23:55,8,69.4,23,64.8,31,66,2,0,0
2/17/2018 0:00,13,69.3,28,64.7,41,66.2,2,0,0
2/17/2018 0:05,14,69.3,30,64.7,44,66.2,2,0,0
2/17/2018 0:10,13,69.3,29,64.7,42,66.1,2,0,0
2/17/2018 0:15,18,69.2,34,64.6,52,66.2,2,0,0
2/17/2018 0:20,12,69.3,27,64.7,39,66.1,2,0,0
2/17/2018 0:25,11,69.2,26,64.6,37,66,2,0,0
2/17/2018 0:30,13,69.2,29,64.6,42,66,2,0,0
2/17/2018 0:35,12,69.2,27,64.6,39,66,2,0,0
2/17/2018 0:40,12,69.3,27,64.7,39,66.1,2,0,0
2/17/2018 0:45,8,69.3,23,64.7,31,65.8,2,0,0
2/17/2018 0:50,8,69.3,24,64.7,32,65.9,2,0,0
2/17/2018 0:55,11,69.1,27,64.5,38,65.8,2,0,0
2/17/2018 1:00,13,69.3,28,64.7,41,66.2,2,0,0
2/17/2018 1:05,11,69.2,26,64.5,37,65.9,2,0,0
2/17/2018 1:10,10,69.2,25,64.6,35,65.9,2,0,0
2/17/2018 1:15,12,69.3,28,64.7,40,66.1,2,0,0
2/17/2018 1:20,9,69.2,24,64.6,33,65.8,2,0,0
2/17/2018 1:25,8,69.2,23,64.6,31,65.8,2,0,0
2/17/2018 1:30,7,69.2,22,64.6,29,65.7,2,0,0
2/17/2018 1:35,13,69.3,29,64.7,42,66.1,2,0,0
2/17/2018 1:40,11,69.3,27,64.7,38,66.1,2,0,0
2/17/2018 1:45,8,69.5,24,64.9,32,66,2,0,0
2/17/2018 1:50,7,69.4,22,64.8,29,65.9,2,0,0
2/17/2018 1:55,7,69.3,23,64.7,30,65.8,2,0,0
2/17/2018 2:00,11,69.4,26,64.7,37,66.1,2,0,0
2/17/2018 2:05,8,69.2,24,64.5,32,65.7,2,0,0
2/17/2018 2:10,13,69.4,28,64.7,41,66.2,2,0,0
2/17/2018 2:15,8,69.4,23,64.8,31,66,2,0,0
2/17/2018 2:20,9,69.4,24,64.7,33,66,2,0,0
2/17/2018 2:25,8,69.4,24,64.8,32,65.9,2,0,0
2/17/2018 2:30,8,69.3,24,64.7,32,65.9,2,0,0
2/17/2018 2:35,8,69.3,24,64.7,32,65.9,2,0,0
2/17/2018 2:40,9,69.3,24,64.7,33,66,2,0,0
2/17/2018 2:45,8,69.2,23,64.6,31,65.8,2,0,0
2/17/2018 2:50,7,69.3,22,64.7,29,65.8,2,0,0
2/17/2018 2:55,9,69.2,24,64.5,33,65.8,2,0,0
2/17/2018 3:00,9,69.4,24,64.8,33,66,2,0,0
2/17/2018 3:05,7,69.4,22,64.8,29,65.9,2,0,0
2/17/2018 3:10,8,69.3,23,64.7,31,65.9,2,0,0
2/17/2018 3:15,7,69.4,22,64.8,29,66,2,0,0
2/17/2018 3:20,8,69.2,23,64.5,31,65.7,2,0,0
2/17/2018 3:25,6,69.2,22,64.6,28,65.6,2,0,0
2/17/2018 3:30,10,69.2,25,64.6,35,65.9,2,0,0
2/17/2018 3:35,7,69.2,22,64.6,29,65.7,2,0,0
2/17/2018 3:40,9,69.3,24,64.7,33,65.9,2,0,0
2/17/2018 3:45,8,69.3,24,64.7,32,65.8,2,0,0
2/17/2018 3:50,7,69.3,23,64.7,30,65.8,2,0,0
2/17/2018 3:55,8,69.3,23,64.7,31,65.9,2,0,0
2/17/2018 4:00,6,69.3,21,64.7,27,65.7,2,0,0
2/17/2018 4:05,6,69.3,21,64.7,27,65.7,2,0,0
2/17/2018 4:10,5,69.4,20,64.8,25,65.7,2,0,0
2/17/2018 4:15,11,69.3,27,64.7,38,66,2,0,0
2/17/2018 4:20,10,69.3,25,64.7,35,66,2,0,0
2/17/2018 4:25,8,69.3,24,64.7,32,65.8,2,0,0
2/17/2018 4:30,10,69.4,26,64.8,36,66.1,2,0,0
2/17/2018 4:35,14,69.3,29,64.7,43,66.2,2,0,0
2/17/2018 4:40,12,69.2,27,64.6,39,66,2,0,0
2/17/2018 4:45,14,69.3,30,64.7,44,66.2,2,0,0
2/17/2018 4:50,21,69.5,37,64.9,58,66.5,2,0,0
2/17/2018 4:55,16,69,32,64.4,48,66,2,0,0
2/17/2018 5:00,14,69.2,30,64.6,44,66.1,2,0,0
2/17/2018 5:05,15,69.2,31,64.6,46,66.1,2,0,0
2/17/2018 5:10,17,69.1,33,64.5,50,66.1,2,0,0
2/17/2018 5:15,18,69.4,34,64.8,52,66.4,2,0,0
2/17/2018 5:20,21,69.2,37,64.6,58,66.3,2,0,0
2/17/2018 5:25,18,69.5,34,64.9,52,66.4,2,0,0
2/17/2018 5:30,16,69.4,32,64.8,48,66.3,2,0,0
2/17/2018 5:35,23,69.3,39,64.6,62,66.3,2,0,0
2/17/2018 5:40,25,68.6,42,63.9,67,65.7,2,0,0
2/17/2018 5:45,21,68.8,37,64.1,58,65.8,2,0,0
2/17/2018 5:50,19,69.2,35,64.5,54,66.2,2,0,0
2/17/2018 5:55,22,69.3,38,64.7,60,66.4,2,0,0
2/17/2018 6:00,19,69,35,64.4,54,66,2,0,0
2/17/2018 6:05,22,69.2,39,64.5,61,66.2,2,0,0
2/17/2018 6:10,23,69.1,39,64.5,62,66.2,2,0,0
2/17/2018 6:15,25,68.8,42,64.2,67,65.9,2,0,0
2/17/2018 6:20,27,68.4,44,63.7,71,65.5,2,0,0
2/17/2018 6:25,24,67.9,40,63,64,64.8,2,0,0
2/17/2018 6:30,26,68.7,42,64,68,65.8,2,0,0
2/17/2018 6:35,23,68.8,40,64.1,63,65.8,2,0,0
2/17/2018 6:40,33,68.9,50,64.2,83,66.1,2,0,0
2/17/2018 6:45,24,69.5,40,64.9,64,66.6,2,0,0
2/17/2018 6:50,24,69.3,40,64.7,64,66.5,2,0,0
2/17/2018 6:55,27,68.5,42,63.9,69,65.7,2,0,0
2/17/2018 7:00,22,69.3,37,64.7,59,66.4,2,0,0
2/17/2018 7:05,18,69.1,34,64.5,52,66.1,2,0,0
2/17/2018 7:10,29,65.8,46,60.9,75,62.8,2,0,0
2/17/2018 7:15,28,68,44,63.3,72,65.1,2,0,0
2/17/2018 7:20,26,68.6,43,63.9,69,65.7,2,0,0
2/17/2018 7:25,33,69,50,64.3,83,66.2,2,0,0
2/17/2018 7:30,31,69.3,48,64.6,79,66.5,2,0,0
2/17/2018 7:35,29,69.4,46,64.7,75,66.5,2,0,0
2/17/2018 7:40,39,69.8,56,65.2,95,67.1,2,0,0
2/17/2018 7:45,41,70,58,65.5,99,67.4,2,0,0
2/17/2018 7:50,39,69,56,64.4,95,66.3,2,0,0
2/17/2018 7:55,46,68.7,64,64,110,66,2,0,0
2/17/2018 8:00,35,69.7,51,65.1,86,66.9,2,0,0
2/17/2018 8:05,35,69.7,52,65.1,87,66.9,2,0,0
2/17/2018 8:10,48,69.5,65,64.8,113,66.8,2,0,0
2/17/2018 8:15,44,69.9,60,65.3,104,67.2,2,0,0
2/17/2018 8:20,50,69.7,68,65.1,118,67.1,2,0,0
2/17/2018 8:25,48,70.1,65,65.5,113,67.5,2,0,0
2/17/2018 8:30,41,68.9,57,64.2,98,66.2,2,0,0
2/17/2018 8:35,51,69.4,68,64.8,119,66.8,2,0,0
2/17/2018 8:40,56,69.1,74,64.5,130,66.5,2,0,0
2/17/2018 8:45,49,68.7,67,64,116,66,2,0,0
2/17/2018 8:50,50,69.3,67,64.7,117,66.7,2,0,0
2/17/2018 8:55,52,69.6,70,64.9,122,66.9,2,0,0
2/17/2018 9:00,56,69.9,73,65.3,129,67.3,2,0,0
2/17/2018 9:05,49,69.1,66,64.4,115,66.4,2,0,0
2/17/2018 9:10,51,69.1,69,64.5,120,66.4,2,0,0
2/17/2018 9:15,57,68.6,75,64,132,66,2,0,0
2/17/2018 9:20,59,69.8,77,65.4,136,67.3,2,0,0
2/17/2018 9:25,61,70.1,78,65.6,139,67.6,2,0,0
2/17/2018 9:30,53,68.3,71,63.7,124,65.6,2,0,0
2/17/2018 9:35,65,68.5,84,63.9,149,65.9,2,0,0
2/17/2018 9:40,59,68.4,78,63.8,137,65.8,2,0,0
2/17/2018 9:45,76,67.8,96,63.2,172,65.2,2,0,0
2/17/2018 9:50,81,68.4,101,63.7,182,65.8,2,0,0
2/17/2018 9:55,68,67.7,87,63,155,65,2,0,0
2/17/2018 10:00,63,67,82,62.2,145,64.3,2,0,0
2/17/2018 10:05,75,67.7,94,62.9,169,65.1,2,0,0
2/17/2018 10:10,77,68.1,96,63.3,173,65.4,2,0,0
2/17/2018 10:15,65,67.8,85,63,150,65.1,2,0,0
2/17/2018 10:20,65,67.9,85,63.1,150,65.2,2,0,0
2/17/2018 10:25,72,67.8,91,63,163,65.2,2,0,0
2/17/2018 10:30,65,67.9,85,63.2,150,65.2,2,0,0
2/17/2018 10:35,70,68.3,89,63.6,159,65.7,2,0,0
2/17/2018 10:40,66,68.5,86,63.8,152,65.8,2,0,0
2/17/2018 10:45,70,67.5,90,62.7,160,64.8,2,0,0
2/17/2018 10:50,71,67.2,90,62.4,161,64.5,2,0,0
2/17/2018 10:55,67,67.8,87,63,154,65.1,2,0,0
2/17/2018 11:00,66,67.9,85,63.1,151,65.2,2,0,0
2/17/2018 11:05,60,68.4,79,63.7,139,65.7,2,0,0
2/17/2018 11:10,65,68.4,84,63.6,149,65.7,2,0,0
2/17/2018 11:15,68,67.6,87,62.8,155,64.9,2,0,0
2/17/2018 11:20,68,68.3,86,63.6,154,65.6,2,0,0
2/17/2018 11:25,70,68.8,89,64.2,159,66.2,2,0,0
2/17/2018 11:30,67,69.3,87,64.7,154,66.7,2,0,0
2/17/2018 11:35,62,68.8,81,64.1,143,66.1,2,0,0
2/17/2018 11:40,72,68.1,91,63.3,163,65.4,2,0,0
2/17/2018 11:45,70,68.1,89,63.3,159,65.4,2,0,0
2/17/2018 11:50,67,68.1,86,63.3,153,65.4,2,0,0
2/17/2018 11:55,65,68.5,84,63.7,149,65.8,2,0,0
2/17/2018 12:00,59,69,78,64.3,137,66.3,2,0,0
2/17/2018 12:05,66,68.1,85,63.3,151,65.4,2,0,0
2/17/2018 12:10,62,68.8,82,64.1,144,66.1,2,0,0
2/17/2018 12:15,71,67.7,92,63,163,65,2,0,0
2/17/2018 12:20,70,67.8,90,63,160,65.1,2,0,0
2/17/2018 12:25,72,68.7,91,64,163,66,2,0,0
2/17/2018 12:30,69,69,89,64.5,158,66.5,2,0,0
2/17/2018 12:35,63,69.3,81,64.7,144,66.7,2,0,0
2/17/2018 12:40,70,68.7,89,64,159,66.1,2,0,0
2/17/2018 12:45,70,68.6,90,63.9,160,65.9,2,0,0
2/17/2018 12:50,59,68.1,78,63.3,137,65.4,2,0,0
2/17/2018 12:55,65,68.7,85,64,150,66,2,0,0
2/17/2018 13:00,70,68.9,91,64.2,161,66.2,2,0,0
2/17/2018 13:05,71,68.1,91,63.4,162,65.5,2,0,0
2/17/2018 13:10,63,68.1,82,63.4,145,65.4,2,0,0
2/17/2018 13:15,73,67.9,92,63.2,165,65.3,2,0,0
2/17/2018 13:20,70,67.7,90,62.9,160,65,2,0,0
2/17/2018 13:25,62,68.1,81,63.4,143,65.5,2,0,0
2/17/2018 13:30,67,68.9,84,64.2,151,66.3,2,0,0
2/17/2018 13:35,65,68.7,83,64.1,148,66.1,2,0,0
2/17/2018 13:40,68,68,87,63.3,155,65.3,2,0,0
2/17/2018 13:45,57,69.2,75,64.6,132,66.6,2,0,0
2/17/2018 13:50,61,68.2,80,63.5,141,65.6,2,0,0
2/17/2018 13:55,57,68.7,76,64.1,133,66.1,2,0,0
2/17/2018 14:00,60,68,79,63.2,139,65.3,2,0,0
2/17/2018 14:05,59,67.9,77,63.2,136,65.2,2,0,0
2/17/2018 14:10,41,68.4,58,63.6,99,65.6,2,0,0
2/17/2018 14:15,84,67.6,106,62.8,190,64.9,2,0,0
2/17/2018 14:20,69,67.9,88,63.1,157,65.2,2,0,0
2/17/2018 14:25,64,68.2,83,63.5,147,65.6,2,0,0
2/17/2018 14:30,63,69,82,64.4,145,66.4,2,0,0
2/17/2018 14:35,57,69.5,75,64.9,132,66.9,2,0,0
2/17/2018 14:40,65,68.3,84,63.6,149,65.6,2,0,0
2/17/2018 14:45,67,68.3,86,63.6,153,65.6,2,0,0
2/17/2018 14:50,66,68.4,85,63.6,151,65.7,2,0,0
2/17/2018 14:55,56,67.8,74,63,130,65.1,2,0,0
2/17/2018 15:00,61,68.5,80,63.8,141,65.8,2,0,0
2/17/2018 15:05,72,68.5,91,63.8,163,65.9,2,0,0
2/17/2018 15:10,61,68.1,81,63.4,142,65.4,2,0,0
2/17/2018 15:15,61,68.7,79,64,140,66,2,0,0
2/17/2018 15:20,64,68,83,63.2,147,65.3,2,0,0
2/17/2018 15:25,65,67.9,83,63.1,148,65.2,2,0,0
2/17/2018 15:30,68,68.2,86,63.4,154,65.5,2,0,0
2/17/2018 15:35,72,67.2,91,62.4,163,64.5,2,0,0
2/17/2018 15:40,72,66.9,92,62,164,64.1,2,0,0
2/17/2018 15:45,58,67.1,75,62.2,133,64.4,2,0,0
2/17/2018 15:50,63,67.5,82,62.6,145,64.7,2,0,0
2/17/2018 15:55,57,67.9,74,63.1,131,65.2,2,0,0
2/17/2018 16:00,60,67.9,77,63.1,137,65.2,2,0,0
2/17/2018 16:05,56,68.2,73,63.5,129,65.5,2,0,0
2/17/2018 16:10,44,68.7,61,64,105,65.9,2,0,0
2/17/2018 16:15,48,68.4,66,63.7,114,65.7,2,0,0
2/17/2018 16:20,50,69.1,68,64.4,118,66.4,2,0,0
2/17/2018 16:25,56,68.7,75,64.1,131,66,2,0,0
2/17/2018 16:30,60,68.7,77,64,137,66.1,2,0,0
2/17/2018 16:35,52,68.1,71,63.3,123,65.4,2,0,0
2/17/2018 16:40,57,68.1,75,63.3,132,65.4,2,0,0
2/17/2018 16:45,68,67.5,87,62.7,155,64.8,2,0,0
2/17/2018 16:50,70,67.5,89,62.7,159,64.8,2,0,0
2/17/2018 16:55,63,67.4,82,62.6,145,64.7,2,0,0
2/17/2018 17:00,74,67.8,93,63,167,65.1,2,0,0
2/17/2018 17:05,64,68,83,63.2,147,65.3,2,0,0
2/17/2018 17:10,64,68.3,84,63.5,148,65.6,2,0,0
2/17/2018 17:15,67,68.3,87,63.5,154,65.6,2,0,0
2/17/2018 17:20,70,68.5,91,63.8,161,65.9,2,0,0
2/17/2018 17:25,70,67.7,91,62.9,161,65,2,0,0
2/17/2018 17:30,79,68.1,98,63.3,177,65.4,2,0,0
2/17/2018 17:35,57,68.7,76,64,133,66,2,0,0
2/17/2018 17:40,68,69.1,86,64.5,154,66.5,2,0,0
2/17/2018 17:45,78,68.3,100,63.5,178,65.6,2,0,0
2/17/2018 17:50,82,68.3,104,63.5,186,65.6,2,0,0
2/17/2018 17:55,65,68.1,85,63.3,150,65.3,2,0,0
2/17/2018 18:00,66,68.3,85,63.5,151,65.6,2,0,0
2/17/2018 18:05,75,68,96,63.1,171,65.3,2,0,0
2/17/2018 18:10,75,67.9,95,63.1,170,65.2,2,0,0
2/17/2018 18:15,59,67.8,78,63,137,65,2,0,0
2/17/2018 18:20,66,68.7,85,64,151,66,2,0,0
2/17/2018 18:25,66,67.9,85,63,151,65.2,2,0,0
2/17/2018 18:30,52,67.9,71,63.1,123,65.1,2,0,0
2/17/2018 18:35,54,68.5,73,63.8,127,65.8,2,0,0
2/17/2018 18:40,61,68.1,80,63.3,141,65.4,2,0,0
2/17/2018 18:45,65,68.8,85,64.2,150,66.2,2,0,0
2/17/2018 18:50,48,68.1,66,63.4,114,65.4,2,0,0
2/17/2018 18:55,46,68.7,64,64,110,66,2,0,0
2/17/2018 19:00,39,68.7,56,64.1,95,66,2,0,0
2/17/2018 19:05,50,67.7,67,62.9,117,65,2,0,0
2/17/2018 19:10,46,68.3,64,63.6,110,65.5,2,0,0
2/17/2018 19:15,45,68.7,63,64.1,108,66,2,0,0
2/17/2018 19:20,46,68.9,62,64.3,108,66.3,2,0,0
2/17/2018 19:25,38,68.5,55,63.8,93,65.7,2,0,0
2/17/2018 19:30,52,68.7,70,64,122,66,2,0,0
2/17/2018 19:35,40,68.2,57,63.5,97,65.4,2,0,0
2/17/2018 19:40,45,68.7,62,64,107,65.9,2,0,0
2/17/2018 19:45,38,68.3,55,63.6,93,65.5,2,0,0
2/17/2018 19:50,45,68.4,61,63.7,106,65.7,2,0,0
2/17/2018 19:55,44,69,62,64.4,106,66.3,2,0,0
2/17/2018 20:00,40,68.8,57,64.2,97,66.1,2,0,0
2/17/2018 20:05,41,67.6,58,62.8,99,64.8,2,0,0
2/17/2018 20:10,35,67.6,51,62.9,86,64.8,2,0,0
2/17/2018 20:15,41,68.5,56,63.9,97,65.8,2,0,0
2/17/2018 20:20,39,69.1,56,64.5,95,66.4,2,0,0
2/17/2018 20:25,34,69.1,51,64.5,85,66.3,2,0,0
2/17/2018 20:30,33,69.2,49,64.5,82,66.4,2,0,0
2/17/2018 20:35,40,69.6,56,65,96,66.9,2,0,0
2/17/2018 20:40,32,69,47,64.3,79,66.2,2,0,0
2/17/2018 20:45,29,69,45,64.3,74,66.2,2,0,0
2/17/2018 20:50,35,69.8,52,65.2,87,67,2,0,0
2/17/2018 20:55,32,69.4,48,64.8,80,66.7,2,0,0
2/17/2018 21:00,33,69.3,49,64.7,82,66.6,2,0,0
2/17/2018 21:05,35,69.1,51,64.5,86,66.3,2,0,0
2/17/2018 21:10,32,68.9,49,64.2,81,66.1,2,0,0
2/17/2018 21:15,39,68,55,63.3,94,65.2,2,0,0
2/17/2018 21:20,31,68.2,47,63.4,78,65.3,2,0,0
2/17/2018 21:25,31,68.2,47,63.4,78,65.3,2,0,0
2/17/2018 21:30,31,68.6,47,63.9,78,65.8,2,0,0
2/17/2018 21:35,31,68.9,47,64.2,78,66,2,0,0
2/17/2018 21:40,37,69.5,54,64.9,91,66.8,2,0,0
2/17/2018 21:45,38,69,54,64.3,92,66.2,2,0,0
2/17/2018 21:50,36,69.1,52,64.4,88,66.3,2,0,0
2/17/2018 21:55,38,68.4,55,63.6,93,65.6,2,0,0
2/17/2018 22:00,27,68.6,43,63.9,70,65.7,2,0,0
2/17/2018 22:05,25,68.6,41,64,66,65.7,2,0,0
2/17/2018 22:10,31,68.5,47,63.8,78,65.7,2,0,0
2/17/2018 22:15,29,69,45,64.4,74,66.2,2,0,0
2/17/2018 22:20,28,68.9,45,64.3,73,66.1,2,0,0
2/17/2018 22:25,28,69.4,43,64.8,71,66.6,2,0,0
2/17/2018 22:30,23,69.2,39,64.6,62,66.3,2,0,0
2/17/2018 22:35,26,69.3,42,64.7,68,66.4,2,0,0
2/17/2018 22:40,27,69.1,43,64.4,70,66.2,2,0,0
2/17/2018 22:45,28,69.8,45,65.2,73,66.9,2,0,0
2/17/2018 22:50,29,69.4,45,64.8,74,66.6,2,0,0
2/17/2018 22:55,29,69,44,64.4,73,66.2,2,0,0
2/17/2018 23:00,23,68.7,40,64,63,65.7,2,0,0
2/17/2018 23:05,20,69.2,35,64.5,55,66.2,2,0,0
2/17/2018 23:10,20,69.6,36,65,56,66.6,2,0,0
2/17/2018 23:15,24,69.4,39,64.8,63,66.6,2,0,0
2/17/2018 23:20,18,69.3,33,64.7,51,66.3,2,0,0
2/17/2018 23:25,21,67.1,37,62.3,58,64,2,0,0
2/17/2018 23:30,15,67.9,30,63.1,45,64.7,2,0,0
2/17/2018 23:35,21,68.6,37,64,58,65.7,2,0,0
2/17/2018 23:40,14,69,30,64.3,44,65.8,2,0,0
2/17/2018 23:45,18,69.1,33,64.4,51,66.1,2,0,0
2/17/2018 23:50,17,69.2,32,64.6,49,66.2,2,0,0
2/17/2018 23:55,13,69.2,28,64.6,41,66.1,2,0,0
2/18/2018 0:00,18,69.3,34,64.7,52,66.3,2,0,0
2/18/2018 0:05,16,69.5,31,64.9,47,66.5,2,0,0
2/18/2018 0:10,19,69.3,34,64.7,53,66.4,2,0,0
2/18/2018 0:15,12,69.3,27,64.7,39,66.1,2,0,0
2/18/2018 0:20,11,69.1,27,64.5,38,65.8,2,0,0
2/18/2018 0:25,12,69.1,27,64.4,39,65.9,2,0,0
2/18/2018 0:30,15,69.4,30,64.7,45,66.3,2,0,0
2/18/2018 0:35,13,69.4,29,64.8,42,66.2,2,0,0
2/18/2018 0:40,10,69.4,25,64.8,35,66.1,2,0,0
2/18/2018 0:45,12,69.2,27,64.6,39,66,2,0,0
2/18/2018 0:50,12,69.3,21,64.7,33,66.3,2,0,0
2/18/2018 0:55,13,69.3,28,64.7,41,66.1,2,0,0
2/18/2018 1:00,10,69.3,25,64.7,35,66.1,2,0,0
2/18/2018 1:05,12,69.2,27,64.6,39,66,2,0,0
2/18/2018 1:10,10,69.2,25,64.6,35,65.9,2,0,0
2/18/2018 1:15,8,69.2,23,64.6,31,65.8,2,0,0
2/18/2018 1:20,9,69.3,24,64.7,33,65.9,2,0,0
2/18/2018 1:25,6,69.3,21,64.7,27,65.7,2,0,0
2/18/2018 1:30,8,69.3,24,64.7,32,65.8,2,0,0
2/18/2018 1:35,7,69.3,22,64.7,29,65.8,2,0,0
2/18/2018 1:40,8,69.3,23,64.7,31,65.9,2,0,0
2/18/2018 1:45,7,69.3,22,64.7,29,65.8,2,0,0
2/18/2018 1:50,8,69.2,24,64.5,32,65.7,2,0,0
2/18/2018 1:55,8,69.2,23,64.6,31,65.8,2,0,0
2/18/2018 2:00,13,69.2,28,64.5,41,66,2,0,0
2/18/2018 2:05,11,69.2,26,64.6,37,66,2,0,0
2/18/2018 2:10,11,69.3,26,64.7,37,66,2,0,0
2/18/2018 2:15,8,69.3,24,64.7,32,65.8,2,0,0
2/18/2018 2:20,8,69.3,23,64.7,31,65.9,2,0,0
2/18/2018 2:25,10,69.2,25,64.6,35,65.9,2,0,0
2/18/2018 2:30,10,69.2,25,64.6,35,65.9,2,0,0
2/18/2018 2:35,9,69.2,24,64.6,33,65.9,2,0,0
2/18/2018 2:40,8,69.2,24,64.6,32,65.7,2,0,0
2/18/2018 2:45,8,69.2,24,64.6,32,65.7,2,0,0
2/18/2018 2:50,8,69.2,24,64.6,32,65.8,2,0,0
2/18/2018 2:55,8,69.2,23,64.6,31,65.8,2,0,0
2/18/2018 3:00,7,69.2,22,64.6,29,65.7,2,0,0
2/18/2018 3:05,9,69.2,24,64.6,33,65.8,2,0,0
2/18/2018 3:10,5,69.2,21,64.6,26,65.5,2,0,0
2/18/2018 3:15,7,69.3,22,64.7,29,65.8,2,0,0
2/18/2018 3:20,6,69.3,21,64.7,27,65.8,2,0,0
2/18/2018 3:25,7,69.3,22,64.7,29,65.8,2,0,0
2/18/2018 3:30,8,69.3,23,64.7,31,65.9,2,0,0
2/18/2018 3:35,6,69.3,22,64.7,28,65.7,2,0,0
2/18/2018 3:40,9,69.1,24,64.5,33,65.7,2,0,0
2/18/2018 3:45,8,69.2,24,64.5,32,65.7,2,0,0
2/18/2018 3:50,7,69.3,22,64.7,29,65.8,2,0,0
2/18/2018 3:55,4,69.3,19,64.7,23,65.5,2,0,0
2/18/2018 4:00,8,69.3,23,64.7,31,65.8,2,0,0
2/18/2018 4:05,9,69.2,24,64.6,33,65.9,2,0,0
2/18/2018 4:10,13,69.3,21,64.7,34,66.4,2,0,0
2/18/2018 4:15,7,69.2,22,64.6,29,65.7,2,0,0
2/18/2018 4:20,10,69.3,26,64.7,36,65.9,2,0,0
2/18/2018 4:25,6,69.3,21,64.7,27,65.8,2,0,0
2/18/2018 4:30,10,69.2,26,64.6,36,65.9,2,0,0
2/18/2018 4:35,8,69.2,24,64.6,32,65.7,2,0,0
2/18/2018 4:40,10,69.3,25,64.7,35,66,2,0,0
2/18/2018 4:45,11,69.2,26,64.5,37,65.9,2,0,0
2/18/2018 4:50,9,69.2,24,64.6,33,65.8,2,0,0
2/18/2018 4:55,11,69.3,26,64.7,37,66.1,2,0,0
2/18/2018 5:00,9,69.3,25,64.7,34,65.9,2,0,0
2/18/2018 5:05,7,69.3,23,64.7,30,65.8,2,0,0
2/18/2018 5:10,11,69.4,27,64.7,38,66.1,2,0,0
2/18/2018 5:15,11,69.3,27,64.7,38,66.1,2,0,0
2/18/2018 5:20,10,69.4,25,64.8,35,66.1,2,0,0
2/18/2018 5:25,13,69.4,29,64.8,42,66.3,2,0,0
2/18/2018 5:30,15,69.4,30,64.8,45,66.3,2,0,0
2/18/2018 5:35,14,69.4,30,64.8,44,66.2,2,0,0
2/18/2018 5:40,17,69.5,33,64.9,50,66.5,2,0,0
2/18/2018 5:45,12,69.3,27,64.7,39,66.2,2,0,0
2/18/2018 5:50,16,69.3,31,64.7,47,66.3,2,0,0
2/18/2018 5:55,13,69.4,29,64.8,42,66.2,2,0,0
2/18/2018 6:00,13,69.3,28,64.7,41,66.2,2,0,0
2/18/2018 6:05,14,69.3,29,64.7,43,66.2,2,0,0
2/18/2018 6:10,15,69.3,30,64.7,45,66.2,2,0,0
2/18/2018 6:15,14,69.3,30,64.7,44,66.1,2,0,0
2/18/2018 6:20,15,69.3,30,64.7,45,66.2,2,0,0
2/18/2018 6:25,15,69,30,64.4,45,65.9,2,0,0
2/18/2018 6:30,19,69.3,34,64.7,53,66.3,2,0,0
2/18/2018 6:35,17,69.1,33,64.4,50,66,2,0,0
2/18/2018 6:40,21,68.8,37,64.1,58,65.8,2,0,0
2/18/2018 6:45,21,69.1,37,64.5,58,66.1,2,0,0
2/18/2018 6:50,19,69.3,35,64.7,54,66.3,2,0,0
2/18/2018 6:55,17,69.3,33,64.7,50,66.3,2,0,0
2/18/2018 7:00,17,69.4,33,64.8,50,66.4,2,0,0
2/18/2018 7:05,17,69.2,33,64.6,50,66.2,2,0,0
2/18/2018 7:10,21,69.5,37,64.9,58,66.6,2,0,0
2/18/2018 7:15,23,69.5,39,64.9,62,66.6,2,0,0
2/18/2018 7:20,20,69.2,36,64.6,56,66.2,2,0,0
2/18/2018 7:25,19,69.3,35,64.7,54,66.3,2,0,0
2/18/2018 7:30,21,69.3,37,64.7,58,66.4,2,0,0
2/18/2018 7:35,30,69.4,47,64.8,77,66.6,2,0,0
2/18/2018 7:40,28,69.7,45,65.2,73,66.9,2,0,0
2/18/2018 7:45,32,69.7,48,65.1,80,67,2,0,0
2/18/2018 7:50,27,69.5,42,65,69,66.7,2,0,0
2/18/2018 7:55,27,69.7,44,65.1,71,66.8,2,0,0
2/18/2018 8:00,18,69.6,34,65,52,66.6,2,0,0
2/18/2018 8:05,25,69,41,64.3,66,66.1,2,0,0
2/18/2018 8:10,29,69.1,46,64.5,75,66.3,2,0,0
2/18/2018 8:15,26,69.3,43,64.7,69,66.4,2,0,0
2/18/2018 8:20,35,69.3,52,64.7,87,66.5,2,0,0
2/18/2018 8:25,35,69.2,51,64.6,86,66.5,2,0,0
2/18/2018 8:30,30,69.3,46,64.7,76,66.6,2,0,0
2/18/2018 8:35,32,69.5,48,64.9,80,66.7,2,0,0
2/18/2018 8:40,34,69.9,50,65.3,84,67.2,2,0,0
2/18/2018 8:45,37,69,53,64.4,90,66.3,2,0,0
2/18/2018 8:50,33,69.5,49,64.9,82,66.7,2,0,0
2/18/2018 8:55,33,69.6,50,65,83,66.8,2,0,0
2/18/2018 9:00,36,69.3,53,64.7,89,66.6,2,0,0
2/18/2018 9:05,29,69.2,45,64.6,74,66.4,2,0,0
2/18/2018 9:10,32,69.5,49,64.9,81,66.7,2,0,0
2/18/2018 9:15,39,69.6,56,65,95,66.9,2,0,0
2/18/2018 9:20,36,69.4,52,64.7,88,66.6,2,0,0
2/18/2018 9:25,38,69.4,55,64.8,93,66.7,2,0,0
2/18/2018 9:30,40,69.7,57,65.1,97,67,2,0,0
2/18/2018 9:35,42,69.1,59,64.4,101,66.4,2,0,0
2/18/2018 9:40,47,68.8,65,64.1,112,66.1,2,0,0
2/18/2018 9:45,48,69.1,65,64.5,113,66.5,2,0,0
2/18/2018 9:50,43,69.5,60,65,103,66.9,2,0,0
2/18/2018 9:55,48,69.5,66,64.9,114,66.9,2,0,0
2/18/2018 10:00,47,69.2,64,64.5,111,66.5,2,0,0
2/18/2018 10:05,44,69.3,62,64.6,106,66.6,2,0,0
2/18/2018 10:10,55,68.5,72,63.8,127,65.8,2,0,0
2/18/2018 10:15,44,68.6,62,63.9,106,65.9,2,0,0
2/18/2018 10:20,52,68.6,70,63.9,122,65.9,2,0,0
2/18/2018 10:25,52,68.6,70,63.8,122,65.9,2,0,0
2/18/2018 10:30,54,68.5,72,63.8,126,65.9,2,0,0
2/18/2018 10:35,59,67.7,78,62.9,137,64.9,2,0,0
2/18/2018 10:40,58,68.9,77,64.2,135,66.2,2,0,0
2/18/2018 10:45,53,67.8,71,62.9,124,65,2,0,0
2/18/2018 10:50,59,68.1,78,63.4,137,65.4,2,0,0
2/18/2018 10:55,52,68.4,70,63.7,122,65.7,2,0,0
2/18/2018 11:00,50,68.7,67,64,117,66,2,0,0
2/18/2018 11:05,59,68.7,78,63.9,137,66,2,0,0
2/18/2018 11:10,56,69.6,76,65,132,66.9,2,0,0
2/18/2018 11:15,61,69.1,79,64.4,140,66.5,2,0,0
2/18/2018 11:20,64,69.5,82,64.9,146,66.9,2,0,0
2/18/2018 11:25,61,68.8,79,64,140,66.1,2,0,0
2/18/2018 11:30,58,68.3,75,63.6,133,65.7,2,0,0
2/18/2018 11:35,56,68.4,74,63.6,130,65.7,2,0,0
2/18/2018 11:40,60,67.9,79,63.1,139,65.2,2,0,0
2/18/2018 11:45,59,68.8,77,64.1,136,66.1,2,0,0
2/18/2018 11:50,60,69.1,79,64.5,139,66.5,2,0,0
2/18/2018 11:55,56,69.2,76,64.5,132,66.5,2,0,0
2/18/2018 12:00,62,68.5,81,63.7,143,65.8,2,0,0
2/18/2018 12:05,59,68.8,78,64.1,137,66.1,2,0,0
2/18/2018 12:10,56,68.2,75,63.4,131,65.5,2,0,0
2/18/2018 12:15,54,68.7,73,64,127,66,2,0,0
2/18/2018 12:20,59,68.8,77,64.1,136,66.1,2,0,0
2/18/2018 12:25,58,68.6,76,63.9,134,66,2,0,0
2/18/2018 12:30,56,69.3,73,64.6,129,66.6,2,0,0
2/18/2018 12:35,58,69.4,77,64.7,135,66.7,2,0,0
2/18/2018 12:40,53,68.7,71,64.1,124,66.1,2,0,0
2/18/2018 12:45,64,68.1,82,63.4,146,65.5,2,0,0
2/18/2018 12:50,61,67.9,80,63.1,141,65.2,2,0,0
2/18/2018 12:55,45,67.9,63,63.1,108,65.1,2,0,0
2/18/2018 13:00,56,67,76,62.2,132,64.2,2,0,0
2/18/2018 13:05,68,66.8,87,61.9,155,64.1,2,0,0
2/18/2018 13:10,56,67.9,74,63,130,65.1,2,0,0
2/18/2018 13:15,61,68,79,63.2,140,65.3,2,0,0
2/18/2018 13:20,59,68.5,76,63.8,135,65.8,2,0,0
2/18/2018 13:25,63,68.3,81,63.5,144,65.6,2,0,0
2/18/2018 13:30,59,68.6,78,63.9,137,65.9,2,0,0
2/18/2018 13:35,66,68.4,85,63.7,151,65.8,2,0,0
2/18/2018 13:40,64,68.1,83,63.3,147,65.4,2,0,0
2/18/2018 13:45,64,68.2,83,63.4,147,65.5,2,0,0
2/18/2018 13:50,69,68.3,88,63.6,157,65.7,2,0,0
2/18/2018 13:55,73,69.3,92,64.7,165,66.8,2,0,0
2/18/2018 14:00,75,69.1,94,64.5,169,66.5,2,0,0
2/18/2018 14:05,72,68.9,92,64.3,164,66.3,2,0,0
2/18/2018 14:10,69,68.5,88,63.8,157,65.9,2,0,0
2/18/2018 14:15,75,68.3,96,63.5,171,65.6,2,0,0
2/18/2018 14:20,71,68.2,91,63.4,162,65.5,2,0,0
2/18/2018 14:25,63,67,83,62.2,146,64.3,2,0,0
2/18/2018 14:30,58,66,77,61,135,63.1,2,0,0
2/18/2018 14:35,73,65.6,93,60.7,166,62.9,2,0,0
2/18/2018 14:40,56,64.4,75,59.4,131,61.5,2,0,0
2/18/2018 14:45,56,65.4,74,60.4,130,62.6,2,0,0
2/18/2018 14:50,44,67.3,61,62.5,105,64.6,2,0,0
2/18/2018 14:55,47,68.4,63,63.7,110,65.7,2,0,0
2/18/2018 15:00,52,69,70,64.3,122,66.3,2,0,0
2/18/2018 15:05,43,67.9,61,63.1,104,65.1,2,0,0
2/18/2018 15:10,49,68.5,67,63.7,116,65.7,2,0,0
2/18/2018 15:15,41,68.8,58,64.1,99,66.1,2,0,0
2/18/2018 15:20,44,69.3,61,64.6,105,66.6,2,0,0
2/18/2018 15:25,48,69.2,66,64.5,114,66.5,2,0,0
2/18/2018 15:30,45,69.3,62,64.7,107,66.6,2,0,0
2/18/2018 15:35,54,68.2,72,63.3,126,65.4,2,0,0
2/18/2018 15:40,56,67.9,73,63.1,129,65.2,2,0,0
2/18/2018 15:45,53,68.1,70,63.3,123,65.3,2,0,0
2/18/2018 15:50,49,68.5,66,63.8,115,65.8,2,0,0
2/18/2018 15:55,48,68.3,65,63.6,113,65.6,2,0,0
2/18/2018 16:00,38,68.7,55,64,93,65.9,2,0,0
2/18/2018 16:05,34,69.3,51,64.7,85,66.6,2,0,0
2/18/2018 16:10,35,69.6,51,65,86,66.9,2,0,0
2/18/2018 16:15,33,69.4,49,64.8,82,66.7,2,0,0
2/18/2018 16:20,35,69.3,52,64.7,87,66.5,2,0,0
2/18/2018 16:25,33,69,49,64.4,82,66.2,2,0,0
2/18/2018 16:30,27,69.3,43,64.7,70,66.5,2,0,0
2/18/2018 16:35,32,69,48,64.3,80,66.2,2,0,0
2/18/2018 16:40,27,69,43,64.4,70,66.2,2,0,0
2/18/2018 16:45,28,69.2,44,64.5,72,66.3,2,0,0
2/18/2018 16:50,32,69.2,49,64.6,81,66.4,2,0,0
2/18/2018 16:55,36,68.9,52,64.3,88,66.2,2,0,0
2/18/2018 17:00,41,69,57,64.3,98,66.3,2,0,0
2/18/2018 17:05,50,69,66,64.3,116,66.3,2,0,0
2/18/2018 17:10,45,68.9,61,64.2,106,66.2,2,0,0
2/18/2018 17:15,47,68.8,64,64.1,111,66.1,2,0,0
2/18/2018 17:20,42,68.2,59,63.5,101,65.4,2,0,0
2/18/2018 17:25,51,68.9,68,64.2,119,66.2,2,0,0
2/18/2018 17:30,53,68.7,71,64,124,66,2,0,0
2/18/2018 17:35,48,69.1,65,64.4,113,66.4,2,0,0
2/18/2018 17:40,48,69,65,64.3,113,66.3,2,0,0
2/18/2018 17:45,51,68.7,69,64,120,66,2,0,0
2/18/2018 17:50,52,67.6,70,62.7,122,64.8,2,0,0
2/18/2018 17:55,48,68.3,66,63.6,114,65.6,2,0,0
2/18/2018 18:00,44,69,61,64.3,105,66.2,2,0,0
2/18/2018 18:05,42,69.2,60,64.6,102,66.5,2,0,0
2/18/2018 18:10,45,68.9,62,64.1,107,66.1,2,0,0
2/18/2018 18:15,40,69,56,64.3,96,66.3,2,0,0
2/18/2018 18:20,37,68.9,54,64.1,91,66.1,2,0,0
2/18/2018 18:25,38,68.2,54,63.5,92,65.4,2,0,0
2/18/2018 18:30,40,68.4,56,63.7,96,65.7,2,0,0
2/18/2018 18:35,38,68.9,55,64.2,93,66.2,2,0,0
2/18/2018 18:40,35,68.8,52,64.1,87,66,2,0,0
2/18/2018 18:45,39,69.6,56,65,95,66.9,2,0,0
2/18/2018 18:50,40,69,58,64.4,98,66.2,2,0,0
2/18/2018 18:55,31,68.4,47,63.7,78,65.6,2,0,0
2/18/2018 19:00,35,69.1,52,64.4,87,66.3,2,0,0
2/18/2018 19:05,38,68.8,55,64.2,93,66.1,2,0,0
2/18/2018 19:10,29,69,44,64.4,73,66.2,2,0,0
2/18/2018 19:15,34,69,51,64.3,85,66.2,2,0,0
2/18/2018 19:20,37,68.7,53,64,90,65.9,2,0,0
2/18/2018 19:25,40,69.3,57,64.7,97,66.6,2,0,0
2/18/2018 19:30,43,69,60,64.3,103,66.3,2,0,0
2/18/2018 19:35,35,68.3,52,63.6,87,65.5,2,0,0
2/18/2018 19:40,38,68.5,54,63.9,92,65.8,2,0,0
2/18/2018 19:45,39,68.4,57,63.7,96,65.6,2,0,0
2/18/2018 19:50,38,68,55,63.2,93,65.2,2,0,0
2/18/2018 19:55,34,68.1,50,63.4,84,65.3,2,0,0
2/18/2018 20:00,33,68.3,49,63.6,82,65.5,2,0,0
2/18/2018 20:05,34,68.7,49,64.1,83,66,2,0,0
2/18/2018 20:10,29,68.4,44,63.7,73,65.6,2,0,0
2/18/2018 20:15,28,68.8,43,64.1,71,66,2,0,0
2/18/2018 20:20,10,69,25,64.4,35,65.7,2,0,0
2/18/2018 20:25,55,64.7,73,59.6,128,61.8,2,0,0
2/18/2018 20:30,30,66.4,45,61.5,75,63.5,2,0,0
2/18/2018 20:35,31,68.3,47,63.6,78,65.5,2,0,0
2/18/2018 20:40,29,68.9,44,64.2,73,66.1,2,0,0
2/18/2018 20:45,32,69.2,48,64.5,80,66.4,2,0,0
2/18/2018 20:50,31,69.3,47,64.7,78,66.5,2,0,0
2/18/2018 20:55,31,69.4,47,64.8,78,66.6,2,0,0
2/18/2018 21:00,30,69.1,46,64.5,76,66.3,2,0,0
2/18/2018 21:05,29,68.9,45,64.2,74,66.1,2,0,0
2/18/2018 21:10,30,69.4,46,64.8,76,66.6,2,0,0
2/18/2018 21:15,25,69.2,41,64.6,66,66.3,2,0,0
2/18/2018 21:20,29,69.2,45,64.6,74,66.4,2,0,0
2/18/2018 21:25,35,69,52,64.3,87,66.2,2,0,0
2/18/2018 21:30,28,68.5,44,63.8,72,65.6,2,0,0
2/18/2018 21:35,39,68.9,55,64.3,94,66.2,2,0,0
2/18/2018 21:40,33,69,49,64.4,82,66.2,2,0,0
2/18/2018 21:45,34,68.7,50,64.1,84,66,2,0,0
2/18/2018 21:50,27,69.4,42,64.8,69,66.6,2,0,0
2/18/2018 21:55,26,69.4,42,64.8,68,66.6,2,0,0
2/18/2018 22:00,26,69.2,42,64.6,68,66.4,2,0,0
2/18/2018 22:05,25,69.3,41,64.7,66,66.4,2,0,0
2/18/2018 22:10,26,69.3,41,64.7,67,66.5,2,0,0
2/18/2018 22:15,27,68.9,43,64.2,70,66,2,0,0
2/18/2018 22:20,25,68.7,41,64,66,65.8,2,0,0
2/18/2018 22:25,19,68.8,35,64.1,54,65.8,2,0,0
2/18/2018 22:30,19,69,35,64.4,54,66,2,0,0
2/18/2018 22:35,19,69.4,34,64.8,53,66.5,2,0,0
2/18/2018 22:40,22,69.4,38,64.8,60,66.5,2,0,0
2/18/2018 22:45,18,69.4,33,64.8,51,66.4,2,0,0
2/18/2018 22:50,24,68.9,40,64.3,64,66,2,0,0
2/18/2018 22:55,16,69.1,31,64.4,47,66,2,0,0
2/18/2018 23:00,25,69.2,40,64.6,65,66.4,2,0,0
2/18/2018 23:05,21,69.2,37,64.6,58,66.3,2,0,0
2/18/2018 23:10,13,69.2,28,64.6,41,66.1,2,0,0
2/18/2018 23:15,18,69.1,34,64.5,52,66.1,2,0,0
2/18/2018 23:20,17,68.8,33,64.2,50,65.7,2,0,0
2/18/2018 23:25,19,68.9,34,64.3,53,65.9,2,0,0
2/18/2018 23:30,16,69.2,32,64.5,48,66.1,2,0,0
2/18/2018 23:35,21,69.3,36,64.7,57,66.4,2,0,0
2/18/2018 23:40,10,69.3,25,64.7,35,66,2,0,0
2/18/2018 23:45,14,69.2,29,64.5,43,66.1,2,0,0
2/18/2018 23:50,13,69.3,28,64.7,41,66.1,2,0,0
2/18/2018 23:55,12,69.2,28,64.6,40,66,2,0,0
