5 Minutes,Lane 1 Flow (Veh/5 Minutes),Lane 1 Speed (mph),Lane 2 Flow (Veh/5 Minutes),Lane 2 Speed (mph),Flow (Veh/5 Minutes),Speed (mph),# Lane Points,% Observed,Holiday
2/19/2018 0:00,14,69.3,30,64.7,44,66.2,2,0,1
2/19/2018 0:05,11,69.2,26,64.6,37,66,2,0,1
2/19/2018 0:10,9,69.2,24,64.6,33,65.9,2,0,1
2/19/2018 0:15,10,69.2,26,64.6,36,65.9,2,0,1
2/19/2018 0:20,12,69.3,28,64.7,40,66.1,2,0,1
2/19/2018 0:25,11,69.3,27,64.7,38,66,2,0,1
2/19/2018 0:30,11,69.3,27,64.7,38,66,2,0,1
2/19/2018 0:35,7,69.4,22,64.8,29,65.9,2,0,1
2/19/2018 0:40,8,69.4,24,64.8,32,66,2,0,1
2/19/2018 0:45,8,69.4,23,64.8,31,66,2,0,1
2/19/2018 0:50,10,69.4,25,64.8,35,66.1,2,0,1
2/19/2018 0:55,10,69.4,25,64.8,35,66.1,2,0,1
2/19/2018 1:00,9,69.4,24,64.8,33,66.1,2,0,1
2/19/2018 1:05,8,69.2,23,64.6,31,65.8,2,0,1
2/19/2018 1:10,10,69.3,25,64.7,35,66,2,0,1
2/19/2018 1:15,5,69.4,20,64.8,25,65.7,2,0,1
2/19/2018 1:20,8,69.4,23,64.8,31,66,2,0,1
2/19/2018 1:25,5,69.3,21,64.7,26,65.6,2,0,1
2/19/2018 1:30,10,69.3,25,64.7,35,66,2,0,1
2/19/2018 1:35,9,69.3,25,64.7,34,65.9,2,0,1
2/19/2018 1:40,7,69.3,22,64.7,29,65.8,2,0,1
2/19/2018 1:45,6,69.2,21,64.6,27,65.6,2,0,1
2/19/2018 1:50,6,69.3,22,64.7,28,65.6,2,0,1
2/19/2018 1:55,7,69.3,22,64.7,29,65.8,2,0,1
2/19/2018 2:00,9,69.3,24,64.7,33,65.9,2,0,1
2/19/2018 2:05,7,69.3,22,64.7,29,65.8,2,0,1
2/19/2018 2:10,10,69.3,25,64.7,35,66,2,0,1
2/19/2018 2:15,10,69.3,20,64.7,30,66.2,2,0,1
2/19/2018 2:20,11,69.3,21,64.7,32,66.2,2,0,1
2/19/2018 2:25,6,69.3,21,64.7,27,65.7,2,0,1
2/19/2018 2:30,7,69.3,22,64.7,29,65.8,2,0,1
2/19/2018 2:35,7,69.3,22,64.7,29,65.8,2,0,1
2/19/2018 2:40,8,69.3,24,64.7,32,65.9,2,0,1
2/19/2018 2:45,7,69.3,22,64.7,29,65.8,2,0,1
2/19/2018 2:50,8,69.2,23,64.6,31,65.8,2,0,1
2/19/2018 2:55,7,69.2,23,64.6,30,65.7,2,0,1
2/19/2018 3:00,6,69.3,21,64.7,27,65.7,2,0,1
2/19/2018 3:05,9,69.3,24,64.7,33,65.9,2,0,1
2/19/2018 3:10,7,69.1,22,64.5,29,65.6,2,0,1
2/19/2018 3:15,7,69.2,22,64.6,29,65.7,2,0,1
2/19/2018 3:20,6,69.2,21,64.6,27,65.6,2,0,1
2/19/2018 3:25,7,69.3,22,64.7,29,65.8,2,0,1
2/19/2018 3:30,11,69.3,27,64.7,38,66,2,0,1
2/19/2018 3:35,12,69.4,27,64.8,39,66.2,2,0,1
2/19/2018 3:40,10,69.3,25,64.7,35,66,2,0,1
2/19/2018 3:45,9,69.4,24,64.8,33,66,2,0,1
2/19/2018 3:50,11,69.5,27,64.9,38,66.2,2,0,1
2/19/2018 3:55,11,69.3,26,64.7,37,66.1,2,0,1
2/19/2018 4:00,13,69.4,28,64.8,41,66.2,2,0,1
2/19/2018 4:05,13,69.3,28,64.7,41,66.2,2,0,1
2/19/2018 4:10,12,69.3,27,64.7,39,66.1,2,0,1
2/19/2018 4:15,12,69.3,27,64.7,39,66.2,2,0,1
2/19/2018 4:20,14,69.3,30,64.7,44,66.2,2,0,1
2/19/2018 4:25,20,69.5,35,64.9,55,66.6,2,0,1
2/19/2018 4:30,16,69.3,32,64.7,48,66.2,2,0,1
2/19/2018 4:35,21,69.4,37,64.8,58,66.5,2,0,1
2/19/2018 4:40,16,69.1,32,64.5,48,66,2,0,1
2/19/2018 4:45,21,69.4,38,64.7,59,66.4,2,0,1
2/19/2018 4:50,20,69.4,36,64.8,56,66.4,2,0,1
2/19/2018 4:55,24,69.4,40,64.8,64,66.5,2,0,1
2/19/2018 5:00,21,69.4,39,64.8,60,66.4,2,0,1
2/19/2018 5:05,20,69.5,36,64.9,56,66.6,2,0,1
2/19/2018 5:10,23,69,40,64.4,63,66.1,2,0,1
2/19/2018 5:15,25,69.3,41,64.7,66,66.5,2,0,1
2/19/2018 5:20,22,68.9,39,64.3,61,65.9,2,0,1
2/19/2018 5:25,29,68.2,47,63.6,76,65.3,2,0,1
2/19/2018 5:30,30,68.5,47,63.9,77,65.7,2,0,1
2/19/2018 5:35,28,69.4,45,64.8,73,66.6,2,0,1
2/19/2018 5:40,27,69.4,43,64.8,70,66.6,2,0,1
2/19/2018 5:45,27,69.5,44,65,71,66.7,2,0,1
2/19/2018 5:50,38,68.7,57,64.1,95,65.9,2,0,1
2/19/2018 5:55,25,69.2,41,64.6,66,66.3,2,0,1
2/19/2018 6:00,28,69.5,45,64.9,73,66.7,2,0,1
2/19/2018 6:05,29,69.5,47,64.8,76,66.6,2,0,1
2/19/2018 6:10,32,68.9,49,64.2,81,66,2,0,1
2/19/2018 6:15,32,69,49,64.3,81,66.1,2,0,1
2/19/2018 6:20,28,69.5,44,64.8,72,66.6,2,0,1
2/19/2018 6:25,32,69,50,64.4,82,66.2,2,0,1
2/19/2018 6:30,33,68.9,50,64.2,83,66.1,2,0,1
2/19/2018 6:35,38,69.2,55,64.6,93,66.5,2,0,1
2/19/2018 6:40,42,66.5,60,61.7,102,63.7,2,0,1
2/19/2018 6:45,34,66.9,52,62.1,86,64,2,0,1
2/19/2018 6:50,37,67.2,55,62.4,92,64.3,2,0,1
2/19/2018 6:55,36,68.5,54,63.9,90,65.7,2,0,1
2/19/2018 7:00,42,68.1,59,63.4,101,65.4,2,0,1
2/19/2018 7:05,38,67.6,56,62.8,94,64.7,2,0,1
2/19/2018 7:10,36,68.6,52,63.9,88,65.8,2,0,1
2/19/2018 7:15,38,69.7,55,65.2,93,67,2,0,1
2/19/2018 7:20,45,68.3,63,63.6,108,65.5,2,0,1
2/19/2018 7:25,35,67.1,53,62.3,88,64.2,2,0,1
2/19/2018 7:30,39,67.3,57,62.5,96,64.4,2,0,1
2/19/2018 7:35,45,68.3,62,63.6,107,65.6,2,0,1
2/19/2018 7:40,43,68.5,61,63.9,104,65.8,2,0,1
2/19/2018 7:45,38,69.1,55,64.5,93,66.4,2,0,1
2/19/2018 7:50,45,69,64,64.3,109,66.3,2,0,1
2/19/2018 7:55,48,69.4,66,64.7,114,66.7,2,0,1
2/19/2018 8:00,39,69.9,55,65.3,94,67.2,2,0,1
2/19/2018 8:05,44,68.8,62,64.1,106,66,2,0,1
2/19/2018 8:10,47,68.7,66,64,113,66,2,0,1
2/19/2018 8:15,42,68.3,60,63.5,102,65.5,2,0,1
2/19/2018 8:20,48,69.2,67,64.5,115,66.4,2,0,1
2/19/2018 8:25,39,69.3,56,64.6,95,66.5,2,0,1
2/19/2018 8:30,40,69.9,57,65.2,97,67.1,2,0,1
2/19/2018 8:35,44,69.7,62,65.2,106,67.1,2,0,1
2/19/2018 8:40,43,68,61,63.3,104,65.2,2,0,1
2/19/2018 8:45,46,68.5,64,63.8,110,65.7,2,0,1
2/19/2018 8:50,44,69.3,63,64.6,107,66.5,2,0,1
2/19/2018 8:55,43,68.9,61,64.2,104,66.2,2,0,1
2/19/2018 9:00,42,68.2,60,63.5,102,65.4,2,0,1
2/19/2018 9:05,38,69,54,64.4,92,66.3,2,0,1
2/19/2018 9:10,46,67.9,64,63.3,110,65.2,2,0,1
2/19/2018 9:15,42,69,59,64.4,101,66.3,2,0,1
2/19/2018 9:20,47,69.2,65,64.6,112,66.5,2,0,1
2/19/2018 9:25,41,68.5,57,63.9,98,65.9,2,0,1
2/19/2018 9:30,49,69,67,64.4,116,66.3,2,0,1
2/19/2018 9:35,51,69.5,69,64.9,120,66.9,2,0,1
2/19/2018 9:40,46,70,63,65.5,109,67.4,2,0,1
2/19/2018 9:45,48,70.8,66,66.3,114,68.2,2,0,1
2/19/2018 9:50,56,70.1,74,65.6,130,67.5,2,0,1
2/19/2018 9:55,53,70.7,70,66.2,123,68.1,2,0,1
2/19/2018 10:00,56,70.1,74,65.4,130,67.4,2,0,1
2/19/2018 10:05,52,69.7,70,65.1,122,67.1,2,0,1
2/19/2018 10:10,53,70.5,71,66,124,67.9,2,0,1
2/19/2018 10:15,56,70.5,73,65.9,129,67.9,2,0,1
2/19/2018 10:20,53,70.8,70,66.3,123,68.2,2,0,1
2/19/2018 10:25,55,70.9,73,66.4,128,68.3,2,0,1
2/19/2018 10:30,54,70.5,71,66,125,67.9,2,0,1
2/19/2018 10:35,66,69.5,85,64.9,151,66.9,2,0,1
2/19/2018 10:40,63,69.5,82,64.8,145,66.8,2,0,1
2/19/2018 10:45,55,70.4,73,65.8,128,67.8,2,0,1
2/19/2018 10:50,61,71.2,80,66.7,141,68.6,2,0,1
2/19/2018 10:55,54,71.2,72,66.8,126,68.7,2,0,1
2/19/2018 11:00,57,71.6,75,67.2,132,69.1,2,0,1
2/19/2018 11:05,52,71.9,69,67.5,121,69.4,2,0,1
2/19/2018 11:10,60,71.4,78,66.9,138,68.9,2,0,1
2/19/2018 11:15,58,70.8,75,66.3,133,68.3,2,0,1
2/19/2018 11:20,57,70.8,75,66.3,132,68.3,2,0,1
2/19/2018 11:25,43,70.1,59,65.5,102,67.4,2,0,1
2/19/2018 11:30,55,71.3,74,66.9,129,68.8,2,0,1
2/19/2018 11:35,55,71.5,74,67.1,129,69,2,0,1
2/19/2018 11:40,61,70.3,79,65.7,140,67.7,2,0,1
2/19/2018 11:45,59,70.1,77,65.4,136,67.4,2,0,1
2/19/2018 11:50,60,70.3,79,65.7,139,67.7,2,0,1
2/19/2018 11:55,48,70.4,65,65.8,113,67.7,2,0,1
2/19/2018 12:00,51,70.2,69,65.5,120,67.5,2,0,1
2/19/2018 12:05,59,70,77,65.4,136,67.4,2,0,1
2/19/2018 12:10,54,70,71,65.3,125,67.4,2,0,1
2/19/2018 12:15,59,70.2,78,65.5,137,67.5,2,0,1
2/19/2018 12:20,54,70.9,72,66.3,126,68.3,2,0,1
2/19/2018 12:25,52,71.1,69,66.5,121,68.5,2,0,1
2/19/2018 12:30,55,70,73,65.4,128,67.4,2,0,1
2/19/2018 12:35,55,70.1,72,65.4,127,67.4,2,0,1
2/19/2018 12:40,62,69.8,80,65.1,142,67.2,2,0,1
2/19/2018 12:45,54,70.5,72,65.9,126,67.9,2,0,1
2/19/2018 12:50,53,71.2,70,66.6,123,68.6,2,0,1
2/19/2018 12:55,56,71.5,74,67,130,68.9,2,0,1
2/19/2018 13:00,53,70,71,65.4,124,67.4,2,0,1
2/19/2018 13:05,47,70,64,65.4,111,67.4,2,0,1
2/19/2018 13:10,47,68.4,66,63.6,113,65.6,2,0,1
2/19/2018 13:15,50,70,68,65.4,118,67.3,2,0,1
2/19/2018 13:20,55,70.4,73,65.8,128,67.8,2,0,1
2/19/2018 13:25,58,70.5,76,66,134,67.9,2,0,1
2/19/2018 13:30,56,70.6,74,66,130,68,2,0,1
2/19/2018 13:35,58,71,77,66.5,135,68.4,2,0,1
2/19/2018 13:40,51,70.6,69,66.1,120,68,2,0,1
2/19/2018 13:45,44,70.9,60,66.3,104,68.2,2,0,1
2/19/2018 13:50,48,69.4,66,64.8,114,66.7,2,0,1
2/19/2018 13:55,47,69.6,65,65,112,67,2,0,1
2/19/2018 14:00,49,69.7,65,65.1,114,67.1,2,0,1
2/19/2018 14:05,60,70,79,65.5,139,67.5,2,0,1
2/19/2018 14:10,51,69.1,68,64.5,119,66.5,2,0,1
2/19/2018 14:15,54,68.5,73,63.9,127,65.8,2,0,1
2/19/2018 14:20,50,68.9,67,64.3,117,66.3,2,0,1
2/19/2018 14:25,55,69,73,64.4,128,66.4,2,0,1
2/19/2018 14:30,53,69.2,71,64.5,124,66.5,2,0,1
2/19/2018 14:35,52,69.5,69,64.9,121,66.9,2,0,1
2/19/2018 14:40,48,69.8,65,65.1,113,67.1,2,0,1
2/19/2018 14:45,54,69.8,71,65.1,125,67.1,2,0,1
2/19/2018 14:50,60,70.4,77,65.9,137,67.9,2,0,1
2/19/2018 14:55,45,70.7,62,66.2,107,68.1,2,0,1
2/19/2018 15:00,52,70.2,70,65.6,122,67.5,2,0,1
2/19/2018 15:05,51,69.6,69,64.9,120,66.9,2,0,1
2/19/2018 15:10,63,68.4,81,63.6,144,65.7,2,0,1
2/19/2018 15:15,60,69.4,78,64.7,138,66.7,2,0,1
2/19/2018 15:20,63,69.1,80,64.4,143,66.5,2,0,1
2/19/2018 15:25,62,69.2,80,64.5,142,66.5,2,0,1
2/19/2018 15:30,64,69.5,83,64.8,147,66.8,2,0,1
2/19/2018 15:35,55,68.8,74,64.1,129,66.2,2,0,1
2/19/2018 15:40,59,68.8,77,64.1,136,66.2,2,0,1
2/19/2018 15:45,61,68.6,80,63.9,141,65.9,2,0,1
2/19/2018 15:50,65,67.7,83,62.8,148,64.9,2,0,1
2/19/2018 15:55,55,67.4,74,62.5,129,64.6,2,0,1
2/19/2018 16:00,58,69.2,77,64.5,135,66.5,2,0,1
2/19/2018 16:05,64,69.7,82,65.1,146,67.1,2,0,1
2/19/2018 16:10,58,69.1,75,64.5,133,66.5,2,0,1
2/19/2018 16:15,51,69,69,64.4,120,66.4,2,0,1
2/19/2018 16:20,58,68.9,75,64.2,133,66.3,2,0,1
2/19/2018 16:25,56,68.9,75,64.3,131,66.3,2,0,1
2/19/2018 16:30,52,68.5,69,63.8,121,65.8,2,0,1
2/19/2018 16:35,56,67.7,73,63,129,65,2,0,1
2/19/2018 16:40,61,67.7,81,62.9,142,64.9,2,0,1
2/19/2018 16:45,52,68.3,69,63.5,121,65.5,2,0,1
2/19/2018 16:50,41,69.5,58,64.9,99,66.8,2,0,1
2/19/2018 16:55,57,68.3,76,63.6,133,65.6,2,0,1
2/19/2018 17:00,48,69.4,65,64.8,113,66.8,2,0,1
2/19/2018 17:05,44,70.5,61,66,105,67.9,2,0,1
2/19/2018 17:10,48,70.7,65,66.3,113,68.2,2,0,1
2/19/2018 17:15,53,70.1,71,65.6,124,67.5,2,0,1
2/19/2018 17:20,58,68.6,77,63.9,135,65.9,2,0,1
2/19/2018 17:25,44,69.2,60,64.6,104,66.5,2,0,1
2/19/2018 17:30,52,68.1,69,63.4,121,65.4,2,0,1
2/19/2018 17:35,52,68.5,71,63.9,123,65.8,2,0,1
2/19/2018 17:40,56,68.9,73,64.3,129,66.3,2,0,1
2/19/2018 17:45,39,69.5,55,64.9,94,66.8,2,0,1
2/19/2018 17:50,45,70,63,65.3,108,67.3,2,0,1
2/19/2018 17:55,53,69.4,71,64.7,124,66.7,2,0,1
2/19/2018 18:00,46,70.1,64,65.6,110,67.5,2,0,1
2/19/2018 18:05,53,69.5,71,64.9,124,66.8,2,0,1
2/19/2018 18:10,44,69.8,62,65.2,106,67.1,2,0,1
2/19/2018 18:15,48,69.2,66,64.5,114,66.5,2,0,1
2/19/2018 18:20,48,68.5,66,63.8,114,65.8,2,0,1
2/19/2018 18:25,42,68.8,58,64.2,100,66.1,2,0,1
2/19/2018 18:30,38,68.5,56,63.7,94,65.6,2,0,1
2/19/2018 18:35,50,69,67,64.3,117,66.3,2,0,1
2/19/2018 18:40,44,67.7,62,63,106,64.9,2,0,1
2/19/2018 18:45,46,68.7,64,64.1,110,66,2,0,1
2/19/2018 18:50,41,68.8,58,64.2,99,66.1,2,0,1
2/19/2018 18:55,49,67.6,66,62.9,115,64.9,2,0,1
2/19/2018 19:00,46,68.2,63,63.5,109,65.5,2,0,1
2/19/2018 19:05,41,68.5,57,63.9,98,65.8,2,0,1
2/19/2018 19:10,42,69.3,59,64.7,101,66.6,2,0,1
2/19/2018 19:15,46,69,64,64.4,110,66.4,2,0,1
2/19/2018 19:20,49,69.4,66,64.9,115,66.8,2,0,1
2/19/2018 19:25,45,70.7,61,66.3,106,68.2,2,0,1
2/19/2018 19:30,38,70.3,55,65.9,93,67.7,2,0,1
2/19/2018 19:35,37,70.2,54,65.6,91,67.5,2,0,1
2/19/2018 19:40,38,69,56,64.4,94,66.3,2,0,1
2/19/2018 19:45,38,69.1,55,64.5,93,66.4,2,0,1
2/19/2018 19:50,27,69.9,43,65.4,70,67.1,2,0,1
2/19/2018 19:55,31,69.7,48,65.1,79,66.9,2,0,1
2/19/2018 20:00,38,69.7,55,65.2,93,67,2,0,1
2/19/2018 20:05,41,68.2,57,63.5,98,65.5,2,0,1
2/19/2018 20:10,34,68.8,51,64.2,85,66,2,0,1
2/19/2018 20:15,34,68.7,51,64,85,65.9,2,0,1
2/19/2018 20:20,35,68.9,52,64.3,87,66.1,2,0,1
2/19/2018 20:25,33,69.2,49,64.6,82,66.5,2,0,1
2/19/2018 20:30,29,69.5,45,64.9,74,66.7,2,0,1
2/19/2018 20:35,34,69.7,51,65.1,85,66.9,2,0,1
2/19/2018 20:40,32,69.9,48,65.3,80,67.1,2,0,1
2/19/2018 20:45,34,69.3,50,64.7,84,66.6,2,0,1
2/19/2018 20:50,38,69.5,54,64.9,92,66.8,2,0,1
2/19/2018 20:55,26,69.6,42,65,68,66.8,2,0,1
2/19/2018 21:00,35,69.4,51,64.8,86,66.6,2,0,1
2/19/2018 21:05,26,69,42,64.4,68,66.1,2,0,1
2/19/2018 21:10,32,69.1,47,64.5,79,66.4,2,0,1
2/19/2018 21:15,31,69.2,48,64.6,79,66.4,2,0,1
2/19/2018 21:20,31,69.5,47,64.9,78,66.7,2,0,1
2/19/2018 21:25,27,69.6,42,65,69,66.8,2,0,1
2/19/2018 21:30,27,69.4,43,64.8,70,66.6,2,0,1
2/19/2018 21:35,30,69.4,46,64.8,76,66.6,2,0,1
2/19/2018 21:40,24,69.4,40,64.8,64,66.5,2,0,1
2/19/2018 21:45,31,69,48,64.3,79,66.2,2,0,1
2/19/2018 21:50,26,69.4,42,64.8,68,66.6,2,0,1
2/19/2018 21:55,23,69.5,39,65,62,66.7,2,0,1
2/19/2018 22:00,22,69.6,38,65,60,66.7,2,0,1
2/19/2018 22:05,27,69.7,42,65.1,69,66.9,2,0,1
2/19/2018 22:10,24,69.5,39,64.9,63,66.6,2,0,1
2/19/2018 22:15,23,69.4,39,64.8,62,66.5,2,0,1
2/19/2018 22:20,21,69.4,36,64.7,57,66.4,2,0,1
2/19/2018 22:25,19,69.3,34,64.7,53,66.4,2,0,1
2/19/2018 22:30,20,69.6,35,65,55,66.7,2,0,1
2/19/2018 22:35,17,69.4,33,64.8,50,66.3,2,0,1
2/19/2018 22:40,20,69.1,36,64.5,56,66.2,2,0,1
2/19/2018 22:45,17,69.3,33,64.7,50,66.2,2,0,1
2/19/2018 22:50,24,69.6,40,65,64,66.7,2,0,1
2/19/2018 22:55,23,69.2,39,64.5,62,66.3,2,0,1
2/19/2018 23:00,19,69.3,35,64.7,54,66.4,2,0,1
2/19/2018 23:05,15,69.4,30,64.8,45,66.3,2,0,1
2/19/2018 23:10,13,69.3,29,64.7,42,66.1,2,0,1
2/19/2018 23:15,13,69.3,28,64.7,41,66.2,2,0,1
2/19/2018 23:20,11,69.3,27,64.7,38,66,2,0,1
2/19/2018 23:25,12,69.4,27,64.8,39,66.2,2,0,1
2/19/2018 23:30,17,69.1,33,64.5,50,66.1,2,0,1
2/19/2018 23:35,16,69.3,31,64.7,47,66.3,2,0,1
2/19/2018 23:40,11,69.4,26,64.8,37,66.1,2,0,1
2/19/2018 23:45,13,69.4,28,64.8,41,66.3,2,0,1
2/19/2018 23:50,13,69.4,29,64.8,42,66.2,2,0,1
2/19/2018 23:55,13,69.4,29,64.8,42,66.2,2,0,1
2/20/2018 0:00,11,69.3,26,64.7,37,66.1,2,0,0
2/20/2018 0:05,12,69.5,27,64.9,39,66.3,2,0,0
2/20/2018 0:10,12,69.1,27,64.5,39,65.9,2,0,0
2/20/2018 0:15,11,68.9,27,64.2,38,65.6,2,0,0
2/20/2018 0:20,9,69.2,24,64.5,33,65.8,2,0,0
2/20/2018 0:25,10,69.3,25,64.7,35,66,2,0,0
2/20/2018 0:30,8,69.3,24,64.7,32,65.9,2,0,0
2/20/2018 0:35,10,69.2,25,64.6,35,65.9,2,0,0
2/20/2018 0:40,7,69.2,22,64.6,29,65.7,2,0,0
2/20/2018 0:45,7,69.3,23,64.7,30,65.7,2,0,0
2/20/2018 0:50,9,69.4,24,64.8,33,66.1,2,0,0
2/20/2018 0:55,10,69.4,25,64.8,35,66.1,2,0,0
2/20/2018 1:00,10,69.5,25,64.9,35,66.2,2,0,0
2/20/2018 1:05,6,69.4,21,64.8,27,65.8,2,0,0
2/20/2018 1:10,6,69.3,21,64.7,27,65.7,2,0,0
2/20/2018 1:15,8,69.4,23,64.8,31,66,2,0,0
2/20/2018 1:20,7,69.4,22,64.8,29,66,2,0,0
2/20/2018 1:25,6,69.4,21,64.8,27,65.8,2,0,0
2/20/2018 1:30,5,70.5,21,66.1,26,66.9,2,0,0
2/20/2018 1:35,6,69.9,22,65.4,28,66.4,2,0,0
2/20/2018 1:40,7,69.7,22,65.2,29,66.3,2,0,0
2/20/2018 1:45,5,69.5,20,65,25,65.9,2,0,0
2/20/2018 1:50,6,69.5,21,64.9,27,65.9,2,0,0
2/20/2018 1:55,10,69.5,20,64.9,30,66.4,2,0,0
2/20/2018 2:00,15,69.5,22,64.9,37,66.7,2,0,0
2/20/2018 2:05,5,69.5,21,64.9,26,65.8,2,0,0
2/20/2018 2:10,7,69.4,22,64.8,29,65.9,2,0,0
2/20/2018 2:15,7,69.4,22,64.8,29,65.9,2,0,0
2/20/2018 2:20,6,69.4,21,64.8,27,65.9,2,0,0
2/20/2018 2:25,8,68.9,23,64.3,31,65.5,2,0,0
2/20/2018 2:30,8,69.2,23,64.5,31,65.7,2,0,0
2/20/2018 2:35,10,69.2,25,64.6,35,65.9,2,0,0
2/20/2018 2:40,7,69.2,23,64.5,30,65.6,2,0,0
2/20/2018 2:45,10,69.3,25,64.7,35,66,2,0,0
2/20/2018 2:50,10,69.1,25,64.5,35,65.8,2,0,0
2/20/2018 2:55,9,68.8,25,64.2,34,65.4,2,0,0
2/20/2018 3:00,10,69.1,25,64.5,35,65.8,2,0,0
2/20/2018 3:05,14,68.9,30,64.3,44,65.8,2,0,0
2/20/2018 3:10,8,69.1,24,64.4,32,65.6,2,0,0
2/20/2018 3:15,8,69.1,23,64.5,31,65.7,2,0,0
2/20/2018 3:20,9,69.2,24,64.6,33,65.8,2,0,0
2/20/2018 3:25,9,69.2,25,64.6,34,65.8,2,0,0
2/20/2018 3:30,10,69.3,26,64.7,36,66,2,0,0
2/20/2018 3:35,9,69.2,25,64.5,34,65.8,2,0,0
2/20/2018 3:40,14,69.2,30,64.5,44,66,2,0,0
2/20/2018 3:45,16,68.9,32,64.3,48,65.8,2,0,0
2/20/2018 3:50,14,69.1,30,64.5,44,66,2,0,0
2/20/2018 3:55,13,69.2,28,64.6,41,66.1,2,0,0
2/20/2018 4:00,16,69.3,31,64.7,47,66.3,2,0,0
2/20/2018 4:05,21,69.6,37,65,58,66.6,2,0,0
2/20/2018 4:10,26,69,42,64.4,68,66.1,2,0,0
2/20/2018 4:15,22,69.2,38,64.6,60,66.3,2,0,0
2/20/2018 4:20,25,69.7,41,65.1,66,66.8,2,0,0
2/20/2018 4:25,36,69.1,53,64.4,89,66.3,2,0,0
2/20/2018 4:30,29,68.7,46,64.1,75,65.9,2,0,0
2/20/2018 4:35,35,68.3,52,63.6,87,65.5,2,0,0
2/20/2018 4:40,38,68.9,56,64.3,94,66.2,2,0,0
2/20/2018 4:45,43,70.1,61,65.6,104,67.5,2,0,0
2/20/2018 4:50,50,69.9,69,65.4,119,67.3,2,0,0
2/20/2018 4:55,40,70.3,58,65.8,98,67.7,2,0,0
2/20/2018 5:00,37,70.3,56,65.7,93,67.5,2,0,0
2/20/2018 5:05,39,69.4,58,64.8,97,66.6,2,0,0
2/20/2018 5:10,47,68.2,66,63.5,113,65.5,2,0,0
2/20/2018 5:15,54,69,74,64.4,128,66.4,2,0,0
2/20/2018 5:20,55,68.4,75,63.7,130,65.7,2,0,0
2/20/2018 5:25,64,68,86,63.3,150,65.3,2,0,0
2/20/2018 5:30,57,68.4,79,63.7,136,65.7,2,0,0
2/20/2018 5:35,61,68.6,82,63.9,143,65.9,2,0,0
2/20/2018 5:40,60,68.1,82,63.3,142,65.3,2,0,0
2/20/2018 5:45,67,69.4,89,64.8,156,66.8,2,0,0
2/20/2018 5:50,55,69.3,76,64.7,131,66.6,2,0,0
2/20/2018 5:55,70,69.1,91,64.3,161,66.4,2,0,0
2/20/2018 6:00,61,69.3,81,64.5,142,66.6,2,0,0
2/20/2018 6:05,54,69.2,73,64.4,127,66.4,2,0,0
2/20/2018 6:10,64,68.6,85,63.8,149,65.8,2,0,0
2/20/2018 6:15,59,68.4,80,63.6,139,65.6,2,0,0
2/20/2018 6:20,67,68.4,89,63.6,156,65.7,2,0,0
2/20/2018 6:25,68,68.5,91,63.7,159,65.7,2,0,0
2/20/2018 6:30,70,67.2,93,62.3,163,64.4,2,0,0
2/20/2018 6:35,77,67.6,99,62.7,176,64.8,2,0,0
2/20/2018 6:40,77,68.4,99,63.5,176,65.7,2,0,0
2/20/2018 6:45,84,68.8,108,64.1,192,66.1,2,0,0
2/20/2018 6:50,70,69.2,91,64.4,161,66.5,2,0,0
2/20/2018 6:55,76,69.1,98,64.4,174,66.4,2,0,0
2/20/2018 7:00,81,68.7,104,64,185,66,2,0,0
2/20/2018 7:05,84,69.2,106,64.5,190,66.5,2,0,0
2/20/2018 7:10,85,67.6,108,62.8,193,64.9,2,0,0
2/20/2018 7:15,87,67.5,110,62.6,197,64.8,2,0,0
2/20/2018 7:20,80,67.7,102,62.9,182,65,2,0,0
2/20/2018 7:25,71,67.8,93,62.9,164,65,2,0,0
2/20/2018 7:30,80,66.4,103,61.5,183,63.6,2,0,0
2/20/2018 7:35,87,65.9,111,60.9,198,63.1,2,0,0
2/20/2018 7:40,96,66.4,121,61.5,217,63.7,2,0,0
2/20/2018 7:45,94,66.1,118,61.2,212,63.4,2,0,0
2/20/2018 7:50,85,65.5,109,60.5,194,62.7,2,0,0
2/20/2018 7:55,79,66.8,102,61.9,181,64.1,2,0,0
2/20/2018 8:00,90,66.9,113,61.9,203,64.1,2,0,0
2/20/2018 8:05,86,66.5,109,61.6,195,63.8,2,0,0
2/20/2018 8:10,84,65.3,108,60.2,192,62.5,2,0,0
2/20/2018 8:15,84,64,107,58.7,191,61,2,0,0
2/20/2018 8:20,81,62.5,104,57.2,185,59.5,2,0,0
2/20/2018 8:25,73,63.5,96,58.2,169,60.5,2,0,0
2/20/2018 8:30,71,64.3,93,59.1,164,61.3,2,0,0
2/20/2018 8:35,75,64.7,98,59.5,173,61.7,2,0,0
2/20/2018 8:40,69,66.6,91,61.6,160,63.7,2,0,0
2/20/2018 8:45,74,65.3,97,60.2,171,62.4,2,0,0
2/20/2018 8:50,77,66.1,98,61.1,175,63.3,2,0,0
2/20/2018 8:55,78,66.6,99,61.7,177,63.9,2,0,0
2/20/2018 9:00,84,65.8,106,60.8,190,63,2,0,0
2/20/2018 9:05,81,66.2,103,61.3,184,63.5,2,0,0
2/20/2018 9:10,83,66.4,105,61.4,188,63.6,2,0,0
2/20/2018 9:15,70,67.4,90,62.6,160,64.7,2,0,0
2/20/2018 9:20,84,67,108,62.2,192,64.3,2,0,0
2/20/2018 9:25,82,66.2,106,61.3,188,63.4,2,0,0
2/20/2018 9:30,78,66.1,99,61.2,177,63.3,2,0,0
2/20/2018 9:35,73,65.9,95,60.9,168,63.1,2,0,0
2/20/2018 9:40,77,65.7,98,60.7,175,62.9,2,0,0
2/20/2018 9:45,80,66.2,101,61.3,181,63.4,2,0,0
2/20/2018 9:50,77,66.1,98,61.2,175,63.3,2,0,0
2/20/2018 9:55,71,66.9,91,62,162,64.1,2,0,0
2/20/2018 10:00,78,68.5,99,63.7,177,65.8,2,0,0
2/20/2018 10:05,67,67.7,87,63,154,65,2,0,0
2/20/2018 10:10,66,66.9,85,62.1,151,64.2,2,0,0
2/20/2018 10:15,65,68.1,83,63.5,148,65.5,2,0,0
2/20/2018 10:20,71,68.5,89,63.8,160,65.9,2,0,0
2/20/2018 10:25,53,68.3,70,63.7,123,65.7,2,0,0
2/20/2018 10:30,65,67.2,85,62.5,150,64.6,2,0,0
2/20/2018 10:35,59,67,77,62.2,136,64.2,2,0,0
2/20/2018 10:40,62,66.2,82,61.4,144,63.5,2,0,0
2/20/2018 10:45,68,67.8,87,63.1,155,65.1,2,0,0
2/20/2018 10:50,59,69,77,64.4,136,66.4,2,0,0
2/20/2018 10:55,61,68.1,80,63.4,141,65.4,2,0,0
2/20/2018 11:00,49,67.1,67,62.3,116,64.3,2,0,0
2/20/2018 11:05,49,67.8,67,63.1,116,65.1,2,0,0
2/20/2018 11:10,59,68,77,63.3,136,65.3,2,0,0
2/20/2018 11:15,52,68.1,69,63.4,121,65.5,2,0,0
2/20/2018 11:20,51,68.5,69,63.8,120,65.8,2,0,0
2/20/2018 11:25,55,68.1,73,63.3,128,65.3,2,0,0
2/20/2018 11:30,51,67.3,68,62.5,119,64.6,2,0,0
2/20/2018 11:35,54,66.8,72,62,126,64.1,2,0,0
2/20/2018 11:40,55,66.1,72,61.2,127,63.3,2,0,0
2/20/2018 11:45,38,67.3,55,62.5,93,64.5,2,0,0
2/20/2018 11:50,49,66.2,67,61.3,116,63.3,2,0,0
2/20/2018 11:55,40,67.4,57,62.7,97,64.6,2,0,0
2/20/2018 12:00,40,67.5,56,62.8,96,64.8,2,0,0
2/20/2018 12:05,36,67.5,52,62.8,88,64.7,2,0,0
2/20/2018 12:10,38,67.4,55,62.6,93,64.5,2,0,0
2/20/2018 12:15,44,67.6,62,62.9,106,64.8,2,0,0
2/20/2018 12:20,47,69,64,64.4,111,66.3,2,0,0
2/20/2018 12:25,49,67.2,67,62.4,116,64.4,2,0,0
2/20/2018 12:30,48,67.1,67,62.2,115,64.3,2,0,0
2/20/2018 12:35,51,68.9,68,64.2,119,66.2,2,0,0
2/20/2018 12:40,46,68.3,64,63.6,110,65.6,2,0,0
2/20/2018 12:45,52,68.7,69,63.9,121,66,2,0,0
2/20/2018 12:50,47,66.9,65,62.1,112,64.1,2,0,0
2/20/2018 12:55,53,69,71,64.3,124,66.3,2,0,0
2/20/2018 13:00,48,67.8,66,63,114,65,2,0,0
2/20/2018 13:05,50,68.2,67,63.4,117,65.5,2,0,0
2/20/2018 13:10,53,68.5,72,63.8,125,65.8,2,0,0
2/20/2018 13:15,44,69,61,64.3,105,66.3,2,0,0
2/20/2018 13:20,61,68.3,79,63.6,140,65.6,2,0,0
2/20/2018 13:25,53,67.9,71,63.2,124,65.2,2,0,0
2/20/2018 13:30,45,68.6,62,63.8,107,65.8,2,0,0
2/20/2018 13:35,45,68.5,61,63.8,106,65.7,2,0,0
2/20/2018 13:40,52,67.9,70,63.2,122,65.2,2,0,0
2/20/2018 13:45,39,68.6,55,63.9,94,65.9,2,0,0
2/20/2018 13:50,51,69.3,69,64.6,120,66.6,2,0,0
2/20/2018 13:55,45,69.1,62,64.5,107,66.4,2,0,0
2/20/2018 14:00,46,68.8,63,64.1,109,66.1,2,0,0
2/20/2018 14:05,50,68.5,67,63.9,117,65.8,2,0,0
2/20/2018 14:10,44,69.8,61,65.3,105,67.2,2,0,0
2/20/2018 14:15,45,68.4,62,63.7,107,65.7,2,0,0
2/20/2018 14:20,55,68.8,73,64.2,128,66.2,2,0,0
2/20/2018 14:25,57,68.6,75,63.9,132,65.9,2,0,0
2/20/2018 14:30,54,68.1,72,63.3,126,65.3,2,0,0
2/20/2018 14:35,55,68.6,73,63.9,128,65.9,2,0,0
2/20/2018 14:40,56,68.7,75,64.1,131,66.1,2,0,0
2/20/2018 14:45,52,69,69,64.4,121,66.3,2,0,0
2/20/2018 14:50,39,69.1,55,64.5,94,66.4,2,0,0
2/20/2018 14:55,51,69.2,68,64.6,119,66.5,2,0,0
2/20/2018 15:00,44,69.2,61,64.6,105,66.6,2,0,0
2/20/2018 15:05,44,70.1,61,65.6,105,67.5,2,0,0
2/20/2018 15:10,52,69.2,69,64.5,121,66.5,2,0,0
2/20/2018 15:15,48,68.3,65,63.6,113,65.6,2,0,0
2/20/2018 15:20,54,69,72,64.3,126,66.3,2,0,0
2/20/2018 15:25,57,69.6,75,65,132,67,2,0,0
2/20/2018 15:30,59,68.9,79,64.2,138,66.2,2,0,0
2/20/2018 15:35,60,68.8,78,64.1,138,66.1,2,0,0
2/20/2018 15:40,57,68.5,76,63.9,133,65.9,2,0,0
2/20/2018 15:45,56,68.9,74,64.2,130,66.3,2,0,0
2/20/2018 15:50,68,68.6,87,63.8,155,65.9,2,0,0
2/20/2018 15:55,65,68.9,82,64.2,147,66.3,2,0,0
2/20/2018 16:00,54,68.8,73,64.1,127,66.1,2,0,0
2/20/2018 16:05,64,69.2,83,64.6,147,66.6,2,0,0
2/20/2018 16:10,59,70.2,76,65.6,135,67.6,2,0,0
2/20/2018 16:15,57,69.1,77,64.4,134,66.4,2,0,0
2/20/2018 16:20,53,68.8,71,64,124,66.1,2,0,0
2/20/2018 16:25,51,69.3,69,64.6,120,66.6,2,0,0
2/20/2018 16:30,48,69.6,65,64.9,113,66.9,2,0,0
2/20/2018 16:35,53,69.3,70,64.6,123,66.6,2,0,0
2/20/2018 16:40,58,69.3,76,64.6,134,66.6,2,0,0
2/20/2018 16:45,58,69.6,75,64.9,133,66.9,2,0,0
2/20/2018 16:50,64,68.4,82,63.6,146,65.7,2,0,0
2/20/2018 16:55,54,69.6,72,64.9,126,66.9,2,0,0
2/20/2018 17:00,50,69.4,68,64.8,118,66.8,2,0,0
2/20/2018 17:05,50,69.1,68,64.5,118,66.4,2,0,0
2/20/2018 17:10,55,69.3,74,64.7,129,66.7,2,0,0
2/20/2018 17:15,52,69.3,71,64.7,123,66.6,2,0,0
2/20/2018 17:20,58,68.9,77,64.2,135,66.2,2,0,0
2/20/2018 17:25,51,68.5,69,63.9,120,65.9,2,0,0
2/20/2018 17:30,51,68.5,69,63.8,120,65.8,2,0,0
2/20/2018 17:35,53,68.5,70,63.7,123,65.7,2,0,0
2/20/2018 17:40,55,68.1,74,63.3,129,65.3,2,0,0
2/20/2018 17:45,55,68.9,73,64.2,128,66.2,2,0,0
2/20/2018 17:50,47,68.7,66,63.9,113,65.9,2,0,0
2/20/2018 17:55,54,68.3,71,63.6,125,65.6,2,0,0
2/20/2018 18:00,45,68.5,61,63.8,106,65.8,2,0,0
2/20/2018 18:05,46,68.3,63,63.6,109,65.6,2,0,0
2/20/2018 18:10,44,68.8,61,64.1,105,66.1,2,0,0
2/20/2018 18:15,55,68.3,73,63.6,128,65.6,2,0,0
2/20/2018 18:20,53,67.8,70,63,123,65,2,0,0
2/20/2018 18:25,49,67.5,66,62.7,115,64.7,2,0,0
2/20/2018 18:30,50,68.7,68,64,118,66,2,0,0
2/20/2018 18:35,45,68.2,62,63.5,107,65.5,2,0,0
2/20/2018 18:40,44,68.5,61,63.7,105,65.7,2,0,0
2/20/2018 18:45,47,68,64,63.3,111,65.3,2,0,0
2/20/2018 18:50,43,67.2,60,62.5,103,64.5,2,0,0
2/20/2018 18:55,41,68.5,58,63.8,99,65.7,2,0,0
2/20/2018 19:00,46,68.1,62,63.3,108,65.3,2,0,0
2/20/2018 19:05,46,68.3,64,63.6,110,65.6,2,0,0
2/20/2018 19:10,43,69.1,61,64.4,104,66.4,2,0,0
2/20/2018 19:15,41,69.1,59,64.5,100,66.4,2,0,0
2/20/2018 19:20,37,69.1,54,64.4,91,66.3,2,0,0
2/20/2018 19:25,40,68.2,58,63.4,98,65.4,2,0,0
2/20/2018 19:30,37,68.1,54,63.4,91,65.3,2,0,0
2/20/2018 19:35,40,69.7,57,65.2,97,67,2,0,0
2/20/2018 19:40,28,68.8,45,64.2,73,66,2,0,0
2/20/2018 19:45,32,68.3,48,63.7,80,65.5,2,0,0
2/20/2018 19:50,31,68.8,48,64.2,79,66,2,0,0
2/20/2018 19:55,28,69.1,44,64.5,72,66.3,2,0,0
2/20/2018 20:00,32,68.9,49,64.2,81,66.1,2,0,0
2/20/2018 20:05,26,69.4,42,64.8,68,66.5,2,0,0
2/20/2018 20:10,33,69.4,49,64.7,82,66.6,2,0,0
2/20/2018 20:15,35,68.5,52,63.9,87,65.7,2,0,0
2/20/2018 20:20,29,68.3,46,63.6,75,65.4,2,0,0
2/20/2018 20:25,31,68.9,48,64.3,79,66.1,2,0,0
2/20/2018 20:30,26,69.1,42,64.4,68,66.2,2,0,0
2/20/2018 20:35,30,68.9,46,64.1,76,66,2,0,0
2/20/2018 20:40,24,69.2,40,64.6,64,66.3,2,0,0
2/20/2018 20:45,24,68.6,40,63.9,64,65.7,2,0,0
2/20/2018 20:50,31,69.2,47,64.6,78,66.4,2,0,0
2/20/2018 20:55,23,69.6,39,65,62,66.7,2,0,0
2/20/2018 21:00,24,69.3,40,64.7,64,66.4,2,0,0
2/20/2018 21:05,22,69.3,38,64.7,60,66.4,2,0,0
2/20/2018 21:10,27,69.3,43,64.7,70,66.4,2,0,0
2/20/2018 21:15,28,68.5,44,63.9,72,65.7,2,0,0
2/20/2018 21:20,30,67.7,46,63,76,64.9,2,0,0
2/20/2018 21:25,24,68.8,39,64.1,63,65.9,2,0,0
2/20/2018 21:30,23,69.2,39,64.6,62,66.3,2,0,0
2/20/2018 21:35,24,69.6,40,65,64,66.7,2,0,0
2/20/2018 21:40,25,69.4,41,64.8,66,66.6,2,0,0
2/20/2018 21:45,27,69.7,42,65.2,69,66.9,2,0,0
2/20/2018 21:50,28,69.7,45,65.1,73,66.8,2,0,0
2/20/2018 21:55,21,68.9,37,64.3,58,65.9,2,0,0
2/20/2018 22:00,21,69.1,37,64.5,58,66.1,2,0,0
2/20/2018 22:05,20,69.3,36,64.7,56,66.4,2,0,0
2/20/2018 22:10,23,69.2,38,64.6,61,66.3,2,0,0
2/20/2018 22:15,24,69.4,40,64.8,64,66.5,2,0,0
2/20/2018 22:20,26,69.6,42,65,68,66.7,2,0,0
2/20/2018 22:25,18,69.6,34,65,52,66.6,2,0,0
2/20/2018 22:30,14,69.4,30,64.8,44,66.3,2,0,0
2/20/2018 22:35,14,69.4,30,64.8,44,66.3,2,0,0
2/20/2018 22:40,19,69.1,34,64.5,53,66.1,2,0,0
2/20/2018 22:45,12,69.3,28,64.7,40,66.1,2,0,0
2/20/2018 22:50,17,69.2,33,64.6,50,66.1,2,0,0
2/20/2018 22:55,15,69.3,31,64.7,46,66.2,2,0,0
2/20/2018 23:00,11,69.4,26,64.8,37,66.1,2,0,0
2/20/2018 23:05,14,69.3,30,64.7,44,66.2,2,0,0
2/20/2018 23:10,15,69.2,31,64.5,46,66.1,2,0,0
2/20/2018 23:15,14,68.9,30,64.2,44,65.7,2,0,0
2/20/2018 23:20,13,69.2,28,64.5,41,66,2,0,0
2/20/2018 23:25,14,69.4,30,64.8,44,66.2,2,0,0
2/20/2018 23:30,12,69.3,28,64.7,40,66.1,2,0,0
2/20/2018 23:35,11,69.2,27,64.6,38,66,2,0,0
2/20/2018 23:40,12,69.3,28,64.7,40,66,2,0,0
2/20/2018 23:45,12,69.3,28,64.7,40,66,2,0,0
2/20/2018 23:50,11,69.2,27,64.6,38,65.9,2,0,0
2/20/2018 23:55,10,69.2,25,64.5,35,65.9,2,0,0
2/21/2018 0:00,11,69.3,26,64.7,37,66.1,2,0,0
2/21/2018 0:05,13,69.2,29,64.5,42,66,2,0,0
2/21/2018 0:10,7,69.2,22,64.6,29,65.7,2,0,0
2/21/2018 0:15,10,69,26,64.4,36,65.7,2,0,0
2/21/2018 0:20,8,69.2,23,64.6,31,65.8,2,0,0
2/21/2018 0:25,9,68.9,24,64.3,33,65.5,2,0,0
2/21/2018 0:30,8,69.1,23,64.5,31,65.7,2,0,0
2/21/2018 0:35,9,69.2,25,64.6,34,65.8,2,0,0
2/21/2018 0:40,8,69.3,23,64.7,31,65.9,2,0,0
2/21/2018 0:45,8,69.3,23,64.7,31,65.8,2,0,0
2/21/2018 0:50,11,69.3,21,64.7,32,66.3,2,0,0
2/21/2018 0:55,5,69.3,20,64.7,25,65.7,2,0,0
2/21/2018 1:00,7,69.3,22,64.7,29,65.8,2,0,0
2/21/2018 1:05,8,69.3,23,64.7,31,65.8,2,0,0
2/21/2018 1:10,10,69.3,20,64.7,30,66.2,2,0,0
2/21/2018 1:15,6,69.1,22,64.5,28,65.5,2,0,0
2/21/2018 1:20,4,69.2,20,64.6,24,65.4,2,0,0
2/21/2018 1:25,5,69.3,21,64.7,26,65.6,2,0,0
2/21/2018 1:30,7,69.2,22,64.6,29,65.7,2,0,0
2/21/2018 1:35,9,69.3,24,64.7,33,66,2,0,0
2/21/2018 1:40,6,69.4,22,64.8,28,65.8,2,0,0
2/21/2018 1:45,6,69.4,21,64.8,27,65.8,2,0,0
2/21/2018 1:50,8,69.4,23,64.8,31,66,2,0,0
2/21/2018 1:55,14,69.5,22,64.9,36,66.7,2,0,0
2/21/2018 2:00,6,69.4,21,64.8,27,65.8,2,0,0
2/21/2018 2:05,12,69.4,21,64.8,33,66.5,2,0,0
2/21/2018 2:10,6,69.4,21,64.8,27,65.9,2,0,0
2/21/2018 2:15,7,69.4,23,64.8,30,65.8,2,0,0
2/21/2018 2:20,5,69.2,21,64.5,26,65.4,2,0,0
2/21/2018 2:25,7,69.4,23,64.8,30,65.8,2,0,0
2/21/2018 2:30,9,69.4,24,64.8,33,66.1,2,0,0
2/21/2018 2:35,7,69.4,22,64.7,29,65.9,2,0,0
2/21/2018 2:40,7,69.2,23,64.6,30,65.7,2,0,0
2/21/2018 2:45,8,69.3,23,64.7,31,65.9,2,0,0
2/21/2018 2:50,7,69.2,22,64.6,29,65.7,2,0,0
2/21/2018 2:55,7,69.3,22,64.7,29,65.8,2,0,0
2/21/2018 3:00,8,69.3,23,64.7,31,65.9,2,0,0
2/21/2018 3:05,11,69.2,27,64.6,38,65.9,2,0,0
2/21/2018 3:10,9,69.2,25,64.6,34,65.8,2,0,0
2/21/2018 3:15,8,69.2,24,64.5,32,65.7,2,0,0
2/21/2018 3:20,12,69.3,27,64.7,39,66.1,2,0,0
2/21/2018 3:25,10,69,26,64.4,36,65.7,2,0,0
2/21/2018 3:30,16,69.3,32,64.7,48,66.2,2,0,0
2/21/2018 3:35,14,69.4,30,64.8,44,66.2,2,0,0
2/21/2018 3:40,11,69.2,27,64.6,38,65.9,2,0,0
2/21/2018 3:45,16,69.3,32,64.7,48,66.2,2,0,0
2/21/2018 3:50,10,69.4,26,64.8,36,66,2,0,0
2/21/2018 3:55,16,69,32,64.3,48,65.9,2,0,0
2/21/2018 4:00,13,69.2,28,64.5,41,66,2,0,0
2/21/2018 4:05,21,69.4,37,64.7,58,66.4,2,0,0
2/21/2018 4:10,19,69.4,35,64.8,54,66.4,2,0,0
2/21/2018 4:15,19,69.1,36,64.5,55,66.1,2,0,0
2/21/2018 4:20,19,69.4,35,64.8,54,66.4,2,0,0
2/21/2018 4:25,27,69,44,64.4,71,66.2,2,0,0
2/21/2018 4:30,28,69,45,64.4,73,66.2,2,0,0
2/21/2018 4:35,32,69.2,49,64.6,81,66.4,2,0,0
2/21/2018 4:40,35,68.1,53,63.3,88,65.2,2,0,0
2/21/2018 4:45,43,69.1,61,64.4,104,66.4,2,0,0
2/21/2018 4:50,44,69.4,63,64.7,107,66.6,2,0,0
2/21/2018 4:55,44,68.9,62,64.3,106,66.2,2,0,0
2/21/2018 5:00,37,69.5,54,65,91,66.8,2,0,0
2/21/2018 5:05,38,70.3,57,65.8,95,67.6,2,0,0
2/21/2018 5:10,45,69.1,65,64.5,110,66.4,2,0,0
2/21/2018 5:15,56,69.3,76,64.8,132,66.7,2,0,0
2/21/2018 5:20,49,70,68,65.4,117,67.3,2,0,0
2/21/2018 5:25,46,69.4,65,64.8,111,66.7,2,0,0
2/21/2018 5:30,61,69.3,83,64.8,144,66.7,2,0,0
2/21/2018 5:35,78,69,101,64.3,179,66.3,2,0,0
2/21/2018 5:40,65,70.4,86,65.9,151,67.8,2,0,0
2/21/2018 5:45,61,71,81,66.5,142,68.5,2,0,0
2/21/2018 5:50,67,70.2,89,65.7,156,67.6,2,0,0
2/21/2018 5:55,63,68.7,83,64.1,146,66.1,2,0,0
2/21/2018 6:00,60,66.9,81,62,141,64.1,2,0,0
2/21/2018 6:05,60,67.2,81,62.3,141,64.4,2,0,0
2/21/2018 6:10,62,67.1,83,62.2,145,64.3,2,0,0
2/21/2018 6:15,68,67.6,89,62.8,157,64.9,2,0,0
2/21/2018 6:20,70,66.4,92,61.4,162,63.5,2,0,0
2/21/2018 6:25,69,66.8,91,61.8,160,64,2,0,0
2/21/2018 6:30,70,67.6,93,62.7,163,64.8,2,0,0
2/21/2018 6:35,70,67.5,92,62.6,162,64.7,2,0,0
2/21/2018 6:40,73,67.8,95,62.9,168,65.1,2,0,0
2/21/2018 6:45,77,68.6,99,63.8,176,65.9,2,0,0
2/21/2018 6:50,73,68.2,95,63.4,168,65.5,2,0,0
2/21/2018 6:55,73,68.9,95,64.1,168,66.2,2,0,0
2/21/2018 7:00,68,68.2,89,63.4,157,65.5,2,0,0
2/21/2018 7:05,66,68.3,88,63.6,154,65.6,2,0,0
2/21/2018 7:10,77,68.8,100,64,177,66.1,2,0,0
2/21/2018 7:15,76,68.2,98,63.4,174,65.5,2,0,0
2/21/2018 7:20,74,67.5,96,62.6,170,64.7,2,0,0
2/21/2018 7:25,80,67.4,103,62.5,183,64.6,2,0,0
2/21/2018 7:30,87,67.7,111,62.8,198,64.9,2,0,0
2/21/2018 7:35,93,68,117,63.2,210,65.3,2,0,0
2/21/2018 7:40,81,67.8,103,62.9,184,65,2,0,0
2/21/2018 7:45,91,67.2,114,62.3,205,64.5,2,0,0
2/21/2018 7:50,84,67.7,107,62.8,191,65,2,0,0
2/21/2018 7:55,75,67.5,97,62.5,172,64.7,2,0,0
2/21/2018 8:00,91,67.2,114,62.2,205,64.4,2,0,0
2/21/2018 8:05,83,65.6,106,60.6,189,62.8,2,0,0
2/21/2018 8:10,93,65.6,118,60.6,211,62.8,2,0,0
2/21/2018 8:15,81,65.8,104,60.8,185,63,2,0,0
2/21/2018 8:20,73,65.1,96,60.1,169,62.2,2,0,0
2/21/2018 8:25,83,65.3,104,60.2,187,62.5,2,0,0
2/21/2018 8:30,76,66.3,98,61.3,174,63.5,2,0,0
2/21/2018 8:35,77,66.7,98,61.7,175,63.9,2,0,0
2/21/2018 8:40,77,66.5,98,61.5,175,63.7,2,0,0
2/21/2018 8:45,89,66.4,112,61.4,201,63.6,2,0,0
2/21/2018 8:50,76,67.2,98,62.3,174,64.4,2,0,0
2/21/2018 8:55,80,67.5,101,62.6,181,64.8,2,0,0
2/21/2018 9:00,67,67.5,88,62.6,155,64.7,2,0,0
2/21/2018 9:05,66,65.4,87,60.4,153,62.6,2,0,0
2/21/2018 9:10,76,65.7,97,60.8,173,63,2,0,0
2/21/2018 9:15,82,65.9,104,60.9,186,63.1,2,0,0
2/21/2018 9:20,69,65.5,90,60.4,159,62.6,2,0,0
2/21/2018 9:25,72,65.9,93,60.9,165,63,2,0,0
2/21/2018 9:30,69,65.9,90,60.9,159,63.1,2,0,0
2/21/2018 9:35,72,66.9,91,62,163,64.2,2,0,0
2/21/2018 9:40,81,66.6,102,61.7,183,63.9,2,0,0
2/21/2018 9:45,70,66.7,91,61.9,161,64,2,0,0
2/21/2018 9:50,83,65.1,104,60.1,187,62.3,2,0,0
2/21/2018 9:55,76,64.1,95,59,171,61.3,2,0,0
2/21/2018 10:00,79,65.4,100,60.4,179,62.6,2,0,0
2/21/2018 10:05,66,67.3,85,62.5,151,64.6,2,0,0
2/21/2018 10:10,63,68.9,83,64.3,146,66.3,2,0,0
2/21/2018 10:15,64,68.5,82,63.9,146,65.9,2,0,0
2/21/2018 10:20,62,55.5,82,49.3,144,52,2,0,0
2/21/2018 10:25,60,43.2,79,35.7,139,39,2,0,0
2/21/2018 10:30,60,39.6,79,31.7,139,35.1,2,0,0
2/21/2018 10:35,54,52.1,72,45.6,126,48.4,2,0,0
2/21/2018 10:40,65,61.2,84,55.7,149,58.1,2,0,0
2/21/2018 10:45,52,64.6,70,59.6,122,61.7,2,0,0
2/21/2018 10:50,61,66,81,61.2,142,63.3,2,0,0
2/21/2018 10:55,47,67.3,65,62.6,112,64.6,2,0,0
2/21/2018 11:00,54,66.3,73,61.4,127,63.5,2,0,0
2/21/2018 11:05,45,67.1,63,62.3,108,64.3,2,0,0
2/21/2018 11:10,46,67.4,64,62.6,110,64.6,2,0,0
2/21/2018 11:15,49,67.8,66,63,115,65,2,0,0
2/21/2018 11:20,42,67.9,59,63.1,101,65.1,2,0,0
2/21/2018 11:25,37,67.5,54,62.8,91,64.7,2,0,0
2/21/2018 11:30,43,66.5,61,61.7,104,63.7,2,0,0
2/21/2018 11:35,43,65.8,61,61,104,63,2,0,0
2/21/2018 11:40,43,65.9,60,61.1,103,63.1,2,0,0
2/21/2018 11:45,52,67,70,62.2,122,64.2,2,0,0
2/21/2018 11:50,48,68.2,66,63.5,114,65.5,2,0,0
2/21/2018 11:55,52,68.8,69,64.3,121,66.2,2,0,0
2/21/2018 12:00,49,68.6,67,63.9,116,65.9,2,0,0
2/21/2018 12:05,40,68.7,57,64,97,65.9,2,0,0
2/21/2018 12:10,57,68,75,63.2,132,65.3,2,0,0
2/21/2018 12:15,48,68.7,66,64,114,65.9,2,0,0
2/21/2018 12:20,51,68,69,63.2,120,65.3,2,0,0
2/21/2018 12:25,54,69.1,71,64.4,125,66.4,2,0,0
2/21/2018 12:30,43,68.6,59,63.9,102,65.9,2,0,0
2/21/2018 12:35,43,68.8,60,64.1,103,66,2,0,0
2/21/2018 12:40,60,68.7,79,64.1,139,66.1,2,0,0
2/21/2018 12:45,60,67.5,79,62.7,139,64.8,2,0,0
2/21/2018 12:50,58,68.4,77,63.8,135,65.8,2,0,0
2/21/2018 12:55,50,68,68,63.3,118,65.3,2,0,0
2/21/2018 13:00,53,70.4,71,65.9,124,67.8,2,0,0
2/21/2018 13:05,49,70.5,67,66.1,116,68,2,0,0
2/21/2018 13:10,47,70.3,64,65.8,111,67.7,2,0,0
2/21/2018 13:15,47,70.4,64,65.8,111,67.7,2,0,0
2/21/2018 13:20,56,68.9,74,64.2,130,66.2,2,0,0
2/21/2018 13:25,48,69.6,66,64.9,114,66.8,2,0,0
2/21/2018 13:30,53,69.9,71,65.3,124,67.3,2,0,0
2/21/2018 13:35,54,69.4,73,64.7,127,66.7,2,0,0
2/21/2018 13:40,52,69.5,70,64.8,122,66.8,2,0,0
2/21/2018 13:45,56,69,74,64.2,130,66.3,2,0,0
2/21/2018 13:50,61,69.9,79,65.2,140,67.2,2,0,0
2/21/2018 13:55,55,70.4,73,65.8,128,67.8,2,0,0
2/21/2018 14:00,51,69.7,69,65.1,120,67.1,2,0,0
2/21/2018 14:05,48,70.1,66,65.5,114,67.5,2,0,0
2/21/2018 14:10,55,69.2,73,64.6,128,66.6,2,0,0
2/21/2018 14:15,51,68.3,69,63.5,120,65.6,2,0,0
2/21/2018 14:20,49,69.6,66,64.9,115,66.9,2,0,0
2/21/2018 14:25,56,69.3,73,64.6,129,66.6,2,0,0
2/21/2018 14:30,49,69.2,67,64.6,116,66.6,2,0,0
2/21/2018 14:35,47,69.2,63,64.6,110,66.6,2,0,0
2/21/2018 14:40,47,68.6,65,63.9,112,65.9,2,0,0
2/21/2018 14:45,46,68.8,63,64.1,109,66.1,2,0,0
2/21/2018 14:50,55,68.5,73,63.8,128,65.8,2,0,0
2/21/2018 14:55,45,68.6,61,63.9,106,65.9,2,0,0
2/21/2018 15:00,46,67.9,64,63.2,110,65.2,2,0,0
2/21/2018 15:05,54,68.8,72,64.2,126,66.2,2,0,0
2/21/2018 15:10,51,69.2,68,64.6,119,66.6,2,0,0
2/21/2018 15:15,52,68.1,71,63.4,123,65.4,2,0,0
2/21/2018 15:20,51,69.1,69,64.5,120,66.4,2,0,0
2/21/2018 15:25,55,69.6,74,65,129,67,2,0,0
2/21/2018 15:30,59,68.4,78,63.7,137,65.7,2,0,0
2/21/2018 15:35,53,70.3,71,65.8,124,67.7,2,0,0
2/21/2018 15:40,64,70.2,83,65.7,147,67.6,2,0,0
2/21/2018 15:45,59,70.2,78,65.7,137,67.7,2,0,0
2/21/2018 15:50,59,70,78,65.5,137,67.4,2,0,0
2/21/2018 15:55,51,71.2,69,66.7,120,68.6,2,0,0
2/21/2018 16:00,49,70.7,67,66.2,116,68.1,2,0,0
2/21/2018 16:05,48,70.3,65,65.8,113,67.7,2,0,0
2/21/2018 16:10,44,69,62,64.3,106,66.3,2,0,0
2/21/2018 16:15,62,69.6,81,65,143,67,2,0,0
2/21/2018 16:20,58,66.7,77,61.8,135,63.9,2,0,0
2/21/2018 16:25,52,66.9,70,62,122,64.1,2,0,0
2/21/2018 16:30,49,66.3,67,61.4,116,63.5,2,0,0
2/21/2018 16:35,53,68.3,71,63.6,124,65.6,2,0,0
2/21/2018 16:40,55,68.7,73,63.9,128,66,2,0,0
2/21/2018 16:45,60,68.3,78,63.5,138,65.6,2,0,0
2/21/2018 16:50,52,69.3,69,64.6,121,66.7,2,0,0
2/21/2018 16:55,47,68.2,65,63.4,112,65.4,2,0,0
2/21/2018 17:00,53,67.8,71,63,124,65.1,2,0,0
2/21/2018 17:05,52,68.4,70,63.6,122,65.6,2,0,0
2/21/2018 17:10,58,68.6,77,63.9,135,66,2,0,0
2/21/2018 17:15,56,67.1,74,62.3,130,64.4,2,0,0
2/21/2018 17:20,47,65.4,67,60.3,114,62.4,2,0,0
2/21/2018 17:25,43,61.1,62,55.5,105,57.8,2,0,0
2/21/2018 17:30,55,63,73,57.7,128,60,2,0,0
2/21/2018 17:35,46,64.2,64,58.9,110,61.1,2,0,0
2/21/2018 17:40,40,66,58,61,98,63.1,2,0,0
2/21/2018 17:45,46,67.8,64,63,110,65,2,0,0
2/21/2018 17:50,45,68.2,63,63.5,108,65.4,2,0,0
2/21/2018 17:55,41,68.2,59,63.5,100,65.5,2,0,0
2/21/2018 18:00,49,68.6,67,63.9,116,65.9,2,0,0
2/21/2018 18:05,41,69.2,58,64.5,99,66.4,2,0,0
2/21/2018 18:10,55,70.1,74,65.5,129,67.5,2,0,0
2/21/2018 18:15,57,69.4,75,64.8,132,66.8,2,0,0
2/21/2018 18:20,48,69.5,65,64.8,113,66.8,2,0,0
2/21/2018 18:25,49,67.1,67,62.2,116,64.3,2,0,0
2/21/2018 18:30,47,67.4,64,62.5,111,64.5,2,0,0
2/21/2018 18:35,41,67.4,58,62.5,99,64.5,2,0,0
2/21/2018 18:40,49,67.8,67,63,116,65,2,0,0
2/21/2018 18:45,41,67.9,58,63.2,99,65.1,2,0,0
2/21/2018 18:50,48,68.1,65,63.3,113,65.4,2,0,0
2/21/2018 18:55,42,68.8,60,64.1,102,66,2,0,0
2/21/2018 19:00,37,68.3,54,63.5,91,65.5,2,0,0
2/21/2018 19:05,33,69.3,50,64.6,83,66.5,2,0,0
2/21/2018 19:10,37,68.1,55,63.4,92,65.3,2,0,0
2/21/2018 19:15,48,69,66,64.3,114,66.3,2,0,0
2/21/2018 19:20,39,69.4,56,64.8,95,66.7,2,0,0
2/21/2018 19:25,50,67.7,68,62.9,118,64.9,2,0,0
2/21/2018 19:30,42,68.3,59,63.6,101,65.6,2,0,0
2/21/2018 19:35,32,69.1,49,64.5,81,66.3,2,0,0
2/21/2018 19:40,38,68.8,55,64.1,93,66,2,0,0
2/21/2018 19:45,33,69.4,50,64.8,83,66.6,2,0,0
2/21/2018 19:50,38,69,55,64.4,93,66.3,2,0,0
2/21/2018 19:55,27,69.5,44,64.9,71,66.7,2,0,0
2/21/2018 20:00,36,68.3,53,63.6,89,65.5,2,0,0
2/21/2018 20:05,30,68.2,46,63.4,76,65.3,2,0,0
2/21/2018 20:10,38,68.6,54,64,92,65.9,2,0,0
2/21/2018 20:15,41,68.4,57,63.8,98,65.7,2,0,0
2/21/2018 20:20,34,68.8,50,64.2,84,66.1,2,0,0
2/21/2018 20:25,31,69.5,48,64.9,79,66.7,2,0,0
2/21/2018 20:30,27,69.1,43,64.5,70,66.3,2,0,0
2/21/2018 20:35,31,69.7,47,65.2,78,67,2,0,0
2/21/2018 20:40,25,68.8,42,64.2,67,65.9,2,0,0
2/21/2018 20:45,32,68.7,49,64,81,65.9,2,0,0
2/21/2018 20:50,26,69.1,43,64.5,69,66.3,2,0,0
2/21/2018 20:55,27,69.4,44,64.8,71,66.6,2,0,0
2/21/2018 21:00,21,69.4,36,64.8,57,66.5,2,0,0
2/21/2018 21:05,23,69.3,39,64.7,62,66.4,2,0,0
2/21/2018 21:10,28,69.3,44,64.6,72,66.4,2,0,0
2/21/2018 21:15,26,69.1,42,64.5,68,66.2,2,0,0
2/21/2018 21:20,26,69,43,64.3,69,66.1,2,0,0
2/21/2018 21:25,24,68.7,39,64.1,63,65.8,2,0,0
2/21/2018 21:30,19,69.1,35,64.5,54,66.1,2,0,0
2/21/2018 21:35,21,69.2,37,64.5,58,66.2,2,0,0
2/21/2018 21:40,22,69.3,38,64.7,60,66.4,2,0,0
2/21/2018 21:45,26,69.1,42,64.4,68,66.2,2,0,0
2/21/2018 21:50,28,69.2,45,64.6,73,66.4,2,0,0
2/21/2018 21:55,23,69.3,39,64.7,62,66.4,2,0,0
2/21/2018 22:00,29,69.3,45,64.7,74,66.5,2,0,0
2/21/2018 22:05,21,69.1,37,64.5,58,66.2,2,0,0
2/21/2018 22:10,18,69.1,33,64.5,51,66.1,2,0,0
2/21/2018 22:15,24,68.9,39,64.2,63,66,2,0,0
2/21/2018 22:20,19,68.9,35,64.3,54,65.9,2,0,0
2/21/2018 22:25,14,69.1,30,64.5,44,65.9,2,0,0
2/21/2018 22:30,21,69.2,36,64.5,57,66.2,2,0,0
2/21/2018 22:35,16,68.7,31,64.1,47,65.7,2,0,0
2/21/2018 22:40,19,68.7,35,64,54,65.6,2,0,0
2/21/2018 22:45,16,68.7,32,64.1,48,65.6,2,0,0
2/21/2018 22:50,18,68.9,34,64.3,52,65.9,2,0,0
2/21/2018 22:55,17,69,34,64.4,51,65.9,2,0,0
2/21/2018 23:00,13,69.1,29,64.5,42,65.9,2,0,0
2/21/2018 23:05,19,69.3,35,64.7,54,66.3,2,0,0
2/21/2018 23:10,15,69.4,30,64.8,45,66.4,2,0,0
2/21/2018 23:15,16,69.4,31,64.8,47,66.4,2,0,0
2/21/2018 23:20,15,69.3,31,64.7,46,66.2,2,0,0
2/21/2018 23:25,15,69.2,30,64.6,45,66.2,2,0,0
2/21/2018 23:30,18,69.2,34,64.5,52,66.1,2,0,0
2/21/2018 23:35,18,69.3,33,64.7,51,66.4,2,0,0
2/21/2018 23:40,12,69.2,27,64.6,39,66,2,0,0
2/21/2018 23:45,12,69.4,27,64.8,39,66.2,2,0,0
2/21/2018 23:50,13,69.3,28,64.7,41,66.2,2,0,0
2/21/2018 23:55,12,69.2,28,64.6,40,66,2,0,0
2/22/2018 0:00,10,69.3,25,64.7,35,66.1,2,0,0
2/22/2018 0:05,8,69.2,23,64.6,31,65.8,2,0,0
2/22/2018 0:10,8,69.3,24,64.7,32,65.8,2,0,0
2/22/2018 0:15,11,68.6,27,63.9,38,65.3,2,0,0
2/22/2018 0:20,6,69,21,64.4,27,65.4,2,0,0
2/22/2018 0:25,9,68.8,24,64.2,33,65.5,2,0,0
2/22/2018 0:30,16,68.9,23,64.3,39,66.2,2,0,0
2/22/2018 0:35,7,69.2,22,64.5,29,65.7,2,0,0
2/22/2018 0:40,6,69.3,21,64.7,27,65.7,2,0,0
2/22/2018 0:45,6,69.3,21,64.7,27,65.7,2,0,0
2/22/2018 0:50,7,69.3,23,64.7,30,65.8,2,0,0
2/22/2018 0:55,6,69.4,22,64.8,28,65.8,2,0,0
2/22/2018 1:00,6,69.3,22,64.7,28,65.7,2,0,0
2/22/2018 1:05,5,69.4,21,64.8,26,65.7,2,0,0
2/22/2018 1:10,6,69.3,21,64.7,27,65.7,2,0,0
2/22/2018 1:15,7,69,22,64.4,29,65.5,2,0,0
2/22/2018 1:20,9,68.3,24,63.7,33,64.9,2,0,0
2/22/2018 1:25,7,68.9,22,64.3,29,65.4,2,0,0
2/22/2018 1:30,10,68.8,25,64.2,35,65.5,2,0,0
2/22/2018 1:35,8,69.1,24,64.5,32,65.6,2,0,0
2/22/2018 1:40,7,69.2,22,64.6,29,65.7,2,0,0
2/22/2018 1:45,10,69.4,25,64.8,35,66.1,2,0,0
2/22/2018 1:50,7,69.4,22,64.8,29,65.9,2,0,0
2/22/2018 1:55,7,69.4,22,64.8,29,65.9,2,0,0
2/22/2018 2:00,7,69.4,22,64.8,29,65.9,2,0,0
2/22/2018 2:05,6,69.4,21,64.8,27,65.8,2,0,0
2/22/2018 2:10,5,69.4,21,64.8,26,65.7,2,0,0
2/22/2018 2:15,12,69.3,21,64.7,33,66.4,2,0,0
2/22/2018 2:20,8,69.2,23,64.5,31,65.7,2,0,0
2/22/2018 2:25,6,69.2,21,64.5,27,65.5,2,0,0
2/22/2018 2:30,6,69.2,21,64.5,27,65.6,2,0,0
2/22/2018 2:35,8,69.2,23,64.6,31,65.8,2,0,0
2/22/2018 2:40,10,69.4,25,64.7,35,66.1,2,0,0
2/22/2018 2:45,10,69.4,26,64.8,36,66.1,2,0,0
2/22/2018 2:50,8,69.5,23,64.9,31,66.1,2,0,0
2/22/2018 2:55,7,69.5,23,64.9,30,66,2,0,0
2/22/2018 3:00,11,69.2,27,64.6,38,66,2,0,0
2/22/2018 3:05,11,69.2,26,64.6,37,66,2,0,0
2/22/2018 3:10,9,69,25,64.4,34,65.6,2,0,0
2/22/2018 3:15,7,69.2,23,64.6,30,65.7,2,0,0
2/22/2018 3:20,10,69.2,25,64.6,35,65.9,2,0,0
2/22/2018 3:25,11,69,27,64.4,38,65.8,2,0,0
2/22/2018 3:30,13,69.2,29,64.6,42,66,2,0,0
2/22/2018 3:35,14,69.4,30,64.8,44,66.3,2,0,0
2/22/2018 3:40,10,69.5,25,64.9,35,66.2,2,0,0
2/22/2018 3:45,11,69.3,27,64.7,38,66.1,2,0,0
2/22/2018 3:50,13,69.2,28,64.6,41,66.1,2,0,0
2/22/2018 3:55,17,68.8,33,64.2,50,65.8,2,0,0
2/22/2018 4:00,13,68.9,28,64.3,41,65.7,2,0,0
2/22/2018 4:05,16,69.1,32,64.5,48,66,2,0,0
2/22/2018 4:10,26,69.3,42,64.6,68,66.4,2,0,0
2/22/2018 4:15,22,69.4,39,64.8,61,66.4,2,0,0
2/22/2018 4:20,23,69.2,40,64.5,63,66.2,2,0,0
2/22/2018 4:25,26,68.9,43,64.3,69,66,2,0,0
2/22/2018 4:30,33,69.4,51,64.8,84,66.6,2,0,0
2/22/2018 4:35,32,69,49,64.4,81,66.2,2,0,0
2/22/2018 4:40,33,69.1,50,64.5,83,66.3,2,0,0
2/22/2018 4:45,42,69.4,61,64.8,103,66.7,2,0,0
2/22/2018 4:50,37,69,54,64.4,91,66.3,2,0,0
2/22/2018 4:55,40,69.5,58,65,98,66.8,2,0,0
2/22/2018 5:00,39,69.1,57,64.4,96,66.3,2,0,0
2/22/2018 5:05,38,69.9,56,65.3,94,67.2,2,0,0
2/22/2018 5:10,45,69,64,64.3,109,66.3,2,0,0
2/22/2018 5:15,46,68.6,66,63.8,112,65.7,2,0,0
2/22/2018 5:20,45,68.5,64,63.7,109,65.7,2,0,0
2/22/2018 5:25,50,68.2,70,63.4,120,65.4,2,0,0
2/22/2018 5:30,51,67,71,62.1,122,64.1,2,0,0
2/22/2018 5:35,62,65.2,83,60.2,145,62.3,2,0,0
2/22/2018 5:40,64,67.1,85,62.3,149,64.4,2,0,0
2/22/2018 5:45,64,67.7,84,62.8,148,64.9,2,0,0
2/22/2018 5:50,57,67.2,77,62.3,134,64.4,2,0,0
2/22/2018 5:55,66,67,89,62.1,155,64.2,2,0,0
2/22/2018 6:00,54,68.6,74,63.8,128,65.8,2,0,0
2/22/2018 6:05,61,67.1,82,62.3,143,64.4,2,0,0
2/22/2018 6:10,62,67.5,83,62.6,145,64.7,2,0,0
2/22/2018 6:15,64,67.6,86,62.7,150,64.8,2,0,0
2/22/2018 6:20,68,67.5,89,62.6,157,64.7,2,0,0
2/22/2018 6:25,67,66.9,89,61.9,156,64.1,2,0,0
2/22/2018 6:30,67,67.3,89,62.4,156,64.5,2,0,0
2/22/2018 6:35,77,67.3,100,62.4,177,64.5,2,0,0
2/22/2018 6:40,69,67.3,93,62.4,162,64.5,2,0,0
2/22/2018 6:45,78,67.7,100,62.8,178,64.9,2,0,0
2/22/2018 6:50,73,69.3,94,64.6,167,66.7,2,0,0
2/22/2018 6:55,70,68.2,91,63.5,161,65.6,2,0,0
2/22/2018 7:00,79,68.3,102,63.5,181,65.6,2,0,0
2/22/2018 7:05,81,68,103,63.2,184,65.3,2,0,0
2/22/2018 7:10,71,69.3,92,64.5,163,66.6,2,0,0
2/22/2018 7:15,82,69.6,104,64.9,186,67,2,0,0
2/22/2018 7:20,88,67.4,112,62.4,200,64.6,2,0,0
2/22/2018 7:25,90,66,114,61,204,63.2,2,0,0
2/22/2018 7:30,80,67.5,103,62.7,183,64.8,2,0,0
2/22/2018 7:35,97,67.7,122,62.8,219,64.9,2,0,0
2/22/2018 7:40,85,67.3,109,62.5,194,64.6,2,0,0
2/22/2018 7:45,91,67.5,114,62.6,205,64.8,2,0,0
2/22/2018 7:50,90,67.5,114,62.6,204,64.7,2,0,0
2/22/2018 7:55,89,67.3,112,62.3,201,64.5,2,0,0
2/22/2018 8:00,91,67.2,114,62.2,205,64.4,2,0,0
2/22/2018 8:05,96,66.6,120,61.6,216,63.8,2,0,0
2/22/2018 8:10,78,67.3,101,62.3,179,64.5,2,0,0
2/22/2018 8:15,78,66.8,100,61.9,178,64.1,2,0,0
2/22/2018 8:20,80,66.2,102,61.2,182,63.4,2,0,0
2/22/2018 8:25,80,66.4,103,61.4,183,63.6,2,0,0
2/22/2018 8:30,76,65.6,99,60.5,175,62.7,2,0,0
2/22/2018 8:35,85,65.4,107,60.2,192,62.5,2,0,0
2/22/2018 8:40,87,65.4,110,60.3,197,62.6,2,0,0
2/22/2018 8:45,81,66.6,104,61.6,185,63.8,2,0,0
2/22/2018 8:50,81,66.8,103,61.8,184,64,2,0,0
2/22/2018 8:55,72,67.6,94,62.7,166,64.8,2,0,0
2/22/2018 9:00,78,66.6,99,61.7,177,63.9,2,0,0
2/22/2018 9:05,70,65.6,90,60.6,160,62.8,2,0,0
2/22/2018 9:10,71,65,89,59.9,160,62.2,2,0,0
2/22/2018 9:15,84,65.5,106,60.5,190,62.7,2,0,0
2/22/2018 9:20,75,64.1,96,59,171,61.2,2,0,0
2/22/2018 9:25,70,64.8,90,59.8,160,62,2,0,0
2/22/2018 9:30,76,64.2,98,59,174,61.3,2,0,0
2/22/2018 9:35,69,65.3,89,60.2,158,62.4,2,0,0
2/22/2018 9:40,71,66.2,92,61.2,163,63.4,2,0,0
2/22/2018 9:45,72,65.2,95,60.2,167,62.4,2,0,0
2/22/2018 9:50,82,66.1,103,61.1,185,63.3,2,0,0
2/22/2018 9:55,84,64,106,58.8,190,61.1,2,0,0
2/22/2018 10:00,74,65.4,94,60.4,168,62.6,2,0,0
2/22/2018 10:05,74,67,93,62.2,167,64.3,2,0,0
2/22/2018 10:10,61,67,81,62.2,142,64.2,2,0,0
2/22/2018 10:15,78,67.7,99,62.9,177,65,2,0,0
2/22/2018 10:20,65,67.6,85,62.9,150,64.9,2,0,0
2/22/2018 10:25,64,68,84,63.4,148,65.4,2,0,0
2/22/2018 10:30,66,67.7,87,63,153,65,2,0,0
2/22/2018 10:35,67,68,86,63.4,153,65.4,2,0,0
2/22/2018 10:40,62,67.9,81,63.3,143,65.3,2,0,0
2/22/2018 10:45,60,67.8,78,63.1,138,65.2,2,0,0
2/22/2018 10:50,60,68.4,78,63.8,138,65.8,2,0,0
2/22/2018 10:55,74,67.7,93,62.9,167,65,2,0,0
2/22/2018 11:00,51,66.2,69,61.4,120,63.4,2,0,0
2/22/2018 11:05,56,66.4,75,61.5,131,63.6,2,0,0
2/22/2018 11:10,53,67.9,72,63.3,125,65.2,2,0,0
2/22/2018 11:15,53,67.9,70,63.2,123,65.2,2,0,0
2/22/2018 11:20,63,67.5,81,62.8,144,64.9,2,0,0
2/22/2018 11:25,66,68,84,63.4,150,65.4,2,0,0
2/22/2018 11:30,61,67.6,80,62.9,141,64.9,2,0,0
2/22/2018 11:35,61,67.8,80,63.1,141,65.2,2,0,0
2/22/2018 11:40,54,67.2,72,62.4,126,64.5,2,0,0
2/22/2018 11:45,55,65.5,74,60.5,129,62.6,2,0,0
2/22/2018 11:50,57,66,76,61.1,133,63.2,2,0,0
2/22/2018 11:55,54,67.1,72,62.2,126,64.3,2,0,0
2/22/2018 12:00,58,65.7,77,60.8,135,62.9,2,0,0
2/22/2018 12:05,44,66.5,62,61.6,106,63.6,2,0,0
2/22/2018 12:10,48,67.4,65,62.6,113,64.7,2,0,0
2/22/2018 12:15,54,67.2,73,62.4,127,64.4,2,0,0
2/22/2018 12:20,56,66.3,75,61.4,131,63.5,2,0,0
2/22/2018 12:25,51,66.8,69,61.9,120,64,2,0,0
2/22/2018 12:30,55,66.3,73,61.4,128,63.5,2,0,0
2/22/2018 12:35,47,66.6,64,61.8,111,63.9,2,0,0
2/22/2018 12:40,49,66.5,66,61.7,115,63.8,2,0,0
2/22/2018 12:45,54,66.7,71,61.9,125,64,2,0,0
2/22/2018 12:50,43,66.4,61,61.6,104,63.6,2,0,0
2/22/2018 12:55,56,67.8,74,63.1,130,65.1,2,0,0
2/22/2018 13:00,51,67.6,69,62.8,120,64.8,2,0,0
2/22/2018 13:05,41,67.6,58,62.9,99,64.8,2,0,0
2/22/2018 13:10,48,66.5,66,61.7,114,63.7,2,0,0
2/22/2018 13:15,48,66.9,65,62.2,113,64.2,2,0,0
2/22/2018 13:20,59,66.5,76,61.7,135,63.8,2,0,0
2/22/2018 13:25,56,66.9,74,62.1,130,64.2,2,0,0
2/22/2018 13:30,55,67,73,62.2,128,64.2,2,0,0
2/22/2018 13:35,63,68,56,62.2,119,65.3,2,0,0
2/22/2018 13:40,64,67.8,58,62,122,65,2,0,0
2/22/2018 13:45,65,67.9,58,62.1,123,65.2,2,0,0
2/22/2018 13:50,65,67.9,58,62.1,123,65.2,2,0,0
2/22/2018 13:55,65,67.9,59,62.1,124,65.1,2,0,0
2/22/2018 14:00,62,68,56,62.2,118,65.2,2,0,0
2/22/2018 14:05,70,65.2,90,60.1,160,62.3,2,0,0
2/22/2018 14:10,49,66,67,61.1,116,63.2,2,0,0
2/22/2018 14:15,49,66,67,61.1,116,63.2,2,0,0
2/22/2018 14:20,55,66.4,73,61.5,128,63.6,2,0,0
2/22/2018 14:25,49,65.4,67,60.5,116,62.6,2,0,0
2/22/2018 14:30,56,66.4,74,61.6,130,63.7,2,0,0
2/22/2018 14:35,55,66.8,73,61.9,128,64,2,0,0
2/22/2018 14:40,55,66.4,74,61.5,129,63.6,2,0,0
2/22/2018 14:45,55,67.6,72,62.9,127,64.9,2,0,0
2/22/2018 14:50,44,67.1,61,62.4,105,64.4,2,0,0
2/22/2018 14:55,56,66.5,73,61.6,129,63.7,2,0,0
2/22/2018 15:00,43,66.7,60,62,103,64,2,0,0
2/22/2018 15:05,55,68.6,73,63.9,128,65.9,2,0,0
2/22/2018 15:10,60,68.5,79,63.8,139,65.8,2,0,0
2/22/2018 15:15,60,68.4,78,63.7,138,65.8,2,0,0
2/22/2018 15:20,67,67.8,85,63,152,65.1,2,0,0
2/22/2018 15:25,59,68.5,78,63.7,137,65.7,2,0,0
2/22/2018 15:30,74,67.7,93,62.8,167,65,2,0,0
2/22/2018 15:35,64,68,83,63.1,147,65.3,2,0,0
2/22/2018 15:40,64,68.8,83,64,147,66.1,2,0,0
2/22/2018 15:45,67,69.5,86,64.8,153,66.8,2,0,0
2/22/2018 15:50,61,68.7,81,63.9,142,65.9,2,0,0
2/22/2018 15:55,63,68.5,82,63.7,145,65.8,2,0,0
2/22/2018 16:00,53,69.8,71,65.2,124,67.2,2,0,0
2/22/2018 16:05,59,67.7,78,62.9,137,64.9,2,0,0
2/22/2018 16:10,49,67.9,66,63,115,65.1,2,0,0
2/22/2018 16:15,58,68.5,77,63.8,135,65.8,2,0,0
2/22/2018 16:20,55,67.9,73,63.1,128,65.2,2,0,0
2/22/2018 16:25,42,67.7,60,63,102,64.9,2,0,0
2/22/2018 16:30,54,68.8,73,64,127,66,2,0,0
2/22/2018 16:35,54,68.9,72,64.2,126,66.2,2,0,0
2/22/2018 16:40,54,67.8,72,63,126,65.1,2,0,0
2/22/2018 16:45,57,68.1,75,63.3,132,65.3,2,0,0
2/22/2018 16:50,56,69.6,74,64.9,130,66.9,2,0,0
2/22/2018 16:55,45,69.6,62,65,107,66.9,2,0,0
2/22/2018 17:00,52,69.8,70,65.1,122,67.1,2,0,0
2/22/2018 17:05,47,68.8,65,64.1,112,66.1,2,0,0
2/22/2018 17:10,47,69.6,64,65,111,66.9,2,0,0
2/22/2018 17:15,56,68.9,74,64.2,130,66.2,2,0,0
2/22/2018 17:20,50,67.6,69,62.7,119,64.8,2,0,0
2/22/2018 17:25,51,67.3,69,62.4,120,64.5,2,0,0
2/22/2018 17:30,49,62.1,67,56.7,116,59,2,0,0
2/22/2018 17:35,49,61.2,68,55.6,117,57.9,2,0,0
2/22/2018 17:40,46,61.9,64,56.4,110,58.7,2,0,0
2/22/2018 17:45,45,65.3,62,60.1,107,62.3,2,0,0
2/22/2018 17:50,48,67.1,66,62.2,114,64.2,2,0,0
2/22/2018 17:55,53,67.8,72,63,125,65.1,2,0,0
2/22/2018 18:00,60,67.7,79,62.8,139,64.9,2,0,0
2/22/2018 18:05,60,64.3,79,59.1,139,61.4,2,0,0
2/22/2018 18:10,54,58.2,74,52.3,128,54.8,2,0,0
2/22/2018 18:15,50,52.6,69,46.2,119,48.9,2,0,0
2/22/2018 18:20,51,53.9,68,47.6,119,50.3,2,0,0
2/22/2018 18:25,54,59.2,72,53.5,126,55.9,2,0,0
2/22/2018 18:30,46,63.4,63,58.1,109,60.4,2,0,0
2/22/2018 18:35,53,66.2,72,61.1,125,63.3,2,0,0
2/22/2018 18:40,53,67.4,72,62.5,125,64.6,2,0,0
2/22/2018 18:45,46,68.7,63,64,109,66,2,0,0
2/22/2018 18:50,38,69.7,56,65.1,94,67,2,0,0
2/22/2018 18:55,49,68.6,67,63.9,116,65.9,2,0,0
2/22/2018 19:00,48,67.9,66,63.2,114,65.2,2,0,0
2/22/2018 19:05,44,68.7,61,64,105,66,2,0,0
2/22/2018 19:10,35,69,52,64.4,87,66.3,2,0,0
2/22/2018 19:15,38,68.9,55,64.2,93,66.2,2,0,0
2/22/2018 19:20,39,69.5,57,64.9,96,66.8,2,0,0
2/22/2018 19:25,37,68.3,55,63.6,92,65.5,2,0,0
2/22/2018 19:30,40,68.8,57,64.1,97,66,2,0,0
2/22/2018 19:35,32,69.3,48,64.7,80,66.6,2,0,0
2/22/2018 19:40,25,68.5,42,63.8,67,65.5,2,0,0
2/22/2018 19:45,33,68.8,49,64.1,82,66,2,0,0
2/22/2018 19:50,35,69.6,51,65,86,66.9,2,0,0
2/22/2018 19:55,26,69,43,64.4,69,66.2,2,0,0
2/22/2018 20:00,27,68.9,44,64.2,71,66,2,0,0
2/22/2018 20:05,33,68.2,49,63.6,82,65.4,2,0,0
2/22/2018 20:10,31,68.9,47,64.2,78,66.1,2,0,0
2/22/2018 20:15,30,68.6,46,63.9,76,65.7,2,0,0
2/22/2018 20:20,31,69.1,48,64.5,79,66.3,2,0,0
2/22/2018 20:25,30,69,47,64.4,77,66.2,2,0,0
2/22/2018 20:30,25,69.2,41,64.5,66,66.3,2,0,0
2/22/2018 20:35,31,68.6,48,63.9,79,65.8,2,0,0
2/22/2018 20:40,27,68,42,63.3,69,65.1,2,0,0
2/22/2018 20:45,27,68.9,44,64.3,71,66.1,2,0,0
2/22/2018 20:50,29,69.2,45,64.5,74,66.3,2,0,0
2/22/2018 20:55,30,69.3,47,64.7,77,66.5,2,0,0
2/22/2018 21:00,32,68.6,47,64,79,65.9,2,0,0
2/22/2018 21:05,30,69.3,46,64.7,76,66.5,2,0,0
2/22/2018 21:10,30,69.1,47,64.5,77,66.3,2,0,0
2/22/2018 21:15,28,68.5,44,63.8,72,65.6,2,0,0
2/22/2018 21:20,32,68.6,49,63.9,81,65.8,2,0,0
2/22/2018 21:25,31,69.1,47,64.5,78,66.3,2,0,0
2/22/2018 21:30,29,69.3,44,64.7,73,66.5,2,0,0
2/22/2018 21:35,27,69.4,44,64.8,71,66.6,2,0,0
2/22/2018 21:40,24,68.8,41,64.2,65,65.9,2,0,0
2/22/2018 21:45,32,69,49,64.3,81,66.2,2,0,0
2/22/2018 21:50,28,68.6,45,63.9,73,65.7,2,0,0
2/22/2018 21:55,24,68.1,40,63.4,64,65.2,2,0,0
2/22/2018 22:00,24,68.8,40,64.1,64,65.9,2,0,0
2/22/2018 22:05,28,69,44,64.3,72,66.1,2,0,0
2/22/2018 22:10,26,69.1,42,64.4,68,66.2,2,0,0
2/22/2018 22:15,21,69.3,36,64.7,57,66.4,2,0,0
2/22/2018 22:20,21,69.4,36,64.8,57,66.5,2,0,0
2/22/2018 22:25,20,69.3,36,64.7,56,66.3,2,0,0
2/22/2018 22:30,25,69.4,42,64.8,67,66.5,2,0,0
2/22/2018 22:35,29,69.5,45,64.9,74,66.7,2,0,0
2/22/2018 22:40,23,68.9,39,64.2,62,65.9,2,0,0
2/22/2018 22:45,16,69,32,64.4,48,65.9,2,0,0
2/22/2018 22:50,19,69,35,64.4,54,66,2,0,0
2/22/2018 22:55,16,69.2,31,64.6,47,66.2,2,0,0
2/22/2018 23:00,17,69.1,33,64.5,50,66.1,2,0,0
2/22/2018 23:05,20,69.6,36,65,56,66.6,2,0,0
2/22/2018 23:10,16,69.5,31,64.9,47,66.5,2,0,0
2/22/2018 23:15,15,69.2,30,64.6,45,66.1,2,0,0
2/22/2018 23:20,18,69.5,34,64.9,52,66.5,2,0,0
2/22/2018 23:25,19,69.6,35,65,54,66.7,2,0,0
2/22/2018 23:30,15,69.3,31,64.7,46,66.2,2,0,0
2/22/2018 23:35,18,68.9,33,64.2,51,65.9,2,0,0
2/22/2018 23:40,10,69.2,26,64.6,36,65.9,2,0,0
2/22/2018 23:45,17,69.2,33,64.6,50,66.2,2,0,0
2/22/2018 23:50,11,69.2,26,64.6,37,66,2,0,0
2/22/2018 23:55,14,69.3,29,64.7,43,66.2,2,0,0
2/23/2018 0:00,10,69.3,25,64.7,35,66.1,2,0,0
2/23/2018 0:05,12,69.4,27,64.8,39,66.3,2,0,0
2/23/2018 0:10,10,69.4,25,64.8,35,66.2,2,0,0
2/23/2018 0:15,11,69.3,27,64.6,38,66,2,0,0
2/23/2018 0:20,12,69.2,28,64.6,40,65.9,2,0,0
2/23/2018 0:25,8,69.2,24,64.6,32,65.7,2,0,0
2/23/2018 0:30,7,69.2,22,64.6,29,65.7,2,0,0
2/23/2018 0:35,7,69.3,22,64.7,29,65.8,2,0,0
2/23/2018 0:40,10,69,25,64.4,35,65.7,2,0,0
2/23/2018 0:45,7,69.2,22,64.6,29,65.7,2,0,0
2/23/2018 0:50,10,69.4,25,64.8,35,66.1,2,0,0
2/23/2018 0:55,7,69.4,23,64.8,30,65.9,2,0,0
2/23/2018 1:00,9,69.4,24,64.8,33,66.1,2,0,0
2/23/2018 1:05,8,69.4,23,64.8,31,66,2,0,0
2/23/2018 1:10,8,69.2,24,64.6,32,65.7,2,0,0
2/23/2018 1:15,8,68.8,24,64.1,32,65.3,2,0,0
2/23/2018 1:20,9,69,24,64.4,33,65.7,2,0,0
2/23/2018 1:25,6,69.2,22,64.6,28,65.6,2,0,0
2/23/2018 1:30,8,69.1,23,64.4,31,65.6,2,0,0
2/23/2018 1:35,9,69.1,25,64.5,34,65.7,2,0,0
2/23/2018 1:40,7,69.3,22,64.7,29,65.8,2,0,0
2/23/2018 1:45,7,69.2,22,64.6,29,65.7,2,0,0
2/23/2018 1:50,7,69.3,22,64.7,29,65.8,2,0,0
2/23/2018 1:55,8,69.3,23,64.7,31,65.9,2,0,0
2/23/2018 2:00,7,69.2,22,64.6,29,65.7,2,0,0
2/23/2018 2:05,10,69.3,25,64.7,35,66,2,0,0
2/23/2018 2:10,9,69.2,24,64.6,33,65.9,2,0,0
2/23/2018 2:15,10,69.3,25,64.7,35,66,2,0,0
2/23/2018 2:20,8,69.3,23,64.7,31,65.9,2,0,0
2/23/2018 2:25,7,69.3,22,64.7,29,65.8,2,0,0
2/23/2018 2:30,7,69.1,22,64.4,29,65.6,2,0,0
2/23/2018 2:35,7,69,23,64.4,30,65.5,2,0,0
2/23/2018 2:40,12,69.3,27,64.7,39,66.1,2,0,0
2/23/2018 2:45,11,69.2,26,64.6,37,66,2,0,0
2/23/2018 2:50,10,69.3,26,64.7,36,66,2,0,0
2/23/2018 2:55,9,69.4,24,64.8,33,66.1,2,0,0
2/23/2018 3:00,10,69.2,26,64.6,36,65.9,2,0,0
2/23/2018 3:05,10,69.1,25,64.5,35,65.8,2,0,0
2/23/2018 3:10,12,68.9,28,64.2,40,65.6,2,0,0
2/23/2018 3:15,8,69.2,24,64.6,32,65.7,2,0,0
2/23/2018 3:20,8,69,24,64.4,32,65.6,2,0,0
2/23/2018 3:25,9,69.2,24,64.6,33,65.9,2,0,0
2/23/2018 3:30,12,69.3,27,64.7,39,66.1,2,0,0
2/23/2018 3:35,14,69,30,64.4,44,65.9,2,0,0
2/23/2018 3:40,15,69.1,31,64.4,46,65.9,2,0,0
2/23/2018 3:45,16,69.3,31,64.7,47,66.2,2,0,0
2/23/2018 3:50,15,69.4,31,64.8,46,66.3,2,0,0
2/23/2018 3:55,12,69.2,28,64.5,40,65.9,2,0,0
2/23/2018 4:00,11,69.1,26,64.5,37,65.8,2,0,0
2/23/2018 4:05,21,68.9,37,64.2,58,65.9,2,0,0
2/23/2018 4:10,22,69,38,64.4,60,66.1,2,0,0
2/23/2018 4:15,21,69.1,37,64.4,58,66.1,2,0,0
2/23/2018 4:20,20,69.3,36,64.7,56,66.3,2,0,0
2/23/2018 4:25,22,69.1,39,64.5,61,66.2,2,0,0
2/23/2018 4:30,30,68.9,46,64.2,76,66.1,2,0,0
2/23/2018 4:35,25,69,41,64.4,66,66.1,2,0,0
2/23/2018 4:40,34,69.2,52,64.5,86,66.3,2,0,0
2/23/2018 4:45,42,69.5,60,64.9,102,66.8,2,0,0
2/23/2018 4:50,36,69.7,54,65,90,66.9,2,0,0
2/23/2018 4:55,35,68.1,53,63.4,88,65.3,2,0,0
2/23/2018 5:00,35,69.3,54,64.7,89,66.5,2,0,0
2/23/2018 5:05,39,69.7,58,65.1,97,67,2,0,0
2/23/2018 5:10,39,70.3,57,65.8,96,67.6,2,0,0
2/23/2018 5:15,56,70.2,76,65.7,132,67.6,2,0,0
2/23/2018 5:20,45,69.5,65,65,110,66.8,2,0,0
2/23/2018 5:25,47,69.5,67,64.9,114,66.8,2,0,0
2/23/2018 5:30,59,68.5,80,63.9,139,65.9,2,0,0
2/23/2018 5:35,60,68.3,81,63.7,141,65.6,2,0,0
2/23/2018 5:40,54,69,74,64.4,128,66.3,2,0,0
2/23/2018 5:45,56,69.1,77,64.5,133,66.5,2,0,0
2/23/2018 5:50,59,69.4,79,64.8,138,66.7,2,0,0
2/23/2018 5:55,60,70,80,65.4,140,67.4,2,0,0
2/23/2018 6:00,54,69.6,74,65,128,67,2,0,0
2/23/2018 6:05,56,69.2,75,64.4,131,66.4,2,0,0
2/23/2018 6:10,66,68.1,88,63.3,154,65.3,2,0,0
2/23/2018 6:15,56,66.5,77,61.6,133,63.6,2,0,0
2/23/2018 6:20,74,67.2,96,62.3,170,64.4,2,0,0
2/23/2018 6:25,66,67.5,89,62.6,155,64.7,2,0,0
2/23/2018 6:30,59,68.3,80,63.5,139,65.5,2,0,0
2/23/2018 6:35,61,67.4,82,62.5,143,64.6,2,0,0
2/23/2018 6:40,71,66.9,94,62,165,64.1,2,0,0
2/23/2018 6:45,66,68.3,88,63.5,154,65.5,2,0,0
2/23/2018 6:50,69,69.2,90,64.5,159,66.5,2,0,0
2/23/2018 6:55,73,68,94,63.2,167,65.3,2,0,0
2/23/2018 7:00,77,68.9,100,64.2,177,66.3,2,0,0
2/23/2018 7:05,64,68.7,85,63.9,149,66,2,0,0
2/23/2018 7:10,65,68.4,86,63.7,151,65.8,2,0,0
2/23/2018 7:15,70,68.2,92,63.4,162,65.4,2,0,0
2/23/2018 7:20,77,68.4,99,63.7,176,65.7,2,0,0
2/23/2018 7:25,72,67.1,95,62.2,167,64.3,2,0,0
2/23/2018 7:30,84,67.1,107,62.2,191,64.3,2,0,0
2/23/2018 7:35,87,67.2,110,62.3,197,64.4,2,0,0
2/23/2018 7:40,92,67,115,62.1,207,64.2,2,0,0
2/23/2018 7:45,81,68,103,63.2,184,65.3,2,0,0
2/23/2018 7:50,91,67.3,115,62.4,206,64.6,2,0,0
2/23/2018 7:55,78,67.9,100,63.1,178,65.2,2,0,0
2/23/2018 8:00,79,68.1,101,63.3,180,65.4,2,0,0
2/23/2018 8:05,88,68.1,112,63.3,200,65.4,2,0,0
2/23/2018 8:10,70,67.2,91,62.4,161,64.4,2,0,0
2/23/2018 8:15,76,67,98,62.2,174,64.3,2,0,0
2/23/2018 8:20,78,66.6,101,61.6,179,63.8,2,0,0
2/23/2018 8:25,69,67.8,89,63,158,65.1,2,0,0
2/23/2018 8:30,75,67.2,96,62.3,171,64.5,2,0,0
2/23/2018 8:35,75,66.4,97,61.4,172,63.6,2,0,0
2/23/2018 8:40,70,65.9,91,60.9,161,63,2,0,0
2/23/2018 8:45,75,66.4,97,61.4,172,63.6,2,0,0
2/23/2018 8:50,73,66.3,93,61.4,166,63.6,2,0,0
2/23/2018 8:55,70,67.2,90,62.4,160,64.5,2,0,0
2/23/2018 9:00,81,67.8,102,63,183,65.1,2,0,0
2/23/2018 9:05,79,67.7,100,62.9,179,65,2,0,0
2/23/2018 9:10,69,66.6,89,61.7,158,63.8,2,0,0
2/23/2018 9:15,68,67,89,62.1,157,64.2,2,0,0
2/23/2018 9:20,79,66.7,100,61.8,179,64,2,0,0
2/23/2018 9:25,80,66.6,102,61.7,182,63.8,2,0,0
2/23/2018 9:30,62,67,82,62.1,144,64.2,1,0,0
2/23/2018 9:35,60,67.6,78,62.8,138,64.9,1,0,0
2/23/2018 9:40,56,67,74,62.2,130,64.3,1,0,0
2/23/2018 9:45,65,66.3,84,61.4,149,63.6,1,0,0
2/23/2018 9:50,63,64.9,83,59.9,146,62.1,1,0,0
2/23/2018 9:55,69,66.3,88,61.4,157,63.5,1,0,0
2/23/2018 10:00,60,67.3,79,62.5,139,64.6,1,0,0
2/23/2018 10:05,63,67.4,83,62.6,146,64.7,1,0,0
2/23/2018 10:10,65,67.2,84,62.5,149,64.5,1,0,0
2/23/2018 10:15,56,66.6,74,61.8,130,63.9,1,0,0
2/23/2018 10:20,73,67.9,93,63.2,166,65.2,1,0,0
2/23/2018 10:25,54,67.4,73,62.6,127,64.6,1,0,0
2/23/2018 10:30,61,66.9,80,62.1,141,64.2,1,0,0
2/23/2018 10:35,67,67,87,62.2,154,64.3,1,0,0
2/23/2018 10:40,65,67.6,84,62.8,149,64.9,1,0,0
2/23/2018 10:45,60,67.1,79,62.2,139,64.3,1,0,0
2/23/2018 10:50,59,67.1,78,62.3,137,64.3,1,0,0
2/23/2018 10:55,54,68.4,72,63.7,126,65.7,1,0,0
2/23/2018 11:00,59,68.3,77,63.7,136,65.7,1,0,0
2/23/2018 11:05,63,66.6,82,61.7,145,63.8,1,0,0
2/23/2018 11:10,69,67.6,89,62.9,158,65,1,0,0
2/23/2018 11:15,56,67.5,75,62.8,131,64.8,1,0,0
2/23/2018 11:20,59,68.3,78,63.7,137,65.7,1,0,0
2/23/2018 11:25,56,67.2,75,62.5,131,64.5,1,0,0
2/23/2018 11:30,56,66.8,74,62.1,130,64.1,1,0,0
2/23/2018 11:35,49,68,67,63.3,116,65.3,1,0,0
2/23/2018 11:40,42,69.6,59,65,101,66.9,1,0,0
2/23/2018 11:45,72,68.6,92,64,164,66,1,0,0
2/23/2018 11:50,56,67.3,75,62.5,131,64.6,1,0,0
2/23/2018 11:55,60,67.8,80,63.1,140,65.1,1,0,0
2/23/2018 12:00,67,67.8,86,63,153,65.1,1,0,0
2/23/2018 12:05,61,67,80,62.2,141,64.3,1,0,0
2/23/2018 12:10,51,68.6,69,64,120,66,1,0,0
2/23/2018 12:15,58,68.6,77,63.9,135,65.9,1,0,0
2/23/2018 12:20,49,68.1,67,63.4,116,65.4,1,0,0
2/23/2018 12:25,44,67.7,62,62.9,106,64.9,1,0,0
2/23/2018 12:30,50,68.3,68,63.5,118,65.6,1,0,0
2/23/2018 12:35,57,68.6,74,63.8,131,65.9,1,0,0
2/23/2018 12:40,49,66.9,66,61.9,115,64.1,1,0,0
2/23/2018 12:45,54,65.2,73,60.2,127,62.3,1,0,0
2/23/2018 12:50,57,67.3,75,62.5,132,64.6,1,0,0
2/23/2018 12:55,50,68.4,68,63.7,118,65.7,1,0,0
2/23/2018 13:00,57,68,74,63.2,131,65.3,1,0,0
2/23/2018 13:05,46,66.4,63,61.4,109,63.5,1,0,0
2/23/2018 13:10,50,67.3,67,62.4,117,64.5,1,0,0
2/23/2018 13:15,43,67.7,60,62.9,103,64.9,1,0,0
2/23/2018 13:20,46,67.7,62,63,108,65,2,0,0
2/23/2018 13:25,46,68.1,61,63.3,107,65.4,2,0,0
2/23/2018 13:30,61,64.9,78,59.6,139,62,2,0,0
2/23/2018 13:35,52,66.3,70,61.3,122,63.4,2,0,0
2/23/2018 13:40,59,66.9,77,62,136,64.1,2,0,0
2/23/2018 13:45,53,64.7,71,59.6,124,61.8,2,0,0
2/23/2018 13:50,53,66,71,61,124,63.2,2,0,0
2/23/2018 13:55,54,66.2,72,61.3,126,63.4,2,0,0
2/23/2018 14:00,58,66.3,78,61.4,136,63.5,2,0,0
2/23/2018 14:05,50,65.8,68,60.9,118,63,2,0,0
2/23/2018 14:10,48,66,66,61,114,63.1,2,0,0
2/23/2018 14:15,58,66.3,77,61.4,135,63.6,2,0,0
2/23/2018 14:20,55,67.4,74,62.6,129,64.7,2,0,0
2/23/2018 14:25,55,67.7,75,62.9,130,64.9,2,0,0
2/23/2018 14:30,53,66.6,71,61.7,124,63.8,2,0,0
2/23/2018 14:35,61,66.9,80,62,141,64.1,2,0,0
2/23/2018 14:40,61,67.8,80,63,141,65.1,2,0,0
2/23/2018 14:45,55,67.7,72,63,127,65,2,0,0
2/23/2018 14:50,53,69.2,70,64.6,123,66.6,2,0,0
2/23/2018 14:55,54,69.1,72,64.5,126,66.4,2,0,0
2/23/2018 15:00,49,67.9,67,63.1,116,65.2,2,0,0
2/23/2018 15:05,63,67.9,82,63.1,145,65.2,2,0,0
2/23/2018 15:10,66,66.8,86,61.9,152,64,2,0,0
2/23/2018 15:15,57,66.8,76,62,133,64.1,2,0,0
2/23/2018 15:20,59,67.5,78,62.8,137,64.8,2,0,0
2/23/2018 15:25,68,68.2,88,63.5,156,65.5,2,0,0
2/23/2018 15:30,57,68.4,76,63.7,133,65.7,2,0,0
2/23/2018 15:35,60,68.8,80,64.1,140,66.1,2,0,0
2/23/2018 15:40,62,67.7,81,63,143,65.1,2,0,0
2/23/2018 15:45,73,67.3,92,62.5,165,64.6,2,0,0
2/23/2018 15:50,62,67.9,81,63.1,143,65.2,2,0,0
2/23/2018 15:55,59,67.6,77,62.8,136,64.9,2,0,0
2/23/2018 16:00,55,67,73,62.1,128,64.2,2,0,0
2/23/2018 16:05,59,67.3,78,62.3,137,64.5,2,0,0
2/23/2018 16:10,58,67.3,77,62.5,135,64.6,2,0,0
2/23/2018 16:15,61,67.6,80,62.8,141,64.9,2,0,0
2/23/2018 16:20,48,68.7,65,63.9,113,65.9,2,0,0
2/23/2018 16:25,47,69.2,64,64.5,111,66.5,2,0,0
2/23/2018 16:30,54,69.3,72,64.6,126,66.6,2,0,0
2/23/2018 16:35,56,68,74,63.2,130,65.3,2,0,0
2/23/2018 16:40,60,68.4,78,63.7,138,65.7,2,0,0
2/23/2018 16:45,57,67.8,76,62.9,133,65,2,0,0
2/23/2018 16:50,51,66.2,70,61.1,121,63.3,2,0,0
2/23/2018 16:55,62,66.5,81,61.5,143,63.7,2,0,0
2/23/2018 17:00,52,66.3,70,61.4,122,63.5,2,0,0
2/23/2018 17:05,62,67.5,81,62.7,143,64.8,2,0,0
2/23/2018 17:10,56,68.4,75,63.7,131,65.7,2,0,0
2/23/2018 17:15,56,68.8,75,64.1,131,66.1,2,0,0
2/23/2018 17:20,50,68.6,69,63.9,119,65.9,2,0,0
2/23/2018 17:25,60,66.4,79,61.5,139,63.6,2,0,0
2/23/2018 17:30,57,66.7,75,61.7,132,63.9,2,0,0
2/23/2018 17:35,47,66,65,61,112,63.1,2,0,0
2/23/2018 17:40,39,66.3,56,61.2,95,63.3,2,0,0
2/23/2018 17:45,49,67.1,67,62.1,116,64.2,2,0,0
2/23/2018 17:50,46,67.9,64,63.2,110,65.2,2,0,0
2/23/2018 17:55,48,67.1,66,62.2,114,64.3,2,0,0
2/23/2018 18:00,56,68.1,75,63.3,131,65.3,2,0,0
2/23/2018 18:05,50,69.3,67,64.6,117,66.6,2,0,0
2/23/2018 18:10,54,69.8,72,65.3,126,67.2,2,0,0
2/23/2018 18:15,56,68.5,75,63.8,131,65.8,2,0,0
2/23/2018 18:20,53,68.2,71,63.4,124,65.5,2,0,0
2/23/2018 18:25,49,67.9,68,63.1,117,65.1,2,0,0
2/23/2018 18:30,53,67.1,71,62.3,124,64.3,2,0,0
2/23/2018 18:35,48,67.1,66,62.3,114,64.3,2,0,0
2/23/2018 18:40,50,67.9,68,63.1,118,65.1,2,0,0
2/23/2018 18:45,54,67.8,71,62.9,125,65,2,0,0
2/23/2018 18:50,51,68.5,68,63.8,119,65.8,2,0,0
2/23/2018 18:55,50,68.7,67,64,117,66,2,0,0
2/23/2018 19:00,42,67.7,59,63,101,64.9,2,0,0
2/23/2018 19:05,48,67.2,66,62.4,114,64.4,2,0,0
2/23/2018 19:10,37,67.7,54,62.8,91,64.8,2,0,0
2/23/2018 19:15,46,67.9,65,63.1,111,65.1,2,0,0
2/23/2018 19:20,52,68.2,70,63.5,122,65.5,2,0,0
2/23/2018 19:25,55,68,72,63.3,127,65.3,2,0,0
2/23/2018 19:30,50,67,68,62.1,118,64.2,2,0,0
2/23/2018 19:35,54,67.5,72,62.7,126,64.8,2,0,0
2/23/2018 19:40,47,67.7,64,62.9,111,64.9,2,0,0
2/23/2018 19:45,44,68.6,61,63.9,105,65.8,2,0,0
2/23/2018 19:50,36,69.3,53,64.7,89,66.5,2,0,0
2/23/2018 19:55,37,70.4,54,65.8,91,67.7,2,0,0
2/23/2018 20:00,42,69.2,60,64.6,102,66.5,2,0,0
2/23/2018 20:05,33,69.2,50,64.6,83,66.4,2,0,0
2/23/2018 20:10,32,69.5,48,64.9,80,66.8,2,0,0
2/23/2018 20:15,36,68.6,53,64,89,65.9,2,0,0
2/23/2018 20:20,39,68.4,56,63.7,95,65.6,2,0,0
2/23/2018 20:25,33,68.7,49,64,82,65.9,2,0,0
2/23/2018 20:30,34,69.1,51,64.5,85,66.3,2,0,0
2/23/2018 20:35,34,69.6,50,64.9,84,66.8,2,0,0
2/23/2018 20:40,33,69.8,50,65.2,83,67,2,0,0
2/23/2018 20:45,31,68.3,47,63.6,78,65.5,2,0,0
2/23/2018 20:50,36,68.3,53,63.6,89,65.5,2,0,0
2/23/2018 20:55,31,69,48,64.3,79,66.1,2,0,0
2/23/2018 21:00,27,69.3,43,64.6,70,66.4,2,0,0
2/23/2018 21:05,35,69.3,52,64.6,87,66.5,2,0,0
2/23/2018 21:10,35,69.1,52,64.4,87,66.3,2,0,0
2/23/2018 21:15,31,69.4,48,64.7,79,66.6,2,0,0
2/23/2018 21:20,31,69.3,48,64.7,79,66.5,2,0,0
2/23/2018 21:25,35,69.4,51,64.8,86,66.7,2,0,0
2/23/2018 21:30,37,69.3,54,64.7,91,66.5,2,0,0
2/23/2018 21:35,26,69.5,42,64.9,68,66.7,2,0,0
2/23/2018 21:40,29,68.5,45,63.8,74,65.6,2,0,0
2/23/2018 21:45,28,69.5,45,64.9,73,66.7,2,0,0
2/23/2018 21:50,26,68.9,42,64.3,68,66,2,0,0
2/23/2018 21:55,27,69.1,43,64.5,70,66.2,2,0,0
2/23/2018 22:00,29,68.9,45,64.2,74,66.1,2,0,0
2/23/2018 22:05,29,69.2,45,64.6,74,66.4,2,0,0
2/23/2018 22:10,29,68.9,46,64.3,75,66.1,2,0,0
2/23/2018 22:15,25,69.1,41,64.5,66,66.3,2,0,0
2/23/2018 22:20,28,68.7,45,64.1,73,65.9,2,0,0
2/23/2018 22:25,23,69,40,64.4,63,66.1,2,0,0
2/23/2018 22:30,21,69.1,37,64.5,58,66.2,2,0,0
2/23/2018 22:35,28,69.4,44,64.8,72,66.6,2,0,0
2/23/2018 22:40,22,69.3,37,64.7,59,66.4,2,0,0
2/23/2018 22:45,17,69.1,33,64.5,50,66.1,2,0,0
2/23/2018 22:50,20,69.4,36,64.8,56,66.5,2,0,0
2/23/2018 22:55,23,69.5,39,64.9,62,66.6,2,0,0
2/23/2018 23:00,20,69.3,35,64.6,55,66.3,2,0,0
2/23/2018 23:05,22,69.1,38,64.5,60,66.2,2,0,0
2/23/2018 23:10,23,69,39,64.4,62,66.1,2,0,0
2/23/2018 23:15,15,69.1,31,64.5,46,66,2,0,0
2/23/2018 23:20,21,69.2,36,64.5,57,66.2,2,0,0
2/23/2018 23:25,13,69.1,29,64.5,42,65.9,2,0,0
2/23/2018 23:30,17,69.3,33,64.7,50,66.2,2,0,0
2/23/2018 23:35,16,69.2,31,64.6,47,66.2,2,0,0
2/23/2018 23:40,20,69.4,36,64.8,56,66.4,2,0,0
2/23/2018 23:45,26,68.8,42,64.2,68,65.9,2,0,0
2/23/2018 23:50,15,69.2,31,64.6,46,66.1,2,0,0
2/23/2018 23:55,16,69.2,32,64.6,48,66.2,2,0,0
2/24/2018 0:00,16,69.3,32,64.7,48,66.3,2,0,0
2/24/2018 0:05,17,69.4,32,64.8,49,66.4,2,0,0
2/24/2018 0:10,14,69.4,30,64.8,44,66.3,2,0,0
2/24/2018 0:15,14,69.3,30,64.7,44,66.1,2,0,0
2/24/2018 0:20,10,69.4,26,64.8,36,66.1,2,0,0
2/24/2018 0:25,15,69.3,30,64.7,45,66.2,2,0,0
2/24/2018 0:30,15,69.4,30,64.8,45,66.3,2,0,0
2/24/2018 0:35,14,69,29,64.4,43,65.9,2,0,0
2/24/2018 0:40,12,69.2,27,64.6,39,66,2,0,0
2/24/2018 0:45,12,69.2,28,64.6,40,66,2,0,0
2/24/2018 0:50,13,69.3,28,64.7,41,66.2,2,0,0
2/24/2018 0:55,11,69.5,26,64.9,37,66.2,2,0,0
2/24/2018 1:00,9,69.4,24,64.8,33,66,2,0,0
2/24/2018 1:05,10,69.4,25,64.8,35,66.1,2,0,0
2/24/2018 1:10,7,69.3,22,64.7,29,65.8,2,0,0
2/24/2018 1:15,10,69.1,25,64.5,35,65.8,2,0,0
2/24/2018 1:20,9,69.3,24,64.7,33,65.9,2,0,0
2/24/2018 1:25,10,69.2,25,64.6,35,65.9,2,0,0
2/24/2018 1:30,9,69.3,24,64.7,33,65.9,2,0,0
2/24/2018 1:35,14,69.2,30,64.5,44,66,2,0,0
2/24/2018 1:40,11,69.2,26,64.6,37,66,2,0,0
2/24/2018 1:45,8,69.3,23,64.7,31,65.9,2,0,0
2/24/2018 1:50,9,69.3,24,64.7,33,66,2,0,0
2/24/2018 1:55,6,69.3,21,64.7,27,65.7,2,0,0
2/24/2018 2:00,6,69.2,21,64.6,27,65.6,2,0,0
2/24/2018 2:05,8,69.3,24,64.7,32,65.9,2,0,0
2/24/2018 2:10,10,69.4,25,64.8,35,66.1,2,0,0
2/24/2018 2:15,7,69.4,22,64.8,29,65.9,2,0,0
2/24/2018 2:20,7,69.3,23,64.7,30,65.8,2,0,0
2/24/2018 2:25,10,69.3,26,64.7,36,66,2,0,0
2/24/2018 2:30,7,69.3,22,64.7,29,65.8,2,0,0
2/24/2018 2:35,10,69.3,25,64.7,35,66,2,0,0
2/24/2018 2:40,8,69.3,23,64.7,31,65.8,2,0,0
2/24/2018 2:45,9,69.4,24,64.8,33,66.1,2,0,0
2/24/2018 2:50,9,69.4,25,64.8,34,66,2,0,0
2/24/2018 2:55,9,69,24,64.4,33,65.7,2,0,0
2/24/2018 3:00,9,69,24,64.4,33,65.7,2,0,0
2/24/2018 3:05,10,69.1,25,64.5,35,65.8,2,0,0
2/24/2018 3:10,7,69.2,22,64.6,29,65.7,2,0,0
2/24/2018 3:15,7,69.3,22,64.7,29,65.8,2,0,0
2/24/2018 3:20,7,69.4,22,64.8,29,65.9,2,0,0
2/24/2018 3:25,7,69.3,22,64.7,29,65.8,2,0,0
2/24/2018 3:30,9,69.3,25,64.7,34,66,2,0,0
2/24/2018 3:35,7,69.4,23,64.8,30,65.9,2,0,0
2/24/2018 3:40,9,69.1,25,64.5,34,65.7,2,0,0
2/24/2018 3:45,8,69.1,24,64.5,32,65.6,2,0,0
2/24/2018 3:50,8,69.2,23,64.6,31,65.8,2,0,0
2/24/2018 3:55,9,69.3,25,64.7,34,65.9,2,0,0
2/24/2018 4:00,8,69.3,23,64.7,31,65.9,2,0,0
2/24/2018 4:05,8,69.3,23,64.7,31,65.9,2,0,0
2/24/2018 4:10,11,69,26,64.3,37,65.7,2,0,0
2/24/2018 4:15,11,69.1,26,64.5,37,65.9,2,0,0
2/24/2018 4:20,11,69.2,26,64.6,37,66,2,0,0
2/24/2018 4:25,14,68.9,30,64.2,44,65.7,2,0,0
2/24/2018 4:30,16,69.2,32,64.5,48,66.1,2,0,0
2/24/2018 4:35,18,69.3,34,64.7,52,66.3,2,0,0
2/24/2018 4:40,15,69.3,30,64.7,45,66.3,2,0,0
2/24/2018 4:45,15,69.3,31,64.7,46,66.2,2,0,0
2/24/2018 4:50,20,69.4,36,64.8,56,66.5,2,0,0
2/24/2018 4:55,15,69.4,31,64.8,46,66.3,2,0,0
2/24/2018 5:00,15,69.3,31,64.7,46,66.2,2,0,0
2/24/2018 5:05,17,69.3,33,64.7,50,66.3,2,0,0
2/24/2018 5:10,16,68.8,32,64.2,48,65.8,2,0,0
2/24/2018 5:15,19,69,35,64.4,54,66,2,0,0
2/24/2018 5:20,12,69.1,28,64.5,40,65.9,2,0,0
2/24/2018 5:25,17,69,34,64.3,51,65.9,2,0,0
2/24/2018 5:30,16,68.9,32,64.3,48,65.9,2,0,0
2/24/2018 5:35,18,69,34,64.4,52,66,2,0,0
2/24/2018 5:40,25,68.7,41,64.1,66,65.8,2,0,0
2/24/2018 5:45,22,69.1,39,64.5,61,66.1,2,0,0
2/24/2018 5:50,22,69.3,38,64.7,60,66.4,2,0,0
2/24/2018 5:55,18,69.3,34,64.7,52,66.3,2,0,0
2/24/2018 6:00,21,69.2,36,64.6,57,66.3,2,0,0
2/24/2018 6:05,17,69,33,64.4,50,66,2,0,0
2/24/2018 6:10,15,69.2,31,64.6,46,66.1,2,0,0
2/24/2018 6:15,24,69.4,41,64.8,65,66.5,2,0,0
2/24/2018 6:20,22,69.1,38,64.5,60,66.2,2,0,0
2/24/2018 6:25,18,69.1,34,64.5,52,66.1,2,0,0
2/24/2018 6:30,21,68.6,37,64,58,65.7,2,0,0
2/24/2018 6:35,23,68.7,40,64.1,63,65.8,2,0,0
2/24/2018 6:40,27,68.8,44,64.2,71,65.9,2,0,0
2/24/2018 6:45,30,68.9,47,64.3,77,66.1,2,0,0
2/24/2018 6:50,24,68.5,40,63.9,64,65.6,2,0,0
2/24/2018 6:55,22,68.8,39,64.2,61,65.8,2,0,0
2/24/2018 7:00,23,69,40,64.4,63,66,2,0,0
2/24/2018 7:05,25,69.2,42,64.5,67,66.3,2,0,0
2/24/2018 7:10,28,68.3,44,63.6,72,65.5,2,0,0
2/24/2018 7:15,29,69.2,46,64.6,75,66.4,2,0,0
2/24/2018 7:20,35,68.7,52,64,87,65.9,2,0,0
2/24/2018 7:25,32,68.9,49,64.2,81,66.1,2,0,0
2/24/2018 7:30,35,68.2,50,63.5,85,65.5,2,0,0
2/24/2018 7:35,32,68.5,49,63.9,81,65.7,2,0,0
2/24/2018 7:40,36,68.6,53,63.9,89,65.8,2,0,0
2/24/2018 7:45,44,69.1,61,64.4,105,66.4,2,0,0
2/24/2018 7:50,45,69.7,62,65.1,107,67,2,0,0
2/24/2018 7:55,44,69.4,60,64.8,104,66.8,2,0,0
2/24/2018 8:00,33,70.6,29,64.6,62,67.8,2,0,0
2/24/2018 8:05,33,70.4,29,64.4,62,67.6,2,0,0
2/24/2018 8:10,34,70.4,30,64.4,64,67.6,2,0,0
2/24/2018 8:15,36,70.4,33,64.4,69,67.5,2,0,0
2/24/2018 8:20,39,70.4,35,64.4,74,67.6,2,0,0
2/24/2018 8:25,40,70.5,36,64.5,76,67.7,2,0,0
2/24/2018 8:30,42,70.6,38,64.6,80,67.8,2,0,0
2/24/2018 8:35,43,70.5,39,64.5,82,67.6,2,0,0
2/24/2018 8:40,46,70.6,41,64.6,87,67.8,2,0,0
2/24/2018 8:45,49,70.6,44,64.6,93,67.8,2,0,0
2/24/2018 8:50,51,70.6,45,64.6,96,67.8,2,0,0
2/24/2018 8:55,47,70.7,42,64.7,89,67.9,2,0,0
2/24/2018 9:00,45,70.6,41,64.6,86,67.7,2,0,0
2/24/2018 9:05,45,70.6,40,64.6,85,67.8,2,0,0
2/24/2018 9:10,46,70.5,41,64.5,87,67.7,2,0,0
2/24/2018 9:15,48,70.5,43,64.5,91,67.7,2,0,0
2/24/2018 9:20,51,70.5,45,64.5,96,67.7,2,0,0
2/24/2018 9:25,52,70.3,47,64.3,99,67.5,2,0,0
2/24/2018 9:30,53,70.4,47,64.4,100,67.6,2,0,0
2/24/2018 9:35,55,70.4,49,64.4,104,67.6,2,0,0
2/24/2018 9:40,57,70.3,52,64.3,109,67.4,2,0,0
2/24/2018 9:45,58,70.4,53,64.4,111,67.5,2,0,0
2/24/2018 9:50,61,70.4,54,64.4,115,67.6,2,0,0
2/24/2018 9:55,58,70.5,53,64.5,111,67.6,2,0,0
2/24/2018 10:00,56,70.4,51,64.4,107,67.5,2,0,0
2/24/2018 10:05,55,70.3,50,64.3,105,67.4,2,0,0
2/24/2018 10:10,57,70.3,52,64.3,109,67.4,2,0,0
2/24/2018 10:15,58,70.2,53,64.2,111,67.3,2,0,0
2/24/2018 10:20,59,70.2,53,64.2,112,67.4,2,0,0
2/24/2018 10:25,60,70.2,54,64.2,114,67.4,2,0,0
2/24/2018 10:30,61,70.2,55,64.2,116,67.4,2,0,0
2/24/2018 10:35,60,70.2,54,64.2,114,67.4,2,0,0
2/24/2018 10:40,63,70.2,57,64.2,120,67.4,2,0,0
2/24/2018 10:45,65,70.2,59,64.2,124,67.3,2,0,0
2/24/2018 10:50,65,70.2,58,64.2,123,67.4,2,0,0
2/24/2018 10:55,65,70.2,58,64.2,123,67.4,2,0,0
2/24/2018 11:00,64,70.2,57,64.2,121,67.4,2,0,0
2/24/2018 11:05,63,70.1,57,64.1,120,67.3,2,0,0
2/24/2018 11:10,65,70,58,64,123,67.2,2,0,0
2/24/2018 11:15,65,70.1,59,64.1,124,67.2,2,0,0
2/24/2018 11:20,66,69.9,59,63.9,125,67.1,2,0,0
2/24/2018 11:25,67,70.1,61,64.1,128,67.2,2,0,0
2/24/2018 11:30,67,70.2,60,64.2,127,67.4,2,0,0
2/24/2018 11:35,68,70,62,64,130,67.1,2,0,0
2/24/2018 11:40,70,70.1,62,64.1,132,67.3,2,0,0
2/24/2018 11:45,71,70.1,64,64.1,135,67.3,2,0,0
2/24/2018 11:50,73,70,65,64,138,67.2,2,0,0
2/24/2018 11:55,70,70,63,64,133,67.2,2,0,0
2/24/2018 12:00,71,70.1,63,64.1,134,67.3,2,0,0
2/24/2018 12:05,68,70,62,64,130,67.1,2,0,0
2/24/2018 12:10,72,69.9,64,63.9,136,67.1,2,0,0
2/24/2018 12:15,73,69.9,66,63.9,139,67.1,2,0,0
2/24/2018 12:20,72,69.9,64,63.9,136,67.1,2,0,0
2/24/2018 12:25,73,69.8,65,63.8,138,67,2,0,0
2/24/2018 12:30,74,69.8,66,63.8,140,67,2,0,0
2/24/2018 12:35,74,69.9,67,63.9,141,67,2,0,0
2/24/2018 12:40,75,69.9,68,63.9,143,67,2,0,0
2/24/2018 12:45,85,68.7,106,64,191,66.1,2,0,0
2/24/2018 12:50,61,67.3,80,62.4,141,64.5,2,0,0
2/24/2018 12:55,66,67.8,86,63,152,65,2,0,0
2/24/2018 13:00,60,68.5,79,63.9,139,65.9,2,0,0
2/24/2018 13:05,67,68.2,86,63.6,153,65.6,2,0,0
2/24/2018 13:10,66,68.6,84,63.9,150,66,2,0,0
2/24/2018 13:15,57,68.6,75,63.9,132,65.9,2,0,0
2/24/2018 13:20,63,67.7,81,62.8,144,64.9,2,0,0
2/24/2018 13:25,67,68.3,86,63.6,153,65.7,2,0,0
2/24/2018 13:30,72,68.5,91,63.8,163,65.9,2,0,0
2/24/2018 13:35,60,67.7,79,63,139,65.1,2,0,0
2/24/2018 13:40,58,67.5,76,62.8,134,64.8,2,0,0
2/24/2018 13:45,64,66.9,84,62.2,148,64.2,2,0,0
2/24/2018 13:50,70,67.8,90,63.1,160,65.2,2,0,0
2/24/2018 13:55,60,68.5,79,63.9,139,65.9,2,0,0
2/24/2018 14:00,63,68.1,82,63.4,145,65.5,2,0,0
2/24/2018 14:05,74,68,94,63.3,168,65.4,2,0,0
2/24/2018 14:10,59,67.5,77,62.6,136,64.7,2,0,0
2/24/2018 14:15,71,66.8,91,61.9,162,64,2,0,0
2/24/2018 14:20,59,67.4,78,62.5,137,64.6,2,0,0
2/24/2018 14:25,62,68,81,63.2,143,65.3,2,0,0
2/24/2018 14:30,63,67.8,82,62.9,145,65,2,0,0
2/24/2018 14:35,54,68.1,74,63.2,128,65.3,2,0,0
2/24/2018 14:40,62,67.7,80,62.8,142,64.9,2,0,0
2/24/2018 14:45,53,67.8,71,62.9,124,65,2,0,0
2/24/2018 14:50,57,68.2,75,63.4,132,65.5,2,0,0
2/24/2018 14:55,50,68.6,68,63.8,118,65.8,2,0,0
2/24/2018 15:00,51,68.6,70,63.8,121,65.8,2,0,0
2/24/2018 15:05,51,68.3,69,63.6,120,65.6,2,0,0
2/24/2018 15:10,52,68.2,70,63.5,122,65.5,2,0,0
2/24/2018 15:15,66,68,84,63.3,150,65.4,2,0,0
2/24/2018 15:20,60,68.3,80,63.5,140,65.6,2,0,0
2/24/2018 15:25,60,67.7,78,62.9,138,65,2,0,0
2/24/2018 15:30,67,67.2,86,62.3,153,64.4,2,0,0
2/24/2018 15:35,59,67.4,77,62.5,136,64.6,2,0,0
2/24/2018 15:40,77,67.6,97,62.8,174,64.9,2,0,0
2/24/2018 15:45,67,67.4,86,62.5,153,64.6,2,0,0
2/24/2018 15:50,70,67.6,89,62.8,159,64.9,2,0,0
2/24/2018 15:55,68,68.2,87,63.5,155,65.6,2,0,0
2/24/2018 16:00,73,68.2,92,63.4,165,65.5,2,0,0
2/24/2018 16:05,71,67.7,90,62.8,161,65,2,0,0
2/24/2018 16:10,65,68,84,63.2,149,65.3,2,0,0
2/24/2018 16:15,68,67.4,89,62.6,157,64.6,2,0,0
2/24/2018 16:20,70,67.7,89,62.9,159,65,2,0,0
2/24/2018 16:25,68,67.8,86,63,154,65.1,2,0,0
2/24/2018 16:30,70,68.2,89,63.4,159,65.5,2,0,0
2/24/2018 16:35,74,67.9,95,63.1,169,65.2,2,0,0
2/24/2018 16:40,62,67.6,81,62.8,143,64.9,2,0,0
2/24/2018 16:45,59,68.2,77,63.5,136,65.5,2,0,0
2/24/2018 16:50,61,68,81,63.3,142,65.3,2,0,0
2/24/2018 16:55,64,68.1,83,63.4,147,65.4,2,0,0
2/24/2018 17:00,61,68.8,80,64.1,141,66.2,2,0,0
2/24/2018 17:05,54,69,72,64.3,126,66.3,2,0,0
2/24/2018 17:10,59,68.5,78,63.8,137,65.8,2,0,0
2/24/2018 17:15,57,69.6,74,65,131,67,2,0,0
2/24/2018 17:20,54,69.6,72,65,126,67,2,0,0
2/24/2018 17:25,53,70.4,70,65.9,123,67.8,2,0,0
2/24/2018 17:30,67,69.7,86,65.1,153,67.1,2,0,0
2/24/2018 17:35,68,69.4,87,64.8,155,66.9,2,0,0
2/24/2018 17:40,74,69,93,64.4,167,66.4,2,0,0
2/24/2018 17:45,72,68.4,92,63.7,164,65.8,2,0,0
2/24/2018 17:50,57,69,75,64.3,132,66.3,2,0,0
2/24/2018 17:55,66,68.6,85,63.8,151,65.9,2,0,0
2/24/2018 18:00,53,69.1,70,64.5,123,66.5,2,0,0
2/24/2018 18:05,64,68.4,84,63.7,148,65.8,2,0,0
2/24/2018 18:10,52,68.3,70,63.5,122,65.6,2,0,0
2/24/2018 18:15,59,67.9,78,63.1,137,65.2,2,0,0
2/24/2018 18:20,48,68.8,65,64.1,113,66.1,2,0,0
2/24/2018 18:25,53,68.2,71,63.4,124,65.5,2,0,0
2/24/2018 18:30,61,68.3,79,63.6,140,65.7,2,0,0
2/24/2018 18:35,61,67.8,81,63,142,65,2,0,0
2/24/2018 18:40,52,68,69,63.2,121,65.3,2,0,0
2/24/2018 18:45,54,67.9,72,63.1,126,65.2,2,0,0
2/24/2018 18:50,51,67.9,68,63.2,119,65.2,2,0,0
2/24/2018 18:55,54,68.6,73,63.9,127,65.9,2,0,0
2/24/2018 19:00,49,68.3,67,63.5,116,65.5,2,0,0
2/24/2018 19:05,45,68.5,63,63.8,108,65.8,2,0,0
2/24/2018 19:10,48,69.4,65,64.8,113,66.7,2,0,0
2/24/2018 19:15,48,69.5,65,65,113,66.9,2,0,0
2/24/2018 19:20,41,69.5,58,64.9,99,66.8,2,0,0
2/24/2018 19:25,41,69,58,64.4,99,66.3,2,0,0
2/24/2018 19:30,47,69.6,64,65.1,111,67,2,0,0
2/24/2018 19:35,42,69.2,59,64.5,101,66.5,2,0,0
2/24/2018 19:40,34,68.9,51,64.2,85,66.1,2,0,0
2/24/2018 19:45,34,68.6,50,63.9,84,65.8,2,0,0
2/24/2018 19:50,35,68.5,51,63.8,86,65.7,2,0,0
2/24/2018 19:55,36,69.4,52,64.8,88,66.7,2,0,0
2/24/2018 20:00,37,69.1,54,64.5,91,66.4,2,0,0
2/24/2018 20:05,32,69.2,47,64.6,79,66.5,2,0,0
2/24/2018 20:10,35,69.1,53,64.5,88,66.3,2,0,0
2/24/2018 20:15,32,69.1,48,64.5,80,66.3,2,0,0
2/24/2018 20:20,24,69.1,39,64.5,63,66.3,2,0,0
2/24/2018 20:25,35,68.9,51,64.2,86,66.1,2,0,0
2/24/2018 20:30,32,69.2,48,64.5,80,66.4,2,0,0
2/24/2018 20:35,33,69.1,49,64.5,82,66.4,2,0,0
2/24/2018 20:40,30,69.5,46,64.9,76,66.7,2,0,0
2/24/2018 20:45,35,69.3,51,64.7,86,66.5,2,0,0
2/24/2018 20:50,28,69.5,44,64.9,72,66.7,2,0,0
2/24/2018 20:55,30,68.9,46,64.3,76,66.1,2,0,0
2/24/2018 21:00,30,69.1,47,64.5,77,66.3,2,0,0
2/24/2018 21:05,28,68.8,44,64.1,72,66,2,0,0
2/24/2018 21:10,41,68.6,58,64,99,65.9,2,0,0
2/24/2018 21:15,31,68.9,47,64.2,78,66.1,2,0,0
2/24/2018 21:20,30,69.1,46,64.5,76,66.3,2,0,0
2/24/2018 21:25,32,69.1,48,64.4,80,66.3,2,0,0
2/24/2018 21:30,36,69.4,52,64.7,88,66.6,2,0,0
2/24/2018 21:35,36,69.4,53,64.8,89,66.7,2,0,0
2/24/2018 21:40,29,69.2,46,64.5,75,66.3,2,0,0
2/24/2018 21:45,40,68.8,57,64.1,97,66,2,0,0
2/24/2018 21:50,33,68.7,51,63.9,84,65.8,2,0,0
2/24/2018 21:55,28,69.2,44,64.6,72,66.4,2,0,0
2/24/2018 22:00,30,68.8,46,64.2,76,66,2,0,0
2/24/2018 22:05,30,69.3,45,64.7,75,66.5,2,0,0
2/24/2018 22:10,33,69.2,49,64.5,82,66.4,2,0,0
2/24/2018 22:15,30,69,46,64.3,76,66.2,2,0,0
2/24/2018 22:20,30,69.2,46,64.6,76,66.4,2,0,0
2/24/2018 22:25,28,69.3,44,64.7,72,66.5,2,0,0
2/24/2018 22:30,28,69.5,45,64.9,73,66.7,2,0,0
2/24/2018 22:35,26,68.8,42,64.2,68,65.9,2,0,0
2/24/2018 22:40,28,69.1,44,64.5,72,66.3,2,0,0
2/24/2018 22:45,27,69.2,42,64.6,69,66.4,2,0,0
2/24/2018 22:50,26,69.4,42,64.7,68,66.5,2,0,0
2/24/2018 22:55,19,69.4,35,64.8,54,66.4,2,0,0
2/24/2018 23:00,23,69.6,39,65,62,66.7,2,0,0
2/24/2018 23:05,21,69.5,37,65,58,66.6,2,0,0
2/24/2018 23:10,21,69.4,36,64.8,57,66.5,2,0,0
2/24/2018 23:15,22,69.4,38,64.8,60,66.5,2,0,0
2/24/2018 23:20,23,69.4,39,64.8,62,66.6,2,0,0
2/24/2018 23:25,22,69.4,38,64.7,60,66.4,2,0,0
2/24/2018 23:30,19,69.5,35,64.9,54,66.5,2,0,0
2/24/2018 23:35,20,69.4,36,64.8,56,66.5,2,0,0
2/24/2018 23:40,22,69.2,37,64.6,59,66.3,2,0,0
2/24/2018 23:45,20,69.3,35,64.7,55,66.3,2,0,0
2/24/2018 23:50,21,69.5,36,64.9,57,66.6,2,0,0
2/24/2018 23:55,18,69.6,33,65,51,66.6,2,0,0
2/25/2018 0:00,17,69.3,32,64.7,49,66.3,2,0,0
2/25/2018 0:05,18,69.2,33,64.6,51,66.2,2,0,0
2/25/2018 0:10,18,69.5,33,64.9,51,66.5,2,0,0
2/25/2018 0:15,20,69.4,35,64.7,55,66.4,2,0,0
2/25/2018 0:20,16,69.3,31,64.7,47,66.2,2,0,0
2/25/2018 0:25,11,69.3,26,64.7,37,66.1,2,0,0
2/25/2018 0:30,13,69.2,28,64.6,41,66.1,2,0,0
2/25/2018 0:35,13,69.4,29,64.8,42,66.2,2,0,0
2/25/2018 0:40,14,69.2,29,64.6,43,66.1,2,0,0
2/25/2018 0:45,14,69.3,29,64.7,43,66.2,2,0,0
2/25/2018 0:50,11,69.3,26,64.7,37,66.1,2,0,0
2/25/2018 0:55,9,69.3,24,64.7,33,65.9,2,0,0
2/25/2018 1:00,14,69.3,29,64.7,43,66.2,2,0,0
2/25/2018 1:05,11,69.2,26,64.6,37,66,2,0,0
2/25/2018 1:10,11,69.4,26,64.8,37,66.2,2,0,0
2/25/2018 1:15,7,69.4,22,64.8,29,66,2,0,0
2/25/2018 1:20,10,69.3,25,64.7,35,66,2,0,0
2/25/2018 1:25,8,69.3,23,64.7,31,65.9,2,0,0
2/25/2018 1:30,9,69.3,24,64.7,33,66,2,0,0
2/25/2018 1:35,8,69.3,23,64.7,31,65.9,2,0,0
2/25/2018 1:40,9,69.3,24,64.7,33,65.9,2,0,0
2/25/2018 1:45,11,69.3,26,64.7,37,66,2,0,0
2/25/2018 1:50,10,69.2,25,64.6,35,65.9,2,0,0
2/25/2018 1:55,8,69.3,23,64.7,31,65.9,2,0,0
2/25/2018 2:00,6,69.3,21,64.7,27,65.7,2,0,0
2/25/2018 2:05,8,69.3,23,64.7,31,65.9,2,0,0
2/25/2018 2:10,9,69.3,24,64.7,33,65.9,2,0,0
2/25/2018 2:15,7,69.3,22,64.7,29,65.8,2,0,0
2/25/2018 2:20,10,69.3,25,64.7,35,66.1,2,0,0
2/25/2018 2:25,10,69.3,25,64.7,35,66.1,2,0,0
2/25/2018 2:30,9,69.2,24,64.6,33,65.9,2,0,0
2/25/2018 2:35,10,69.4,25,64.8,35,66.1,2,0,0
2/25/2018 2:40,9,69.3,24,64.7,33,66,2,0,0
2/25/2018 2:45,14,69.3,29,64.7,43,66.2,2,0,0
2/25/2018 2:50,7,69.3,22,64.7,29,65.8,2,0,0
2/25/2018 2:55,7,69.3,22,64.7,29,65.8,2,0,0
2/25/2018 3:00,6,69.3,21,64.7,27,65.8,2,0,0
2/25/2018 3:05,7,69.3,22,64.7,29,65.8,2,0,0
2/25/2018 3:10,8,69.2,23,64.6,31,65.8,2,0,0
2/25/2018 3:15,8,69,24,64.4,32,65.6,2,0,0
2/25/2018 3:20,12,69.2,21,64.6,33,66.3,2,0,0
2/25/2018 3:25,7,69.2,22,64.5,29,65.7,2,0,0
2/25/2018 3:30,7,69.2,23,64.6,30,65.7,2,0,0
2/25/2018 3:35,7,69.3,22,64.7,29,65.8,2,0,0
2/25/2018 3:40,9,69.3,24,64.7,33,65.9,2,0,0
2/25/2018 3:45,6,69.3,21,64.7,27,65.7,2,0,0
2/25/2018 3:50,6,69.4,21,64.8,27,65.8,2,0,0
2/25/2018 3:55,9,69.1,24,64.5,33,65.7,2,0,0
2/25/2018 4:00,6,69.2,21,64.6,27,65.6,2,0,0
2/25/2018 4:05,7,69.3,22,64.7,29,65.8,2,0,0
2/25/2018 4:10,7,69.2,22,64.6,29,65.7,2,0,0
2/25/2018 4:15,7,69.2,22,64.6,29,65.7,2,0,0
2/25/2018 4:20,8,69.2,24,64.5,32,65.7,2,0,0
2/25/2018 4:25,9,69.3,24,64.7,33,65.9,2,0,0
2/25/2018 4:30,9,69.3,24,64.7,33,66,2,0,0
2/25/2018 4:35,14,69.4,30,64.8,44,66.3,2,0,0
2/25/2018 4:40,8,69.3,24,64.7,32,65.9,2,0,0
2/25/2018 4:45,9,69.2,25,64.6,34,65.8,2,0,0
2/25/2018 4:50,12,69,27,64.4,39,65.8,2,0,0
2/25/2018 4:55,12,69.1,27,64.5,39,65.9,2,0,0
2/25/2018 5:00,7,69.2,22,64.5,29,65.7,2,0,0
2/25/2018 5:05,8,69.3,24,64.7,32,65.9,2,0,0
2/25/2018 5:10,12,69.5,27,64.9,39,66.3,2,0,0
2/25/2018 5:15,13,69.4,28,64.8,41,66.3,2,0,0
2/25/2018 5:20,12,69.3,27,64.7,39,66.1,2,0,0
2/25/2018 5:25,11,69.3,26,64.7,37,66.1,2,0,0
2/25/2018 5:30,16,69.4,32,64.8,48,66.3,2,0,0
2/25/2018 5:35,14,69.3,30,64.7,44,66.2,2,0,0
2/25/2018 5:40,21,69.4,37,64.8,58,66.5,2,0,0
2/25/2018 5:45,13,69.4,29,64.8,42,66.3,2,0,0
2/25/2018 5:50,11,69.4,27,64.8,38,66.1,2,0,0
2/25/2018 5:55,14,69.4,29,64.8,43,66.3,2,0,0
2/25/2018 6:00,16,69.2,31,64.6,47,66.2,2,0,0
2/25/2018 6:05,17,69,33,64.4,50,66,2,0,0
2/25/2018 6:10,13,69.2,29,64.6,42,66,2,0,0
2/25/2018 6:15,14,69.1,30,64.5,44,66,2,0,0
2/25/2018 6:20,16,68.9,32,64.3,48,65.8,2,0,0
2/25/2018 6:25,17,69,32,64.3,49,65.9,2,0,0
2/25/2018 6:30,17,69.1,33,64.5,50,66.1,2,0,0
2/25/2018 6:35,18,69.1,33,64.5,51,66.1,2,0,0
2/25/2018 6:40,19,69,34,64.4,53,66,2,0,0
2/25/2018 6:45,21,69.1,37,64.5,58,66.2,2,0,0
2/25/2018 6:50,18,69.2,34,64.5,52,66.1,2,0,0
2/25/2018 6:55,21,69.3,37,64.7,58,66.4,2,0,0
2/25/2018 7:00,13,69.3,28,64.7,41,66.2,2,0,0
2/25/2018 7:05,19,69.1,36,64.5,55,66.1,2,0,0
2/25/2018 7:10,23,69.3,40,64.7,63,66.4,2,0,0
2/25/2018 7:15,23,69.4,38,64.8,61,66.5,2,0,0
2/25/2018 7:20,24,69.4,39,64.8,63,66.5,2,0,0
2/25/2018 7:25,22,69.1,38,64.4,60,66.1,2,0,0
2/25/2018 7:30,24,68.9,39,64.3,63,66,2,0,0
2/25/2018 7:35,19,69,35,64.4,54,66,2,0,0
2/25/2018 7:40,28,69.4,45,64.8,73,66.5,2,0,0
2/25/2018 7:45,28,69,44,64.4,72,66.2,2,0,0
2/25/2018 7:50,22,69.2,38,64.6,60,66.3,2,0,0
2/25/2018 7:55,30,69.2,47,64.6,77,66.4,2,0,0
2/25/2018 8:00,25,69,41,64.4,66,66.2,2,0,0
2/25/2018 8:05,23,69.1,39,64.5,62,66.2,2,0,0
2/25/2018 8:10,33,69,50,64.4,83,66.2,2,0,0
2/25/2018 8:15,28,68.7,45,64.1,73,65.8,2,0,0
2/25/2018 8:20,30,68.7,46,64,76,65.8,2,0,0
2/25/2018 8:25,33,68.8,50,64.1,83,66,2,0,0
2/25/2018 8:30,26,68.9,43,64.2,69,66,2,0,0
2/25/2018 8:35,41,68.7,59,64.1,100,66,2,0,0
2/25/2018 8:40,33,69.4,50,64.8,83,66.7,2,0,0
2/25/2018 8:45,28,69.6,44,65,72,66.8,2,0,0
2/25/2018 8:50,33,69.5,50,64.9,83,66.7,2,0,0
2/25/2018 8:55,35,69.2,52,64.6,87,66.5,2,0,0
2/25/2018 9:00,25,68.9,42,64.3,67,66,2,0,0
2/25/2018 9:05,36,68.7,52,64,88,65.9,2,0,0
2/25/2018 9:10,38,68.8,55,64.2,93,66.1,2,0,0
2/25/2018 9:15,39,69.6,56,65,95,66.8,2,0,0
2/25/2018 9:20,37,69.3,54,64.7,91,66.5,2,0,0
2/25/2018 9:25,39,69.3,56,64.7,95,66.6,2,0,0
2/25/2018 9:30,43,69.5,61,64.9,104,66.8,2,0,0
2/25/2018 9:35,48,68.8,65,64.1,113,66.1,2,0,0
2/25/2018 9:40,49,67.5,67,62.6,116,64.7,2,0,0
2/25/2018 9:45,45,68.1,63,63.4,108,65.4,2,0,0
2/25/2018 9:50,43,69.2,60,64.5,103,66.5,2,0,0
2/25/2018 9:55,57,69,74,64.4,131,66.4,2,0,0
2/25/2018 10:00,44,68.9,62,64.2,106,66.2,2,0,0
2/25/2018 10:05,50,69.2,69,64.6,119,66.6,2,0,0
2/25/2018 10:10,47,68.9,64,64.3,111,66.2,2,0,0
2/25/2018 10:15,58,69.6,76,65,134,67,2,0,0
2/25/2018 10:20,52,69.9,70,65.3,122,67.2,2,0,0
2/25/2018 10:25,62,69.5,81,64.9,143,66.8,2,0,0
2/25/2018 10:30,52,68.8,70,64.1,122,66.1,2,0,0
2/25/2018 10:35,43,68.5,60,63.8,103,65.7,2,0,0
2/25/2018 10:40,54,67.9,73,63.1,127,65.2,2,0,0
2/25/2018 10:45,52,67.6,70,62.8,122,64.8,2,0,0
2/25/2018 10:50,54,67.9,71,63.1,125,65.2,2,0,0
2/25/2018 10:55,48,67.9,65,63.2,113,65.2,2,0,0
2/25/2018 11:00,48,68.6,66,63.9,114,65.9,2,0,0
2/25/2018 11:05,46,68.7,64,64,110,66,2,0,0
2/25/2018 11:10,45,69.3,62,64.6,107,66.6,2,0,0
2/25/2018 11:15,56,68.4,74,63.7,130,65.7,2,0,0
2/25/2018 11:20,66,68.9,85,64.2,151,66.2,2,0,0
2/25/2018 11:25,59,68,77,63.2,136,65.3,2,0,0
2/25/2018 11:30,55,68.5,74,63.8,129,65.8,2,0,0
2/25/2018 11:35,52,68.8,71,64,123,66,2,0,0
2/25/2018 11:40,57,68.4,75,63.6,132,65.7,2,0,0
2/25/2018 11:45,64,68,82,63.2,146,65.3,2,0,0
2/25/2018 11:50,62,68.5,80,63.8,142,65.8,2,0,0
2/25/2018 11:55,60,68.3,79,63.6,139,65.6,2,0,0
2/25/2018 12:00,55,68.2,73,63.4,128,65.4,2,0,0
2/25/2018 12:05,57,67.9,75,63.1,132,65.2,2,0,0
2/25/2018 12:10,63,67.9,81,63.2,144,65.2,2,0,0
2/25/2018 12:15,64,68,82,63.2,146,65.3,2,0,0
2/25/2018 12:20,64,68.4,81,63.7,145,65.8,2,0,0
2/25/2018 12:25,62,67.9,80,63.2,142,65.2,2,0,0
2/25/2018 12:30,58,68.3,76,63.6,134,65.7,2,0,0
2/25/2018 12:35,62,68.5,81,63.8,143,65.8,2,0,0
2/25/2018 12:40,55,68.6,73,63.9,128,65.9,2,0,0
2/25/2018 12:45,70,68.2,90,63.5,160,65.6,2,0,0
2/25/2018 12:50,56,68.5,74,63.7,130,65.8,2,0,0
2/25/2018 12:55,63,67.6,83,62.7,146,64.8,2,0,0
2/25/2018 13:00,65,67.2,83,62.3,148,64.5,2,0,0
2/25/2018 13:05,47,67.8,65,63,112,65,2,0,0
2/25/2018 13:10,58,67.3,77,62.4,135,64.5,2,0,0
2/25/2018 13:15,63,68.2,82,63.5,145,65.6,2,0,0
2/25/2018 13:20,64,68,82,63.2,146,65.3,2,0,0
2/25/2018 13:25,56,68,75,63.2,131,65.2,2,0,0
2/25/2018 13:30,64,68.6,83,63.9,147,66,2,0,0
2/25/2018 13:35,64,68.4,82,63.6,146,65.7,2,0,0
2/25/2018 13:40,65,68.5,83,63.8,148,65.8,2,0,0
2/25/2018 13:45,64,68.5,83,63.8,147,65.9,2,0,0
2/25/2018 13:50,65,68.9,86,64.3,151,66.3,2,0,0
2/25/2018 13:55,62,68.5,81,63.8,143,65.9,2,0,0
2/25/2018 14:00,60,68.7,77,64,137,66,2,0,0
2/25/2018 14:05,62,68.2,80,63.4,142,65.5,2,0,0
2/25/2018 14:10,58,68.7,77,64,135,66,2,0,0
2/25/2018 14:15,56,69.3,73,64.7,129,66.7,2,0,0
2/25/2018 14:20,64,68.8,83,64.1,147,66.1,2,0,0
2/25/2018 14:25,56,68.7,74,64,130,66,2,0,0
2/25/2018 14:30,54,68.2,72,63.4,126,65.5,2,0,0
2/25/2018 14:35,65,67.6,84,62.7,149,64.8,2,0,0
2/25/2018 14:40,60,66.9,78,62,138,64.1,2,0,0
2/25/2018 14:45,55,66.9,74,62,129,64.1,2,0,0
2/25/2018 14:50,67,68.3,86,63.5,153,65.6,2,0,0
2/25/2018 14:55,75,67.9,95,63.1,170,65.2,2,0,0
2/25/2018 15:00,68,68,87,63.3,155,65.4,2,0,0
2/25/2018 15:05,69,68,88,63.2,157,65.3,2,0,0
2/25/2018 15:10,59,68.6,78,63.9,137,65.9,2,0,0
2/25/2018 15:15,63,68.1,81,63.3,144,65.4,2,0,0
2/25/2018 15:20,58,68.3,77,63.5,135,65.6,2,0,0
2/25/2018 15:25,57,68,75,63.2,132,65.2,2,0,0
2/25/2018 15:30,60,68.1,78,63.4,138,65.4,2,0,0
2/25/2018 15:35,56,68.1,73,63.3,129,65.4,2,0,0
2/25/2018 15:40,62,67.8,80,63,142,65.1,2,0,0
2/25/2018 15:45,54,67.9,72,63.1,126,65.2,2,0,0
2/25/2018 15:50,51,68.7,69,63.9,120,65.9,2,0,0
2/25/2018 15:55,53,68,71,63.2,124,65.2,2,0,0
2/25/2018 16:00,44,68.7,61,64,105,65.9,2,0,0
2/25/2018 16:05,50,68.5,67,63.8,117,65.8,2,0,0
2/25/2018 16:10,52,69.1,68,64.4,120,66.5,2,0,0
2/25/2018 16:15,61,68.7,80,64,141,66,2,0,0
2/25/2018 16:20,54,68.7,72,64,126,66,2,0,0
2/25/2018 16:25,52,68.1,69,63.3,121,65.4,2,0,0
2/25/2018 16:30,59,68.3,78,63.6,137,65.6,2,0,0
2/25/2018 16:35,60,68.4,78,63.6,138,65.7,2,0,0
2/25/2018 16:40,64,69,82,64.3,146,66.4,2,0,0
2/25/2018 16:45,55,68.6,73,63.8,128,65.8,2,0,0
2/25/2018 16:50,56,68.2,74,63.5,130,65.5,2,0,0
2/25/2018 16:55,53,68.6,71,63.8,124,65.9,2,0,0
2/25/2018 17:00,65,67.8,84,63,149,65.1,2,0,0
2/25/2018 17:05,51,68,69,63.2,120,65.3,2,0,0
2/25/2018 17:10,52,67.9,70,63.1,122,65.1,2,0,0
2/25/2018 17:15,56,68.3,74,63.5,130,65.5,2,0,0
2/25/2018 17:20,61,68.7,80,64,141,66.1,2,0,0
2/25/2018 17:25,68,68.5,87,63.8,155,65.8,2,0,0
2/25/2018 17:30,55,69.4,73,64.7,128,66.7,2,0,0
2/25/2018 17:35,50,69.5,67,64.9,117,66.9,2,0,0
2/25/2018 17:40,61,69,79,64.3,140,66.3,2,0,0
2/25/2018 17:45,63,68.4,83,63.7,146,65.7,2,0,0
2/25/2018 17:50,58,68.7,76,64.1,134,66.1,2,0,0
2/25/2018 17:55,51,68.4,69,63.7,120,65.7,2,0,0
2/25/2018 18:00,57,69,75,64.3,132,66.3,2,0,0
2/25/2018 18:05,51,69.3,69,64.7,120,66.6,2,0,0
2/25/2018 18:10,54,68.4,71,63.7,125,65.7,2,0,0
2/25/2018 18:15,58,68.7,77,63.9,135,66,2,0,0
2/25/2018 18:20,58,68.9,76,64.3,134,66.3,2,0,0
2/25/2018 18:25,54,69.2,72,64.6,126,66.6,2,0,0
2/25/2018 18:30,52,69.1,69,64.4,121,66.4,2,0,0
2/25/2018 18:35,49,68.5,66,63.8,115,65.8,2,0,0
2/25/2018 18:40,53,68.1,70,63.3,123,65.4,2,0,0
2/25/2018 18:45,56,68.5,75,63.8,131,65.8,2,0,0
2/25/2018 18:50,52,68.6,70,63.9,122,65.9,2,0,0
2/25/2018 18:55,50,68.8,67,64.1,117,66.1,2,0,0
2/25/2018 19:00,47,69.4,64,64.8,111,66.8,2,0,0
2/25/2018 19:05,42,69.8,58,65.2,100,67.2,2,0,0
2/25/2018 19:10,33,69.6,49,65,82,66.9,2,0,0
2/25/2018 19:15,30,68.9,46,64.2,76,66.1,2,0,0
2/25/2018 19:20,26,69.2,42,64.6,68,66.3,2,0,0
2/25/2018 19:25,31,69.7,47,65.1,78,66.9,2,0,0
2/25/2018 19:30,28,69.6,44,65,72,66.8,2,0,0
2/25/2018 19:35,22,69.5,37,64.9,59,66.6,2,0,0
2/25/2018 19:40,26,69,42,64.4,68,66.2,2,0,0
2/25/2018 19:45,33,69.2,50,64.6,83,66.4,2,0,0
2/25/2018 19:50,23,69.3,38,64.7,61,66.4,2,0,0
2/25/2018 19:55,26,69.3,42,64.7,68,66.5,2,0,0
2/25/2018 20:00,23,69.4,39,64.8,62,66.5,2,0,0
2/25/2018 20:05,32,69.5,49,64.9,81,66.7,2,0,0
2/25/2018 20:10,26,69.3,42,64.6,68,66.4,2,0,0
2/25/2018 20:15,29,69.7,44,65.1,73,66.9,2,0,0
2/25/2018 20:20,35,69.6,51,65.1,86,66.9,2,0,0
2/25/2018 20:25,39,69.1,56,64.5,95,66.4,2,0,0
2/25/2018 20:30,35,69.1,51,64.5,86,66.4,2,0,0
2/25/2018 20:35,32,69,48,64.4,80,66.2,2,0,0
2/25/2018 20:40,38,69.2,54,64.5,92,66.4,2,0,0
2/25/2018 20:45,41,68.8,57,64.2,98,66.1,2,0,0
2/25/2018 20:50,27,68.1,44,63.4,71,65.2,2,0,0
2/25/2018 20:55,33,68.3,49,63.6,82,65.5,2,0,0
2/25/2018 21:00,34,68.4,50,63.6,84,65.5,2,0,0
2/25/2018 21:05,32,69.1,48,64.4,80,66.3,2,0,0
2/25/2018 21:10,30,69,46,64.4,76,66.2,2,0,0
2/25/2018 21:15,31,69.6,47,65,78,66.8,2,0,0
2/25/2018 21:20,31,69.2,47,64.6,78,66.4,2,0,0
2/25/2018 21:25,27,69.2,43,64.7,70,66.4,2,0,0
2/25/2018 21:30,25,69.3,42,64.7,67,66.4,2,0,0
2/25/2018 21:35,33,69.1,49,64.5,82,66.4,2,0,0
2/25/2018 21:40,27,69.2,43,64.7,70,66.4,2,0,0
2/25/2018 21:45,33,69,50,64.4,83,66.2,2,0,0
2/25/2018 21:50,33,69.2,49,64.5,82,66.4,2,0,0
2/25/2018 21:55,33,69,50,64.3,83,66.1,2,0,0
2/25/2018 22:00,27,69,42,64.4,69,66.2,2,0,0
2/25/2018 22:05,27,69,43,64.4,70,66.1,2,0,0
2/25/2018 22:10,30,68.8,46,64.1,76,66,2,0,0
2/25/2018 22:15,23,68.8,39,64.2,62,65.9,2,0,0
2/25/2018 22:20,26,68.9,42,64.2,68,66,2,0,0
2/25/2018 22:25,25,69,41,64.3,66,66.1,2,0,0
2/25/2018 22:30,21,69,37,64.4,58,66.1,2,0,0
2/25/2018 22:35,21,68.8,37,64.2,58,65.9,2,0,0
2/25/2018 22:40,26,69.2,42,64.6,68,66.4,2,0,0
2/25/2018 22:45,18,68.9,33,64.3,51,65.9,2,0,0
2/25/2018 22:50,19,69.3,34,64.7,53,66.3,2,0,0
2/25/2018 22:55,15,69.1,30,64.5,45,66,2,0,0
2/25/2018 23:00,15,69.2,31,64.5,46,66.1,2,0,0
2/25/2018 23:05,14,69.2,30,64.6,44,66.1,2,0,0
2/25/2018 23:10,15,69.3,31,64.7,46,66.2,2,0,0
2/25/2018 23:15,19,69.5,35,64.9,54,66.5,2,0,0
2/25/2018 23:20,16,69.4,32,64.8,48,66.3,2,0,0
2/25/2018 23:25,16,69.3,32,64.7,48,66.3,2,0,0
2/25/2018 23:30,13,69.3,29,64.7,42,66.1,2,0,0
2/25/2018 23:35,17,69.2,32,64.6,49,66.2,2,0,0
2/25/2018 23:40,16,69,31,64.3,47,65.9,2,0,0
2/25/2018 23:45,13,68.7,28,64.1,41,65.6,2,0,0
2/25/2018 23:50,15,69,30,64.4,45,65.9,2,0,0
2/25/2018 23:55,9,69.2,24,64.5,33,65.8,2,0,0
