5 Minutes,Lane 1 Flow (Veh/5 Minutes),Lane 1 Speed (mph),Lane 2 Flow (Veh/5 Minutes),Lane 2 Speed (mph),Flow (Veh/5 Minutes),Speed (mph),# Lane Points,% Observed,Holiday
2/26/2018 0:00,12,69.3,28,64.7,40,66.1,2,0,0
2/26/2018 0:05,13,69.2,28,64.6,41,66.1,2,0,0
2/26/2018 0:10,8,69.3,23,64.7,31,65.8,2,0,0
2/26/2018 0:15,7,69.3,22,64.7,29,65.8,2,0,0
2/26/2018 0:20,11,69.3,26,64.7,37,66.1,2,0,0
2/26/2018 0:25,9,69.3,24,64.7,33,66,2,0,0
2/26/2018 0:30,5,69.3,21,64.7,26,65.6,2,0,0
2/26/2018 0:35,9,69.3,24,64.7,33,65.9,2,0,0
2/26/2018 0:40,7,69.1,23,64.5,30,65.6,2,0,0
2/26/2018 0:45,9,69.4,24,64.8,33,66,2,0,0
2/26/2018 0:50,9,69.3,24,64.7,33,65.9,2,0,0
2/26/2018 0:55,6,69.3,21,64.7,27,65.7,2,0,0
2/26/2018 1:00,5,69.1,20,64.5,25,65.4,2,0,0
2/26/2018 1:05,5,69.2,21,64.6,26,65.5,2,0,0
2/26/2018 1:10,7,69.3,22,64.7,29,65.8,2,0,0
2/26/2018 1:15,6,69.3,21,64.7,27,65.8,2,0,0
2/26/2018 1:20,9,69.3,24,64.7,33,66,2,0,0
2/26/2018 1:25,7,69.4,22,64.8,29,65.9,2,0,0
2/26/2018 1:30,8,69.3,19,64.7,27,66.1,2,0,0
2/26/2018 1:35,9,69.3,24,64.7,33,65.9,2,0,0
2/26/2018 1:40,6,69.2,21,64.6,27,65.7,2,0,0
2/26/2018 1:45,9,69,24,64.4,33,65.7,2,0,0
2/26/2018 1:50,7,69.2,22,64.5,29,65.7,2,0,0
2/26/2018 1:55,12,69.2,21,64.6,33,66.3,2,0,0
2/26/2018 2:00,8,69.2,23,64.5,31,65.7,2,0,0
2/26/2018 2:05,10,69.2,20,64.5,30,66.1,2,0,0
2/26/2018 2:10,12,69.2,21,64.5,33,66.2,2,0,0
2/26/2018 2:15,5,69.1,20,64.5,25,65.4,2,0,0
2/26/2018 2:20,7,69.2,22,64.6,29,65.7,2,0,0
2/26/2018 2:25,5,69.2,21,64.5,26,65.4,2,0,0
2/26/2018 2:30,8,69.2,24,64.6,32,65.8,2,0,0
2/26/2018 2:35,8,69.2,23,64.6,31,65.8,2,0,0
2/26/2018 2:40,5,69.2,21,64.6,26,65.5,2,0,0
2/26/2018 2:45,8,69.3,24,64.7,32,65.8,2,0,0
2/26/2018 2:50,10,69.4,26,64.8,36,66.1,2,0,0
2/26/2018 2:55,9,69.3,25,64.7,34,65.9,2,0,0
2/26/2018 3:00,10,69.3,26,64.7,36,66,2,0,0
2/26/2018 3:05,8,69.3,23,64.7,31,65.9,2,0,0
2/26/2018 3:10,8,69.2,24,64.6,32,65.7,2,0,0
2/26/2018 3:15,6,69.3,22,64.7,28,65.6,2,0,0
2/26/2018 3:20,6,69.1,22,64.5,28,65.5,2,0,0
2/26/2018 3:25,8,69.2,23,64.5,31,65.7,2,0,0
2/26/2018 3:30,10,69.4,25,64.8,35,66.1,2,0,0
2/26/2018 3:35,16,69.4,32,64.8,48,66.3,2,0,0
2/26/2018 3:40,14,69.5,30,64.9,44,66.3,2,0,0
2/26/2018 3:45,16,69.4,32,64.8,48,66.3,2,0,0
2/26/2018 3:50,13,69,28,64.4,41,65.9,2,0,0
2/26/2018 3:55,18,69.1,33,64.5,51,66.1,2,0,0
2/26/2018 4:00,13,69,29,64.4,42,65.8,2,0,0
2/26/2018 4:05,17,69.1,33,64.4,50,66,2,0,0
2/26/2018 4:10,20,69.3,36,64.7,56,66.3,2,0,0
2/26/2018 4:15,22,69.5,39,64.9,61,66.5,2,0,0
2/26/2018 4:20,21,69.1,38,64.5,59,66.1,2,0,0
2/26/2018 4:25,23,69.3,40,64.7,63,66.4,2,0,0
2/26/2018 4:30,31,69,49,64.3,80,66.1,2,0,0
2/26/2018 4:35,34,68.7,52,64.1,86,65.9,2,0,0
2/26/2018 4:40,37,68.9,54,64.3,91,66.2,2,0,0
2/26/2018 4:45,41,69.8,59,65.3,100,67.2,2,0,0
2/26/2018 4:50,40,69.2,58,64.6,98,66.5,2,0,0
2/26/2018 4:55,40,68.8,58,64.2,98,66.1,2,0,0
2/26/2018 5:00,43,70.1,62,65.7,105,67.5,2,0,0
2/26/2018 5:05,41,69.4,59,64.8,100,66.7,2,0,0
2/26/2018 5:10,45,68.6,64,63.9,109,65.8,2,0,0
2/26/2018 5:15,50,67.9,70,63.1,120,65.1,2,0,0
2/26/2018 5:20,56,68.2,76,63.5,132,65.5,2,0,0
2/26/2018 5:25,58,68.1,78,63.4,136,65.4,2,0,0
2/26/2018 5:30,54,66.7,75,61.8,129,63.8,2,0,0
2/26/2018 5:35,56,67.5,77,62.7,133,64.7,2,0,0
2/26/2018 5:40,61,66.4,81,61.4,142,63.6,2,0,0
2/26/2018 5:45,58,65.8,78,60.8,136,63,2,0,0
2/26/2018 5:50,57,64.9,78,59.8,135,61.9,2,0,0
2/26/2018 5:55,65,64.5,87,59.3,152,61.5,2,0,0
2/26/2018 6:00,58,65.2,77,60.1,135,62.3,2,0,0
2/26/2018 6:05,54,65.6,75,60.5,129,62.6,2,0,0
2/26/2018 6:10,59,66.6,80,61.6,139,63.7,2,0,0
2/26/2018 6:15,62,65.5,83,60.4,145,62.6,2,0,0
2/26/2018 6:20,70,65,94,59.9,164,62.1,2,0,0
2/26/2018 6:25,53,65.4,72,60.4,125,62.5,2,0,0
2/26/2018 6:30,54,66.5,74,61.6,128,63.7,2,0,0
2/26/2018 6:35,64,66.5,85,61.5,149,63.7,2,0,0
2/26/2018 6:40,64,65.8,85,60.7,149,62.9,2,0,0
2/26/2018 6:45,68,65.2,89,60.1,157,62.3,2,0,0
2/26/2018 6:50,65,65.3,87,60.2,152,62.4,2,0,0
2/26/2018 6:55,56,66.5,77,61.6,133,63.7,2,0,0
2/26/2018 7:00,68,66.2,90,61.3,158,63.4,2,0,0
2/26/2018 7:05,58,66.8,79,61.9,137,64,2,0,0
2/26/2018 7:10,66,65.9,87,60.9,153,63,2,0,0
2/26/2018 7:15,72,64.6,93,59.4,165,61.7,2,0,0
2/26/2018 7:20,78,62.8,101,57.4,179,59.7,2,0,0
2/26/2018 7:25,74,63,96,57.7,170,60,2,0,0
2/26/2018 7:30,74,64.4,95,59.2,169,61.4,2,0,0
2/26/2018 7:35,82,64.7,105,59.4,187,61.7,2,0,0
2/26/2018 7:40,78,64.7,101,59.5,179,61.8,2,0,0
2/26/2018 7:45,83,64.3,106,59.1,189,61.4,2,0,0
2/26/2018 7:50,83,64.6,105,59.4,188,61.7,2,0,0
2/26/2018 7:55,81,64.4,104,59.2,185,61.4,2,0,0
2/26/2018 8:00,85,64.8,108,59.6,193,61.9,2,0,0
2/26/2018 8:05,74,64.2,97,59.1,171,61.3,2,0,0
2/26/2018 8:10,81,64.2,105,59,186,61.3,2,0,0
2/26/2018 8:15,66,63.6,88,58.4,154,60.6,2,0,0
2/26/2018 8:20,76,64.1,99,59,175,61.2,2,0,0
2/26/2018 8:25,67,64.2,88,59,155,61.2,2,0,0
2/26/2018 8:30,73,66.1,94,61.1,167,63.3,2,0,0
2/26/2018 8:35,75,65,98,59.9,173,62.1,2,0,0
2/26/2018 8:40,75,66.7,96,61.7,171,63.9,2,0,0
2/26/2018 8:45,80,66.4,102,61.4,182,63.6,2,0,0
2/26/2018 8:50,74,65.2,96,60.2,170,62.4,2,0,0
2/26/2018 8:55,63,66,82,61.1,145,63.2,2,0,0
2/26/2018 9:00,68,65.3,89,60.3,157,62.5,2,0,0
2/26/2018 9:05,65,67,86,62,151,64.2,2,0,0
2/26/2018 9:10,70,67.6,90,62.7,160,64.8,2,0,0
2/26/2018 9:15,65,67.5,85,62.6,150,64.8,2,0,0
2/26/2018 9:20,79,66.5,100,61.6,179,63.8,2,0,0
2/26/2018 9:25,70,65.7,91,60.7,161,62.9,2,0,0
2/26/2018 9:30,78,65,99,59.9,177,62.2,1,0,0
2/26/2018 9:35,76,64.4,99,59.3,175,61.5,1,0,0
2/26/2018 9:40,67,65.3,88,60.3,155,62.4,1,0,0
2/26/2018 9:45,83,63.2,104,58.1,187,60.4,1,0,0
2/26/2018 9:50,83,63.5,106,58.3,189,60.6,1,0,0
2/26/2018 9:55,72,64.4,93,59.4,165,61.6,1,0,0
2/26/2018 10:00,79,64.1,99,59,178,61.3,1,0,0
2/26/2018 10:05,65,64.8,85,59.8,150,62,1,0,0
2/26/2018 10:10,69,66.3,89,61.4,158,63.5,1,0,0
2/26/2018 10:15,55,67.2,74,62.3,129,64.4,1,0,0
2/26/2018 10:20,65,66.9,85,62,150,64.1,1,0,0
2/26/2018 10:25,66,67.8,85,63.1,151,65.1,1,0,0
2/26/2018 10:30,67,67.7,86,63,153,65.1,1,0,0
2/26/2018 10:35,55,68.6,74,64,129,66,1,0,0
2/26/2018 10:40,62,68.1,81,63.4,143,65.5,1,0,0
2/26/2018 10:45,58,67.9,76,63.2,134,65.2,1,0,0
2/26/2018 10:50,57,67,76,62.1,133,64.2,1,0,0
2/26/2018 10:55,55,67.6,74,62.7,129,64.8,1,0,0
2/26/2018 11:00,56,65.9,74,61,130,63.1,1,0,0
2/26/2018 11:05,50,66.6,69,61.7,119,63.7,1,0,0
2/26/2018 11:10,56,67.1,74,62.3,130,64.3,1,0,0
2/26/2018 11:15,56,67.1,74,62.3,130,64.4,1,0,0
2/26/2018 11:20,54,67.1,73,62.3,127,64.3,1,0,0
2/26/2018 11:25,59,65.6,77,60.7,136,62.8,1,0,0
2/26/2018 11:30,45,67.4,62,62.7,107,64.7,1,0,0
2/26/2018 11:35,53,66.3,71,61.5,124,63.6,1,0,0
2/26/2018 11:40,48,66.3,66,61.5,114,63.5,1,0,0
2/26/2018 11:45,58,65.9,76,61.1,134,63.2,1,0,0
2/26/2018 11:50,48,67.7,66,63,114,65,1,0,0
2/26/2018 11:55,55,67.1,73,62.4,128,64.4,1,0,0
2/26/2018 12:00,51,64.3,69,59.4,120,61.5,1,0,0
2/26/2018 12:05,49,65.4,67,60.5,116,62.6,1,0,0
2/26/2018 12:10,55,67.1,73,62.3,128,64.4,1,0,0
2/26/2018 12:15,54,67.5,73,62.8,127,64.8,1,0,0
2/26/2018 12:20,60,68.2,79,63.5,139,65.5,1,0,0
2/26/2018 12:25,57,65.8,75,61,132,63,1,0,0
2/26/2018 12:30,48,65.9,66,61.1,114,63.1,1,0,0
2/26/2018 12:35,50,66.3,67,61.4,117,63.5,1,0,0
2/26/2018 12:40,46,68,64,63.3,110,65.3,1,0,0
2/26/2018 12:45,41,67,58,62.3,99,64.2,1,0,0
2/26/2018 12:50,58,67.3,76,62.4,134,64.5,1,0,0
2/26/2018 12:55,50,66.6,68,61.7,118,63.8,1,0,0
2/26/2018 13:00,44,66.4,62,61.5,106,63.5,1,0,0
2/26/2018 13:05,42,65.5,59,60.6,101,62.6,1,0,0
2/26/2018 13:10,49,65.1,68,60.2,117,62.3,1,0,0
2/26/2018 13:15,57,66.4,74,61.5,131,63.7,1,0,0
2/26/2018 13:20,53,66.3,71,61.4,124,63.5,1,0,0
2/26/2018 13:25,42,65.7,59,60.8,101,62.8,1,0,0
2/26/2018 13:30,46,65.7,64,60.8,110,62.9,2,0,0
2/26/2018 13:35,48,66.8,65,62,113,64,2,0,0
2/26/2018 13:40,33,67.7,49,62.9,82,64.8,2,0,0
2/26/2018 13:45,46,68.7,63,64.1,109,66,2,0,0
2/26/2018 13:50,37,69.2,52,64.6,89,66.5,2,0,0
2/26/2018 13:55,45,68.6,62,63.8,107,65.8,2,0,0
2/26/2018 14:00,42,68.3,59,63.5,101,65.5,2,0,0
2/26/2018 14:05,24,68.4,41,63.6,65,65.4,2,0,0
2/26/2018 14:10,48,68.3,66,63.6,114,65.6,2,0,0
2/26/2018 14:15,45,67.3,62,62.5,107,64.5,2,0,0
2/26/2018 14:20,45,67.5,63,62.6,108,64.6,2,0,0
2/26/2018 14:25,55,68.1,73,63.4,128,65.4,2,0,0
2/26/2018 14:30,41,68.7,58,64,99,65.9,2,0,0
2/26/2018 14:35,45,69.5,62,64.8,107,66.8,2,0,0
2/26/2018 14:40,77,69.4,69,63.4,146,66.6,2,0,0
2/26/2018 14:45,79,69.7,71,63.7,150,66.9,2,0,0
2/26/2018 14:50,81,69.5,72,63.5,153,66.7,2,0,0
2/26/2018 14:55,44,70.5,61,66,105,67.9,2,0,0
2/26/2018 15:00,74,69.2,67,63.2,141,66.3,2,0,0
2/26/2018 15:05,77,69,69,63,146,66.2,2,0,0
2/26/2018 15:10,77,68.9,70,62.9,147,66,2,0,0
2/26/2018 15:15,23,69.3,40,64.7,63,66.4,2,0,0
2/26/2018 15:20,82,68.7,73,62.9,155,66,2,0,0
2/26/2018 15:25,80,68.7,71,62.9,151,66,2,0,0
2/26/2018 15:30,78,68.7,70,62.9,148,66,2,0,0
2/26/2018 15:35,29,69.3,43,64.7,72,66.6,2,0,0
2/26/2018 15:40,85,68.5,76,62.7,161,65.8,2,0,0
2/26/2018 15:45,84,68.6,76,62.8,160,65.8,2,0,0
2/26/2018 15:50,29,69.3,43,64.7,72,66.6,2,0,0
2/26/2018 15:55,81,68.7,73,62.9,154,66,2,0,0
2/26/2018 16:00,78,68.5,70,62.7,148,65.8,2,0,0
2/26/2018 16:05,80,68.6,72,62.8,152,65.9,2,0,0
2/26/2018 16:10,84,68.6,75,62.8,159,65.9,2,0,0
2/26/2018 16:15,83,68.6,75,62.8,158,65.8,2,0,0
2/26/2018 16:20,84,68.6,76,62.8,160,65.8,2,0,0
2/26/2018 16:25,81,68.5,72,62.7,153,65.8,2,0,0
2/26/2018 16:30,81,68.6,72,62.8,153,65.9,2,0,0
2/26/2018 16:35,84,68.4,75,62.6,159,65.7,2,0,0
2/26/2018 16:40,85,68.4,77,62.6,162,65.6,2,0,0
2/26/2018 16:45,87,68.3,78,62.5,165,65.6,2,0,0
2/26/2018 16:50,55,67.6,72,62.9,127,64.9,2,0,0
2/26/2018 16:55,51,67.8,69,63.1,120,65.1,2,0,0
2/26/2018 17:00,51,68,69,63.2,120,65.2,2,0,0
2/26/2018 17:05,45,68.8,63,64.1,108,66.1,2,0,0
2/26/2018 17:10,51,68.7,69,63.9,120,65.9,2,0,0
2/26/2018 17:15,57,68.9,75,64.2,132,66.2,2,0,0
2/26/2018 17:20,52,68.4,70,63.7,122,65.7,2,0,0
2/26/2018 17:25,48,66.9,65,62,113,64,2,0,0
2/26/2018 17:30,54,67.3,73,62.4,127,64.5,2,0,0
2/26/2018 17:35,42,66.6,59,61.6,101,63.7,2,0,0
2/26/2018 17:40,53,66.9,71,62,124,64.1,2,0,0
2/26/2018 17:45,46,67.7,64,62.8,110,64.8,2,0,0
2/26/2018 17:50,47,67.2,65,62.4,112,64.4,2,0,0
2/26/2018 17:55,45,68.5,62,63.8,107,65.8,2,0,0
2/26/2018 18:00,50,68.9,68,64.2,118,66.2,2,0,0
2/26/2018 18:05,34,68.3,51,63.5,85,65.4,2,0,0
2/26/2018 18:10,43,68.2,61,63.4,104,65.4,2,0,0
2/26/2018 18:15,43,66.6,60,61.6,103,63.7,2,0,0
2/26/2018 18:20,39,67.3,57,62.5,96,64.5,2,0,0
2/26/2018 18:25,38,68.6,54,63.9,92,65.8,2,0,0
2/26/2018 18:30,46,68.4,64,63.7,110,65.7,2,0,0
2/26/2018 18:35,43,68.2,60,63.5,103,65.5,2,0,0
2/26/2018 18:40,48,67.3,65,62.4,113,64.5,2,0,0
2/26/2018 18:45,42,67.6,60,62.7,102,64.7,2,0,0
2/26/2018 18:50,41,67.8,57,63,98,65,2,0,0
2/26/2018 18:55,42,68.4,59,63.6,101,65.6,2,0,0
2/26/2018 19:00,39,68.3,56,63.6,95,65.6,2,0,0
2/26/2018 19:05,39,67.5,56,62.7,95,64.7,2,0,0
2/26/2018 19:10,35,67.7,53,62.9,88,64.8,2,0,0
2/26/2018 19:15,34,68.4,51,63.7,85,65.6,2,0,0
2/26/2018 19:20,36,67.6,53,62.9,89,64.8,2,0,0
2/26/2018 19:25,36,68.4,53,63.6,89,65.5,2,0,0
2/26/2018 19:30,38,68.8,54,64.1,92,66.1,2,0,0
2/26/2018 19:35,39,68.1,56,63.3,95,65.2,2,0,0
2/26/2018 19:40,28,67.9,45,63.2,73,65,2,0,0
2/26/2018 19:45,29,68.4,45,63.7,74,65.5,2,0,0
2/26/2018 19:50,32,67.4,49,62.6,81,64.5,2,0,0
2/26/2018 19:55,29,67.9,45,63.2,74,65.1,2,0,0
2/26/2018 20:00,30,68.5,47,63.9,77,65.7,2,0,0
2/26/2018 20:05,40,68.3,58,63.6,98,65.5,2,0,0
2/26/2018 20:10,31,69,47,64.4,78,66.2,2,0,0
2/26/2018 20:15,28,69.4,45,64.7,73,66.5,2,0,0
2/26/2018 20:20,30,69.3,47,64.6,77,66.4,2,0,0
2/26/2018 20:25,27,69.5,43,64.9,70,66.6,2,0,0
2/26/2018 20:30,30,69.2,46,64.5,76,66.4,2,0,0
2/26/2018 20:35,31,69.4,48,64.7,79,66.5,2,0,0
2/26/2018 20:40,23,68.9,39,64.2,62,65.9,2,0,0
2/26/2018 20:45,34,67.4,50,62.6,84,64.5,2,0,0
2/26/2018 20:50,26,68.4,42,63.7,68,65.5,2,0,0
2/26/2018 20:55,26,68.7,43,64,69,65.7,2,0,0
2/26/2018 21:00,25,69.4,41,64.7,66,66.5,2,0,0
2/26/2018 21:05,24,69.2,40,64.5,64,66.3,2,0,0
2/26/2018 21:10,21,68.7,36,64,57,65.8,2,0,0
2/26/2018 21:15,22,68.9,38,64.3,60,66,2,0,0
2/26/2018 21:20,24,69.6,40,65,64,66.7,2,0,0
2/26/2018 21:25,21,68.9,37,64.3,58,66,2,0,0
2/26/2018 21:30,24,69.2,39,64.6,63,66.4,2,0,0
2/26/2018 21:35,24,69.4,40,64.7,64,66.5,2,0,0
2/26/2018 21:40,26,69.5,41,64.9,67,66.7,2,0,0
2/26/2018 21:45,20,69.3,36,64.7,56,66.3,2,0,0
2/26/2018 21:50,21,69.2,37,64.6,58,66.3,2,0,0
2/26/2018 21:55,20,69.2,36,64.6,56,66.2,2,0,0
2/26/2018 22:00,23,69.2,39,64.6,62,66.3,2,0,0
2/26/2018 22:05,15,69.1,31,64.4,46,65.9,2,0,0
2/26/2018 22:10,17,69.2,32,64.6,49,66.2,2,0,0
2/26/2018 22:15,22,69.1,37,64.5,59,66.2,2,0,0
2/26/2018 22:20,25,68.8,41,64.2,66,66,2,0,0
2/26/2018 22:25,19,68.9,34,64.2,53,65.9,2,0,0
2/26/2018 22:30,21,69.1,37,64.5,58,66.2,2,0,0
2/26/2018 22:35,15,69.2,30,64.5,45,66.1,2,0,0
2/26/2018 22:40,18,68.6,33,63.9,51,65.5,2,0,0
2/26/2018 22:45,20,68.9,36,64.3,56,65.9,2,0,0
2/26/2018 22:50,17,69.1,33,64.5,50,66,2,0,0
2/26/2018 22:55,11,69.3,27,64.7,38,66,2,0,0
2/26/2018 23:00,11,69.4,27,64.8,38,66.1,2,0,0
2/26/2018 23:05,11,69.3,27,64.7,38,66,2,0,0
2/26/2018 23:10,13,69.2,28,64.5,41,66,2,0,0
2/26/2018 23:15,12,69,28,64.4,40,65.7,2,0,0
2/26/2018 23:20,12,69.2,26,64.6,38,66,2,0,0
2/26/2018 23:25,13,69.3,29,64.7,42,66.1,2,0,0
2/26/2018 23:30,16,69.2,32,64.6,48,66.2,2,0,0
2/26/2018 23:35,11,69.1,27,64.5,38,65.8,2,0,0
2/26/2018 23:40,11,69.2,26,64.6,37,66,2,0,0
2/26/2018 23:45,13,69.3,28,64.7,41,66.2,2,0,0
2/26/2018 23:50,10,69.3,25,64.7,35,66,2,0,0
2/26/2018 23:55,11,69.1,27,64.5,38,65.8,2,0,0
2/27/2018 0:00,10,69.3,26,64.7,36,66,2,0,0
2/27/2018 0:05,6,69.2,21,64.6,27,65.7,2,0,0
2/27/2018 0:10,12,69.1,27,64.4,39,65.9,2,0,0
2/27/2018 0:15,8,69.2,24,64.5,32,65.7,2,0,0
2/27/2018 0:20,10,69.3,25,64.7,35,66,2,0,0
2/27/2018 0:25,8,69.3,23,64.7,31,65.9,2,0,0
2/27/2018 0:30,7,69.2,22,64.5,29,65.7,2,0,0
2/27/2018 0:35,8,69,23,64.4,31,65.6,2,0,0
2/27/2018 0:40,13,69.2,21,64.6,34,66.4,2,0,0
2/27/2018 0:45,9,69.3,24,64.7,33,66,2,0,0
2/27/2018 0:50,8,69.3,24,64.7,32,65.9,2,0,0
2/27/2018 0:55,6,69.3,21,64.7,27,65.8,2,0,0
2/27/2018 1:00,6,69.3,22,64.7,28,65.7,2,0,0
2/27/2018 1:05,7,69.4,22,64.8,29,66,2,0,0
2/27/2018 1:10,8,69.4,23,64.8,31,66,2,0,0
2/27/2018 1:15,4,69.1,19,64.5,23,65.3,2,0,0
2/27/2018 1:20,6,69.2,21,64.6,27,65.6,2,0,0
2/27/2018 1:25,6,69.3,21,64.7,27,65.8,2,0,0
2/27/2018 1:30,6,69.3,21,64.7,27,65.7,2,0,0
2/27/2018 1:35,8,69.3,23,64.7,31,65.9,2,0,0
2/27/2018 1:40,5,69.3,21,64.7,26,65.6,2,0,0
2/27/2018 1:45,6,69.4,22,64.8,28,65.8,2,0,0
2/27/2018 1:50,11,69.5,21,64.9,32,66.5,2,0,0
2/27/2018 1:55,7,69.4,22,64.8,29,65.9,2,0,0
2/27/2018 2:00,5,69.4,21,64.8,26,65.7,2,0,0
2/27/2018 2:05,5,69.5,20,64.9,25,65.8,2,0,0
2/27/2018 2:10,6,69.4,21,64.8,27,65.8,2,0,0
2/27/2018 2:15,6,69.4,22,64.8,28,65.8,2,0,0
2/27/2018 2:20,5,69.3,20,64.7,25,65.7,2,0,0
2/27/2018 2:25,6,69.4,22,64.8,28,65.8,2,0,0
2/27/2018 2:30,7,69.4,22,64.8,29,65.9,2,0,0
2/27/2018 2:35,8,69.2,24,64.6,32,65.8,2,0,0
2/27/2018 2:40,7,69.2,22,64.6,29,65.7,2,0,0
2/27/2018 2:45,11,69.2,27,64.5,38,65.9,2,0,0
2/27/2018 2:50,10,69,25,64.4,35,65.7,2,0,0
2/27/2018 2:55,9,69.1,25,64.4,34,65.7,2,0,0
2/27/2018 3:00,11,69,27,64.3,38,65.7,2,0,0
2/27/2018 3:05,10,69.2,25,64.6,35,65.9,2,0,0
2/27/2018 3:10,13,69.1,28,64.5,41,66,2,0,0
2/27/2018 3:15,9,69.3,24,64.7,33,65.9,2,0,0
2/27/2018 3:20,6,69.3,22,64.7,28,65.7,2,0,0
2/27/2018 3:25,11,69.3,27,64.7,38,66,2,0,0
2/27/2018 3:30,14,69.4,30,64.8,44,66.3,2,0,0
2/27/2018 3:35,14,69.4,29,64.8,43,66.3,2,0,0
2/27/2018 3:40,13,69.4,29,64.8,42,66.3,2,0,0
2/27/2018 3:45,15,69.5,31,64.9,46,66.4,2,0,0
2/27/2018 3:50,12,69.5,28,64.9,40,66.3,2,0,0
2/27/2018 3:55,15,69.3,31,64.7,46,66.2,2,0,0
2/27/2018 4:00,13,69.3,29,64.7,42,66.1,2,0,0
2/27/2018 4:05,15,69.2,31,64.5,46,66.1,2,0,0
2/27/2018 4:10,23,69.3,39,64.6,62,66.3,2,0,0
2/27/2018 4:15,19,69.4,35,64.8,54,66.4,2,0,0
2/27/2018 4:20,23,69.6,39,65,62,66.7,2,0,0
2/27/2018 4:25,24,69.4,41,64.8,65,66.5,2,0,0
2/27/2018 4:30,27,69.6,44,65,71,66.7,2,0,0
2/27/2018 4:35,28,68.6,44,64,72,65.8,2,0,0
2/27/2018 4:40,31,68.9,49,64.3,80,66.1,2,0,0
2/27/2018 4:45,45,70.5,63,66,108,67.8,2,0,0
2/27/2018 4:50,32,69.7,50,65.2,82,67,2,0,0
2/27/2018 4:55,36,69.4,55,64.9,91,66.7,2,0,0
2/27/2018 5:00,36,69,54,64.4,90,66.2,2,0,0
2/27/2018 5:05,37,69.5,55,64.9,92,66.7,2,0,0
2/27/2018 5:10,45,70.1,64,65.6,109,67.5,2,0,0
2/27/2018 5:15,52,69.1,71,64.5,123,66.5,2,0,0
2/27/2018 5:20,54,69,75,64.3,129,66.3,2,0,0
2/27/2018 5:25,54,69.5,74,64.9,128,66.8,2,0,0
2/27/2018 5:30,57,69.6,78,65,135,66.9,2,0,0
2/27/2018 5:35,60,70,80,65.4,140,67.4,2,0,0
2/27/2018 5:40,69,68.4,91,63.7,160,65.7,2,0,0
2/27/2018 5:45,65,67.9,86,63.1,151,65.2,2,0,0
2/27/2018 5:50,63,68,83,63.2,146,65.3,2,0,0
2/27/2018 5:55,66,67.7,88,62.8,154,64.9,2,0,0
2/27/2018 6:00,57,67.9,77,63,134,65.1,2,0,0
2/27/2018 6:05,65,67.6,86,62.7,151,64.8,2,0,0
2/27/2018 6:10,70,66.9,92,61.9,162,64.1,2,0,0
2/27/2018 6:15,70,67.2,91,62.3,161,64.4,2,0,0
2/27/2018 6:20,68,66.9,89,62,157,64.2,2,0,0
2/27/2018 6:25,66,67.5,89,62.6,155,64.7,2,0,0
2/27/2018 6:30,78,67.5,102,62.7,180,64.8,2,0,0
2/27/2018 6:35,63,68,85,63.1,148,65.2,2,0,0
2/27/2018 6:40,62,68.4,84,63.7,146,65.7,2,0,0
2/27/2018 6:45,75,68.3,97,63.5,172,65.6,2,0,0
2/27/2018 6:50,71,68.1,92,63.4,163,65.5,2,0,0
2/27/2018 6:55,73,67.6,95,62.7,168,64.8,2,0,0
2/27/2018 7:00,77,68.2,100,63.5,177,65.6,2,0,0
2/27/2018 7:05,88,68.3,112,63.4,200,65.5,2,0,0
2/27/2018 7:10,73,69.1,96,64.3,169,66.4,2,0,0
2/27/2018 7:15,89,68.7,113,64,202,66.1,2,0,0
2/27/2018 7:20,81,67.8,104,63,185,65.1,2,0,0
2/27/2018 7:25,86,67.3,109,62.4,195,64.6,2,0,0
2/27/2018 7:30,91,67.4,114,62.5,205,64.7,2,0,0
2/27/2018 7:35,95,67.5,118,62.6,213,64.8,2,0,0
2/27/2018 7:40,89,67.4,113,62.5,202,64.7,2,0,0
2/27/2018 7:45,97,66.5,122,61.5,219,63.7,2,0,0
2/27/2018 7:50,83,66.7,106,61.7,189,63.9,2,0,0
2/27/2018 7:55,93,65.9,117,60.8,210,63,2,0,0
2/27/2018 8:00,80,65.7,102,60.6,182,62.9,2,0,0
2/27/2018 8:05,85,67.3,109,62.3,194,64.5,2,0,0
2/27/2018 8:10,80,67.4,102,62.5,182,64.7,2,0,0
2/27/2018 8:15,77,66.6,101,61.7,178,63.8,2,0,0
2/27/2018 8:20,78,66.2,100,61.3,178,63.5,2,0,0
2/27/2018 8:25,84,65.9,107,60.9,191,63.1,2,0,0
2/27/2018 8:30,69,66.4,91,61.4,160,63.6,2,0,0
2/27/2018 8:35,74,66.2,95,61.2,169,63.4,2,0,0
2/27/2018 8:40,93,65.5,116,60.4,209,62.7,2,0,0
2/27/2018 8:45,89,65.6,112,60.5,201,62.8,2,0,0
2/27/2018 8:50,87,64,110,58.8,197,61.1,2,0,0
2/27/2018 8:55,92,63.4,115,58.1,207,60.5,2,0,0
2/27/2018 9:00,79,68.5,70,62.7,149,65.8,2,0,0
2/27/2018 9:05,75,68.5,68,62.7,143,65.7,2,0,0
2/27/2018 9:10,62,66.6,83,61.6,145,63.8,2,0,0
2/27/2018 9:15,67,65.6,89,60.6,156,62.7,2,0,0
2/27/2018 9:20,67,65,88,60,155,62.2,2,0,0
2/27/2018 9:25,64,65.8,83,60.9,147,63,2,0,0
2/27/2018 9:30,68,65.8,90,60.8,158,63,2,0,0
2/27/2018 9:35,74,65.6,95,60.7,169,62.9,2,0,0
2/27/2018 9:40,83,64.6,104,59.6,187,61.9,2,0,0
2/27/2018 9:45,76,64.1,97,59,173,61.3,2,0,0
2/27/2018 9:50,77,65.3,98,60.3,175,62.5,2,0,0
2/27/2018 9:55,78,65.2,98,60.3,176,62.5,2,0,0
2/27/2018 10:00,62,65,81,60,143,62.2,2,0,0
2/27/2018 10:05,52,65.1,71,60.1,123,62.2,2,0,0
2/27/2018 10:10,60,66.2,79,61.3,139,63.4,2,0,0
2/27/2018 10:15,60,65.3,78,60.4,138,62.6,2,0,0
2/27/2018 10:20,66,65.7,86,60.8,152,62.9,2,0,0
2/27/2018 10:25,62,66.2,82,61.4,144,63.5,2,0,0
2/27/2018 10:30,59,66.4,79,61.6,138,63.6,2,0,0
2/27/2018 10:35,47,66.4,65,61.5,112,63.6,2,0,0
2/27/2018 10:40,51,65.7,68,60.9,119,63,2,0,0
2/27/2018 10:45,61,66.9,80,62.1,141,64.2,2,0,0
2/27/2018 10:50,71,66.6,92,61.7,163,63.8,2,0,0
2/27/2018 10:55,57,67.1,75,62.3,132,64.4,2,0,0
2/27/2018 11:00,56,66.9,74,62.1,130,64.2,2,0,0
2/27/2018 11:05,50,66.6,69,61.8,119,63.8,2,0,0
2/27/2018 11:10,63,67.5,82,62.8,145,64.9,2,0,0
2/27/2018 11:15,57,67.4,76,62.7,133,64.7,2,0,0
2/27/2018 11:20,56,68.4,74,63.8,130,65.8,2,0,0
2/27/2018 11:25,53,68.9,72,64.3,125,66.2,2,0,0
2/27/2018 11:30,54,69.1,73,64.4,127,66.4,2,0,0
2/27/2018 11:35,52,68.8,70,64.2,122,66.1,2,0,0
2/27/2018 11:40,54,68.9,72,64.3,126,66.3,2,0,0
2/27/2018 11:45,59,68.2,77,63.5,136,65.5,2,0,0
2/27/2018 11:50,48,68.6,66,64,114,66,2,0,0
2/27/2018 11:55,51,66.9,70,62.1,121,64.1,2,0,0
2/27/2018 12:00,45,67.2,62,62.4,107,64.4,2,0,0
2/27/2018 12:05,46,66.6,65,61.8,111,63.8,2,0,0
2/27/2018 12:10,50,66.9,68,62.1,118,64.1,2,0,0
2/27/2018 12:15,41,68.6,58,63.9,99,65.9,2,0,0
2/27/2018 12:20,44,68.7,61,64,105,66,2,0,0
2/27/2018 12:25,49,69.2,67,64.5,116,66.5,2,0,0
2/27/2018 12:30,47,68,64,63.3,111,65.3,2,0,0
2/27/2018 12:35,48,67.5,67,62.6,115,64.6,2,0,0
2/27/2018 12:40,45,67.7,63,62.8,108,64.8,2,0,0
2/27/2018 12:45,55,69.1,73,64.4,128,66.4,2,0,0
2/27/2018 12:50,40,69,56,64.3,96,66.2,2,0,0
2/27/2018 12:55,48,67.6,66,62.8,114,64.8,2,0,0
2/27/2018 13:00,38,68.9,54,64.2,92,66.1,2,0,0
2/27/2018 13:05,44,68.5,62,63.9,106,65.8,2,0,0
2/27/2018 13:10,47,69.5,64,64.9,111,66.8,2,0,0
2/27/2018 13:15,52,69.2,70,64.6,122,66.6,2,0,0
2/27/2018 13:20,46,70.2,64,65.7,110,67.5,2,0,0
2/27/2018 13:25,54,68.9,72,64.3,126,66.2,2,0,0
2/27/2018 13:30,47,69.3,64,64.8,111,66.7,2,0,0
2/27/2018 13:35,46,70.6,63,66.1,109,68,2,0,0
2/27/2018 13:40,46,70.7,63,66.2,109,68.1,2,0,0
2/27/2018 13:45,47,68.4,65,63.7,112,65.7,2,0,0
2/27/2018 13:50,47,68.8,65,64.2,112,66.2,2,0,0
2/27/2018 13:55,47,69.8,64,65.2,111,67.2,2,0,0
2/27/2018 14:00,48,67.6,66,62.8,114,64.8,2,0,0
2/27/2018 14:05,60,67.6,78,62.9,138,64.9,2,0,0
2/27/2018 14:10,47,68,65,63.2,112,65.2,2,0,0
2/27/2018 14:15,57,68.5,74,63.8,131,65.9,2,0,0
2/27/2018 14:20,63,69.1,81,64.3,144,66.4,2,0,0
2/27/2018 14:25,66,69.3,84,64.6,150,66.7,2,0,0
2/27/2018 14:30,55,68.7,73,64,128,66,2,0,0
2/27/2018 14:35,59,69.7,77,65,136,67,2,0,0
2/27/2018 14:40,65,69.2,84,64.5,149,66.5,2,0,0
2/27/2018 14:45,49,68.1,67,63.4,116,65.4,2,0,0
2/27/2018 14:50,60,67.1,79,62.2,139,64.3,2,0,0
2/27/2018 14:55,43,68.1,60,63.3,103,65.3,2,0,0
2/27/2018 15:00,41,68.8,58,64.1,99,66,2,0,0
2/27/2018 15:05,45,69.2,63,64.7,108,66.6,2,0,0
2/27/2018 15:10,43,68.4,60,63.7,103,65.7,2,0,0
2/27/2018 15:15,44,68.2,62,63.5,106,65.4,2,0,0
2/27/2018 15:20,50,68.8,68,64.1,118,66.1,2,0,0
2/27/2018 15:25,54,67.7,73,62.9,127,64.9,2,0,0
2/27/2018 15:30,70,68.3,90,63.7,160,65.7,2,0,0
2/27/2018 15:35,54,67.2,71,62.4,125,64.4,2,0,0
2/27/2018 15:40,60,67.9,78,63.2,138,65.3,2,0,0
2/27/2018 15:45,71,68.8,91,64.2,162,66.2,2,0,0
2/27/2018 15:50,60,69,78,64.4,138,66.4,2,0,0
2/27/2018 15:55,56,68.5,73,63.8,129,65.9,2,0,0
2/27/2018 16:00,68,69.6,86,65.1,154,67.1,2,0,0
2/27/2018 16:05,54,67.1,72,62.3,126,64.3,2,0,0
2/27/2018 16:10,51,67.9,68,63.1,119,65.2,2,0,0
2/27/2018 16:15,47,69.2,65,64.6,112,66.5,2,0,0
2/27/2018 16:20,53,69.6,71,65,124,67,2,0,0
2/27/2018 16:25,43,69,60,64.3,103,66.3,2,0,0
2/27/2018 16:30,43,69.5,61,64.8,104,66.7,2,0,0
2/27/2018 16:35,52,68.9,70,64.2,122,66.2,2,0,0
2/27/2018 16:40,46,68.3,63,63.6,109,65.6,2,0,0
2/27/2018 16:45,56,68.4,73,63.7,129,65.7,2,0,0
2/27/2018 16:50,46,68.7,63,64.1,109,66,2,0,0
2/27/2018 16:55,48,67.7,66,62.7,114,64.8,2,0,0
2/27/2018 17:00,42,68,60,63.1,102,65.1,2,0,0
2/27/2018 17:05,47,68.3,65,63.5,112,65.5,2,0,0
2/27/2018 17:10,42,68.9,61,64.2,103,66.1,2,0,0
2/27/2018 17:15,52,69.7,70,65.1,122,67,2,0,0
2/27/2018 17:20,60,70,79,65.4,139,67.4,2,0,0
2/27/2018 17:25,53,69.8,71,65.3,124,67.2,2,0,0
2/27/2018 17:30,49,70,68,65.4,117,67.3,2,0,0
2/27/2018 17:35,56,68.1,75,63.4,131,65.4,2,0,0
2/27/2018 17:40,46,68.1,64,63.3,110,65.3,2,0,0
2/27/2018 17:45,44,69.5,61,64.9,105,66.8,2,0,0
2/27/2018 17:50,43,67.9,61,63.1,104,65.1,2,0,0
2/27/2018 17:55,47,68.8,65,64.2,112,66.2,2,0,0
2/27/2018 18:00,49,67.4,67,62.5,116,64.5,2,0,0
2/27/2018 18:05,45,69.3,62,64.7,107,66.6,2,0,0
2/27/2018 18:10,42,68.9,60,64.3,102,66.2,2,0,0
2/27/2018 18:15,46,69,63,64.4,109,66.3,2,0,0
2/27/2018 18:20,49,68.8,66,64.1,115,66.1,2,0,0
2/27/2018 18:25,50,67.9,68,63.1,118,65.1,2,0,0
2/27/2018 18:30,47,66.7,65,61.8,112,63.8,2,0,0
2/27/2018 18:35,49,66.8,67,62,116,64.1,2,0,0
2/27/2018 18:40,38,68.4,56,63.6,94,65.5,2,0,0
2/27/2018 18:45,37,67.9,54,63.2,91,65.1,2,0,0
2/27/2018 18:50,41,67.7,57,62.9,98,64.9,2,0,0
2/27/2018 18:55,37,68.2,53,63.5,90,65.4,2,0,0
2/27/2018 19:00,37,68.5,54,63.7,91,65.6,2,0,0
2/27/2018 19:05,43,67.9,59,63.1,102,65.1,2,0,0
2/27/2018 19:10,45,68.6,63,63.9,108,65.9,2,0,0
2/27/2018 19:15,42,69.6,59,65,101,66.9,2,0,0
2/27/2018 19:20,39,69,56,64.3,95,66.2,2,0,0
2/27/2018 19:25,45,68.3,63,63.5,108,65.5,2,0,0
2/27/2018 19:30,39,68.3,56,63.4,95,65.4,2,0,0
2/27/2018 19:35,40,67.4,57,62.6,97,64.6,2,0,0
2/27/2018 19:40,36,68.3,53,63.6,89,65.5,2,0,0
2/27/2018 19:45,35,68.5,52,63.8,87,65.7,2,0,0
2/27/2018 19:50,41,68.4,58,63.7,99,65.7,2,0,0
2/27/2018 19:55,34,68.2,51,63.5,85,65.4,2,0,0
2/27/2018 20:00,31,69.2,48,64.5,79,66.3,2,0,0
2/27/2018 20:05,33,69.1,50,64.4,83,66.3,2,0,0
2/27/2018 20:10,28,69.4,45,64.7,73,66.5,2,0,0
2/27/2018 20:15,29,69.2,46,64.5,75,66.3,2,0,0
2/27/2018 20:20,27,69.8,42,65.2,69,67,2,0,0
2/27/2018 20:25,28,69.8,45,65.2,73,67,2,0,0
2/27/2018 20:30,28,69.8,44,65.2,72,67,2,0,0
2/27/2018 20:35,30,69.9,46,65.3,76,67.2,2,0,0
2/27/2018 20:40,21,69.8,37,65.2,58,66.9,2,0,0
2/27/2018 20:45,27,70,42,65.4,69,67.2,2,0,0
2/27/2018 20:50,29,70,45,65.5,74,67.2,2,0,0
2/27/2018 20:55,25,69.8,40,65.2,65,67,2,0,0
2/27/2018 21:00,27,69.5,43,64.9,70,66.7,2,0,0
2/27/2018 21:05,27,68.7,42,64,69,65.8,2,0,0
2/27/2018 21:10,31,68.9,48,64.2,79,66,2,0,0
2/27/2018 21:15,26,67.7,43,62.9,69,64.7,2,0,0
2/27/2018 21:20,25,68.5,41,63.8,66,65.6,2,0,0
2/27/2018 21:25,28,68.9,45,64.2,73,66,2,0,0
2/27/2018 21:30,24,68.9,39,64.3,63,66.1,2,0,0
2/27/2018 21:35,31,68,48,63.2,79,65.1,2,0,0
2/27/2018 21:40,21,68.5,36,63.8,57,65.5,2,0,0
2/27/2018 21:45,19,69,35,64.3,54,66,2,0,0
2/27/2018 21:50,25,68.4,41,63.7,66,65.5,2,0,0
2/27/2018 21:55,22,69,38,64.4,60,66,2,0,0
2/27/2018 22:00,19,69.2,35,64.6,54,66.2,2,0,0
2/27/2018 22:05,19,69.4,34,64.8,53,66.5,2,0,0
2/27/2018 22:10,20,69.3,36,64.7,56,66.3,2,0,0
2/27/2018 22:15,22,68.9,38,64.3,60,66,2,0,0
2/27/2018 22:20,22,69.3,38,64.7,60,66.4,2,0,0
2/27/2018 22:25,16,69.3,32,64.7,48,66.3,2,0,0
2/27/2018 22:30,18,69.3,35,64.6,53,66.2,2,0,0
2/27/2018 22:35,19,69.3,35,64.7,54,66.3,2,0,0
2/27/2018 22:40,18,69.2,33,64.5,51,66.2,2,0,0
2/27/2018 22:45,19,68.9,35,64.2,54,65.9,2,0,0
2/27/2018 22:50,13,69.1,28,64.4,41,65.9,2,0,0
2/27/2018 22:55,12,69.2,27,64.5,39,66,2,0,0
2/27/2018 23:00,13,69.4,28,64.8,41,66.2,2,0,0
2/27/2018 23:05,13,69.5,28,64.9,41,66.3,2,0,0
2/27/2018 23:10,12,69.4,27,64.8,39,66.3,2,0,0
2/27/2018 23:15,13,69.2,29,64.6,42,66,2,0,0
2/27/2018 23:20,17,69.3,32,64.7,49,66.3,2,0,0
2/27/2018 23:25,14,69.3,30,64.7,44,66.1,2,0,0
2/27/2018 23:30,14,69.3,30,64.7,44,66.1,2,0,0
2/27/2018 23:35,12,69.4,27,64.8,39,66.2,2,0,0
2/27/2018 23:40,15,69.4,30,64.8,45,66.3,2,0,0
2/27/2018 23:45,11,69.4,27,64.8,38,66.2,2,0,0
2/27/2018 23:50,13,69.4,28,64.8,41,66.3,2,0,0
2/27/2018 23:55,15,69.3,30,64.7,45,66.3,2,0,0
2/28/2018 0:00,12,69.3,28,64.7,40,66.1,2,0,0
2/28/2018 0:05,12,69.2,28,64.6,40,66,2,0,0
2/28/2018 0:10,9,69.3,24,64.7,33,65.9,2,0,0
2/28/2018 0:15,11,68.7,27,64,38,65.3,2,0,0
2/28/2018 0:20,8,68.6,23,63.9,31,65.1,2,0,0
2/28/2018 0:25,14,68.8,22,64.1,36,66,2,0,0
2/28/2018 0:30,7,68.9,22,64.2,29,65.4,2,0,0
2/28/2018 0:35,6,69.1,21,64.5,27,65.5,2,0,0
2/28/2018 0:40,8,69.3,23,64.7,31,65.9,2,0,0
2/28/2018 0:45,7,69.3,23,64.7,30,65.8,2,0,0
2/28/2018 0:50,8,69.3,23,64.7,31,65.9,2,0,0
2/28/2018 0:55,7,69.4,22,64.8,29,65.9,2,0,0
2/28/2018 1:00,8,69.3,24,64.7,32,65.9,2,0,0
2/28/2018 1:05,6,69.4,21,64.8,27,65.8,2,0,0
2/28/2018 1:10,8,69.4,24,64.8,32,65.9,2,0,0
2/28/2018 1:15,5,69.2,21,64.5,26,65.4,2,0,0
2/28/2018 1:20,7,69.3,22,64.7,29,65.8,2,0,0
2/28/2018 1:25,10,69.3,20,64.7,30,66.3,2,0,0
2/28/2018 1:30,6,69.2,22,64.6,28,65.6,2,0,0
2/28/2018 1:35,13,69.3,28,64.7,41,66.2,2,0,0
2/28/2018 1:40,5,69.4,20,64.8,25,65.7,2,0,0
2/28/2018 1:45,10,69.4,25,64.8,35,66.1,2,0,0
2/28/2018 1:50,6,69.3,21,64.7,27,65.7,2,0,0
2/28/2018 1:55,7,69.3,22,64.7,29,65.8,2,0,0
2/28/2018 2:00,7,69.3,22,64.7,29,65.8,2,0,0
2/28/2018 2:05,8,69.4,23,64.8,31,66,2,0,0
2/28/2018 2:10,7,69.4,22,64.8,29,65.9,2,0,0
2/28/2018 2:15,6,69.3,21,64.7,27,65.7,2,0,0
2/28/2018 2:20,9,69.2,24,64.6,33,65.9,2,0,0
2/28/2018 2:25,7,69.3,22,64.7,29,65.8,2,0,0
2/28/2018 2:30,9,69.3,24,64.7,33,66,2,0,0
2/28/2018 2:35,5,69.3,20,64.7,25,65.6,2,0,0
2/28/2018 2:40,7,69.3,22,64.7,29,65.8,2,0,0
2/28/2018 2:45,9,69.2,24,64.6,33,65.8,2,0,0
2/28/2018 2:50,10,69,26,64.4,36,65.7,2,0,0
2/28/2018 2:55,15,69,22,64.4,37,66.2,2,0,0
2/28/2018 3:00,10,68.9,25,64.2,35,65.5,2,0,0
2/28/2018 3:05,9,69.1,25,64.5,34,65.7,2,0,0
2/28/2018 3:10,10,69.2,25,64.6,35,65.9,2,0,0
2/28/2018 3:15,8,69.3,23,64.7,31,65.9,2,0,0
2/28/2018 3:20,14,69.4,30,64.8,44,66.3,2,0,0
2/28/2018 3:25,10,68.7,26,64,36,65.3,2,0,0
2/28/2018 3:30,10,69,26,64.4,36,65.6,2,0,0
2/28/2018 3:35,8,69.3,24,64.7,32,65.9,2,0,0
2/28/2018 3:40,15,69.4,30,64.8,45,66.4,2,0,0
2/28/2018 3:45,11,69.4,27,64.8,38,66.2,2,0,0
2/28/2018 3:50,12,69.3,28,64.7,40,66,2,0,0
2/28/2018 3:55,17,69.1,34,64.5,51,66,2,0,0
2/28/2018 4:00,13,69.3,29,64.7,42,66.1,2,0,0
2/28/2018 4:05,19,68.2,35,63.6,54,65.2,2,0,0
2/28/2018 4:10,18,68.8,35,64.2,53,65.7,2,0,0
2/28/2018 4:15,20,69.3,36,64.7,56,66.3,2,0,0
2/28/2018 4:20,20,68.7,37,64,57,65.7,2,0,0
2/28/2018 4:25,28,69.2,45,64.6,73,66.4,2,0,0
2/28/2018 4:30,24,69.5,41,64.9,65,66.6,2,0,0
2/28/2018 4:35,25,69.5,41,64.9,66,66.6,2,0,0
2/28/2018 4:40,36,69.8,54,65.3,90,67.1,2,0,0
2/28/2018 4:45,40,70.5,58,66,98,67.8,2,0,0
2/28/2018 4:50,37,70.1,55,65.6,92,67.4,2,0,0
2/28/2018 4:55,33,70.1,51,65.6,84,67.4,2,0,0
2/28/2018 5:00,38,70.1,57,65.5,95,67.4,2,0,0
2/28/2018 5:05,42,70.2,60,65.6,102,67.5,2,0,0
2/28/2018 5:10,41,70.7,59,66.2,100,68,2,0,0
2/28/2018 5:15,51,70,72,65.5,123,67.4,2,0,0
2/28/2018 5:20,49,70.2,70,65.7,119,67.5,2,0,0
2/28/2018 5:25,51,68.6,71,64,122,65.9,2,0,0
2/28/2018 5:30,61,69.1,83,64.4,144,66.4,2,0,0
2/28/2018 5:35,61,67.8,84,63.1,145,65.1,2,0,0
2/28/2018 5:40,59,68.2,80,63.5,139,65.5,2,0,0
2/28/2018 5:45,69,67.5,92,62.7,161,64.7,2,0,0
2/28/2018 5:50,64,68,85,63.3,149,65.3,2,0,0
2/28/2018 5:55,58,69.3,79,64.7,137,66.6,2,0,0
2/28/2018 6:00,57,66.3,78,61.4,135,63.5,2,0,0
2/28/2018 6:05,55,67.2,76,62.2,131,64.3,2,0,0
2/28/2018 6:10,66,66.9,87,61.9,153,64.1,2,0,0
2/28/2018 6:15,68,67.2,89,62.3,157,64.4,2,0,0
2/28/2018 6:20,67,67.3,90,62.3,157,64.4,2,0,0
2/28/2018 6:25,76,67.5,100,62.5,176,64.6,2,0,0
2/28/2018 6:30,68,67.7,90,62.8,158,64.9,2,0,0
2/28/2018 6:35,66,66.3,88,61.3,154,63.4,2,0,0
2/28/2018 6:40,73,67.2,94,62.3,167,64.4,2,0,0
2/28/2018 6:45,77,67,101,62.1,178,64.2,2,0,0
2/28/2018 6:50,67,68.6,89,63.8,156,65.9,2,0,0
2/28/2018 6:55,73,68.9,96,64.2,169,66.2,2,0,0
2/28/2018 7:00,79,68.9,101,64.2,180,66.3,2,0,0
2/28/2018 7:05,78,68.3,102,63.5,180,65.6,2,0,0
2/28/2018 7:10,74,68.7,97,63.9,171,66,2,0,0
2/28/2018 7:15,88,68.3,112,63.5,200,65.6,2,0,0
2/28/2018 7:20,78,67.4,100,62.5,178,64.6,2,0,0
2/28/2018 7:25,82,66.8,105,61.8,187,64,2,0,0
2/28/2018 7:30,74,66.9,96,61.9,170,64.1,2,0,0
2/28/2018 7:35,81,66.7,104,61.7,185,63.9,2,0,0
2/28/2018 7:40,96,66.8,121,61.9,217,64.1,2,0,0
2/28/2018 7:45,83,67.6,107,62.7,190,64.8,2,0,0
2/28/2018 7:50,85,67,107,62,192,64.2,2,0,0
2/28/2018 7:55,93,64.7,117,59.6,210,61.9,2,0,0
2/28/2018 8:00,89,65.6,113,60.5,202,62.8,2,0,0
2/28/2018 8:05,92,64.2,115,59,207,61.3,2,0,0
2/28/2018 8:10,91,63.2,115,57.9,206,60.2,2,0,0
2/28/2018 8:15,92,63.5,116,58.1,208,60.5,2,0,0
2/28/2018 8:20,84,65.2,107,60,191,62.3,2,0,0
2/28/2018 8:25,72,64.4,95,59.3,167,61.5,2,0,0
2/28/2018 8:30,78,63.6,101,58.4,179,60.7,2,0,0
2/28/2018 8:35,85,63.7,109,58.4,194,60.7,2,0,0
2/28/2018 8:40,83,65.4,105,60.3,188,62.5,2,0,0
2/28/2018 8:45,97,64.1,121,58.8,218,61.2,2,0,0
2/28/2018 8:50,76,63.9,100,58.7,176,61,2,0,0
2/28/2018 8:55,86,65.6,108,60.5,194,62.8,2,0,0
2/28/2018 9:00,73,65.6,94,60.5,167,62.7,2,0,0
2/28/2018 9:05,69,64.2,90,59,159,61.3,2,0,0
2/28/2018 9:10,81,65.2,104,60.1,185,62.4,2,0,0
2/28/2018 9:15,75,64.7,97,59.7,172,61.9,2,0,0
2/28/2018 9:20,68,66.2,88,61.3,156,63.4,2,0,0
2/28/2018 9:25,79,67.2,100,62.4,179,64.5,2,0,0
2/28/2018 9:30,59,67.2,78,62.4,137,64.5,2,0,0
2/28/2018 9:35,63,68.2,82,63.4,145,65.5,2,0,0
2/28/2018 9:40,72,67.1,92,62.2,164,64.3,2,0,0
2/28/2018 9:45,70,65.8,90,60.8,160,63,2,0,0
2/28/2018 9:50,89,65.1,110,60.1,199,62.3,2,0,0
2/28/2018 9:55,64,66.3,83,61.4,147,63.5,2,0,0
2/28/2018 10:00,70,65.8,90,61,160,63.1,2,0,0
2/28/2018 10:05,52,66.1,71,61.3,123,63.3,2,0,0
2/28/2018 10:10,57,65.8,76,60.9,133,63,2,0,0
2/28/2018 10:15,73,67.3,92,62.6,165,64.7,2,0,0
2/28/2018 10:20,63,68,81,63.3,144,65.4,2,0,0
2/28/2018 10:25,58,67.7,76,62.9,134,65,2,0,0
2/28/2018 10:30,59,65.8,79,61,138,63,2,0,0
2/28/2018 10:35,63,67.3,82,62.5,145,64.6,2,0,0
2/28/2018 10:40,55,68,73,63.3,128,65.3,2,0,0
2/28/2018 10:45,68,68.6,88,64,156,66,2,0,0
2/28/2018 10:50,61,68.3,80,63.7,141,65.7,2,0,0
2/28/2018 10:55,63,67.7,82,63,145,65.1,2,0,0
2/28/2018 11:00,56,66.6,74,61.8,130,63.8,2,0,0
2/28/2018 11:05,58,67.4,77,62.7,135,64.8,2,0,0
2/28/2018 11:10,53,66.6,71,61.8,124,63.9,2,0,0
2/28/2018 11:15,65,65.7,85,60.9,150,63,2,0,0
2/28/2018 11:20,69,66.2,89,61.3,158,63.5,2,0,0
2/28/2018 11:25,53,67.3,71,62.6,124,64.6,2,0,0
2/28/2018 11:30,63,67.3,82,62.6,145,64.6,2,0,0
2/28/2018 11:35,56,67.6,75,62.8,131,64.8,2,0,0
2/28/2018 11:40,58,67.8,77,63,135,65.1,2,0,0
2/28/2018 11:45,59,66.9,78,62.1,137,64.2,2,0,0
2/28/2018 11:50,50,65.2,68,60.3,118,62.4,2,0,0
2/28/2018 11:55,50,66.4,68,61.5,118,63.6,2,0,0
2/28/2018 12:00,45,67.4,62,62.6,107,64.6,2,0,0
2/28/2018 12:05,44,68.3,61,63.5,105,65.5,2,0,0
2/28/2018 12:10,43,67.8,60,63.1,103,65.1,2,0,0
2/28/2018 12:15,51,69.4,69,64.7,120,66.7,2,0,0
2/28/2018 12:20,49,69.2,66,64.6,115,66.6,2,0,0
2/28/2018 12:25,49,69.3,67,64.6,116,66.6,2,0,0
2/28/2018 12:30,45,68.4,63,63.7,108,65.6,2,0,0
2/28/2018 12:35,51,68.3,69,63.6,120,65.6,2,0,0
2/28/2018 12:40,48,67.6,65,62.8,113,64.8,2,0,0
2/28/2018 12:45,55,68.1,73,63.3,128,65.4,2,0,0
2/28/2018 12:50,52,68.1,70,63.3,122,65.4,2,0,0
2/28/2018 12:55,46,68.2,62,63.4,108,65.4,2,0,0
2/28/2018 13:00,44,67.6,61,62.9,105,64.9,2,0,0
2/28/2018 13:05,49,68.8,66,64.1,115,66.1,2,0,0
2/28/2018 13:10,53,68,72,63.3,125,65.3,2,0,0
2/28/2018 13:15,45,68.4,63,63.7,108,65.7,2,0,0
2/28/2018 13:20,49,67.8,67,63,116,65,2,0,0
2/28/2018 13:25,47,67.3,65,62.5,112,64.5,2,0,0
2/28/2018 13:30,55,67.9,72,63.2,127,65.2,2,0,0
2/28/2018 13:35,49,66.9,67,62.1,116,64.1,2,0,0
2/28/2018 13:40,47,67.5,66,62.7,113,64.7,2,0,0
2/28/2018 13:45,50,68.1,68,63.4,118,65.4,2,0,0
2/28/2018 13:50,42,68.6,58,63.9,100,65.9,2,0,0
2/28/2018 13:55,51,68.7,69,63.9,120,65.9,2,0,0
2/28/2018 14:00,49,69.2,67,64.5,116,66.5,2,0,0
2/28/2018 14:05,49,67.2,66,62.5,115,64.5,2,0,0
2/28/2018 14:10,58,67.7,77,62.9,135,64.9,2,0,0
2/28/2018 14:15,47,67.5,65,62.7,112,64.7,2,0,0
2/28/2018 14:20,55,68,74,63.3,129,65.3,2,0,0
2/28/2018 14:25,49,67.5,67,62.7,116,64.8,2,0,0
2/28/2018 14:30,49,68.6,67,63.9,116,65.9,2,0,0
2/28/2018 14:35,44,68.8,61,64.1,105,66.1,2,0,0
2/28/2018 14:40,50,67.4,68,62.5,118,64.6,2,0,0
2/28/2018 14:45,46,67.4,64,62.6,110,64.6,2,0,0
2/28/2018 14:50,49,68,66,63.2,115,65.3,2,0,0
2/28/2018 14:55,49,67.9,66,63.2,115,65.2,2,0,0
2/28/2018 15:00,49,67.5,66,62.7,115,64.8,2,0,0
2/28/2018 15:05,46,66.9,64,62.1,110,64.1,2,0,0
2/28/2018 15:10,45,67,62,62.2,107,64.2,2,0,0
2/28/2018 15:15,53,67.5,70,62.7,123,64.8,2,0,0
2/28/2018 15:20,56,67.4,75,62.6,131,64.7,2,0,0
2/28/2018 15:25,54,67.3,72,62.5,126,64.5,2,0,0
2/28/2018 15:30,56,68.1,74,63.3,130,65.4,2,0,0
2/28/2018 15:35,59,68.3,77,63.6,136,65.6,2,0,0
2/28/2018 15:40,57,66,75,61.1,132,63.2,2,0,0
2/28/2018 15:45,57,66.7,75,61.9,132,64,2,0,0
2/28/2018 15:50,66,66.4,85,61.5,151,63.6,2,0,0
2/28/2018 15:55,67,66.4,86,61.5,153,63.6,2,0,0
2/28/2018 16:00,56,66.7,73,61.9,129,64,2,0,0
2/28/2018 16:05,54,66.5,72,61.7,126,63.7,2,0,0
2/28/2018 16:10,58,67.1,76,62.3,134,64.4,2,0,0
2/28/2018 16:15,55,68,72,63.2,127,65.3,2,0,0
2/28/2018 16:20,65,68.7,84,64,149,66,2,0,0
2/28/2018 16:25,58,68.8,77,64,135,66,2,0,0
2/28/2018 16:30,45,67.9,63,63.1,108,65.1,2,0,0
2/28/2018 16:35,63,68.4,81,63.7,144,65.7,2,0,0
2/28/2018 16:40,44,69.3,61,64.7,105,66.6,2,0,0
2/28/2018 16:45,46,68.3,63,63.6,109,65.6,2,0,0
2/28/2018 16:50,40,68.4,58,63.7,98,65.6,2,0,0
2/28/2018 16:55,44,67.4,61,62.6,105,64.6,2,0,0
2/28/2018 17:00,52,65.7,71,60.6,123,62.8,2,0,0
2/28/2018 17:05,46,67.7,65,62.8,111,64.8,2,0,0
2/28/2018 17:10,49,69,68,64.3,117,66.3,2,0,0
2/28/2018 17:15,42,69.7,59,65,101,67,2,0,0
2/28/2018 17:20,54,70.2,72,65.6,126,67.5,2,0,0
2/28/2018 17:25,50,69.5,68,64.9,118,66.8,2,0,0
2/28/2018 17:30,56,69.9,75,65.4,131,67.3,2,0,0
2/28/2018 17:35,52,69.3,70,64.6,122,66.6,2,0,0
2/28/2018 17:40,51,70.1,69,65.5,120,67.5,2,0,0
2/28/2018 17:45,58,70,75,65.4,133,67.4,2,0,0
2/28/2018 17:50,54,69.1,73,64.4,127,66.4,2,0,0
2/28/2018 17:55,50,67.2,68,62.3,118,64.4,2,0,0
2/28/2018 18:00,47,66.9,66,62,113,64,2,0,0
2/28/2018 18:05,47,67,66,62.1,113,64.2,2,0,0
2/28/2018 18:10,55,65.6,74,60.6,129,62.7,2,0,0
2/28/2018 18:15,43,66.4,61,61.5,104,63.5,2,0,0
2/28/2018 18:20,45,68.8,61,64,106,66,2,0,0
2/28/2018 18:25,44,67.4,61,62.5,105,64.5,2,0,0
2/28/2018 18:30,47,67.6,65,62.8,112,64.8,2,0,0
2/28/2018 18:35,41,67.8,59,63,100,65,2,0,0
2/28/2018 18:40,47,66.8,65,61.9,112,63.9,2,0,0
2/28/2018 18:45,47,67.4,65,62.5,112,64.6,2,0,0
2/28/2018 18:50,38,68.1,55,63.3,93,65.2,2,0,0
2/28/2018 18:55,38,68.5,54,63.8,92,65.7,2,0,0
2/28/2018 19:00,41,67.1,59,62.2,100,64.2,2,0,0
2/28/2018 19:05,38,67.7,55,62.9,93,64.8,2,0,0
2/28/2018 19:10,37,67.8,53,63,90,64.9,2,0,0
2/28/2018 19:15,35,68.8,51,64.1,86,66,2,0,0
2/28/2018 19:20,44,67.8,62,62.9,106,65,2,0,0
2/28/2018 19:25,40,65.4,57,60.3,97,62.4,2,0,0
2/28/2018 19:30,33,66.5,49,61.6,82,63.6,2,0,0
2/28/2018 19:35,40,66.6,58,61.7,98,63.7,2,0,0
2/28/2018 19:40,44,67.1,60,62.3,104,64.3,2,0,0
2/28/2018 19:45,34,68.1,51,63.3,85,65.2,2,0,0
2/28/2018 19:50,34,69.2,51,64.6,85,66.5,2,0,0
2/28/2018 19:55,31,69,48,64.3,79,66.2,2,0,0
2/28/2018 20:00,35,69,52,64.3,87,66.2,2,0,0
2/28/2018 20:05,41,68,57,63.2,98,65.2,2,0,0
2/28/2018 20:10,31,68.2,47,63.5,78,65.3,2,0,0
2/28/2018 20:15,36,67.3,53,62.5,89,64.5,2,0,0
2/28/2018 20:20,28,67.7,44,63,72,64.8,2,0,0
2/28/2018 20:25,33,68,50,63.3,83,65.1,2,0,0
2/28/2018 20:30,28,68.7,44,64.1,72,65.9,2,0,0
2/28/2018 20:35,31,68.9,47,64.2,78,66.1,2,0,0
2/28/2018 20:40,30,69.2,46,64.5,76,66.3,2,0,0
2/28/2018 20:45,32,68.4,48,63.7,80,65.5,2,0,0
2/28/2018 20:50,33,67.5,49,62.7,82,64.6,2,0,0
2/28/2018 20:55,25,67.8,41,63.1,66,64.9,2,0,0
2/28/2018 21:00,27,67.6,42,62.9,69,64.7,2,0,0
2/28/2018 21:05,23,68.4,39,63.7,62,65.4,2,0,0
2/28/2018 21:10,27,68.5,42,63.8,69,65.6,2,0,0
2/28/2018 21:15,26,68.7,41,64,67,65.8,2,0,0
2/28/2018 21:20,37,68.5,54,63.8,91,65.7,2,0,0
2/28/2018 21:25,27,69.1,43,64.5,70,66.3,2,0,0
2/28/2018 21:30,26,69.1,43,64.5,69,66.2,2,0,0
2/28/2018 21:35,28,68.9,45,64.2,73,66,2,0,0
2/28/2018 21:40,23,68.2,39,63.5,62,65.2,2,0,0
2/28/2018 21:45,24,68.6,39,64,63,65.7,2,0,0
2/28/2018 21:50,29,68.3,45,63.6,74,65.5,2,0,0
2/28/2018 21:55,26,68.3,42,63.6,68,65.4,2,0,0
2/28/2018 22:00,24,68.6,40,63.9,64,65.6,2,0,0
2/28/2018 22:05,22,68.5,38,63.8,60,65.5,2,0,0
2/28/2018 22:10,24,68.4,40,63.7,64,65.5,2,0,0
2/28/2018 22:15,21,68.7,37,64,58,65.7,2,0,0
2/28/2018 22:20,21,69,37,64.3,58,66,2,0,0
2/28/2018 22:25,16,69.3,32,64.6,48,66.2,2,0,0
2/28/2018 22:30,23,68.9,40,64.2,63,65.9,2,0,0
2/28/2018 22:35,23,68.5,38,63.8,61,65.5,2,0,0
2/28/2018 22:40,17,68.3,32,63.6,49,65.3,2,0,0
2/28/2018 22:45,21,67.9,37,63.1,58,64.8,2,0,0
2/28/2018 22:50,26,67.5,42,62.8,68,64.6,2,0,0
2/28/2018 22:55,15,68.1,31,63.4,46,64.9,2,0,0
2/28/2018 23:00,14,68.6,30,63.9,44,65.4,2,0,0
2/28/2018 23:05,20,68.5,36,63.8,56,65.5,2,0,0
2/28/2018 23:10,17,68,33,63.3,50,64.9,2,0,0
2/28/2018 23:15,13,68.6,28,63.9,41,65.4,2,0,0
2/28/2018 23:20,15,68.7,30,64,45,65.6,2,0,0
2/28/2018 23:25,15,68.6,31,63.9,46,65.4,2,0,0
2/28/2018 23:30,15,68.6,30,63.9,45,65.5,2,0,0
2/28/2018 23:35,16,68.3,31,63.6,47,65.2,2,0,0
2/28/2018 23:40,14,68.6,29,63.9,43,65.4,2,0,0
2/28/2018 23:45,15,68.3,31,63.6,46,65.1,2,0,0
2/28/2018 23:50,14,68.1,29,63.4,43,64.9,2,0,0
2/28/2018 23:55,10,68.5,26,63.8,36,65.1,2,0,0
3/01/2018 0:00,15,69.3,30,64.7,45,66.3,2,0,0
3/01/2018 0:05,8,69.2,23,64.6,31,65.8,2,0,0
3/01/2018 0:10,9,69,24,64.3,33,65.6,2,0,0
3/01/2018 0:15,11,69,26,64.4,37,65.7,2,0,0
3/01/2018 0:20,18,68.8,24,64.2,42,66.2,2,0,0
3/01/2018 0:25,8,68.7,23,64,31,65.2,2,0,0
3/01/2018 0:30,10,68.8,25,64.1,35,65.4,2,0,0
3/01/2018 0:35,9,68.5,24,63.9,33,65.2,2,0,0
3/01/2018 0:40,7,68.9,22,64.3,29,65.4,2,0,0
3/01/2018 0:45,7,69.1,22,64.5,29,65.6,2,0,0
3/01/2018 0:50,8,69,24,64.4,32,65.6,2,0,0
3/01/2018 0:55,7,69.1,22,64.5,29,65.6,2,0,0
3/01/2018 1:00,6,69.1,21,64.5,27,65.5,2,0,0
3/01/2018 1:05,9,69.1,24,64.5,33,65.7,2,0,0
3/01/2018 1:10,9,69.2,24,64.6,33,65.8,2,0,0
3/01/2018 1:15,7,69.2,22,64.6,29,65.7,2,0,0
3/01/2018 1:20,8,69,23,64.4,31,65.5,2,0,0
3/01/2018 1:25,7,69.2,19,64.5,26,65.8,2,0,0
3/01/2018 1:30,8,68.9,23,64.2,31,65.4,2,0,0
3/01/2018 1:35,10,68.9,25,64.2,35,65.5,2,0,0
3/01/2018 1:40,7,68.9,22,64.3,29,65.4,2,0,0
3/01/2018 1:45,6,69.1,21,64.5,27,65.5,2,0,0
3/01/2018 1:50,19,69.1,24,64.5,43,66.6,2,0,0
3/01/2018 1:55,5,69.2,21,64.5,26,65.4,2,0,0
3/01/2018 2:00,12,68.9,27,64.3,39,65.7,2,0,0
3/01/2018 2:05,17,68.9,23,64.3,40,66.3,2,0,0
3/01/2018 2:10,8,68.8,23,64.2,31,65.4,2,0,0
3/01/2018 2:15,7,68.6,22,63.9,29,65.1,2,0,0
3/01/2018 2:20,8,68.9,24,64.3,32,65.4,2,0,0
3/01/2018 2:25,11,68.7,26,64,37,65.4,2,0,0
3/01/2018 2:30,14,68,29,63.4,43,64.9,2,0,0
3/01/2018 2:35,9,68.7,24,64,33,65.3,2,0,0
3/01/2018 2:40,13,67.8,28,63.1,41,64.6,2,0,0
3/01/2018 2:45,10,68.2,25,63.6,35,64.9,2,0,0
3/01/2018 2:50,7,68.5,23,63.9,30,64.9,2,0,0
3/01/2018 2:55,10,68.8,25,64.1,35,65.5,2,0,0
3/01/2018 3:00,15,66.9,30,62.1,45,63.7,2,0,0
3/01/2018 3:05,15,68,22,63.3,37,65.2,2,0,0
3/01/2018 3:10,13,68.1,28,63.4,41,64.9,2,0,0
3/01/2018 3:15,11,68.1,26,63.4,37,64.8,2,0,0
3/01/2018 3:20,9,68.6,24,63.9,33,65.2,2,0,0
3/01/2018 3:25,14,68.5,30,63.8,44,65.3,2,0,0
3/01/2018 3:30,15,68.5,30,63.8,45,65.4,2,0,0
3/01/2018 3:35,16,68.3,32,63.7,48,65.2,2,0,0
3/01/2018 3:40,17,65.8,32,61,49,62.7,2,0,0
3/01/2018 3:45,13,67.4,28,62.7,41,64.2,2,0,0
3/01/2018 3:50,14,68.1,29,63.4,43,64.9,2,0,0
3/01/2018 3:55,18,67.8,34,63.1,52,64.7,2,0,0
3/01/2018 4:00,15,67.5,30,62.8,45,64.4,2,0,0
3/01/2018 4:05,16,68,31,63.3,47,64.9,2,0,0
3/01/2018 4:10,16,67.9,32,63.2,48,64.8,2,0,0
3/01/2018 4:15,17,67.4,33,62.7,50,64.3,2,0,0
3/01/2018 4:20,16,67.6,31,62.9,47,64.5,2,0,0
3/01/2018 4:25,22,66.1,38,61.2,60,63,2,0,0
3/01/2018 4:30,24,66.4,40,61.6,64,63.4,2,0,0
3/01/2018 4:35,22,67.6,38,62.8,60,64.6,2,0,0
3/01/2018 4:40,33,65.3,50,60.4,83,62.3,2,0,0
3/01/2018 4:45,36,66.5,54,61.7,90,63.6,2,0,0
3/01/2018 4:50,39,65.4,57,60.4,96,62.5,2,0,0
3/01/2018 4:55,34,65.7,51,60.7,85,62.7,2,0,0
3/01/2018 5:00,23,67,40,62.2,63,64,2,0,0
3/01/2018 5:05,42,65.5,59,60.5,101,62.6,2,0,0
3/01/2018 5:10,40,65.4,58,60.4,98,62.4,2,0,0
3/01/2018 5:15,36,62.3,54,56.9,90,59.1,2,0,0
3/01/2018 5:20,50,62.6,68,57.2,118,59.5,2,0,0
3/01/2018 5:25,63,63.1,84,57.8,147,60.1,2,0,0
3/01/2018 5:30,46,63.4,66,58.1,112,60.3,2,0,0
3/01/2018 5:35,57,63.1,78,57.7,135,60,2,0,0
3/01/2018 5:40,58,61.8,77,56.3,135,58.6,2,0,0
3/01/2018 5:45,57,62.5,77,57.1,134,59.4,2,0,0
3/01/2018 5:50,65,61.1,86,55.6,151,57.9,2,0,0
3/01/2018 5:55,62,61.5,82,56.1,144,58.4,2,0,0
3/01/2018 6:00,52,61.2,72,55.6,124,57.9,2,0,0
3/01/2018 6:05,49,62.4,69,57,118,59.2,2,0,0
3/01/2018 6:10,56,62.8,76,57.4,132,59.7,2,0,0
3/01/2018 6:15,59,61.5,79,56,138,58.3,2,0,0
3/01/2018 6:20,57,61.9,78,56.4,135,58.7,2,0,0
3/01/2018 6:25,63,61.8,84,56.4,147,58.7,2,0,0
3/01/2018 6:30,68,61.4,90,55.8,158,58.2,2,0,0
3/01/2018 6:35,58,62.5,79,57.1,137,59.4,2,0,0
3/01/2018 6:40,56,63.8,76,58.4,132,60.7,2,0,0
3/01/2018 6:45,51,64.5,70,59.1,121,61.4,2,0,0
3/01/2018 6:50,54,64.2,73,58.9,127,61.1,2,0,0
3/01/2018 6:55,48,64.8,67,59.5,115,61.7,2,0,0
3/01/2018 7:00,53,64.4,72,59.1,125,61.4,2,0,0
3/01/2018 7:05,45,63,62,57.5,107,59.8,2,0,0
3/01/2018 7:10,48,64,67,58.7,115,60.9,2,0,0
3/01/2018 7:15,53,65.1,72,59.9,125,62.1,2,0,0
3/01/2018 7:20,57,65.8,77,60.6,134,62.8,2,0,0
3/01/2018 7:25,57,64.1,76,58.7,133,61,2,0,0
3/01/2018 7:30,62,63.8,83,58.4,145,60.7,2,0,0
3/01/2018 7:35,57,63.2,78,57.8,135,60.1,2,0,0
3/01/2018 7:40,67,64.6,88,59.4,155,61.6,2,0,0
3/01/2018 7:45,67,64.3,89,58.9,156,61.2,2,0,0
3/01/2018 7:50,63,64.4,85,59.1,148,61.4,2,0,0
3/01/2018 7:55,65,63.2,86,57.8,151,60.1,2,0,0
3/01/2018 8:00,63,62.5,83,56.9,146,59.3,2,0,0
3/01/2018 8:05,68,62.7,90,57.1,158,59.5,2,0,0
3/01/2018 8:10,72,62.1,93,56.5,165,58.9,2,0,0
3/01/2018 8:15,73,62.7,95,57.1,168,59.5,2,0,0
3/01/2018 8:20,67,62.3,88,56.7,155,59.1,2,0,0
3/01/2018 8:25,75,61.4,97,55.8,172,58.3,2,0,0
3/01/2018 8:30,79,61.5,102,55.8,181,58.3,2,0,0
3/01/2018 8:35,67,63,87,57.5,154,59.9,2,0,0
3/01/2018 8:40,73,62.9,94,57.5,167,59.9,2,0,0
3/01/2018 8:45,70,63.8,92,58.4,162,60.8,2,0,0
3/01/2018 8:50,68,63.6,89,58.3,157,60.6,2,0,0
3/01/2018 8:55,59,64.5,79,59.2,138,61.5,2,0,0
3/01/2018 9:00,57,63.9,77,58.7,134,60.9,2,0,0
3/01/2018 9:05,70,63.2,90,57.9,160,60.2,2,0,0
3/01/2018 9:10,60,62.9,80,57.6,140,59.9,2,0,0
3/01/2018 9:15,62,62.5,82,57.1,144,59.4,2,0,0
3/01/2018 9:20,52,62.3,71,57,123,59.2,2,0,0
3/01/2018 9:25,57,63,75,57.8,132,60.1,2,0,0
3/01/2018 9:30,71,63.1,93,57.8,164,60.1,2,0,0
3/01/2018 9:35,52,67.7,47,61.9,99,64.9,2,0,0
3/01/2018 9:40,53,67.7,47,61.9,100,65,2,0,0
3/01/2018 9:45,71,60.4,91,54.7,162,57.2,2,0,0
3/01/2018 9:50,69,60.7,89,55.1,158,57.6,2,0,0
3/01/2018 9:55,63,62.5,81,57,144,59.4,2,0,0
3/01/2018 10:00,56,64,74,58.8,130,61,2,0,0
3/01/2018 10:05,49,65.3,68,60.3,117,62.4,2,0,0
3/01/2018 10:10,48,65.7,67,60.6,115,62.7,2,0,0
3/01/2018 10:15,51,63.7,69,58.4,120,60.7,2,0,0
3/01/2018 10:20,57,62.3,76,56.9,133,59.2,2,0,0
3/01/2018 10:25,50,58.9,67,53.1,117,55.5,2,0,0
3/01/2018 10:30,56,59,73,53.2,129,55.7,2,0,0
3/01/2018 10:35,56,59.1,74,53.3,130,55.8,2,0,0
3/01/2018 10:40,55,59.7,73,54,128,56.4,2,0,0
3/01/2018 10:45,48,61.4,67,55.9,115,58.2,2,0,0
3/01/2018 10:50,51,62.3,70,56.9,121,59.2,2,0,0
3/01/2018 10:55,44,63.8,62,58.7,106,60.8,2,0,0
3/01/2018 11:00,53,64.2,70,59.1,123,61.3,2,0,0
3/01/2018 11:05,54,64.3,71,59.2,125,61.4,2,0,0
3/01/2018 11:10,50,65.6,68,60.6,118,62.7,2,0,0
3/01/2018 11:15,54,66,72,61,126,63.2,2,0,0
3/01/2018 11:20,47,66.3,65,61.4,112,63.5,2,0,0
3/01/2018 11:25,57,65.5,76,60.5,133,62.7,2,0,0
3/01/2018 11:30,52,65.9,71,61,123,63.1,2,0,0
3/01/2018 11:35,54,65.7,72,60.7,126,62.8,2,0,0
3/01/2018 11:40,48,64.9,66,59.9,114,62,2,0,0
3/01/2018 11:45,52,65.7,71,60.8,123,62.9,2,0,0
3/01/2018 11:50,47,66.2,64,61.3,111,63.4,2,0,0
3/01/2018 11:55,39,65.9,55,61,94,63,2,0,0
3/01/2018 12:00,28,68.1,44,63.4,72,65.2,2,0,0
3/01/2018 12:05,38,69.2,55,64.5,93,66.4,2,0,0
3/01/2018 12:10,37,67.1,54,62.4,91,64.3,2,0,0
3/01/2018 12:15,43,66.4,61,61.6,104,63.6,2,0,0
3/01/2018 12:20,45,67.2,62,62.5,107,64.5,2,0,0
3/01/2018 12:25,46,64.3,64,59.3,110,61.4,2,0,0
3/01/2018 12:30,48,64.9,66,59.9,114,62,2,0,0
3/01/2018 12:35,46,65.6,64,60.6,110,62.7,2,0,0
3/01/2018 12:40,39,66.3,56,61.4,95,63.4,2,0,0
3/01/2018 12:45,40,65.4,57,60.4,97,62.5,2,0,0
3/01/2018 12:50,44,66.1,61,61.2,105,63.2,2,0,0
3/01/2018 12:55,40,65.8,57,61,97,63,2,0,0
3/01/2018 13:00,40,66.9,57,62.1,97,64.1,2,0,0
3/01/2018 13:05,37,67.2,55,62.5,92,64.4,2,0,0
3/01/2018 13:10,36,68.1,52,63.4,88,65.3,2,0,0
3/01/2018 13:15,46,68.2,63,63.5,109,65.5,2,0,0
3/01/2018 13:20,48,69.2,65,64.6,113,66.6,2,0,0
3/01/2018 13:25,37,68.5,54,63.7,91,65.7,2,0,0
3/01/2018 13:30,30,68.5,46,63.8,76,65.7,2,0,0
3/01/2018 13:35,60,69,78,64.3,138,66.4,2,0,0
3/01/2018 13:40,38,67.9,54,63.1,92,65.1,2,0,0
3/01/2018 13:45,53,68.1,70,63.4,123,65.4,2,0,0
3/01/2018 13:50,59,68.4,77,63.7,136,65.7,2,0,0
3/01/2018 13:55,58,68.8,77,64.2,135,66.2,2,0,0
3/01/2018 14:00,54,68,73,63.3,127,65.3,2,0,0
3/01/2018 14:05,56,68.4,73,63.7,129,65.8,2,0,0
3/01/2018 14:10,42,66.1,59,61.3,101,63.3,2,0,0
3/01/2018 14:15,55,67.1,72,62.4,127,64.5,2,0,0
3/01/2018 14:20,46,66.7,64,61.9,110,63.9,2,0,0
3/01/2018 14:25,46,67.5,62,62.8,108,64.8,2,0,0
3/01/2018 14:30,53,65.8,70,60.8,123,63,2,0,0
3/01/2018 14:35,47,67.4,64,62.5,111,64.6,2,0,0
3/01/2018 14:40,57,67.7,75,62.9,132,65,2,0,0
3/01/2018 14:45,44,68.7,61,64,105,66,2,0,0
3/01/2018 14:50,50,68.2,68,63.4,118,65.4,2,0,0
3/01/2018 14:55,50,67.7,68,62.9,118,64.9,2,0,0
3/01/2018 15:00,48,68.3,65,63.5,113,65.5,2,0,0
3/01/2018 15:05,53,69.8,71,65.2,124,67.2,2,0,0
3/01/2018 15:10,53,70.2,71,65.6,124,67.6,2,0,0
3/01/2018 15:15,53,70.1,71,65.5,124,67.5,2,0,0
3/01/2018 15:20,52,68.8,70,64.1,122,66.1,2,0,0
3/01/2018 15:25,51,69.5,68,64.9,119,66.9,2,0,0
3/01/2018 15:30,52,69.9,70,65.3,122,67.3,2,0,0
3/01/2018 15:35,52,69.5,70,64.9,122,66.9,2,0,0
3/01/2018 15:40,57,69.6,75,65,132,67,2,0,0
3/01/2018 15:45,59,68.1,77,63.4,136,65.4,2,0,0
3/01/2018 15:50,58,67.6,77,62.8,135,64.9,2,0,0
3/01/2018 15:55,50,67.4,67,62.6,117,64.6,2,0,0
3/01/2018 16:00,51,67.6,69,62.7,120,64.8,2,0,0
3/01/2018 16:05,42,68.3,60,63.5,102,65.5,2,0,0
3/01/2018 16:10,56,68.2,74,63.4,130,65.5,2,0,0
3/01/2018 16:15,60,68.3,78,63.5,138,65.6,2,0,0
3/01/2018 16:20,68,68.7,87,63.9,155,66,2,0,0
3/01/2018 16:25,58,67.8,77,62.9,135,65,2,0,0
3/01/2018 16:30,56,67.4,75,62.6,131,64.7,2,0,0
3/01/2018 16:35,69,67.9,88,63,157,65.2,2,0,0
3/01/2018 16:40,57,67.9,75,63.2,132,65.2,2,0,0
3/01/2018 16:45,54,68.4,71,63.8,125,65.8,2,0,0
3/01/2018 16:50,65,67.6,84,62.8,149,64.9,2,0,0
3/01/2018 16:55,49,68.7,67,63.9,116,65.9,2,0,0
3/01/2018 17:00,54,68.8,72,64.1,126,66.1,2,0,0
3/01/2018 17:05,49,70.2,68,65.6,117,67.5,2,0,0
3/01/2018 17:10,43,68.9,61,64.1,104,66.1,2,0,0
3/01/2018 17:15,53,70.1,70,65.5,123,67.4,2,0,0
3/01/2018 17:20,52,69.6,71,64.9,123,66.9,2,0,0
3/01/2018 17:25,47,69.8,65,65.2,112,67.1,2,0,0
3/01/2018 17:30,54,68.3,72,63.6,126,65.6,2,0,0
3/01/2018 17:35,54,68.7,72,64,126,66,2,0,0
3/01/2018 17:40,50,69,68,64.2,118,66.2,2,0,0
3/01/2018 17:45,50,70,68,65.3,118,67.3,2,0,0
3/01/2018 17:50,52,69.9,70,65.3,122,67.2,2,0,0
3/01/2018 17:55,59,70.7,78,66.1,137,68.1,2,0,0
3/01/2018 18:00,43,69.9,60,65.3,103,67.2,2,0,0
3/01/2018 18:05,36,69.9,52,65.3,88,67.2,2,0,0
3/01/2018 18:10,49,69,66,64.4,115,66.3,2,0,0
3/01/2018 18:15,43,69.2,61,64.6,104,66.5,2,0,0
3/01/2018 18:20,36,68.6,52,64,88,65.9,2,0,0
3/01/2018 18:25,46,68.9,64,64.2,110,66.2,2,0,0
3/01/2018 18:30,43,68.7,60,64.1,103,66,2,0,0
3/01/2018 18:35,47,67.1,65,62.3,112,64.3,2,0,0
3/01/2018 18:40,49,67.1,66,62.3,115,64.4,2,0,0
3/01/2018 18:45,44,67.8,61,63,105,65,2,0,0
3/01/2018 18:50,47,67.6,64,62.8,111,64.8,2,0,0
3/01/2018 18:55,39,66.5,56,61.6,95,63.6,2,0,0
3/01/2018 19:00,54,68.3,73,63.6,127,65.6,2,0,0
3/01/2018 19:05,34,68.4,51,63.7,85,65.6,2,0,0
3/01/2018 19:10,39,69.2,56,64.6,95,66.5,2,0,0
3/01/2018 19:15,43,69.1,60,64.4,103,66.3,2,0,0
3/01/2018 19:20,45,68.9,63,64.2,108,66.2,2,0,0
3/01/2018 19:25,38,68.6,55,63.8,93,65.8,2,0,0
3/01/2018 19:30,35,68.9,52,64.2,87,66.1,2,0,0
3/01/2018 19:35,43,68.5,60,63.8,103,65.7,2,0,0
3/01/2018 19:40,38,68.4,55,63.7,93,65.6,2,0,0
3/01/2018 19:45,37,69.3,55,64.7,92,66.5,2,0,0
3/01/2018 19:50,40,70.2,57,65.7,97,67.6,2,0,0
3/01/2018 19:55,35,69.9,51,65.3,86,67.2,2,0,0
3/01/2018 20:00,37,69.5,53,64.9,90,66.8,2,0,0
3/01/2018 20:05,32,69.1,48,64.4,80,66.3,2,0,0
3/01/2018 20:10,33,69,49,64.4,82,66.2,2,0,0
3/01/2018 20:15,31,69.2,47,64.6,78,66.4,2,0,0
3/01/2018 20:20,41,70.2,36,64.2,77,67.4,2,0,0
3/01/2018 20:25,39,70.1,35,64.1,74,67.3,2,0,0
3/01/2018 20:30,38,70.1,35,64.1,73,67.2,2,0,0
3/01/2018 20:35,38,70.2,34,64.2,72,67.4,2,0,0
3/01/2018 20:40,36,70.4,32,64.4,68,67.6,2,0,0
3/01/2018 20:45,36,70.3,33,64.3,69,67.4,2,0,0
3/01/2018 20:50,33,69.3,50,64.7,83,66.6,2,0,0
3/01/2018 20:55,25,69.2,41,64.5,66,66.3,2,0,0
3/01/2018 21:00,30,68.5,45,63.8,75,65.7,2,0,0
3/01/2018 21:05,26,68.2,42,63.5,68,65.3,2,0,0
3/01/2018 21:10,29,66.9,45,62.1,74,64,2,0,0
3/01/2018 21:15,28,66.7,44,61.9,72,63.7,2,0,0
3/01/2018 21:20,32,65.8,49,60.9,81,62.8,2,0,0
3/01/2018 21:25,28,65.3,45,60.3,73,62.2,2,0,0
3/01/2018 21:30,34,70.3,31,64.3,65,67.4,2,0,0
3/01/2018 21:35,19,69.3,34,64.7,53,66.4,2,0,0
3/01/2018 21:40,23,68.3,38,63.6,61,65.4,2,0,0
3/01/2018 21:45,33,67,49,62.2,82,64.1,2,0,0
3/01/2018 21:50,32,65.9,48,61,80,62.9,2,0,0
3/01/2018 21:55,24,65.7,39,60.8,63,62.7,2,0,0
3/01/2018 22:00,28,66.3,44,61.5,72,63.4,2,0,0
3/01/2018 22:05,25,66.9,40,62.1,65,64,2,0,0
3/01/2018 22:10,29,67,45,62.2,74,64,2,0,0
3/01/2018 22:15,20,66.5,35,61.7,55,63.4,2,0,0
3/01/2018 22:20,20,67.2,37,62.4,57,64.1,2,0,0
3/01/2018 22:25,24,66.3,39,61.5,63,63.4,2,0,0
3/01/2018 22:30,23,67.2,38,62.5,61,64.3,2,0,0
3/01/2018 22:35,21,67.6,36,62.8,57,64.6,2,0,0
3/01/2018 22:40,21,67.5,36,62.8,57,64.5,2,0,0
3/01/2018 22:45,24,67.1,39,62.3,63,64.2,2,0,0
3/01/2018 22:50,22,67.9,38,63.2,60,64.9,2,0,0
3/01/2018 22:55,15,68.4,31,63.7,46,65.2,2,0,0
3/01/2018 23:00,16,68.7,31,64.1,47,65.6,2,0,0
3/01/2018 23:05,20,68.4,36,63.8,56,65.4,2,0,0
3/01/2018 23:10,19,68.3,34,63.6,53,65.3,2,0,0
3/01/2018 23:15,15,68.7,30,64.1,45,65.6,2,0,0
3/01/2018 23:20,19,68.9,34,64.2,53,65.9,2,0,0
3/01/2018 23:25,14,68.9,29,64.2,43,65.8,2,0,0
3/01/2018 23:30,15,69.1,30,64.4,45,66,2,0,0
3/01/2018 23:35,16,69.2,32,64.6,48,66.1,2,0,0
3/01/2018 23:40,14,68.7,29,64.1,43,65.6,2,0,0
3/01/2018 23:45,12,69,27,64.4,39,65.8,2,0,0
3/01/2018 23:50,16,69.1,31,64.4,47,66,2,0,0
3/01/2018 23:55,11,69.2,26,64.5,37,65.9,2,0,0
3/02/2018 0:00,12,69.3,27,64.7,39,66.2,2,0,0
3/02/2018 0:05,10,69.2,25,64.6,35,65.9,2,0,0
3/02/2018 0:10,13,69.1,28,64.5,41,65.9,2,0,0
3/02/2018 0:15,12,69.1,27,64.5,39,65.9,2,0,0
3/02/2018 0:20,8,69.2,23,64.6,31,65.8,2,0,0
3/02/2018 0:25,9,68.9,24,64.3,33,65.6,2,0,0
3/02/2018 0:30,8,69.1,24,64.4,32,65.6,2,0,0
3/02/2018 0:35,10,68.5,26,63.9,36,65.2,2,0,0
3/02/2018 0:40,9,68.9,24,64.2,33,65.5,2,0,0
3/02/2018 0:45,10,69.1,26,64.5,36,65.8,2,0,0
3/02/2018 0:50,10,69.1,20,64.4,30,66,2,0,0
3/02/2018 0:55,10,68.6,25,64,35,65.3,2,0,0
3/02/2018 1:00,7,68.6,22,64,29,65.1,2,0,0
3/02/2018 1:05,7,69,23,64.4,30,65.4,2,0,0
3/02/2018 1:10,7,69.2,22,64.6,29,65.7,2,0,0
3/02/2018 1:15,10,69.1,25,64.5,35,65.8,2,0,0
3/02/2018 1:20,6,69.1,21,64.5,27,65.5,2,0,0
3/02/2018 1:25,12,69.2,21,64.6,33,66.3,2,0,0
3/02/2018 1:30,10,69.3,26,64.7,36,65.9,2,0,0
3/02/2018 1:35,11,69.3,26,64.7,37,66,2,0,0
3/02/2018 1:40,7,69.1,23,64.5,30,65.6,2,0,0
3/02/2018 1:45,9,69.3,24,64.7,33,65.9,2,0,0
3/02/2018 1:50,5,69.4,20,64.8,25,65.7,2,0,0
3/02/2018 1:55,7,69.5,22,64.9,29,66,2,0,0
3/02/2018 2:00,10,69.3,25,64.7,35,66,2,0,0
3/02/2018 2:05,7,69.2,23,64.6,30,65.7,2,0,0
3/02/2018 2:10,10,69.3,25,64.7,35,66,2,0,0
3/02/2018 2:15,10,69.3,26,64.7,36,65.9,2,0,0
3/02/2018 2:20,5,69.3,21,64.7,26,65.5,2,0,0
3/02/2018 2:25,8,69.3,23,64.7,31,65.9,2,0,0
3/02/2018 2:30,9,69.3,25,64.7,34,66,2,0,0
3/02/2018 2:35,8,69.1,23,64.5,31,65.7,2,0,0
3/02/2018 2:40,13,69.3,28,64.7,41,66.2,2,0,0
3/02/2018 2:45,8,69.3,24,64.7,32,65.8,2,0,0
3/02/2018 2:50,9,69.4,24,64.8,33,66.1,2,0,0
3/02/2018 2:55,8,69.4,23,64.8,31,66,2,0,0
3/02/2018 3:00,8,69.3,24,64.7,32,65.9,2,0,0
3/02/2018 3:05,11,69.3,27,64.7,38,66,2,0,0
3/02/2018 3:10,10,69.3,25,64.7,35,66,2,0,0
3/02/2018 3:15,10,69.3,25,64.7,35,66,2,0,0
3/02/2018 3:20,11,69.4,27,64.8,38,66.1,2,0,0
3/02/2018 3:25,10,69.1,25,64.5,35,65.8,2,0,0
3/02/2018 3:30,14,69.2,30,64.6,44,66.1,2,0,0
3/02/2018 3:35,11,68.8,27,64.2,38,65.5,2,0,0
3/02/2018 3:40,12,69.1,28,64.5,40,65.9,2,0,0
3/02/2018 3:45,15,69.3,31,64.7,46,66.2,2,0,0
3/02/2018 3:50,11,69.3,27,64.7,38,66,2,0,0
3/02/2018 3:55,15,69.3,31,64.7,46,66.2,2,0,0
3/02/2018 4:00,17,69.4,33,64.7,50,66.3,2,0,0
3/02/2018 4:05,18,69.5,33,64.9,51,66.6,2,0,0
3/02/2018 4:10,20,69.4,36,64.8,56,66.4,2,0,0
3/02/2018 4:15,17,69.6,33,65,50,66.5,2,0,0
3/02/2018 4:20,19,69.5,36,64.9,55,66.5,2,0,0
3/02/2018 4:25,22,69,39,64.3,61,66,2,0,0
3/02/2018 4:30,25,68.7,42,64,67,65.7,2,0,0
3/02/2018 4:35,22,69.3,39,64.7,61,66.4,2,0,0
3/02/2018 4:40,37,69.2,54,64.6,91,66.5,2,0,0
3/02/2018 4:45,36,68.6,53,63.9,89,65.8,2,0,0
3/02/2018 4:50,33,68,51,63.2,84,65.1,2,0,0
3/02/2018 4:55,37,68.3,54,63.5,91,65.5,2,0,0
3/02/2018 5:00,38,69.4,57,64.8,95,66.7,2,0,0
3/02/2018 5:05,37,68.5,55,63.9,92,65.8,2,0,0
3/02/2018 5:10,35,69.2,53,64.6,88,66.5,2,0,0
3/02/2018 5:15,44,68.6,64,63.9,108,65.9,2,0,0
3/02/2018 5:20,53,68.5,73,63.8,126,65.8,2,0,0
3/02/2018 5:25,54,69,75,64.3,129,66.3,2,0,0
3/02/2018 5:30,49,68.4,69,63.7,118,65.7,2,0,0
3/02/2018 5:35,48,67.2,69,62.4,117,64.4,2,0,0
3/02/2018 5:40,57,67.2,78,62.4,135,64.5,2,0,0
3/02/2018 5:45,64,67.5,85,62.7,149,64.8,2,0,0
3/02/2018 5:50,53,67.8,74,63,127,65,2,0,0
3/02/2018 5:55,57,66.5,77,61.7,134,63.7,2,0,0
3/02/2018 6:00,56,67.5,76,62.7,132,64.7,2,0,0
3/02/2018 6:05,54,65.5,74,60.5,128,62.6,2,0,0
3/02/2018 6:10,58,66.5,79,61.5,137,63.6,2,0,0
3/02/2018 6:15,60,66.4,81,61.4,141,63.5,2,0,0
3/02/2018 6:20,68,66.5,89,61.5,157,63.7,2,0,0
3/02/2018 6:25,60,66.4,82,61.4,142,63.5,2,0,0
3/02/2018 6:30,62,67.3,84,62.4,146,64.5,2,0,0
3/02/2018 6:35,62,67.8,83,62.9,145,65,2,0,0
3/02/2018 6:40,70,68.5,91,63.7,161,65.8,2,0,0
3/02/2018 6:45,79,67.2,101,62.4,180,64.5,2,0,0
3/02/2018 6:50,68,68,90,63.2,158,65.2,2,0,0
3/02/2018 6:55,59,69,80,64.3,139,66.3,2,0,0
3/02/2018 7:00,69,68.8,91,64.1,160,66.1,2,0,0
3/02/2018 7:05,62,67.4,82,62.6,144,64.7,2,0,0
3/02/2018 7:10,78,68,100,63.2,178,65.3,2,0,0
3/02/2018 7:15,72,66.9,95,62,167,64.1,2,0,0
3/02/2018 7:20,84,67.3,107,62.4,191,64.5,2,0,0
3/02/2018 7:25,70,66.5,92,61.6,162,63.7,2,0,0
3/02/2018 7:30,90,67.4,115,62.5,205,64.7,2,0,0
3/02/2018 7:35,82,66.3,106,61.3,188,63.5,2,0,0
3/02/2018 7:40,85,66.5,108,61.6,193,63.7,2,0,0
3/02/2018 7:45,78,66.2,99,61.2,177,63.4,2,0,0
3/02/2018 7:50,85,66.8,107,61.9,192,64.1,2,0,0
3/02/2018 7:55,81,67.1,104,62.2,185,64.4,2,0,0
3/02/2018 8:00,72,67,94,62,166,64.2,2,0,0
3/02/2018 8:05,67,67,88,62,155,64.2,2,0,0
3/02/2018 8:10,72,66.7,94,61.7,166,63.9,2,0,0
3/02/2018 8:15,83,66.1,106,61.1,189,63.3,2,0,0
3/02/2018 8:20,70,66.8,92,62,162,64.1,2,0,0
3/02/2018 8:25,78,67.8,100,63,178,65.1,2,0,0
3/02/2018 8:30,75,66.7,97,61.8,172,64,2,0,0
3/02/2018 8:35,76,67,97,62.1,173,64.3,2,0,0
3/02/2018 8:40,69,65.9,90,60.9,159,63.1,2,0,0
3/02/2018 8:45,71,65.6,91,60.6,162,62.8,2,0,0
3/02/2018 8:50,66,66,86,61.1,152,63.2,2,0,0
3/02/2018 8:55,67,66.8,88,61.9,155,64,2,0,0
3/02/2018 9:00,69,68,89,63.1,158,65.3,2,0,0
3/02/2018 9:05,53,64.4,71,59.2,124,61.4,2,0,0
3/02/2018 9:10,58,64.5,78,59.4,136,61.6,2,0,0
3/02/2018 9:15,57,64.9,75,59.8,132,62,2,0,0
3/02/2018 9:20,55,64.8,74,59.8,129,61.9,2,0,0
3/02/2018 9:25,60,65.1,79,60.1,139,62.2,2,0,0
3/02/2018 9:30,56,66,74,61.1,130,63.2,2,0,0
3/02/2018 9:35,61,67.7,80,62.9,141,65,2,0,0
3/02/2018 9:40,75,67.4,96,62.5,171,64.6,2,0,0
3/02/2018 9:45,63,64.9,83,59.8,146,62,2,0,0
3/02/2018 9:50,57,64.5,76,59.4,133,61.6,2,0,0
3/02/2018 9:55,59,65.3,78,60.4,137,62.5,2,0,0
3/02/2018 10:00,58,66.2,77,61.2,135,63.4,2,0,0
3/02/2018 10:05,61,66,81,61,142,63.1,2,0,0
3/02/2018 10:10,59,65.1,79,60,138,62.2,2,0,0
3/02/2018 10:15,53,66.3,73,61.3,126,63.4,2,0,0
3/02/2018 10:20,64,65.3,84,60.3,148,62.5,2,0,0
3/02/2018 10:25,73,66.1,92,61.2,165,63.4,2,0,0
3/02/2018 10:30,69,67.1,90,62.3,159,64.4,2,0,0
3/02/2018 10:35,58,66.7,76,61.8,134,63.9,2,0,0
3/02/2018 10:40,66,65.2,84,60.2,150,62.4,2,0,0
3/02/2018 10:45,70,66.6,90,61.7,160,63.9,2,0,0
3/02/2018 10:50,53,66.6,71,61.7,124,63.8,2,0,0
3/02/2018 10:55,59,67,78,62.1,137,64.2,2,0,0
3/02/2018 11:00,55,67.5,72,62.7,127,64.7,2,0,0
3/02/2018 11:05,63,67.6,82,62.8,145,64.9,2,0,0
3/02/2018 11:10,63,68.4,81,63.8,144,65.8,2,0,0
3/02/2018 11:15,64,67.4,83,62.7,147,64.8,2,0,0
3/02/2018 11:20,56,66.9,73,62.1,129,64.2,2,0,0
3/02/2018 11:25,62,66,82,61.2,144,63.3,2,0,0
3/02/2018 11:30,55,67.3,73,62.6,128,64.6,2,0,0
3/02/2018 11:35,61,67.1,80,62.3,141,64.4,2,0,0
3/02/2018 11:40,61,66.5,79,61.6,140,63.7,2,0,0
3/02/2018 11:45,60,66.7,80,61.8,140,63.9,2,0,0
3/02/2018 11:50,56,67,73,62.3,129,64.3,2,0,0
3/02/2018 11:55,56,67.9,73,63.1,129,65.2,2,0,0
3/02/2018 12:00,59,68.4,78,63.7,137,65.7,2,0,0
3/02/2018 12:05,48,68.2,65,63.5,113,65.5,2,0,0
3/02/2018 12:10,53,67.8,70,63,123,65.1,2,0,0
3/02/2018 12:15,58,67.9,74,63.2,132,65.3,2,0,0
3/02/2018 12:20,60,68.5,79,63.8,139,65.8,2,0,0
3/02/2018 12:25,53,67.8,71,63.1,124,65.1,2,0,0
3/02/2018 12:30,53,67.3,71,62.5,124,64.5,2,0,0
3/02/2018 12:35,58,68,76,63.4,134,65.4,2,0,0
3/02/2018 12:40,54,67.9,73,63.1,127,65.1,2,0,0
3/02/2018 12:45,50,68,68,63.2,118,65.2,2,0,0
3/02/2018 12:50,49,67.5,67,62.7,116,64.7,2,0,0
3/02/2018 12:55,55,66.9,75,62,130,64,2,0,0
3/02/2018 13:00,50,67.1,68,62.3,118,64.3,2,0,0
3/02/2018 13:05,52,65.4,71,60.4,123,62.5,2,0,0
3/02/2018 13:10,54,65.8,72,60.9,126,63,2,0,0
3/02/2018 13:15,42,66.1,60,61.2,102,63.2,2,0,0
3/02/2018 13:20,40,66.5,57,61.7,97,63.7,2,0,0
3/02/2018 13:25,49,65.9,68,60.9,117,63,2,0,0
3/02/2018 13:30,44,65.7,61,60.7,105,62.8,2,0,0
3/02/2018 13:35,50,64.4,68,59.3,118,61.5,2,0,0
3/02/2018 13:40,47,65.5,64,60.5,111,62.6,2,0,0
3/02/2018 13:45,50,65.2,69,60,119,62.2,2,0,0
3/02/2018 13:50,49,63.1,67,57.9,116,60.1,2,0,0
3/02/2018 13:55,47,61,65,55.5,112,57.8,2,0,0
3/02/2018 14:00,43,62.1,60,56.7,103,59,2,0,0
3/02/2018 14:05,53,62.8,71,57.5,124,59.7,2,0,0
3/02/2018 14:10,50,62.5,67,57.2,117,59.4,2,0,0
3/02/2018 14:15,49,63.5,66,58.4,115,60.6,2,0,0
3/02/2018 14:20,43,64.7,60,59.7,103,61.8,2,0,0
3/02/2018 14:25,50,65.5,67,60.6,117,62.7,2,0,0
3/02/2018 14:30,41,65.8,59,60.8,100,62.9,2,0,0
3/02/2018 14:35,51,65.7,69,60.7,120,62.8,2,0,0
3/02/2018 14:40,60,65.4,79,60.3,139,62.5,2,0,0
3/02/2018 14:45,57,66.5,75,61.5,132,63.7,2,0,0
3/02/2018 14:50,51,67.3,68,62.4,119,64.5,2,0,0
3/02/2018 14:55,51,65.7,69,60.6,120,62.8,2,0,0
3/02/2018 15:00,47,66,65,61.1,112,63.1,2,0,0
3/02/2018 15:05,66,65.2,86,60.1,152,62.3,2,0,0
3/02/2018 15:10,53,66.6,70,61.6,123,63.8,2,0,0
3/02/2018 15:15,63,66.4,82,61.4,145,63.6,2,0,0
3/02/2018 15:20,62,66.7,81,61.7,143,63.9,2,0,0
3/02/2018 15:25,57,66.9,75,62,132,64.1,2,0,0
3/02/2018 15:30,51,67,70,62,121,64.1,2,0,0
3/02/2018 15:35,55,67.2,74,62.3,129,64.4,2,0,0
3/02/2018 15:40,57,67.3,75,62.4,132,64.5,2,0,0
3/02/2018 15:45,55,64.9,74,59.8,129,62,2,0,0
3/02/2018 15:50,57,65.5,75,60.4,132,62.6,2,0,0
3/02/2018 15:55,57,67.1,74,62.2,131,64.4,2,0,0
3/02/2018 16:00,58,67.2,76,62.4,134,64.5,2,0,0
3/02/2018 16:05,60,67.4,79,62.5,139,64.6,2,0,0
3/02/2018 16:10,65,66.8,83,61.9,148,64,2,0,0
3/02/2018 16:15,59,67.2,76,62.3,135,64.5,2,0,0
3/02/2018 16:20,62,66.8,81,61.9,143,64,2,0,0
3/02/2018 16:25,66,66.9,83,62,149,64.2,2,0,0
3/02/2018 16:30,66,66.1,84,61.2,150,63.4,2,0,0
3/02/2018 16:35,51,62.7,68,57.4,119,59.7,2,0,0
3/02/2018 16:40,54,62.6,72,57.2,126,59.5,2,0,0
3/02/2018 16:45,43,62.2,60,56.8,103,59,2,0,0
3/02/2018 16:50,51,62.2,69,56.8,120,59.1,2,0,0
3/02/2018 16:55,39,63.8,55,58.6,94,60.7,2,0,0
3/02/2018 17:00,54,63.8,72,58.6,126,60.8,2,0,0
3/02/2018 17:05,44,65,61,59.9,105,62,2,0,0
3/02/2018 17:10,62,62.1,81,56.6,143,59,2,0,0
3/02/2018 17:15,49,64.5,66,59.3,115,61.5,2,0,0
3/02/2018 17:20,49,65.6,67,60.6,116,62.7,2,0,0
3/02/2018 17:25,54,65.6,72,60.5,126,62.7,2,0,0
3/02/2018 17:30,56,65.5,74,60.4,130,62.6,2,0,0
3/02/2018 17:35,54,66.8,72,61.8,126,63.9,2,0,0
3/02/2018 17:40,56,67.2,73,62.2,129,64.4,2,0,0
3/02/2018 17:45,52,66,70,61,122,63.1,2,0,0
3/02/2018 17:50,53,66,70,61,123,63.1,2,0,0
3/02/2018 17:55,56,65.2,75,60.1,131,62.2,2,0,0
3/02/2018 18:00,51,66.3,69,61.4,120,63.5,2,0,0
3/02/2018 18:05,48,66.9,65,62,113,64.1,2,0,0
3/02/2018 18:10,51,67.6,69,62.8,120,64.9,2,0,0
3/02/2018 18:15,44,68.6,61,64,105,65.9,2,0,0
3/02/2018 18:20,53,68.1,71,63.3,124,65.3,2,0,0
3/02/2018 18:25,54,66.5,71,61.5,125,63.7,2,0,0
3/02/2018 18:30,53,65.4,71,60.3,124,62.5,2,0,0
3/02/2018 18:35,48,65.1,66,60,114,62.2,2,0,0
3/02/2018 18:40,51,65.6,69,60.6,120,62.7,2,0,0
3/02/2018 18:45,50,66.4,68,61.5,118,63.6,2,0,0
3/02/2018 18:50,51,66.5,68,61.5,119,63.7,2,0,0
3/02/2018 18:55,39,67,56,62.1,95,64.1,2,0,0
3/02/2018 19:00,46,66.2,62,61.2,108,63.3,2,0,0
3/02/2018 19:05,50,67.4,67,62.6,117,64.7,2,0,0
3/02/2018 19:10,48,66.6,65,61.7,113,63.8,2,0,0
3/02/2018 19:15,42,67,59,62.1,101,64.1,2,0,0
3/02/2018 19:20,45,67.5,62,62.6,107,64.7,2,0,0
3/02/2018 19:25,48,64.7,66,59.5,114,61.7,2,0,0
3/02/2018 19:30,37,65.4,53,60.2,90,62.4,2,0,0
3/02/2018 19:35,40,66,58,61,98,63,2,0,0
3/02/2018 19:40,43,68.1,60,63.3,103,65.3,2,0,0
3/02/2018 19:45,35,68.7,52,64,87,65.9,2,0,0
3/02/2018 19:50,36,67.4,52,62.6,88,64.5,2,0,0
3/02/2018 19:55,40,67.4,57,62.6,97,64.6,2,0,0
3/02/2018 20:00,32,67.9,49,63.2,81,65.1,2,0,0
3/02/2018 20:05,35,67,51,62.2,86,64.2,2,0,0
3/02/2018 20:10,38,66.9,54,62,92,64,2,0,0
3/02/2018 20:15,45,67.1,62,62.2,107,64.3,2,0,0
3/02/2018 20:20,40,67,57,62.1,97,64.1,2,0,0
3/02/2018 20:25,41,67.7,58,62.9,99,64.9,2,0,0
3/02/2018 20:30,33,68.4,50,63.7,83,65.6,2,0,0
3/02/2018 20:35,34,69.1,50,64.5,84,66.4,2,0,0
3/02/2018 20:40,33,68.7,49,64,82,65.9,2,0,0
3/02/2018 20:45,26,68.6,41,63.9,67,65.7,2,0,0
3/02/2018 20:50,27,69,43,64.3,70,66.1,2,0,0
3/02/2018 20:55,28,69.1,44,64.5,72,66.3,2,0,0
3/02/2018 21:00,27,68.7,43,64,70,65.8,2,0,0
3/02/2018 21:05,27,68.5,43,63.8,70,65.6,2,0,0
3/02/2018 21:10,29,69,45,64.4,74,66.2,2,0,0
3/02/2018 21:15,35,68.5,51,63.8,86,65.7,2,0,0
3/02/2018 21:20,30,68.7,45,64,75,65.9,2,0,0
3/02/2018 21:25,27,69,43,64.4,70,66.2,2,0,0
3/02/2018 21:30,34,68.8,51,64.1,85,66,2,0,0
3/02/2018 21:35,31,68.5,48,63.8,79,65.7,2,0,0
3/02/2018 21:40,29,69.2,46,64.5,75,66.3,2,0,0
3/02/2018 21:45,30,69,45,64.3,75,66.2,2,0,0
3/02/2018 21:50,43,68.2,60,63.5,103,65.5,2,0,0
3/02/2018 21:55,27,68.4,43,63.7,70,65.5,2,0,0
3/02/2018 22:00,28,67.8,45,63.1,73,64.9,2,0,0
3/02/2018 22:05,24,68.4,40,63.7,64,65.5,2,0,0
3/02/2018 22:10,31,68.3,46,63.6,77,65.5,2,0,0
3/02/2018 22:15,25,68.2,42,63.6,67,65.3,2,0,0
3/02/2018 22:20,28,68.4,44,63.7,72,65.6,2,0,0
3/02/2018 22:25,27,68.6,43,64,70,65.8,2,0,0
3/02/2018 22:30,29,68.6,45,64,74,65.8,2,0,0
3/02/2018 22:35,28,69.2,45,64.6,73,66.4,2,0,0
3/02/2018 22:40,24,68.9,41,64.2,65,65.9,2,0,0
3/02/2018 22:45,27,68.4,43,63.7,70,65.5,2,0,0
3/02/2018 22:50,23,68.3,39,63.6,62,65.4,2,0,0
3/02/2018 22:55,24,68.8,39,64.2,63,65.9,2,0,0
3/02/2018 23:00,27,69,44,64.4,71,66.2,2,0,0
3/02/2018 23:05,21,69.2,36,64.6,57,66.3,2,0,0
3/02/2018 23:10,23,69.1,39,64.4,62,66.2,2,0,0
3/02/2018 23:15,19,69,34,64.3,53,66,2,0,0
3/02/2018 23:20,23,68.1,38,63.4,61,65.2,2,0,0
3/02/2018 23:25,18,68.7,34,64.1,52,65.7,2,0,0
3/02/2018 23:30,21,68.7,37,64.1,58,65.7,2,0,0
3/02/2018 23:35,20,69,36,64.3,56,66,2,0,0
3/02/2018 23:40,20,69.1,35,64.4,55,66.1,2,0,0
3/02/2018 23:45,18,69.1,33,64.5,51,66.1,2,0,0
3/02/2018 23:50,19,69.2,34,64.6,53,66.3,2,0,0
3/02/2018 23:55,15,69.4,30,64.8,45,66.3,2,0,0
3/03/2018 0:00,13,69.3,28,64.7,41,66.2,2,0,0
3/03/2018 0:05,11,69.4,26,64.8,37,66.2,2,0,0
3/03/2018 0:10,14,69.3,30,64.7,44,66.2,2,0,0
3/03/2018 0:15,14,69.4,29,64.8,43,66.3,2,0,0
3/03/2018 0:20,12,69.2,27,64.5,39,66,2,0,0
3/03/2018 0:25,14,69.1,30,64.5,44,66,2,0,0
3/03/2018 0:30,11,69,26,64.4,37,65.7,2,0,0
3/03/2018 0:35,10,69,26,64.4,36,65.7,2,0,0
3/03/2018 0:40,9,69.2,24,64.6,33,65.8,2,0,0
3/03/2018 0:45,10,69.3,26,64.7,36,66,2,0,0
3/03/2018 0:50,9,69.3,24,64.7,33,66,2,0,0
3/03/2018 0:55,10,69.2,26,64.6,36,65.9,2,0,0
3/03/2018 1:00,12,69.2,27,64.5,39,66,2,0,0
3/03/2018 1:05,11,69.2,21,64.6,32,66.2,2,0,0
3/03/2018 1:10,7,69.2,22,64.5,29,65.7,2,0,0
3/03/2018 1:15,9,69.3,24,64.7,33,66,2,0,0
3/03/2018 1:20,8,69.2,23,64.5,31,65.7,2,0,0
3/03/2018 1:25,9,69.2,24,64.6,33,65.8,2,0,0
3/03/2018 1:30,6,69.2,21,64.6,27,65.6,2,0,0
3/03/2018 1:35,11,69.3,26,64.7,37,66,2,0,0
3/03/2018 1:40,5,69.3,21,64.7,26,65.6,2,0,0
3/03/2018 1:45,7,69.3,22,64.7,29,65.8,2,0,0
3/03/2018 1:50,7,69.3,22,64.7,29,65.8,2,0,0
3/03/2018 1:55,9,69.2,24,64.6,33,65.8,2,0,0
3/03/2018 2:00,8,69.3,23,64.7,31,65.9,2,0,0
3/03/2018 2:05,6,69.3,21,64.7,27,65.7,2,0,0
3/03/2018 2:10,10,69.3,26,64.7,36,66,2,0,0
3/03/2018 2:15,7,69.4,22,64.8,29,65.9,2,0,0
3/03/2018 2:20,9,69.3,24,64.7,33,66,2,0,0
3/03/2018 2:25,8,69.3,23,64.7,31,65.9,2,0,0
3/03/2018 2:30,8,69.2,24,64.6,32,65.8,2,0,0
3/03/2018 2:35,7,69.3,23,64.7,30,65.8,2,0,0
3/03/2018 2:40,6,69.3,21,64.7,27,65.7,2,0,0
3/03/2018 2:45,9,69.3,24,64.7,33,66,2,0,0
3/03/2018 2:50,6,69.3,21,64.7,27,65.8,2,0,0
3/03/2018 2:55,10,69.2,25,64.6,35,65.9,2,0,0
3/03/2018 3:00,12,68.7,27,64,39,65.5,2,0,0
3/03/2018 3:05,7,68.8,23,64.1,30,65.2,2,0,0
3/03/2018 3:10,9,68.8,24,64.2,33,65.4,2,0,0
3/03/2018 3:15,6,69.1,22,64.4,28,65.4,2,0,0
3/03/2018 3:20,8,69.2,23,64.5,31,65.7,2,0,0
3/03/2018 3:25,10,69.2,25,64.5,35,65.9,2,0,0
3/03/2018 3:30,7,69.2,22,64.6,29,65.7,2,0,0
3/03/2018 3:35,7,69.3,22,64.7,29,65.8,2,0,0
3/03/2018 3:40,7,69.3,22,64.7,29,65.8,2,0,0
3/03/2018 3:45,9,69.3,24,64.7,33,66,2,0,0
3/03/2018 3:50,9,69.2,24,64.6,33,65.9,2,0,0
3/03/2018 3:55,12,69.2,27,64.6,39,66,2,0,0
3/03/2018 4:00,6,69.3,22,64.7,28,65.6,2,0,0
3/03/2018 4:05,10,69.3,26,64.7,36,66,2,0,0
3/03/2018 4:10,10,69.2,26,64.6,36,65.9,2,0,0
3/03/2018 4:15,9,69.3,24,64.7,33,65.9,2,0,0
3/03/2018 4:20,12,68.8,27,64.1,39,65.6,2,0,0
3/03/2018 4:25,15,69,31,64.4,46,65.9,2,0,0
3/03/2018 4:30,15,69.2,30,64.6,45,66.1,2,0,0
3/03/2018 4:35,17,68.7,32,64,49,65.7,2,0,0
3/03/2018 4:40,15,69.1,30,64.5,45,66,2,0,0
3/03/2018 4:45,15,69.1,30,64.5,45,66,2,0,0
3/03/2018 4:50,17,69.1,33,64.4,50,66,2,0,0
3/03/2018 4:55,16,69.1,32,64.4,48,66,2,0,0
3/03/2018 5:00,13,69.1,29,64.4,42,65.9,2,0,0
3/03/2018 5:05,15,69.2,31,64.5,46,66.1,2,0,0
3/03/2018 5:10,16,69,31,64.4,47,66,2,0,0
3/03/2018 5:15,17,68.9,33,64.2,50,65.8,2,0,0
3/03/2018 5:20,11,69.1,26,64.5,37,65.8,2,0,0
3/03/2018 5:25,15,69.2,30,64.5,45,66.1,2,0,0
3/03/2018 5:30,23,68.5,39,63.9,62,65.6,2,0,0
3/03/2018 5:35,21,68.7,37,64.1,58,65.8,2,0,0
3/03/2018 5:40,20,68.6,37,63.9,57,65.5,2,0,0
3/03/2018 5:45,20,68.9,37,64.2,57,65.9,2,0,0
3/03/2018 5:50,22,68.9,38,64.3,60,66,2,0,0
3/03/2018 5:55,23,68.6,38,63.9,61,65.7,2,0,0
3/03/2018 6:00,21,68.2,37,63.5,58,65.2,2,0,0
3/03/2018 6:05,25,67.8,41,63.1,66,64.9,2,0,0
3/03/2018 6:10,21,68.4,37,63.7,58,65.4,2,0,0
3/03/2018 6:15,27,67.9,43,63.1,70,65,2,0,0
3/03/2018 6:20,24,68.1,39,63.3,63,65.1,2,0,0
3/03/2018 6:25,23,68.6,39,63.9,62,65.7,2,0,0
3/03/2018 6:30,24,68.9,41,64.2,65,66,2,0,0
3/03/2018 6:35,28,69,45,64.4,73,66.2,2,0,0
3/03/2018 6:40,27,68.8,43,64.1,70,65.9,2,0,0
3/03/2018 6:45,28,69.3,45,64.7,73,66.4,2,0,0
3/03/2018 6:50,24,69.3,40,64.7,64,66.4,2,0,0
3/03/2018 6:55,27,69.1,43,64.5,70,66.3,2,0,0
3/03/2018 7:00,24,69.1,40,64.5,64,66.2,2,0,0
3/03/2018 7:05,23,69.4,39,64.8,62,66.5,2,0,0
3/03/2018 7:10,31,68.9,48,64.2,79,66,2,0,0
3/03/2018 7:15,38,68.7,55,64.1,93,66,2,0,0
3/03/2018 7:20,28,69.2,44,64.5,72,66.3,2,0,0
3/03/2018 7:25,37,68.1,54,63.4,91,65.3,2,0,0
3/03/2018 7:30,35,67.8,52,62.9,87,64.9,2,0,0
3/03/2018 7:35,37,68,54,63.2,91,65.2,2,0,0
3/03/2018 7:40,37,68.8,54,64.1,91,66,2,0,0
3/03/2018 7:45,34,68.7,50,64.1,84,65.9,2,0,0
3/03/2018 7:50,38,68.6,56,63.9,94,65.8,2,0,0
3/03/2018 7:55,37,69.3,54,64.6,91,66.5,2,0,0
3/03/2018 8:00,44,68.3,62,63.5,106,65.5,2,0,0
3/03/2018 8:05,34,67.7,51,62.9,85,64.8,2,0,0
3/03/2018 8:10,40,67.4,57,62.6,97,64.6,2,0,0
3/03/2018 8:15,37,67.5,54,62.7,91,64.7,2,0,0
3/03/2018 8:20,44,67.4,61,62.6,105,64.6,2,0,0
3/03/2018 8:25,45,68.3,63,63.6,108,65.6,2,0,0
3/03/2018 8:30,47,68.8,64,64.1,111,66.1,2,0,0
3/03/2018 8:35,44,68.9,61,64.2,105,66.2,2,0,0
3/03/2018 8:40,50,68.7,68,64,118,66,2,0,0
3/03/2018 8:45,55,67.5,73,62.7,128,64.8,2,0,0
3/03/2018 8:50,58,68.5,77,63.8,135,65.8,2,0,0
3/03/2018 8:55,51,68.7,68,64.1,119,66.1,2,0,0
3/03/2018 9:00,45,68.5,63,63.8,108,65.8,2,0,0
3/03/2018 9:05,45,67.6,62,62.8,107,64.8,2,0,0
3/03/2018 9:10,53,67.6,71,62.8,124,64.8,2,0,0
3/03/2018 9:15,56,67.7,75,63,131,65,2,0,0
3/03/2018 9:20,52,68.1,70,63.4,122,65.4,2,0,0
3/03/2018 9:25,54,67.4,72,62.6,126,64.7,2,0,0
3/03/2018 9:30,59,67.2,78,62.4,137,64.4,2,0,0
3/03/2018 9:35,58,66.7,76,61.9,134,64,2,0,0
3/03/2018 9:40,63,67.1,82,62.2,145,64.3,2,0,0
3/03/2018 9:45,69,67,88,62.2,157,64.3,2,0,0
3/03/2018 9:50,67,67,87,62.3,154,64.3,2,0,0
3/03/2018 9:55,73,67.9,93,63.1,166,65.2,2,0,0
3/03/2018 10:00,74,67.5,93,62.7,167,64.8,2,0,0
3/03/2018 10:05,74,66.1,94,61.1,168,63.3,2,0,0
3/03/2018 10:10,67,66.3,87,61.4,154,63.6,2,0,0
3/03/2018 10:15,75,66.3,95,61.4,170,63.6,2,0,0
3/03/2018 10:20,76,66.6,95,61.7,171,63.9,2,0,0
3/03/2018 10:25,65,67.2,85,62.3,150,64.4,2,0,0
3/03/2018 10:30,75,66.3,95,61.3,170,63.5,2,0,0
3/03/2018 10:35,67,66.8,86,61.9,153,64,2,0,0
3/03/2018 10:40,66,67.2,86,62.4,152,64.5,2,0,0
3/03/2018 10:45,66,67.2,85,62.3,151,64.5,2,0,0
3/03/2018 10:50,68,66.9,86,62,154,64.1,2,0,0
3/03/2018 10:55,58,67,76,62.1,134,64.2,2,0,0
3/03/2018 11:00,68,67,87,62.1,155,64.3,2,0,0
3/03/2018 11:05,59,67.4,78,62.5,137,64.6,2,0,0
3/03/2018 11:10,61,66.9,80,62,141,64.1,2,0,0
3/03/2018 11:15,62,67.2,81,62.3,143,64.4,2,0,0
3/03/2018 11:20,64,67.2,82,62.3,146,64.5,2,0,0
3/03/2018 11:25,61,66.6,79,61.6,140,63.8,2,0,0
3/03/2018 11:30,58,66.4,77,61.4,135,63.5,2,0,0
3/03/2018 11:35,70,66.3,89,61.4,159,63.6,2,0,0
3/03/2018 11:40,65,67.3,84,62.4,149,64.5,2,0,0
3/03/2018 11:45,57,68,75,63.2,132,65.3,2,0,0
3/03/2018 11:50,66,67.4,84,62.6,150,64.7,2,0,0
3/03/2018 11:55,67,67.7,85,62.9,152,65,2,0,0
3/03/2018 12:00,70,68.3,89,63.7,159,65.7,2,0,0
3/03/2018 12:05,62,68.7,80,64.1,142,66.1,2,0,0
3/03/2018 12:10,57,68.9,75,64.2,132,66.2,2,0,0
3/03/2018 12:15,52,69.6,69,65.1,121,67,2,0,0
3/03/2018 12:20,66,68.9,85,64.3,151,66.3,2,0,0
3/03/2018 12:25,64,68.8,82,64.1,146,66.2,2,0,0
3/03/2018 12:30,60,68.2,78,63.4,138,65.5,2,0,0
3/03/2018 12:35,56,68.3,73,63.6,129,65.7,2,0,0
3/03/2018 12:40,62,68.4,81,63.7,143,65.8,2,0,0
3/03/2018 12:45,58,67.9,76,63.2,134,65.2,2,0,0
3/03/2018 12:50,56,67.8,74,63,130,65.1,2,0,0
3/03/2018 12:55,56,68.3,73,63.5,129,65.6,2,0,0
3/03/2018 13:00,52,68,70,63.2,122,65.2,2,0,0
3/03/2018 13:05,55,67.3,73,62.5,128,64.6,2,0,0
3/03/2018 13:10,48,67.9,65,63.2,113,65.2,2,0,0
3/03/2018 13:15,52,68,70,63.2,122,65.3,2,0,0
3/03/2018 13:20,44,68.7,61,64.1,105,66,2,0,0
3/03/2018 13:25,47,67.9,64,63.2,111,65.2,2,0,0
3/03/2018 13:30,41,68,58,63.3,99,65.2,2,0,0
3/03/2018 13:35,47,68.3,65,63.5,112,65.5,2,0,0
3/03/2018 13:40,50,68.1,67,63.4,117,65.4,2,0,0
3/03/2018 13:45,47,68.1,63,63.4,110,65.4,2,0,0
3/03/2018 13:50,49,69.1,66,64.5,115,66.5,2,0,0
3/03/2018 13:55,46,69,63,64.3,109,66.3,2,0,0
3/03/2018 14:00,41,68.7,58,64.1,99,66,2,0,0
3/03/2018 14:05,64,68.1,84,63.4,148,65.4,2,0,0
3/03/2018 14:10,73,68.1,92,63.3,165,65.4,2,0,0
3/03/2018 14:15,63,68,82,63.2,145,65.3,2,0,0
3/03/2018 14:20,68,67.4,88,62.5,156,64.6,2,0,0
3/03/2018 14:25,55,67,74,62.1,129,64.2,2,0,0
3/03/2018 14:30,60,67.6,77,62.8,137,64.9,2,0,0
3/03/2018 14:35,61,68.5,79,63.7,140,65.8,2,0,0
3/03/2018 14:40,59,68.6,78,63.9,137,65.9,2,0,0
3/03/2018 14:45,54,68.7,72,64,126,66,2,0,0
3/03/2018 14:50,66,67.7,85,62.9,151,65,2,0,0
3/03/2018 14:55,63,67.8,82,63,145,65.1,2,0,0
3/03/2018 15:00,54,68.3,72,63.6,126,65.6,2,0,0
3/03/2018 15:05,46,67.9,64,63.1,110,65.1,2,0,0
3/03/2018 15:10,55,68.5,74,63.8,129,65.8,2,0,0
3/03/2018 15:15,47,67,65,62.2,112,64.2,2,0,0
3/03/2018 15:20,60,67.6,78,62.7,138,64.8,2,0,0
3/03/2018 15:25,46,67.3,64,62.5,110,64.5,2,0,0
3/03/2018 15:30,59,67.4,77,62.7,136,64.7,2,0,0
3/03/2018 15:35,66,67.4,84,62.6,150,64.7,2,0,0
3/03/2018 15:40,60,68.1,77,63.3,137,65.4,2,0,0
3/03/2018 15:45,66,67.8,85,63,151,65.1,2,0,0
3/03/2018 15:50,52,67.9,69,63.1,121,65.2,2,0,0
3/03/2018 15:55,57,67.7,76,62.9,133,64.9,2,0,0
3/03/2018 16:00,52,67.9,71,63.1,123,65.1,2,0,0
3/03/2018 16:05,59,68.5,77,63.8,136,65.8,2,0,0
3/03/2018 16:10,54,68.2,72,63.5,126,65.6,2,0,0
3/03/2018 16:15,53,68,70,63.3,123,65.3,2,0,0
3/03/2018 16:20,61,68.2,79,63.5,140,65.6,2,0,0
3/03/2018 16:25,60,68.3,78,63.6,138,65.7,2,0,0
3/03/2018 16:30,50,68.9,67,64.2,117,66.2,2,0,0
3/03/2018 16:35,59,68.8,77,64.2,136,66.2,2,0,0
3/03/2018 16:40,43,69.3,60,64.7,103,66.6,2,0,0
3/03/2018 16:45,44,69.5,61,64.9,105,66.8,2,0,0
3/03/2018 16:50,50,68.8,68,64.2,118,66.1,2,0,0
3/03/2018 16:55,47,68.7,64,64,111,66,2,0,0
3/03/2018 17:00,53,68.8,71,64.2,124,66.2,2,0,0
3/03/2018 17:05,43,69.4,60,64.8,103,66.7,2,0,0
3/03/2018 17:10,49,69,67,64.3,116,66.3,2,0,0
3/03/2018 17:15,51,68.2,69,63.4,120,65.5,2,0,0
3/03/2018 17:20,53,67.9,71,63.1,124,65.2,2,0,0
3/03/2018 17:25,49,68.2,66,63.5,115,65.5,2,0,0
3/03/2018 17:30,55,68.8,74,64.1,129,66.1,2,0,0
3/03/2018 17:35,60,68.9,78,64.2,138,66.2,2,0,0
3/03/2018 17:40,63,69.1,81,64.5,144,66.5,2,0,0
3/03/2018 17:45,59,69.9,78,65.3,137,67.3,2,0,0
3/03/2018 17:50,56,69.5,73,65,129,67,2,0,0
3/03/2018 17:55,53,69.6,72,65,125,67,2,0,0
3/03/2018 18:00,49,69.8,68,65.2,117,67.1,2,0,0
3/03/2018 18:05,60,69,78,64.4,138,66.4,2,0,0
3/03/2018 18:10,52,69.4,70,64.8,122,66.8,2,0,0
3/03/2018 18:15,50,69.1,67,64.5,117,66.5,2,0,0
3/03/2018 18:20,60,68.9,79,64.1,139,66.2,2,0,0
3/03/2018 18:25,62,69.2,81,64.5,143,66.5,2,0,0
3/03/2018 18:30,53,68.1,71,63.2,124,65.3,2,0,0
3/03/2018 18:35,44,68,62,63.1,106,65.2,2,0,0
3/03/2018 18:40,54,67.8,72,63,126,65.1,2,0,0
3/03/2018 18:45,48,68.5,65,63.8,113,65.8,2,0,0
3/03/2018 18:50,47,69.7,63,65.1,110,67.1,2,0,0
3/03/2018 18:55,49,69.2,67,64.6,116,66.5,2,0,0
3/03/2018 19:00,45,68.6,62,63.9,107,65.9,2,0,0
3/03/2018 19:05,46,69,65,64.3,111,66.3,2,0,0
3/03/2018 19:10,45,69.3,62,64.6,107,66.6,2,0,0
3/03/2018 19:15,48,68.8,65,64.1,113,66.1,2,0,0
3/03/2018 19:20,43,69.2,60,64.6,103,66.5,2,0,0
3/03/2018 19:25,45,68.8,62,64.1,107,66.1,2,0,0
3/03/2018 19:30,38,69,55,64.4,93,66.3,2,0,0
3/03/2018 19:35,42,69.3,59,64.6,101,66.6,2,0,0
3/03/2018 19:40,39,69.3,55,64.6,94,66.6,2,0,0
3/03/2018 19:45,27,69.3,44,64.7,71,66.5,2,0,0
3/03/2018 19:50,33,68.8,50,64.2,83,66,2,0,0
3/03/2018 19:55,37,69.4,52,64.8,89,66.7,2,0,0
3/03/2018 20:00,42,69.2,58,64.6,100,66.5,2,0,0
3/03/2018 20:05,35,69.2,52,64.5,87,66.4,2,0,0
3/03/2018 20:10,30,69.1,46,64.4,76,66.3,2,0,0
3/03/2018 20:15,34,69.1,51,64.5,85,66.3,2,0,0
3/03/2018 20:20,28,68.6,44,63.9,72,65.7,2,0,0
3/03/2018 20:25,30,68.9,47,64.2,77,66,2,0,0
3/03/2018 20:30,30,68.4,46,63.7,76,65.5,2,0,0
3/03/2018 20:35,29,68.8,45,64.1,74,65.9,2,0,0
3/03/2018 20:40,29,69,45,64.4,74,66.2,2,0,0
3/03/2018 20:45,29,69.1,45,64.5,74,66.3,2,0,0
3/03/2018 20:50,25,69.1,41,64.5,66,66.2,2,0,0
3/03/2018 20:55,31,69.6,46,65,77,66.8,2,0,0
3/03/2018 21:00,30,69.5,46,64.9,76,66.7,2,0,0
3/03/2018 21:05,28,69.2,44,64.6,72,66.4,2,0,0
3/03/2018 21:10,35,68.7,51,64,86,65.9,2,0,0
3/03/2018 21:15,32,68.9,49,64.3,81,66.1,2,0,0
3/03/2018 21:20,28,68.8,45,64.1,73,65.9,2,0,0
3/03/2018 21:25,34,68.8,51,64.2,85,66,2,0,0
3/03/2018 21:30,24,69.2,40,64.6,64,66.4,2,0,0
3/03/2018 21:35,32,69,48,64.4,80,66.2,2,0,0
3/03/2018 21:40,30,68.7,47,64,77,65.9,2,0,0
3/03/2018 21:45,30,69.4,47,64.7,77,66.5,2,0,0
3/03/2018 21:50,31,69.2,48,64.5,79,66.4,2,0,0
3/03/2018 21:55,27,69.2,44,64.6,71,66.4,2,0,0
3/03/2018 22:00,22,69.3,38,64.7,60,66.3,2,0,0
3/03/2018 22:05,27,68.9,43,64.3,70,66.1,2,0,0
3/03/2018 22:10,27,69.1,43,64.5,70,66.3,2,0,0
3/03/2018 22:15,26,69.3,41,64.7,67,66.5,2,0,0
3/03/2018 22:20,26,69.1,42,64.5,68,66.2,2,0,0
3/03/2018 22:25,28,69.2,44,64.6,72,66.4,2,0,0
3/03/2018 22:30,29,69.1,46,64.4,75,66.2,2,0,0
3/03/2018 22:35,21,69.2,37,64.5,58,66.2,2,0,0
3/03/2018 22:40,25,69,41,64.4,66,66.1,2,0,0
3/03/2018 22:45,24,68.9,40,64.2,64,66,2,0,0
3/03/2018 22:50,26,68.9,42,64.2,68,66,2,0,0
3/03/2018 22:55,25,69.2,41,64.5,66,66.3,2,0,0
3/03/2018 23:00,21,69.1,37,64.5,58,66.2,2,0,0
3/03/2018 23:05,23,68.7,38,64.1,61,65.8,2,0,0
3/03/2018 23:10,24,69.2,40,64.5,64,66.3,2,0,0
3/03/2018 23:15,18,69.2,34,64.6,52,66.2,2,0,0
3/03/2018 23:20,17,69.2,33,64.6,50,66.2,2,0,0
3/03/2018 23:25,21,69.3,36,64.7,57,66.4,2,0,0
3/03/2018 23:30,20,69.2,36,64.6,56,66.2,2,0,0
3/03/2018 23:35,21,69.1,36,64.5,57,66.2,2,0,0
3/03/2018 23:40,22,69.2,38,64.6,60,66.3,2,0,0
3/03/2018 23:45,18,69.2,33,64.6,51,66.2,2,0,0
3/03/2018 23:50,16,69.2,31,64.6,47,66.1,2,0,0
3/03/2018 23:55,13,69.1,29,64.5,42,65.9,2,0,0
3/04/2018 0:00,17,69.3,32,64.7,49,66.3,2,0,0
3/04/2018 0:05,13,68.9,29,64.3,42,65.7,2,0,0
3/04/2018 0:10,16,68.9,31,64.3,47,65.9,2,0,0
3/04/2018 0:15,17,68.9,33,64.3,50,65.9,2,0,0
3/04/2018 0:20,14,68.6,29,64,43,65.5,2,0,0
3/04/2018 0:25,15,68.7,30,64.1,45,65.6,2,0,0
3/04/2018 0:30,14,69.1,29,64.4,43,65.9,2,0,0
3/04/2018 0:35,14,69.2,29,64.5,43,66,2,0,0
3/04/2018 0:40,16,68.9,31,64.3,47,65.9,2,0,0
3/04/2018 0:45,13,69,29,64.4,42,65.8,2,0,0
3/04/2018 0:50,13,69,28,64.4,41,65.8,2,0,0
3/04/2018 0:55,13,69,28,64.4,41,65.9,2,0,0
3/04/2018 1:00,10,69.1,26,64.5,36,65.8,2,0,0
3/04/2018 1:05,10,69.2,25,64.6,35,65.9,2,0,0
3/04/2018 1:10,12,69.1,27,64.5,39,65.9,2,0,0
3/04/2018 1:15,6,69.2,21,64.6,27,65.6,2,0,0
3/04/2018 1:20,12,69.1,28,64.5,40,65.9,2,0,0
3/04/2018 1:25,10,69.2,25,64.5,35,65.9,2,0,0
3/04/2018 1:30,8,69.3,23,64.7,31,65.8,2,0,0
3/04/2018 1:35,12,69.2,27,64.5,39,66,2,0,0
3/04/2018 1:40,8,69.3,24,64.7,32,65.8,2,0,0
3/04/2018 1:45,10,69.3,25,64.7,35,66,2,0,0
3/04/2018 1:50,9,69.4,24,64.8,33,66,2,0,0
3/04/2018 1:55,8,69.4,23,64.8,31,66,2,0,0
3/04/2018 2:00,12,69.2,27,64.6,39,66,2,0,0
3/04/2018 2:05,8,69.2,23,64.6,31,65.8,2,0,0
3/04/2018 2:10,11,69.2,26,64.5,37,65.9,2,0,0
3/04/2018 2:15,10,69.3,25,64.7,35,66,2,0,0
3/04/2018 2:20,9,69.2,24,64.5,33,65.8,2,0,0
3/04/2018 2:25,11,69.2,21,64.6,32,66.2,2,0,0
3/04/2018 2:30,7,69.3,22,64.7,29,65.8,2,0,0
3/04/2018 2:35,8,69.3,23,64.7,31,65.9,2,0,0
3/04/2018 2:40,12,68.5,27,63.8,39,65.2,2,0,0
3/04/2018 2:45,8,68.9,24,64.2,32,65.4,2,0,0
3/04/2018 2:50,13,69.1,21,64.4,34,66.2,2,0,0
3/04/2018 2:55,7,69.2,22,64.6,29,65.7,2,0,0
3/04/2018 3:00,6,69.2,21,64.6,27,65.6,2,0,0
3/04/2018 3:05,7,69.2,22,64.6,29,65.7,2,0,0
3/04/2018 3:10,8,69.4,23,64.8,31,66,2,0,0
3/04/2018 3:15,4,69.3,19,64.7,23,65.5,2,0,0
3/04/2018 3:20,13,69.3,21,64.7,34,66.5,2,0,0
3/04/2018 3:25,5,69.4,21,64.8,26,65.7,2,0,0
3/04/2018 3:30,6,69.2,22,64.6,28,65.6,2,0,0
3/04/2018 3:35,7,69.3,22,64.7,29,65.8,2,0,0
3/04/2018 3:40,6,69.3,21,64.7,27,65.7,2,0,0
3/04/2018 3:45,10,69.3,20,64.7,30,66.2,2,0,0
3/04/2018 3:50,8,69.3,23,64.7,31,65.9,2,0,0
3/04/2018 3:55,6,69.4,22,64.8,28,65.8,2,0,0
3/04/2018 4:00,7,69.3,23,64.7,30,65.8,2,0,0
3/04/2018 4:05,8,69.3,24,64.7,32,65.9,2,0,0
3/04/2018 4:10,10,69.2,25,64.6,35,65.9,2,0,0
3/04/2018 4:15,10,69.3,25,64.7,35,66,2,0,0
3/04/2018 4:20,8,69.2,23,64.6,31,65.8,2,0,0
3/04/2018 4:25,8,69.3,23,64.7,31,65.9,2,0,0
3/04/2018 4:30,11,69.4,26,64.8,37,66.1,2,0,0
3/04/2018 4:35,11,69.3,27,64.7,38,66.1,2,0,0
3/04/2018 4:40,8,69.4,23,64.8,31,66,2,0,0
3/04/2018 4:45,14,69.3,30,64.7,44,66.1,2,0,0
3/04/2018 4:50,12,69.3,27,64.7,39,66.1,2,0,0
3/04/2018 4:55,10,69.2,25,64.6,35,65.9,2,0,0
3/04/2018 5:00,9,69.2,24,64.6,33,65.9,2,0,0
3/04/2018 5:05,11,69.2,26,64.6,37,66,2,0,0
3/04/2018 5:10,14,69,29,64.4,43,65.9,2,0,0
3/04/2018 5:15,9,69.2,25,64.5,34,65.8,2,0,0
3/04/2018 5:20,12,69.3,27,64.7,39,66.1,2,0,0
3/04/2018 5:25,12,69.3,28,64.7,40,66.1,2,0,0
3/04/2018 5:30,15,69.3,30,64.7,45,66.2,2,0,0
3/04/2018 5:35,15,69.3,31,64.7,46,66.2,2,0,0
3/04/2018 5:40,20,69.3,36,64.7,56,66.4,2,0,0
3/04/2018 5:45,15,69.4,31,64.8,46,66.3,2,0,0
3/04/2018 5:50,15,69.4,30,64.8,45,66.3,2,0,0
3/04/2018 5:55,19,69.4,34,64.8,53,66.5,2,0,0
3/04/2018 6:00,17,69.3,33,64.7,50,66.3,2,0,0
3/04/2018 6:05,11,69.3,27,64.7,38,66.1,2,0,0
3/04/2018 6:10,16,68.9,32,64.2,48,65.8,2,0,0
3/04/2018 6:15,18,69.1,33,64.5,51,66.1,2,0,0
3/04/2018 6:20,18,69,33,64.3,51,66,2,0,0
3/04/2018 6:25,20,69.1,35,64.5,55,66.2,2,0,0
3/04/2018 6:30,20,69,36,64.4,56,66,2,0,0
3/04/2018 6:35,25,69.2,42,64.5,67,66.3,2,0,0
3/04/2018 6:40,29,68.3,45,63.7,74,65.5,2,0,0
3/04/2018 6:45,20,68.9,36,64.3,56,65.9,2,0,0
3/04/2018 6:50,33,69.1,50,64.4,83,66.3,2,0,0
3/04/2018 6:55,27,68.9,43,64.2,70,66,2,0,0
3/04/2018 7:00,22,68.9,38,64.3,60,66,2,0,0
3/04/2018 7:05,20,68.3,37,63.6,57,65.3,2,0,0
3/04/2018 7:10,25,68.6,41,63.9,66,65.7,2,0,0
3/04/2018 7:15,23,68.7,39,64,62,65.8,2,0,0
3/04/2018 7:20,27,68.8,43,64.1,70,65.9,2,0,0
3/04/2018 7:25,22,69.1,38,64.4,60,66.1,2,0,0
3/04/2018 7:30,26,69.1,42,64.5,68,66.2,2,0,0
3/04/2018 7:35,27,69.3,43,64.7,70,66.4,2,0,0
3/04/2018 7:40,31,68.6,48,63.9,79,65.7,2,0,0
3/04/2018 7:45,30,68.2,46,63.5,76,65.4,2,0,0
3/04/2018 7:50,29,68.3,45,63.6,74,65.4,2,0,0
3/04/2018 7:55,27,68.6,43,64,70,65.8,2,0,0
3/04/2018 8:00,24,68.8,40,64.2,64,65.9,2,0,0
3/04/2018 8:05,26,68.9,42,64.2,68,66,2,0,0
3/04/2018 8:10,28,69.1,44,64.5,72,66.3,2,0,0
3/04/2018 8:15,35,68.9,51,64.2,86,66.1,2,0,0
3/04/2018 8:20,36,68.5,53,63.8,89,65.7,2,0,0
3/04/2018 8:25,38,68.2,55,63.5,93,65.4,2,0,0
3/04/2018 8:30,38,68.8,54,64.1,92,66.1,2,0,0
3/04/2018 8:35,37,69,54,64.3,91,66.2,2,0,0
3/04/2018 8:40,38,68.2,55,63.5,93,65.4,2,0,0
3/04/2018 8:45,45,68.1,62,63.4,107,65.4,2,0,0
3/04/2018 8:50,38,68.5,55,63.9,93,65.8,2,0,0
3/04/2018 8:55,40,69.1,57,64.5,97,66.4,2,0,0
3/04/2018 9:00,36,68.9,52,64.2,88,66.1,2,0,0
3/04/2018 9:05,38,69,55,64.4,93,66.3,2,0,0
3/04/2018 9:10,43,68.9,60,64.3,103,66.2,2,0,0
3/04/2018 9:15,42,69.1,59,64.4,101,66.3,2,0,0
3/04/2018 9:20,48,68.5,66,63.8,114,65.8,2,0,0
3/04/2018 9:25,55,68,74,63.3,129,65.3,2,0,0
3/04/2018 9:30,47,68.1,65,63.3,112,65.3,2,0,0
3/04/2018 9:35,43,68.4,61,63.7,104,65.7,2,0,0
3/04/2018 9:40,55,67.8,73,63,128,65.1,2,0,0
3/04/2018 9:45,57,68.2,75,63.4,132,65.5,2,0,0
3/04/2018 9:50,57,68.1,76,63.3,133,65.3,2,0,0
3/04/2018 9:55,61,68,80,63.2,141,65.3,2,0,0
3/04/2018 10:00,58,68.1,76,63.3,134,65.4,2,0,0
3/04/2018 10:05,67,67.8,86,63,153,65.1,2,0,0
3/04/2018 10:10,63,68,82,63.3,145,65.4,2,0,0
3/04/2018 10:15,69,68.2,88,63.5,157,65.6,2,0,0
3/04/2018 10:20,68,68.4,88,63.7,156,65.8,2,0,0
3/04/2018 10:25,75,67.7,95,62.9,170,65,2,0,0
3/04/2018 10:30,71,67.5,91,62.7,162,64.8,2,0,0
3/04/2018 10:35,75,67.6,95,62.8,170,64.9,2,0,0
3/04/2018 10:40,66,68.3,85,63.6,151,65.7,2,0,0
3/04/2018 10:45,56,68.7,75,64,131,66,2,0,0
3/04/2018 10:50,68,68.8,87,64.1,155,66.2,2,0,0
3/04/2018 10:55,54,68.7,71,64.1,125,66.1,2,0,0
3/04/2018 11:00,60,68.4,78,63.7,138,65.7,2,0,0
3/04/2018 11:05,69,68.6,89,64,158,66,2,0,0
3/04/2018 11:10,52,68.9,69,64.2,121,66.2,2,0,0
3/04/2018 11:15,70,69.8,89,65.3,159,67.3,2,0,0
3/04/2018 11:20,69,69.1,88,64.5,157,66.5,2,0,0
3/04/2018 11:25,65,69,83,64.4,148,66.4,2,0,0
3/04/2018 11:30,57,69.3,75,64.7,132,66.7,2,0,0
3/04/2018 11:35,67,68.6,86,63.8,153,65.9,2,0,0
3/04/2018 11:40,68,68.5,88,63.8,156,65.8,2,0,0
3/04/2018 11:45,66,68,85,63.2,151,65.3,2,0,0
3/04/2018 11:50,66,68.6,84,63.8,150,65.9,2,0,0
3/04/2018 11:55,63,69,81,64.4,144,66.4,2,0,0
3/04/2018 12:00,64,68.8,83,64.1,147,66.2,2,0,0
3/04/2018 12:05,66,68.8,85,64.1,151,66.1,2,0,0
3/04/2018 12:10,64,68.2,83,63.5,147,65.6,2,0,0
3/04/2018 12:15,69,67.8,88,63,157,65.1,2,0,0
3/04/2018 12:20,61,67.9,80,63.1,141,65.2,2,0,0
3/04/2018 12:25,59,68,77,63.2,136,65.3,2,0,0
3/04/2018 12:30,62,68.1,81,63.4,143,65.4,2,0,0
3/04/2018 12:35,63,68.1,82,63.4,145,65.5,2,0,0
3/04/2018 12:40,64,68.5,82,63.8,146,65.9,2,0,0
3/04/2018 12:45,65,68.8,83,64.1,148,66.2,2,0,0
3/04/2018 12:50,66,68.2,86,63.5,152,65.5,2,0,0
3/04/2018 12:55,71,68.4,91,63.7,162,65.8,2,0,0
3/04/2018 13:00,62,69,81,64.4,143,66.4,2,0,0
3/04/2018 13:05,66,68.9,85,64.3,151,66.3,2,0,0
3/04/2018 13:10,53,69.3,71,64.7,124,66.7,2,0,0
3/04/2018 13:15,68,69,87,64.5,155,66.5,2,0,0
3/04/2018 13:20,61,68.6,78,63.9,139,66,2,0,0
3/04/2018 13:25,70,68.4,89,63.8,159,65.8,2,0,0
3/04/2018 13:30,62,69,81,64.4,143,66.4,2,0,0
3/04/2018 13:35,62,69.3,80,64.7,142,66.7,2,0,0
3/04/2018 13:40,64,68.8,83,64.2,147,66.2,2,0,0
3/04/2018 13:45,66,68.7,86,64.1,152,66.1,2,0,0
3/04/2018 13:50,70,68.6,90,64,160,66,2,0,0
3/04/2018 13:55,49,69.4,67,64.8,116,66.8,2,0,0
3/04/2018 14:00,54,69.4,72,64.8,126,66.8,2,0,0
3/04/2018 14:05,52,69.4,70,64.8,122,66.8,2,0,0
3/04/2018 14:10,64,68.9,84,64.2,148,66.2,2,0,0
3/04/2018 14:15,74,68.4,94,63.7,168,65.8,2,0,0
3/04/2018 14:20,67,68.2,87,63.5,154,65.5,2,0,0
3/04/2018 14:25,76,68.6,97,63.9,173,65.9,2,0,0
3/04/2018 14:30,57,68.6,75,63.8,132,65.9,2,0,0
3/04/2018 14:35,61,67.7,80,62.9,141,65,2,0,0
3/04/2018 14:40,59,68,79,63.2,138,65.3,2,0,0
3/04/2018 14:45,55,68.3,73,63.5,128,65.6,2,0,0
3/04/2018 14:50,62,69.5,81,64.8,143,66.8,2,0,0
3/04/2018 14:55,55,68.4,74,63.6,129,65.7,2,0,0
3/04/2018 15:00,46,68.6,63,64,109,65.9,2,0,0
3/04/2018 15:05,51,68.5,69,63.9,120,65.9,2,0,0
3/04/2018 15:10,67,68.3,87,63.5,154,65.6,2,0,0
3/04/2018 15:15,53,68.1,71,63.3,124,65.4,2,0,0
3/04/2018 15:20,66,68.6,85,63.9,151,66,2,0,0
3/04/2018 15:25,54,68.5,72,63.8,126,65.8,2,0,0
3/04/2018 15:30,56,67.8,75,63,131,65.1,2,0,0
3/04/2018 15:35,67,68.1,87,63.4,154,65.5,2,0,0
3/04/2018 15:40,73,68.3,94,63.5,167,65.6,2,0,0
3/04/2018 15:45,67,67.8,87,63,154,65.1,2,0,0
3/04/2018 15:50,69,67.3,89,62.4,158,64.5,2,0,0
3/04/2018 15:55,63,67.7,82,62.9,145,65,2,0,0
3/04/2018 16:00,62,68.5,81,63.7,143,65.8,2,0,0
3/04/2018 16:05,61,68.1,80,63.3,141,65.4,2,0,0
3/04/2018 16:10,63,67.7,83,62.9,146,65,2,0,0
3/04/2018 16:15,54,68.6,73,63.9,127,65.9,2,0,0
3/04/2018 16:20,48,68.6,65,63.9,113,65.9,2,0,0
3/04/2018 16:25,45,69.2,62,64.5,107,66.5,2,0,0
3/04/2018 16:30,56,69.6,73,65.1,129,67.1,2,0,0
3/04/2018 16:35,59,69,77,64.4,136,66.4,2,0,0
3/04/2018 16:40,53,68.7,70,64,123,66,2,0,0
3/04/2018 16:45,44,69.1,61,64.4,105,66.4,2,0,0
3/04/2018 16:50,47,69.2,64,64.5,111,66.5,2,0,0
3/04/2018 16:55,47,69.1,65,64.5,112,66.4,2,0,0
3/04/2018 17:00,52,68.6,69,63.9,121,65.9,2,0,0
3/04/2018 17:05,59,69.2,77,64.5,136,66.5,2,0,0
3/04/2018 17:10,51,68.8,68,64.1,119,66.1,2,0,0
3/04/2018 17:15,55,69.2,73,64.6,128,66.6,2,0,0
3/04/2018 17:20,54,69.4,73,64.9,127,66.8,2,0,0
3/04/2018 17:25,50,70,68,65.5,118,67.4,2,0,0
3/04/2018 17:30,47,69.3,64,64.7,111,66.6,2,0,0
3/04/2018 17:35,51,69.2,68,64.6,119,66.6,2,0,0
3/04/2018 17:40,52,69.7,69,65.2,121,67.1,2,0,0
3/04/2018 17:45,44,70.1,60,65.6,104,67.5,2,0,0
3/04/2018 17:50,56,70.3,75,65.8,131,67.8,2,0,0
3/04/2018 17:55,50,69.7,69,65.1,119,67.1,2,0,0
3/04/2018 18:00,54,69.6,72,65.1,126,67,2,0,0
3/04/2018 18:05,48,69.7,66,65.1,114,67,2,0,0
3/04/2018 18:10,49,69.4,67,64.8,116,66.7,2,0,0
3/04/2018 18:15,44,69.8,63,65.2,107,67.1,2,0,0
3/04/2018 18:20,45,69,62,64.4,107,66.3,2,0,0
3/04/2018 18:25,50,68.9,67,64.2,117,66.2,2,0,0
3/04/2018 18:30,43,68.7,61,64,104,66,2,0,0
3/04/2018 18:35,39,68.4,55,63.7,94,65.6,2,0,0
3/04/2018 18:40,61,68.5,79,63.8,140,65.9,2,0,0
3/04/2018 18:45,51,68.5,69,63.8,120,65.8,2,0,0
3/04/2018 18:50,44,68.4,62,63.6,106,65.6,2,0,0
3/04/2018 18:55,46,68.6,63,63.9,109,65.9,2,0,0
3/04/2018 19:00,45,69.3,62,64.7,107,66.6,2,0,0
3/04/2018 19:05,42,69.4,58,64.8,100,66.7,2,0,0
3/04/2018 19:10,43,69.1,60,64.5,103,66.4,2,0,0
3/04/2018 19:15,39,68.9,56,64.3,95,66.2,2,0,0
3/04/2018 19:20,44,68.4,60,63.7,104,65.7,2,0,0
3/04/2018 19:25,43,69,60,64.4,103,66.3,2,0,0
3/04/2018 19:30,32,69,49,64.4,81,66.2,2,0,0
3/04/2018 19:35,35,69.1,52,64.5,87,66.4,2,0,0
3/04/2018 19:40,38,69.2,54,64.7,92,66.6,2,0,0
3/04/2018 19:45,36,69.3,52,64.7,88,66.6,2,0,0
3/04/2018 19:50,31,69.3,48,64.6,79,66.4,2,0,0
3/04/2018 19:55,32,69.5,47,64.9,79,66.8,2,0,0
3/04/2018 20:00,30,69.9,46,65.3,76,67.1,2,0,0
3/04/2018 20:05,30,69.3,46,64.7,76,66.5,2,0,0
3/04/2018 20:10,28,69.1,44,64.5,72,66.3,2,0,0
3/04/2018 20:15,31,68.3,47,63.6,78,65.4,2,0,0
3/04/2018 20:20,33,68.5,50,63.8,83,65.6,2,0,0
3/04/2018 20:25,21,68.9,37,64.2,58,65.9,2,0,0
3/04/2018 20:30,30,69.4,46,64.7,76,66.6,2,0,0
3/04/2018 20:35,38,68.3,54,63.6,92,65.5,2,0,0
3/04/2018 20:40,24,68.9,40,64.2,64,66,2,0,0
3/04/2018 20:45,25,69.2,41,64.5,66,66.3,2,0,0
3/04/2018 20:50,28,69.4,45,64.8,73,66.6,2,0,0
3/04/2018 20:55,23,69.2,39,64.5,62,66.3,2,0,0
3/04/2018 21:00,27,69.5,43,64.9,70,66.7,2,0,0
3/04/2018 21:05,28,69.7,44,65.1,72,66.9,2,0,0
3/04/2018 21:10,26,69.8,42,65.2,68,67,2,0,0
3/04/2018 21:15,28,70.1,44,65.5,72,67.3,2,0,0
3/04/2018 21:20,29,69.5,45,65,74,66.8,2,0,0
3/04/2018 21:25,27,69.6,43,65.1,70,66.8,2,0,0
3/04/2018 21:30,31,69.4,48,64.8,79,66.6,2,0,0
3/04/2018 21:35,25,69.4,41,64.8,66,66.5,2,0,0
3/04/2018 21:40,25,69.2,41,64.6,66,66.4,2,0,0
3/04/2018 21:45,24,69.2,39,64.6,63,66.4,2,0,0
3/04/2018 21:50,24,69.5,40,64.9,64,66.6,2,0,0
3/04/2018 21:55,20,69.3,35,64.7,55,66.4,2,0,0
3/04/2018 22:00,22,69.3,38,64.7,60,66.4,2,0,0
3/04/2018 22:05,20,69.4,36,64.8,56,66.5,2,0,0
3/04/2018 22:10,21,69.4,37,64.8,58,66.4,2,0,0
3/04/2018 22:15,21,69,37,64.4,58,66.1,2,0,0
3/04/2018 22:20,19,69.2,34,64.5,53,66.2,2,0,0
3/04/2018 22:25,25,69.3,42,64.7,67,66.4,2,0,0
3/04/2018 22:30,16,69.3,32,64.7,48,66.3,2,0,0
3/04/2018 22:35,25,68.7,41,64,66,65.8,2,0,0
3/04/2018 22:40,20,69.1,35,64.4,55,66.1,2,0,0
3/04/2018 22:45,19,69.1,35,64.4,54,66.1,2,0,0
3/04/2018 22:50,22,69.2,38,64.5,60,66.2,2,0,0
3/04/2018 22:55,14,69.2,30,64.6,44,66.1,2,0,0
3/04/2018 23:00,16,69.2,31,64.5,47,66.1,2,0,0
3/04/2018 23:05,17,69.2,33,64.6,50,66.2,2,0,0
3/04/2018 23:10,20,69.2,35,64.6,55,66.3,2,0,0
3/04/2018 23:15,17,69.4,32,64.8,49,66.4,2,0,0
3/04/2018 23:20,19,69.3,34,64.7,53,66.3,2,0,0
3/04/2018 23:25,18,69.5,34,64.9,52,66.4,2,0,0
3/04/2018 23:30,20,69.3,36,64.7,56,66.3,2,0,0
3/04/2018 23:35,15,69.3,31,64.7,46,66.2,2,0,0
3/04/2018 23:40,12,69.4,27,64.7,39,66.2,2,0,0
3/04/2018 23:45,16,68.7,32,64.1,48,65.6,2,0,0
3/04/2018 23:50,14,69.1,29,64.4,43,65.9,2,0,0
3/04/2018 23:55,15,69.3,31,64.7,46,66.2,2,0,0
