5 Minutes,Lane 1 Flow (Veh/5 Minutes),Lane 1 Speed (mph),Lane 2 Flow (Veh/5 Minutes),Lane 2 Speed (mph),Flow (Veh/5 Minutes),Speed (mph),# Lane Points,% Observed,Holiday
10/02/2017 0:00,16,69.3,32,64.7,48,66.3,2,0,0
10/02/2017 0:05,12,69.3,27,64.7,39,66.2,2,0,0
10/02/2017 0:10,10,69.3,25,64.7,35,66.1,2,0,0
10/02/2017 0:15,9,69.3,24,64.7,33,65.9,2,0,0
10/02/2017 0:20,12,69.3,27,64.7,39,66.1,2,0,0
10/02/2017 0:25,13,69.3,28,64.7,41,66.2,2,0,0
10/02/2017 0:30,9,69.2,25,64.6,34,65.8,2,0,0
10/02/2017 0:35,8,69.3,24,64.7,32,65.8,2,0,0
10/02/2017 0:40,9,69.2,24,64.6,33,65.8,2,0,0
10/02/2017 0:45,9,69,24,64.3,33,65.6,2,0,0
10/02/2017 0:50,10,69.1,26,64.5,36,65.8,2,0,0
10/02/2017 0:55,8,69.1,23,64.5,31,65.7,2,0,0
10/02/2017 1:00,8,69.2,24,64.6,32,65.7,2,0,0
10/02/2017 1:05,9,69.4,24,64.7,33,66,2,0,0
10/02/2017 1:10,7,69.4,22,64.8,29,66,2,0,0
10/02/2017 1:15,7,69.4,22,64.8,29,65.9,2,0,0
10/02/2017 1:20,6,69.4,21,64.8,27,65.8,2,0,0
10/02/2017 1:25,10,69.4,20,64.8,30,66.3,2,0,0
10/02/2017 1:30,8,69.4,24,64.7,32,65.9,2,0,0
10/02/2017 1:35,6,69.4,21,64.8,27,65.8,2,0,0
10/02/2017 1:40,6,69.3,21,64.7,27,65.8,2,0,0
10/02/2017 1:45,8,69.4,24,64.8,32,65.9,2,0,0
10/02/2017 1:50,7,69.4,22,64.8,29,65.9,2,0,0
10/02/2017 1:55,6,69.4,21,64.8,27,65.8,2,0,0
10/02/2017 2:00,5,69.2,21,64.5,26,65.4,2,0,0
10/02/2017 2:05,5,69.2,20,64.6,25,65.5,2,0,0
10/02/2017 2:10,6,69.2,21,64.6,27,65.6,2,0,0
10/02/2017 2:15,10,69.1,20,64.4,30,66,2,0,0
10/02/2017 2:20,5,69.2,20,64.6,25,65.5,2,0,0
10/02/2017 2:25,10,69.2,25,64.6,35,65.9,2,0,0
10/02/2017 2:30,7,69,22,64.4,29,65.5,2,0,0
10/02/2017 2:35,7,69.2,22,64.5,29,65.7,2,0,0
10/02/2017 2:40,8,69.2,23,64.6,31,65.8,2,0,0
10/02/2017 2:45,9,69,25,64.4,34,65.6,2,0,0
10/02/2017 2:50,13,69.2,29,64.6,42,66,2,0,0
10/02/2017 2:55,8,69.3,24,64.7,32,65.9,2,0,0
10/02/2017 3:00,8,69.3,23,64.7,31,65.9,2,0,0
10/02/2017 3:05,7,69.2,23,64.6,30,65.7,2,0,0
10/02/2017 3:10,8,69.3,24,64.7,32,65.8,2,0,0
10/02/2017 3:15,7,69.4,22,64.8,29,65.9,2,0,0
10/02/2017 3:20,11,68.9,27,64.3,38,65.6,2,0,0
10/02/2017 3:25,6,69.2,22,64.5,28,65.5,2,0,0
10/02/2017 3:30,11,69.1,26,64.4,37,65.8,2,0,0
10/02/2017 3:35,14,68.4,30,63.8,44,65.3,2,0,0
10/02/2017 3:40,11,68.9,27,64.2,38,65.6,2,0,0
10/02/2017 3:45,13,69,28,64.3,41,65.8,2,0,0
10/02/2017 3:50,18,69.1,34,64.5,52,66.1,2,0,0
10/02/2017 3:55,13,69.2,29,64.6,42,66.1,2,0,0
10/02/2017 4:00,12,69.4,27,64.8,39,66.2,2,0,0
10/02/2017 4:05,13,69.5,29,64.9,42,66.3,2,0,0
10/02/2017 4:10,18,69.4,34,64.8,52,66.4,2,0,0
10/02/2017 4:15,23,69.5,39,64.9,62,66.6,2,0,0
10/02/2017 4:20,24,69.5,40,64.9,64,66.7,2,0,0
10/02/2017 4:25,24,69.2,40,64.5,64,66.3,2,0,0
10/02/2017 4:30,26,69,43,64.3,69,66,2,0,0
10/02/2017 4:35,33,69.5,51,64.9,84,66.7,2,0,0
10/02/2017 4:40,32,69.5,49,64.8,81,66.7,2,0,0
10/02/2017 4:45,40,69.1,58,64.4,98,66.3,2,0,0
10/02/2017 4:50,32,69.7,49,65.1,81,66.9,2,0,0
10/02/2017 4:55,40,70.1,58,65.5,98,67.4,2,0,0
10/02/2017 5:00,37,70.1,54,65.5,91,67.4,2,0,0
10/02/2017 5:05,47,69.1,67,64.5,114,66.4,2,0,0
10/02/2017 5:10,47,67.5,67,62.7,114,64.7,2,0,0
10/02/2017 5:15,56,68.3,76,63.5,132,65.5,2,0,0
10/02/2017 5:20,53,67.9,73,63.1,126,65.1,2,0,0
10/02/2017 5:25,54,67.3,75,62.5,129,64.5,2,0,0
10/02/2017 5:30,56,67.4,75,62.6,131,64.7,2,0,0
10/02/2017 5:35,60,68.1,79,63.3,139,65.4,2,0,0
10/02/2017 5:40,32,70.6,28,64.6,60,67.8,2,0,0
10/02/2017 5:45,34,70.6,30,64.6,64,67.8,2,0,0
10/02/2017 5:50,71,67.9,92,63.1,163,65.2,2,0,0
10/02/2017 5:55,70,68.6,90,63.9,160,65.9,2,0,0
10/02/2017 6:00,54,68.4,75,63.6,129,65.6,2,0,0
10/02/2017 6:05,64,68,84,63.2,148,65.2,2,0,0
10/02/2017 6:10,60,68.1,80,63.2,140,65.3,2,0,0
10/02/2017 6:15,70,66.9,92,62,162,64.1,2,0,0
10/02/2017 6:20,76,67.5,100,62.6,176,64.8,2,0,0
10/02/2017 6:25,74,66.3,96,61.2,170,63.4,2,0,0
10/02/2017 6:30,49,69.5,44,63.5,93,66.7,2,0,0
10/02/2017 6:35,112,63.6,140,58.2,252,60.6,2,0,0
10/02/2017 6:40,75,64.2,97,58.9,172,61.2,2,0,0
10/02/2017 6:45,84,65.7,107,60.6,191,62.8,2,0,0
10/02/2017 6:50,73,66.6,96,61.6,169,63.7,2,0,0
10/02/2017 6:55,57,69.5,52,63.5,109,66.6,2,0,0
10/02/2017 7:00,58,69.2,52,63.2,110,66.4,2,0,0
10/02/2017 7:05,66,68,86,63.2,152,65.3,2,0,0
10/02/2017 7:10,79,68.3,100,63.4,179,65.6,2,0,0
10/02/2017 7:15,79,67.1,103,62.2,182,64.3,2,0,0
10/02/2017 7:20,85,67.6,109,62.7,194,64.9,2,0,0
10/02/2017 7:25,70,68,92,63.2,162,65.3,2,0,0
10/02/2017 7:30,78,67.3,100,62.4,178,64.5,2,0,0
10/02/2017 7:35,83,67.9,106,63.1,189,65.2,2,0,0
10/02/2017 7:40,85,67.9,109,63.1,194,65.2,2,0,0
10/02/2017 7:45,88,68.1,111,63.2,199,65.4,2,0,0
10/02/2017 7:50,90,68.1,113,63.3,203,65.4,2,0,0
10/02/2017 7:55,86,67.1,109,62.3,195,64.4,2,0,0
10/02/2017 8:00,75,67.4,97,62.6,172,64.7,2,0,0
10/02/2017 8:05,79,67.4,102,62.5,181,64.6,2,0,0
10/02/2017 8:10,74,67.4,96,62.5,170,64.6,2,0,0
10/02/2017 8:15,72,67.3,93,62.4,165,64.5,2,0,0
10/02/2017 8:20,71,66.8,93,61.9,164,64,2,0,0
10/02/2017 8:25,69,67.3,90,62.5,159,64.6,2,0,0
10/02/2017 8:30,79,67.4,101,62.6,180,64.7,2,0,0
10/02/2017 8:35,72,68.2,93,63.5,165,65.6,2,0,0
10/02/2017 8:40,77,68,99,63.2,176,65.3,2,0,0
10/02/2017 8:45,75,67,97,62.1,172,64.2,2,0,0
10/02/2017 8:50,73,68.3,95,63.5,168,65.6,2,0,0
10/02/2017 8:55,77,68.6,99,63.9,176,65.9,2,0,0
10/02/2017 9:00,63,68.5,83,63.8,146,65.8,2,0,0
10/02/2017 9:05,71,67.5,92,62.7,163,64.8,2,0,0
10/02/2017 9:10,59,67.4,78,62.5,137,64.6,2,0,0
10/02/2017 9:15,74,67.7,94,62.9,168,65,2,0,0
10/02/2017 9:20,71,66.5,91,61.6,162,63.8,2,0,0
10/02/2017 9:25,69,66.3,89,61.4,158,63.5,2,0,0
10/02/2017 9:30,68,66,88,61,156,63.1,2,0,0
10/02/2017 9:35,67,64.8,86,59.8,153,62,2,0,0
10/02/2017 9:40,65,65.1,85,60.1,150,62.2,2,0,0
10/02/2017 9:45,70,65.2,90,60.2,160,62.4,2,0,0
10/02/2017 9:50,77,65.3,97,60.3,174,62.5,2,0,0
10/02/2017 9:55,66,65.9,85,61,151,63.1,2,0,0
10/02/2017 10:00,70,64.8,91,59.8,161,62,2,0,0
10/02/2017 10:05,62,65.2,82,60.2,144,62.3,2,0,0
10/02/2017 10:10,60,65.8,79,60.9,139,63,2,0,0
10/02/2017 10:15,48,65.5,67,60.5,115,62.6,2,0,0
10/02/2017 10:20,58,66.8,77,62,135,64.1,2,0,0
10/02/2017 10:25,55,67.7,72,63,127,65,2,0,0
10/02/2017 10:30,53,68.2,71,63.5,124,65.5,2,0,0
10/02/2017 10:35,54,68.1,73,63.3,127,65.3,2,0,0
10/02/2017 10:40,55,68.1,72,63.4,127,65.4,2,0,0
10/02/2017 10:45,51,67.6,69,62.9,120,64.9,2,0,0
10/02/2017 10:50,53,68.7,72,64.1,125,66,2,0,0
10/02/2017 10:55,55,68.6,72,64,127,66,2,0,0
10/02/2017 11:00,61,67.6,80,62.9,141,64.9,2,0,0
10/02/2017 11:05,68,66.4,89,61.6,157,63.7,2,0,0
10/02/2017 11:10,65,65.8,84,60.9,149,63,2,0,0
10/02/2017 11:15,62,65.7,82,60.8,144,62.9,2,0,0
10/02/2017 11:20,60,65.3,79,60.4,139,62.5,2,0,0
10/02/2017 11:25,48,66.7,65,61.9,113,63.9,2,0,0
10/02/2017 11:30,55,67.8,74,63.1,129,65.1,2,0,0
10/02/2017 11:35,52,67.3,71,62.6,123,64.6,2,0,0
10/02/2017 11:40,46,68.5,63,63.9,109,65.8,2,0,0
10/02/2017 11:45,58,67.3,77,62.6,135,64.6,2,0,0
10/02/2017 11:50,64,68.1,82,63.4,146,65.5,2,0,0
10/02/2017 11:55,61,66.4,80,61.6,141,63.7,2,0,0
10/02/2017 12:00,57,67.1,74,62.4,131,64.4,2,0,0
10/02/2017 12:05,49,67.6,68,62.9,117,64.8,2,0,0
10/02/2017 12:10,48,69,66,64.4,114,66.4,2,0,0
10/02/2017 12:15,51,69.8,68,65.3,119,67.2,2,0,0
10/02/2017 12:20,44,70.6,62,66,106,67.9,2,0,0
10/02/2017 12:25,53,69.1,71,64.5,124,66.5,2,0,0
10/02/2017 12:30,52,69.6,69,65,121,67,2,0,0
10/02/2017 12:35,48,69.6,65,65,113,67,2,0,0
10/02/2017 12:40,51,68.8,69,64.2,120,66.1,2,0,0
10/02/2017 12:45,53,68.5,71,63.9,124,65.8,2,0,0
10/02/2017 12:50,48,68.9,66,64.3,114,66.2,2,0,0
10/02/2017 12:55,44,68.9,62,64.3,106,66.2,2,0,0
10/02/2017 13:00,49,69.3,67,64.8,116,66.7,2,0,0
10/02/2017 13:05,56,68.9,74,64.3,130,66.3,2,0,0
10/02/2017 13:10,44,68.8,62,64.1,106,66.1,2,0,0
10/02/2017 13:15,43,69.5,61,64.9,104,66.8,2,0,0
10/02/2017 13:20,44,69,63,64.4,107,66.3,2,0,0
10/02/2017 13:25,45,68.2,62,63.4,107,65.4,2,0,0
10/02/2017 13:30,37,69.4,54,64.7,91,66.6,2,0,0
10/02/2017 13:35,52,68.2,71,63.5,123,65.5,2,0,0
10/02/2017 13:40,44,68.9,61,64.3,105,66.2,2,0,0
10/02/2017 13:45,52,69.5,71,64.9,123,66.8,2,0,0
10/02/2017 13:50,45,69.3,63,64.6,108,66.5,2,0,0
10/02/2017 13:55,45,68.3,63,63.5,108,65.5,2,0,0
10/02/2017 14:00,44,68.7,61,64,105,66,2,0,0
10/02/2017 14:05,42,68.6,59,63.9,101,65.8,2,0,0
10/02/2017 14:10,46,68.2,64,63.5,110,65.5,2,0,0
10/02/2017 14:15,55,68.5,73,63.8,128,65.8,2,0,0
10/02/2017 14:20,45,68.1,63,63.4,108,65.4,2,0,0
10/02/2017 14:25,43,68.3,61,63.6,104,65.5,2,0,0
10/02/2017 14:30,39,69.2,56,64.6,95,66.5,2,0,0
10/02/2017 14:35,46,68,64,63.3,110,65.2,2,0,0
10/02/2017 14:40,46,67.4,64,62.7,110,64.6,2,0,0
10/02/2017 14:45,53,67.1,71,62.2,124,64.3,2,0,0
10/02/2017 14:50,36,68.8,52,64.1,88,66,2,0,0
10/02/2017 14:55,45,67.6,62,62.7,107,64.7,2,0,0
10/02/2017 15:00,41,67.7,58,63,99,65,2,0,0
10/02/2017 15:05,39,67.1,56,62.4,95,64.4,2,0,0
10/02/2017 15:10,51,67.7,69,63,120,65,2,0,0
10/02/2017 15:15,49,68.6,66,63.9,115,65.9,2,0,0
10/02/2017 15:20,55,68.1,73,63.4,128,65.4,2,0,0
10/02/2017 15:25,53,68.1,71,63.4,124,65.4,2,0,0
10/02/2017 15:30,53,67.8,72,63.1,125,65.1,2,0,0
10/02/2017 15:35,56,68.2,76,63.5,132,65.5,2,0,0
10/02/2017 15:40,55,67.9,73,63.2,128,65.2,2,0,0
10/02/2017 15:45,62,67.9,81,63.2,143,65.3,2,0,0
10/02/2017 15:50,56,68.4,74,63.7,130,65.7,2,0,0
10/02/2017 15:55,60,67.8,78,63.1,138,65.1,2,0,0
10/02/2017 16:00,53,68.4,71,63.8,124,65.8,2,0,0
10/02/2017 16:05,51,68.7,69,64.1,120,66.1,2,0,0
10/02/2017 16:10,54,68.4,73,63.8,127,65.8,2,0,0
10/02/2017 16:15,54,67.7,72,62.9,126,64.9,2,0,0
10/02/2017 16:20,59,67.8,77,63,136,65.1,2,0,0
10/02/2017 16:25,54,67.8,72,62.9,126,65,2,0,0
10/02/2017 16:30,48,68.4,65,63.7,113,65.7,2,0,0
10/02/2017 16:35,54,69.2,72,64.5,126,66.5,2,0,0
10/02/2017 16:40,56,68.2,74,63.5,130,65.5,2,0,0
10/02/2017 16:45,50,69.4,68,64.8,118,66.8,2,0,0
10/02/2017 16:50,60,67.6,78,62.9,138,65,2,0,0
10/02/2017 16:55,51,67.5,69,62.8,120,64.8,2,0,0
10/02/2017 17:00,42,68.5,60,63.8,102,65.7,2,0,0
10/02/2017 17:05,51,69,69,64.3,120,66.3,2,0,0
10/02/2017 17:10,46,69.9,63,65.3,109,67.2,2,0,0
10/02/2017 17:15,47,68.8,67,64.1,114,66,2,0,0
10/02/2017 17:20,44,69.8,61,65.2,105,67.1,2,0,0
10/02/2017 17:25,42,70.6,60,66,102,67.9,2,0,0
10/02/2017 17:30,53,69.4,71,64.7,124,66.7,2,0,0
10/02/2017 17:35,50,68.9,67,64.2,117,66.2,2,0,0
10/02/2017 17:40,49,69.5,66,64.8,115,66.8,2,0,0
10/02/2017 17:45,51,68.9,69,64.2,120,66.2,2,0,0
10/02/2017 17:50,52,68.1,70,63.3,122,65.3,2,0,0
10/02/2017 17:55,46,68.1,63,63.4,109,65.4,2,0,0
10/02/2017 18:00,54,68.2,72,63.5,126,65.5,2,0,0
10/02/2017 18:05,53,68.1,71,63.4,124,65.4,2,0,0
10/02/2017 18:10,49,68.1,67,63.5,116,65.5,2,0,0
10/02/2017 18:15,49,68.8,68,64.3,117,66.2,2,0,0
10/02/2017 18:20,52,68.8,70,64.3,122,66.2,2,0,0
10/02/2017 18:25,47,68.9,64,64.3,111,66.2,2,0,0
10/02/2017 18:30,44,68.7,62,64,106,66,2,0,0
10/02/2017 18:35,40,69.8,57,65.3,97,67.2,2,0,0
10/02/2017 18:40,38,68.9,56,64.3,94,66.2,2,0,0
10/02/2017 18:45,43,70.1,60,65.6,103,67.5,2,0,0
10/02/2017 18:50,40,69.7,57,65.1,97,67,2,0,0
10/02/2017 18:55,37,69.4,54,64.8,91,66.6,2,0,0
10/02/2017 19:00,46,68.6,63,64,109,66,2,0,0
10/02/2017 19:05,37,69.1,53,64.5,90,66.4,2,0,0
10/02/2017 19:10,38,69.5,55,64.9,93,66.8,2,0,0
10/02/2017 19:15,43,67.9,60,63.3,103,65.2,2,0,0
10/02/2017 19:20,40,68.1,57,63.4,97,65.4,2,0,0
10/02/2017 19:25,38,68,55,63.2,93,65.2,2,0,0
10/02/2017 19:30,35,68.2,52,63.5,87,65.4,2,0,0
10/02/2017 19:35,38,68.2,55,63.5,93,65.4,2,0,0
10/02/2017 19:40,37,68.8,55,64.1,92,66,2,0,0
10/02/2017 19:45,34,69.3,50,64.6,84,66.5,2,0,0
10/02/2017 19:50,31,69.2,47,64.5,78,66.4,2,0,0
10/02/2017 19:55,30,69.6,47,65,77,66.8,2,0,0
10/02/2017 20:00,25,69.2,41,64.6,66,66.3,2,0,0
10/02/2017 20:05,32,68.8,49,64.1,81,66,2,0,0
10/02/2017 20:10,30,69.2,47,64.6,77,66.4,2,0,0
10/02/2017 20:15,33,68.6,49,63.9,82,65.8,2,0,0
10/02/2017 20:20,30,67.7,47,63,77,64.8,2,0,0
10/02/2017 20:25,39,68.9,56,64.2,95,66.1,2,0,0
10/02/2017 20:30,27,69.3,43,64.7,70,66.4,2,0,0
10/02/2017 20:35,23,69.2,39,64.6,62,66.3,2,0,0
10/02/2017 20:40,32,68.7,48,64.1,80,65.9,2,0,0
10/02/2017 20:45,32,68.8,49,64.2,81,66,2,0,0
10/02/2017 20:50,31,69.5,47,64.9,78,66.7,2,0,0
10/02/2017 20:55,29,69.6,45,65,74,66.8,2,0,0
10/02/2017 21:00,27,69.6,44,65,71,66.7,2,0,0
10/02/2017 21:05,25,69.9,41,65.3,66,67,2,0,0
10/02/2017 21:10,29,69.4,45,64.8,74,66.6,2,0,0
10/02/2017 21:15,27,69.5,43,64.9,70,66.7,2,0,0
10/02/2017 21:20,23,69.8,40,65.2,63,66.9,2,0,0
10/02/2017 21:25,26,69.1,42,64.5,68,66.3,2,0,0
10/02/2017 21:30,19,69.3,35,64.7,54,66.3,2,0,0
10/02/2017 21:35,21,69.2,37,64.6,58,66.3,2,0,0
10/02/2017 21:40,25,69.7,42,65.1,67,66.8,2,0,0
10/02/2017 21:45,21,69.7,36,65.1,57,66.8,2,0,0
10/02/2017 21:50,24,69.1,40,64.5,64,66.3,2,0,0
10/02/2017 21:55,22,69.2,38,64.5,60,66.2,2,0,0
10/02/2017 22:00,21,69,37,64.4,58,66.1,2,0,0
10/02/2017 22:05,23,69.2,40,64.6,63,66.3,2,0,0
10/02/2017 22:10,21,69.1,37,64.5,58,66.2,2,0,0
10/02/2017 22:15,23,69.4,39,64.8,62,66.5,2,0,0
10/02/2017 22:20,18,69.5,34,64.9,52,66.4,2,0,0
10/02/2017 22:25,21,69.1,37,64.5,58,66.2,2,0,0
10/02/2017 22:30,17,69.3,33,64.7,50,66.3,2,0,0
10/02/2017 22:35,18,69.4,34,64.8,52,66.4,2,0,0
10/02/2017 22:40,18,69.5,34,64.9,52,66.5,2,0,0
10/02/2017 22:45,14,69.5,30,64.9,44,66.4,2,0,0
10/02/2017 22:50,16,69.6,32,65,48,66.5,2,0,0
10/02/2017 22:55,20,69.7,36,65.1,56,66.7,2,0,0
10/02/2017 23:00,17,69.6,33,65,50,66.6,2,0,0
10/02/2017 23:05,15,69.4,31,64.8,46,66.3,2,0,0
10/02/2017 23:10,15,69.1,30,64.5,45,66,2,0,0
10/02/2017 23:15,17,69.2,33,64.6,50,66.2,2,0,0
10/02/2017 23:20,12,69.4,27,64.7,39,66.2,2,0,0
10/02/2017 23:25,8,69.3,24,64.7,32,65.9,2,0,0
10/02/2017 23:30,11,69.5,26,64.9,37,66.3,2,0,0
10/02/2017 23:35,11,69.5,26,64.9,37,66.3,2,0,0
10/02/2017 23:40,15,69.6,31,65,46,66.5,2,0,0
10/02/2017 23:45,12,69.5,27,64.9,39,66.3,2,0,0
10/02/2017 23:50,10,69.4,25,64.8,35,66.2,2,0,0
10/02/2017 23:55,9,69.4,25,64.8,34,66,2,0,0
10/03/2017 0:00,11,69.3,27,64.7,38,66.1,2,0,0
10/03/2017 0:05,10,69.3,25,64.7,35,66.1,2,0,0
10/03/2017 0:10,8,69.3,23,64.7,31,65.9,2,0,0
10/03/2017 0:15,7,69,22,64.4,29,65.5,2,0,0
10/03/2017 0:20,6,69.1,22,64.5,28,65.5,2,0,0
10/03/2017 0:25,10,69.2,25,64.6,35,65.9,2,0,0
10/03/2017 0:30,9,69.3,25,64.7,34,65.9,2,0,0
10/03/2017 0:35,6,69.3,21,64.7,27,65.7,2,0,0
10/03/2017 0:40,8,69.3,23,64.7,31,65.9,2,0,0
10/03/2017 0:45,5,69.3,20,64.7,25,65.6,2,0,0
10/03/2017 0:50,7,69.4,22,64.8,29,65.9,2,0,0
10/03/2017 0:55,8,69.4,24,64.8,32,66,2,0,0
10/03/2017 1:00,5,69.5,21,64.9,26,65.8,2,0,0
10/03/2017 1:05,9,69.5,24,64.9,33,66.1,2,0,0
10/03/2017 1:10,6,69.4,21,64.8,27,65.8,2,0,0
10/03/2017 1:15,5,69.4,21,64.8,26,65.7,2,0,0
10/03/2017 1:20,6,69.4,21,64.8,27,65.8,2,0,0
10/03/2017 1:25,6,69.4,21,64.8,27,65.8,2,0,0
10/03/2017 1:30,8,69.5,23,64.9,31,66.1,2,0,0
10/03/2017 1:35,9,69.4,24,64.8,33,66.1,2,0,0
10/03/2017 1:40,6,69.4,21,64.8,27,65.8,2,0,0
10/03/2017 1:45,12,69.5,21,64.9,33,66.6,2,0,0
10/03/2017 1:50,5,69.4,20,64.8,25,65.7,2,0,0
10/03/2017 1:55,5,69.4,21,64.8,26,65.7,2,0,0
10/03/2017 2:00,6,69.3,22,64.6,28,65.6,2,0,0
10/03/2017 2:05,8,69.4,23,64.7,31,65.9,2,0,0
10/03/2017 2:10,5,69.4,21,64.8,26,65.7,2,0,0
10/03/2017 2:15,15,68.9,22,64.3,37,66.2,2,0,0
10/03/2017 2:20,8,69.2,23,64.5,31,65.7,2,0,0
10/03/2017 2:25,8,69.2,23,64.6,31,65.8,2,0,0
10/03/2017 2:30,11,69.4,26,64.8,37,66.2,2,0,0
10/03/2017 2:35,9,69.6,24,65.1,33,66.3,2,0,0
10/03/2017 2:40,5,69.5,21,64.9,26,65.8,2,0,0
10/03/2017 2:45,9,69.2,24,64.6,33,65.8,2,0,0
10/03/2017 2:50,11,69.5,27,65,38,66.3,2,0,0
10/03/2017 2:55,7,69.5,23,64.9,30,66,2,0,0
10/03/2017 3:00,12,69.5,27,64.9,39,66.3,2,0,0
10/03/2017 3:05,11,69.2,26,64.6,37,66,2,0,0
10/03/2017 3:10,9,69.3,24,64.7,33,65.9,2,0,0
10/03/2017 3:15,12,69.2,27,64.6,39,66,2,0,0
10/03/2017 3:20,10,69.2,25,64.5,35,65.9,2,0,0
10/03/2017 3:25,7,69.3,22,64.7,29,65.8,2,0,0
10/03/2017 3:30,9,69,25,64.4,34,65.6,2,0,0
10/03/2017 3:35,12,69.2,28,64.5,40,65.9,2,0,0
10/03/2017 3:40,15,69.3,31,64.7,46,66.2,2,0,0
10/03/2017 3:45,12,69.4,27,64.8,39,66.2,2,0,0
10/03/2017 3:50,15,69.4,31,64.8,46,66.3,2,0,0
10/03/2017 3:55,12,69.5,28,64.9,40,66.3,2,0,0
10/03/2017 4:00,10,69.5,26,64.9,36,66.2,2,0,0
10/03/2017 4:05,12,69.4,28,64.8,40,66.2,2,0,0
10/03/2017 4:10,15,68.9,30,64.3,45,65.9,2,0,0
10/03/2017 4:15,16,69,32,64.4,48,66,2,0,0
10/03/2017 4:20,16,69.3,32,64.7,48,66.2,2,0,0
10/03/2017 4:25,22,69.6,38,65,60,66.7,2,0,0
10/03/2017 4:30,20,69.5,37,64.9,57,66.5,2,0,0
10/03/2017 4:35,32,70,50,65.5,82,67.2,2,0,0
10/03/2017 4:40,28,70,45,65.4,73,67.2,2,0,0
10/03/2017 4:45,32,69.3,50,64.7,82,66.5,2,0,0
10/03/2017 4:50,38,69.8,56,65.3,94,67.1,2,0,0
10/03/2017 4:55,47,70.2,66,65.7,113,67.6,2,0,0
10/03/2017 5:00,42,70.7,60,66.2,102,68.1,2,0,0
10/03/2017 5:05,36,71,55,66.5,91,68.3,2,0,0
10/03/2017 5:10,38,70.2,57,65.7,95,67.5,2,0,0
10/03/2017 5:15,42,69.7,61,65.1,103,67,2,0,0
10/03/2017 5:20,54,69.6,76,65.1,130,66.9,2,0,0
10/03/2017 5:25,54,70.7,74,66.3,128,68.1,2,0,0
10/03/2017 5:30,61,71.1,83,66.7,144,68.6,2,0,0
10/03/2017 5:35,58,70.7,79,66.3,137,68.2,2,0,0
10/03/2017 5:40,52,69.1,72,64.5,124,66.4,2,0,0
10/03/2017 5:45,66,68.7,89,64,155,66,2,0,0
10/03/2017 5:50,69,68.9,91,64.2,160,66.2,2,0,0
10/03/2017 5:55,62,69.2,83,64.5,145,66.5,2,0,0
10/03/2017 6:00,65,67.5,87,62.7,152,64.8,2,0,0
10/03/2017 6:05,68,68.1,89,63.4,157,65.4,2,0,0
10/03/2017 6:10,58,68.8,79,64,137,66,2,0,0
10/03/2017 6:15,67,68.2,89,63.4,156,65.5,2,0,0
10/03/2017 6:20,63,68.3,85,63.5,148,65.6,2,0,0
10/03/2017 6:25,67,68.5,89,63.7,156,65.8,2,0,0
10/03/2017 6:30,74,67.9,96,63.1,170,65.2,2,0,0
10/03/2017 6:35,67,67.7,89,62.8,156,64.9,2,0,0
10/03/2017 6:40,71,68.4,91,63.6,162,65.7,2,0,0
10/03/2017 6:45,76,67.3,99,62.4,175,64.5,2,0,0
10/03/2017 6:50,80,68.1,102,63.3,182,65.4,2,0,0
10/03/2017 6:55,73,68.3,96,63.5,169,65.6,2,0,0
10/03/2017 7:00,67,68.2,88,63.4,155,65.5,2,0,0
10/03/2017 7:05,69,69.5,91,64.9,160,66.9,2,0,0
10/03/2017 7:10,80,68.3,102,63.5,182,65.6,2,0,0
10/03/2017 7:15,72,68.5,94,63.7,166,65.8,2,0,0
10/03/2017 7:20,75,68.4,96,63.7,171,65.7,2,0,0
10/03/2017 7:25,81,67.9,104,63.2,185,65.2,2,0,0
10/03/2017 7:30,81,68.7,103,64.1,184,66.1,2,0,0
10/03/2017 7:35,85,68.4,108,63.6,193,65.7,2,0,0
10/03/2017 7:40,83,67.9,106,63.1,189,65.2,2,0,0
10/03/2017 7:45,93,68.4,116,63.6,209,65.8,2,0,0
10/03/2017 7:50,90,67.3,112,62.5,202,64.6,2,0,0
10/03/2017 7:55,81,67.4,104,62.5,185,64.7,2,0,0
10/03/2017 8:00,91,68,113,63.1,204,65.3,2,0,0
10/03/2017 8:05,87,67.4,111,62.5,198,64.6,2,0,0
10/03/2017 8:10,83,66.5,104,61.6,187,63.8,2,0,0
10/03/2017 8:15,81,67.3,105,62.5,186,64.6,2,0,0
10/03/2017 8:20,81,67.6,104,62.7,185,64.8,2,0,0
10/03/2017 8:25,91,67.6,115,62.7,206,64.8,2,0,0
10/03/2017 8:30,77,67.3,100,62.3,177,64.5,2,0,0
10/03/2017 8:35,75,66.6,98,61.6,173,63.8,2,0,0
10/03/2017 8:40,79,65.9,103,60.9,182,63.1,2,0,0
10/03/2017 8:45,75,65.8,97,60.7,172,62.9,2,0,0
10/03/2017 8:50,89,65.1,112,60,201,62.3,2,0,0
10/03/2017 8:55,82,65.1,103,60,185,62.3,2,0,0
10/03/2017 9:00,84,64.6,107,59.5,191,61.8,2,0,0
10/03/2017 9:05,69,65.8,90,60.8,159,63,2,0,0
10/03/2017 9:10,71,66.9,93,62,164,64.1,2,0,0
10/03/2017 9:15,68,67.2,88,62.2,156,64.4,2,0,0
10/03/2017 9:20,74,66.4,96,61.5,170,63.6,2,0,0
10/03/2017 9:25,73,66.3,95,61.3,168,63.5,2,0,0
10/03/2017 9:30,70,65.8,92,60.8,162,63,2,0,0
10/03/2017 9:35,73,66.9,93,62.1,166,64.2,2,0,0
10/03/2017 9:40,68,66.9,88,62,156,64.1,2,0,0
10/03/2017 9:45,66,63.3,87,58.3,153,60.5,2,0,0
10/03/2017 9:50,79,65.2,99,60.2,178,62.4,2,0,0
10/03/2017 9:55,60,65.4,79,60.5,139,62.6,2,0,0
10/03/2017 10:00,70,65.7,90,60.8,160,62.9,2,0,0
10/03/2017 10:05,82,64.8,104,59.8,186,62,2,0,0
10/03/2017 10:10,61,64.7,80,59.7,141,61.9,2,0,0
10/03/2017 10:15,72,63.8,92,58.6,164,60.9,2,0,0
10/03/2017 10:20,69,63.7,89,58.5,158,60.8,2,0,0
10/03/2017 10:25,62,58.4,82,52.6,144,55.1,2,0,0
10/03/2017 10:30,66,51,86,44.4,152,47.3,2,0,0
10/03/2017 10:35,57,45.9,76,38.7,133,41.8,2,0,0
10/03/2017 10:40,59,54.3,78,48.1,137,50.8,2,0,0
10/03/2017 10:45,58,60.7,77,55.1,135,57.5,2,0,0
10/03/2017 10:50,54,62.9,72,57.6,126,59.9,2,0,0
10/03/2017 10:55,42,65.6,60,60.7,102,62.7,2,0,0
10/03/2017 11:00,43,65.5,61,60.6,104,62.6,2,0,0
10/03/2017 11:05,56,65.8,74,60.8,130,63,2,0,0
10/03/2017 11:10,50,66.3,69,61.5,119,63.5,2,0,0
10/03/2017 11:15,45,65.1,64,60,109,62.1,2,0,0
10/03/2017 11:20,54,66.7,72,61.9,126,63.9,2,0,0
10/03/2017 11:25,57,67.1,75,62.3,132,64.3,2,0,0
10/03/2017 11:30,49,67.1,67,62.4,116,64.4,2,0,0
10/03/2017 11:35,44,67.9,61,63.1,105,65.1,2,0,0
10/03/2017 11:40,53,67.5,70,62.8,123,64.8,2,0,0
10/03/2017 11:45,51,66.8,69,62,120,64,2,0,0
10/03/2017 11:50,58,66.2,76,61.4,134,63.4,2,0,0
10/03/2017 11:55,52,65,70,60,122,62.1,2,0,0
10/03/2017 12:00,50,65,67,60,117,62.2,2,0,0
10/03/2017 12:05,50,66.1,69,61.1,119,63.2,2,0,0
10/03/2017 12:10,49,67,67,62.2,116,64.2,2,0,0
10/03/2017 12:15,47,67.9,65,63.1,112,65.1,2,0,0
10/03/2017 12:20,63,66.5,82,61.7,145,63.8,2,0,0
10/03/2017 12:25,44,67.4,61,62.6,105,64.6,2,0,0
10/03/2017 12:30,45,66.4,63,61.6,108,63.6,2,0,0
10/03/2017 12:35,49,67.4,68,62.6,117,64.6,2,0,0
10/03/2017 12:40,48,67.9,66,63.2,114,65.2,2,0,0
10/03/2017 12:45,47,68.2,64,63.5,111,65.5,2,0,0
10/03/2017 12:50,44,67,61,62.3,105,64.3,2,0,0
10/03/2017 12:55,36,67.7,53,63,89,64.9,2,0,0
10/03/2017 13:00,59,67,78,62.2,137,64.2,2,0,0
10/03/2017 13:05,44,68.7,61,64,105,66,2,0,0
10/03/2017 13:10,48,68.6,65,63.9,113,65.9,2,0,0
10/03/2017 13:15,54,67.2,73,62.5,127,64.5,2,0,0
10/03/2017 13:20,47,66.7,64,61.9,111,63.9,2,0,0
10/03/2017 13:25,49,67.6,68,62.8,117,64.8,2,0,0
10/03/2017 13:30,47,69.1,64,64.5,111,66.5,2,0,0
10/03/2017 13:35,43,68.7,59,64,102,66,2,0,0
10/03/2017 13:40,45,67.6,62,62.8,107,64.8,2,0,0
10/03/2017 13:45,44,67.4,62,62.6,106,64.6,2,0,0
10/03/2017 13:50,45,66.6,63,61.7,108,63.8,2,0,0
10/03/2017 13:55,51,66.1,70,61.1,121,63.2,2,0,0
10/03/2017 14:00,45,66.8,63,61.9,108,63.9,2,0,0
10/03/2017 14:05,45,67.1,64,62.2,109,64.2,2,0,0
10/03/2017 14:10,44,65.8,62,60.9,106,62.9,2,0,0
10/03/2017 14:15,52,67.6,70,62.8,122,64.8,2,0,0
10/03/2017 14:20,43,67.7,61,63,104,65,2,0,0
10/03/2017 14:25,51,67.1,69,62.3,120,64.4,2,0,0
10/03/2017 14:30,39,67.2,56,62.4,95,64.4,2,0,0
10/03/2017 14:35,44,67.5,61,62.7,105,64.7,2,0,0
10/03/2017 14:40,52,68.2,71,63.6,123,65.5,2,0,0
10/03/2017 14:45,42,67,60,62.1,102,64.1,2,0,0
10/03/2017 14:50,49,66.5,67,61.6,116,63.7,2,0,0
10/03/2017 14:55,41,65.3,58,60.4,99,62.5,2,0,0
10/03/2017 15:00,43,66.4,59,61.6,102,63.6,2,0,0
10/03/2017 15:05,48,66.6,66,61.7,114,63.8,2,0,0
10/03/2017 15:10,52,66.8,70,61.9,122,64,2,0,0
10/03/2017 15:15,48,67.8,66,63.1,114,65.1,2,0,0
10/03/2017 15:20,56,66.4,75,61.6,131,63.6,2,0,0
10/03/2017 15:25,50,67.6,69,62.8,119,64.8,2,0,0
10/03/2017 15:30,46,68.3,64,63.5,110,65.5,2,0,0
10/03/2017 15:35,55,68.5,73,63.8,128,65.8,2,0,0
10/03/2017 15:40,59,67.9,79,63.1,138,65.1,2,0,0
10/03/2017 15:45,66,67.6,86,62.9,152,64.9,2,0,0
10/03/2017 15:50,52,67.8,70,63,122,65.1,2,0,0
10/03/2017 15:55,59,68,77,63.3,136,65.3,2,0,0
10/03/2017 16:00,64,67.7,83,62.9,147,65,2,0,0
10/03/2017 16:05,66,68.4,85,63.7,151,65.7,2,0,0
10/03/2017 16:10,59,68.4,77,63.7,136,65.8,2,0,0
10/03/2017 16:15,52,68.5,70,63.8,122,65.8,2,0,0
10/03/2017 16:20,57,67.5,75,62.7,132,64.8,2,0,0
10/03/2017 16:25,55,66.8,72,62.1,127,64.1,2,0,0
10/03/2017 16:30,54,68.2,71,63.5,125,65.5,2,0,0
10/03/2017 16:35,63,68.3,81,63.7,144,65.7,2,0,0
10/03/2017 16:40,61,69.3,79,64.7,140,66.7,2,0,0
10/03/2017 16:45,57,69,75,64.4,132,66.4,2,0,0
10/03/2017 16:50,59,68.6,79,63.9,138,65.9,2,0,0
10/03/2017 16:55,54,69.3,72,64.7,126,66.7,2,0,0
10/03/2017 17:00,43,69.8,61,65.3,104,67.2,2,0,0
10/03/2017 17:05,57,69,75,64.4,132,66.4,2,0,0
10/03/2017 17:10,63,68.2,82,63.5,145,65.5,2,0,0
10/03/2017 17:15,58,68.8,77,64.1,135,66.1,2,0,0
10/03/2017 17:20,53,68.5,72,63.8,125,65.8,2,0,0
10/03/2017 17:25,54,69.3,73,64.7,127,66.6,2,0,0
10/03/2017 17:30,52,69.8,71,65.2,123,67.1,2,0,0
10/03/2017 17:35,51,69.9,69,65.4,120,67.3,2,0,0
10/03/2017 17:40,52,68.9,69,64.2,121,66.2,2,0,0
10/03/2017 17:45,57,69.1,74,64.5,131,66.5,2,0,0
10/03/2017 17:50,57,68.7,77,64,134,66,2,0,0
10/03/2017 17:55,56,68.7,74,64.1,130,66.1,2,0,0
10/03/2017 18:00,50,67.8,67,63.1,117,65.1,2,0,0
10/03/2017 18:05,54,68.3,72,63.6,126,65.6,2,0,0
10/03/2017 18:10,51,68.3,69,63.5,120,65.5,2,0,0
10/03/2017 18:15,51,67.2,69,62.3,120,64.4,2,0,0
10/03/2017 18:20,59,67.9,78,63.1,137,65.1,2,0,0
10/03/2017 18:25,58,68.6,76,63.8,134,65.9,2,0,0
10/03/2017 18:30,38,68.6,55,63.9,93,65.9,2,0,0
10/03/2017 18:35,49,68.7,67,64,116,66,2,0,0
10/03/2017 18:40,38,69.9,55,65.3,93,67.2,2,0,0
10/03/2017 18:45,46,70.5,64,66,110,67.9,2,0,0
10/03/2017 18:50,48,69.9,65,65.4,113,67.3,2,0,0
10/03/2017 18:55,42,70.3,59,65.8,101,67.7,2,0,0
10/03/2017 19:00,46,69,64,64.3,110,66.3,2,0,0
10/03/2017 19:05,45,68.9,63,64.2,108,66.2,2,0,0
10/03/2017 19:10,46,68.9,65,64.2,111,66.1,2,0,0
10/03/2017 19:15,51,67.3,69,62.4,120,64.5,2,0,0
10/03/2017 19:20,47,66.8,65,61.9,112,64,2,0,0
10/03/2017 19:25,44,68.1,61,63.4,105,65.4,2,0,0
10/03/2017 19:30,45,68.9,62,64.3,107,66.2,2,0,0
10/03/2017 19:35,33,69.1,49,64.5,82,66.4,2,0,0
10/03/2017 19:40,45,67.3,63,62.4,108,64.5,2,0,0
10/03/2017 19:45,41,68.3,57,63.6,98,65.6,2,0,0
10/03/2017 19:50,34,68.7,51,64.1,85,65.9,2,0,0
10/03/2017 19:55,37,69,53,64.3,90,66.2,2,0,0
10/03/2017 20:00,34,69.6,50,65,84,66.9,2,0,0
10/03/2017 20:05,34,68.9,51,64.3,85,66.2,2,0,0
10/03/2017 20:10,29,69.2,46,64.5,75,66.3,2,0,0
10/03/2017 20:15,33,69.5,49,64.9,82,66.7,2,0,0
10/03/2017 20:20,31,69,47,64.4,78,66.2,2,0,0
10/03/2017 20:25,34,67.2,51,62.4,85,64.4,2,0,0
10/03/2017 20:30,40,68.2,56,63.4,96,65.4,2,0,0
10/03/2017 20:35,34,68,50,63.3,84,65.2,2,0,0
10/03/2017 20:40,32,68.8,48,64.2,80,66,2,0,0
10/03/2017 20:45,34,68.3,51,63.7,85,65.5,2,0,0
10/03/2017 20:50,30,69.2,47,64.6,77,66.4,2,0,0
10/03/2017 20:55,30,69,46,64.4,76,66.3,2,0,0
10/03/2017 21:00,24,69.3,39,64.7,63,66.4,2,0,0
10/03/2017 21:05,23,69.2,39,64.6,62,66.3,2,0,0
10/03/2017 21:10,28,69.6,44,65,72,66.8,2,0,0
10/03/2017 21:15,26,69.9,42,65.3,68,67.1,2,0,0
10/03/2017 21:20,25,69.5,42,64.9,67,66.6,2,0,0
10/03/2017 21:25,26,69.7,42,65.1,68,66.8,2,0,0
10/03/2017 21:30,27,69.3,43,64.7,70,66.4,2,0,0
10/03/2017 21:35,19,69.3,35,64.7,54,66.4,2,0,0
10/03/2017 21:40,14,69.3,30,64.7,44,66.2,2,0,0
10/03/2017 21:45,17,69.4,33,64.8,50,66.4,2,0,0
10/03/2017 21:50,15,69.6,31,65,46,66.5,2,0,0
10/03/2017 21:55,16,69.1,32,64.5,48,66,2,0,0
10/03/2017 22:00,27,69.2,42,64.6,69,66.4,2,0,0
10/03/2017 22:05,23,68.6,38,64,61,65.7,2,0,0
10/03/2017 22:10,22,68.9,38,64.2,60,65.9,2,0,0
10/03/2017 22:15,21,69.1,37,64.5,58,66.1,2,0,0
10/03/2017 22:20,21,68.9,37,64.2,58,65.9,2,0,0
10/03/2017 22:25,20,69.2,36,64.6,56,66.3,2,0,0
10/03/2017 22:30,21,69.6,37,65,58,66.7,2,0,0
10/03/2017 22:35,25,69.7,41,65.1,66,66.8,2,0,0
10/03/2017 22:40,16,69.6,32,65,48,66.6,2,0,0
10/03/2017 22:45,20,69.4,36,64.8,56,66.5,2,0,0
10/03/2017 22:50,17,69.5,32,64.9,49,66.5,2,0,0
10/03/2017 22:55,21,69.7,36,65.1,57,66.8,2,0,0
10/03/2017 23:00,14,69.6,30,65,44,66.4,2,0,0
10/03/2017 23:05,16,69.6,31,65,47,66.6,2,0,0
10/03/2017 23:10,15,69.6,30,65,45,66.5,2,0,0
10/03/2017 23:15,20,69.4,36,64.8,56,66.5,2,0,0
10/03/2017 23:20,20,69.7,35,65.1,55,66.7,2,0,0
10/03/2017 23:25,11,69.4,26,64.8,37,66.2,2,0,0
10/03/2017 23:30,18,69.5,34,64.9,52,66.5,2,0,0
10/03/2017 23:35,15,69.6,30,65,45,66.5,2,0,0
10/03/2017 23:40,14,69.5,29,64.9,43,66.4,2,0,0
10/03/2017 23:45,13,69.5,28,64.9,41,66.4,2,0,0
10/03/2017 23:50,10,69.4,26,64.8,36,66.1,2,0,0
10/03/2017 23:55,14,69,29,64.4,43,65.9,2,0,0
10/04/2017 0:00,12,69.3,27,64.7,39,66.2,2,0,0
10/04/2017 0:05,11,69.4,27,64.8,38,66.1,2,0,0
10/04/2017 0:10,8,69.4,24,64.8,32,66,2,0,0
10/04/2017 0:15,8,69.4,24,64.8,32,66,2,0,0
10/04/2017 0:20,8,69.4,23,64.8,31,66,2,0,0
10/04/2017 0:25,10,69.3,25,64.7,35,66,2,0,0
10/04/2017 0:30,7,69.3,22,64.7,29,65.8,2,0,0
10/04/2017 0:35,10,69.3,25,64.7,35,66,2,0,0
10/04/2017 0:40,9,69.2,24,64.6,33,65.9,2,0,0
10/04/2017 0:45,7,69.3,23,64.7,30,65.7,2,0,0
10/04/2017 0:50,5,69.3,20,64.7,25,65.6,2,0,0
10/04/2017 0:55,6,69.4,21,64.8,27,65.8,2,0,0
10/04/2017 1:00,14,69.3,22,64.7,36,66.5,2,0,0
10/04/2017 1:05,9,69.3,24,64.7,33,66,2,0,0
10/04/2017 1:10,7,69.3,22,64.7,29,65.8,2,0,0
10/04/2017 1:15,6,69.4,21,64.8,27,65.8,2,0,0
10/04/2017 1:20,7,69.4,22,64.8,29,65.9,2,0,0
10/04/2017 1:25,7,69.2,22,64.6,29,65.7,2,0,0
10/04/2017 1:30,7,69.3,22,64.7,29,65.8,2,0,0
10/04/2017 1:35,8,69.3,23,64.7,31,65.9,2,0,0
10/04/2017 1:40,8,69.4,23,64.8,31,66,2,0,0
10/04/2017 1:45,11,69.4,21,64.8,32,66.4,2,0,0
10/04/2017 1:50,7,69.4,22,64.8,29,65.9,2,0,0
10/04/2017 1:55,6,69.3,21,64.7,27,65.7,2,0,0
10/04/2017 2:00,8,69.3,23,64.7,31,65.8,2,0,0
10/04/2017 2:05,6,69.1,21,64.5,27,65.5,2,0,0
10/04/2017 2:10,8,69.3,23,64.7,31,65.9,2,0,0
10/04/2017 2:15,6,69.3,21,64.7,27,65.7,2,0,0
10/04/2017 2:20,6,69.4,21,64.8,27,65.8,2,0,0
10/04/2017 2:25,9,69.4,24,64.8,33,66.1,2,0,0
10/04/2017 2:30,7,69.2,22,64.6,29,65.7,2,0,0
10/04/2017 2:35,9,69,24,64.4,33,65.7,2,0,0
10/04/2017 2:40,8,69.2,24,64.6,32,65.8,2,0,0
10/04/2017 2:45,10,69.3,26,64.7,36,65.9,2,0,0
10/04/2017 2:50,11,69.4,27,64.8,38,66.1,2,0,0
10/04/2017 2:55,11,69.1,27,64.4,38,65.8,2,0,0
10/04/2017 3:00,8,69.3,24,64.6,32,65.8,2,0,0
10/04/2017 3:05,10,69.3,26,64.7,36,65.9,2,0,0
10/04/2017 3:10,9,69.3,24,64.7,33,66,2,0,0
10/04/2017 3:15,11,69.2,26,64.6,37,66,2,0,0
10/04/2017 3:20,8,69.3,23,64.7,31,65.9,2,0,0
10/04/2017 3:25,12,69.4,28,64.8,40,66.2,2,0,0
10/04/2017 3:30,11,69.4,27,64.8,38,66.1,2,0,0
10/04/2017 3:35,10,69.5,26,64.9,36,66.2,2,0,0
10/04/2017 3:40,9,69.5,24,64.9,33,66.1,2,0,0
10/04/2017 3:45,12,69.4,27,64.8,39,66.2,2,0,0
10/04/2017 3:50,13,69.2,28,64.6,41,66.1,2,0,0
10/04/2017 3:55,15,69.5,31,64.9,46,66.4,2,0,0
10/04/2017 4:00,11,69.5,26,64.9,37,66.3,2,0,0
10/04/2017 4:05,17,69.4,33,64.8,50,66.4,2,0,0
10/04/2017 4:10,13,69,29,64.3,42,65.8,2,0,0
10/04/2017 4:15,17,69.2,34,64.5,51,66.1,2,0,0
10/04/2017 4:20,20,69.1,36,64.5,56,66.1,2,0,0
10/04/2017 4:25,25,69.4,41,64.7,66,66.5,2,0,0
10/04/2017 4:30,26,68.9,43,64.2,69,65.9,2,0,0
10/04/2017 4:35,27,69.1,44,64.5,71,66.3,2,0,0
10/04/2017 4:40,25,68.8,41,64.1,66,65.8,2,0,0
10/04/2017 4:45,33,69.6,49,65,82,66.8,2,0,0
10/04/2017 4:50,30,69.7,47,65.2,77,66.9,2,0,0
10/04/2017 4:55,25,68.9,41,64.3,66,66,2,0,0
10/04/2017 5:00,34,68.4,52,63.7,86,65.5,2,0,0
10/04/2017 5:05,34,68,51,63.3,85,65.2,2,0,0
10/04/2017 5:10,43,68.9,61,64.2,104,66.1,2,0,0
10/04/2017 5:15,40,69.8,57,65.1,97,67,2,0,0
10/04/2017 5:20,42,69.9,60,65.3,102,67.2,2,0,0
10/04/2017 5:25,54,71,73,66.6,127,68.5,2,0,0
10/04/2017 5:30,46,69.7,65,65,111,67,2,0,0
10/04/2017 5:35,48,68.3,67,63.5,115,65.5,2,0,0
10/04/2017 5:40,49,68.6,68,63.9,117,65.8,2,0,0
10/04/2017 5:45,55,69.8,75,65.2,130,67.1,2,0,0
10/04/2017 5:50,62,68.9,83,64.2,145,66.2,2,0,0
10/04/2017 5:55,59,68.8,79,64.1,138,66.1,2,0,0
10/04/2017 6:00,61,68.9,82,64.3,143,66.2,2,0,0
10/04/2017 6:05,56,67.8,76,63,132,65,2,0,0
10/04/2017 6:10,64,67.4,86,62.5,150,64.6,2,0,0
10/04/2017 6:15,67,67.3,88,62.5,155,64.6,2,0,0
10/04/2017 6:20,73,66.5,96,61.6,169,63.8,2,0,0
10/04/2017 6:25,72,67.3,93,62.4,165,64.6,2,0,0
10/04/2017 6:30,58,66.9,79,61.9,137,64.1,2,0,0
10/04/2017 6:35,69,67.9,91,63,160,65.1,2,0,0
10/04/2017 6:40,66,66.7,87,61.8,153,63.9,2,0,0
10/04/2017 6:45,64,66.7,86,61.8,150,63.9,2,0,0
10/04/2017 6:50,78,67.5,100,62.7,178,64.8,2,0,0
10/04/2017 6:55,75,67.8,98,62.9,173,65,2,0,0
10/04/2017 7:00,65,67.2,87,62.3,152,64.4,2,0,0
10/04/2017 7:05,73,67.2,95,62.3,168,64.5,2,0,0
10/04/2017 7:10,83,67,105,62.1,188,64.3,2,0,0
10/04/2017 7:15,76,66.7,99,61.7,175,63.9,2,0,0
10/04/2017 7:20,88,66.8,112,61.9,200,64,2,0,0
10/04/2017 7:25,84,66.2,108,61.2,192,63.4,2,0,0
10/04/2017 7:30,71,66.1,93,61,164,63.2,2,0,0
10/04/2017 7:35,83,65.7,105,60.7,188,62.9,2,0,0
10/04/2017 7:40,78,66.2,101,61.2,179,63.4,2,0,0
10/04/2017 7:45,90,66.1,114,61.1,204,63.3,2,0,0
10/04/2017 7:50,84,66.7,108,61.8,192,64,2,0,0
10/04/2017 7:55,87,66,110,61.1,197,63.3,2,0,0
10/04/2017 8:00,83,66.1,107,61.1,190,63.3,2,0,0
10/04/2017 8:05,79,66.7,102,61.8,181,63.9,2,0,0
10/04/2017 8:10,84,66.6,107,61.7,191,63.8,2,0,0
10/04/2017 8:15,82,66,105,61,187,63.2,2,0,0
10/04/2017 8:20,83,66.2,105,61.3,188,63.5,2,0,0
10/04/2017 8:25,79,66.5,102,61.6,181,63.7,2,0,0
10/04/2017 8:30,88,65.8,111,60.8,199,63,2,0,0
10/04/2017 8:35,80,65.4,103,60.4,183,62.6,2,0,0
10/04/2017 8:40,81,66.3,103,61.3,184,63.5,2,0,0
10/04/2017 8:45,80,66.3,102,61.3,182,63.5,2,0,0
10/04/2017 8:50,79,65.6,102,60.5,181,62.7,2,0,0
10/04/2017 8:55,75,65,97,59.9,172,62.1,2,0,0
10/04/2017 9:00,81,64.4,103,59.2,184,61.5,2,0,0
10/04/2017 9:05,65,65.6,85,60.7,150,62.8,2,0,0
10/04/2017 9:10,76,65.8,98,60.9,174,63,2,0,0
10/04/2017 9:15,70,66.6,92,61.7,162,63.9,2,0,0
10/04/2017 9:20,76,64.6,98,59.5,174,61.7,2,0,0
10/04/2017 9:25,61,65.1,82,60.1,143,62.3,2,0,0
10/04/2017 9:30,60,65.9,80,61.1,140,63.2,2,0,0
10/04/2017 9:35,76,66.2,98,61.3,174,63.5,2,0,0
10/04/2017 9:40,67,65.5,88,60.6,155,62.7,2,0,0
10/04/2017 9:45,79,65.2,101,60.2,180,62.4,2,0,0
10/04/2017 9:50,72,64,93,58.9,165,61.1,2,0,0
10/04/2017 9:55,67,63.5,87,58.4,154,60.6,2,0,0
10/04/2017 10:00,59,64.7,79,59.6,138,61.8,2,0,0
10/04/2017 10:05,67,63.7,86,58.5,153,60.8,2,0,0
10/04/2017 10:10,74,64.8,95,59.8,169,62,2,0,0
10/04/2017 10:15,61,65.1,80,60.1,141,62.3,2,0,0
10/04/2017 10:20,72,65.6,92,60.7,164,62.8,2,0,0
10/04/2017 10:25,79,65.4,100,60.4,179,62.6,2,0,0
10/04/2017 10:30,70,65.8,89,60.8,159,63,2,0,0
10/04/2017 10:35,75,66.2,95,61.4,170,63.5,2,0,0
10/04/2017 10:40,68,65,88,60.1,156,62.2,2,0,0
10/04/2017 10:45,53,66.2,71,61.4,124,63.4,2,0,0
10/04/2017 10:50,55,66.7,74,62,129,64,2,0,0
10/04/2017 10:55,54,66.4,73,61.6,127,63.7,2,0,0
10/04/2017 11:00,57,66.9,76,62.2,133,64.2,2,0,0
10/04/2017 11:05,47,65.6,66,60.8,113,62.8,2,0,0
10/04/2017 11:10,47,65.4,66,60.7,113,62.6,2,0,0
10/04/2017 11:15,48,64.6,67,59.8,115,61.8,2,0,0
10/04/2017 11:20,55,64.7,74,59.9,129,62,2,0,0
10/04/2017 11:25,54,65,73,60.2,127,62.2,2,0,0
10/04/2017 11:30,61,64.9,81,60.1,142,62.2,2,0,0
10/04/2017 11:35,60,66.2,78,61.4,138,63.5,2,0,0
10/04/2017 11:40,66,66.3,86,61.5,152,63.6,2,0,0
10/04/2017 11:45,55,65.5,74,60.7,129,62.7,2,0,0
10/04/2017 11:50,60,66.5,79,61.7,139,63.8,2,0,0
10/04/2017 11:55,58,67.4,77,62.6,135,64.7,2,0,0
10/04/2017 12:00,52,67.9,70,63.2,122,65.2,2,0,0
10/04/2017 12:05,56,66.8,76,62.1,132,64.1,2,0,0
10/04/2017 12:10,55,64.3,73,59.3,128,61.4,2,0,0
10/04/2017 12:15,36,65.3,52,60.4,88,62.4,2,0,0
10/04/2017 12:20,32,67.2,49,62.5,81,64.4,2,0,0
10/04/2017 12:25,44,67.8,61,63.1,105,65.1,2,0,0
10/04/2017 12:30,51,68.5,68,63.9,119,65.9,2,0,0
10/04/2017 12:35,50,67.8,68,63.1,118,65.1,2,0,0
10/04/2017 12:40,53,67.2,71,62.6,124,64.6,2,0,0
10/04/2017 12:45,47,66.8,65,62.1,112,64.1,2,0,0
10/04/2017 12:50,49,67.1,66,62.5,115,64.5,2,0,0
10/04/2017 12:55,54,67.3,72,62.7,126,64.7,2,0,0
10/04/2017 13:00,45,68.6,62,64.1,107,66,2,0,0
10/04/2017 13:05,51,70,69,65.5,120,67.4,2,0,0
10/04/2017 13:10,56,69.8,74,65.3,130,67.2,2,0,0
10/04/2017 13:15,52,69.3,71,64.7,123,66.7,2,0,0
10/04/2017 13:20,52,68.6,71,64,123,66,2,0,0
10/04/2017 13:25,47,69.3,64,64.6,111,66.6,2,0,0
10/04/2017 13:30,60,70.3,78,65.7,138,67.7,2,0,0
10/04/2017 13:35,6,70.3,18,65.7,24,66.9,2,0,0
10/04/2017 13:40,69,68.3,62,62.5,131,65.6,2,0,0
10/04/2017 13:45,53,72.3,71,67.8,124,69.7,2,0,0
10/04/2017 13:50,53,71.3,71,66.7,124,68.6,2,0,0
10/04/2017 13:55,42,69.9,60,65.3,102,67.2,2,0,0
10/04/2017 14:00,39,69.1,56,64.4,95,66.4,2,0,0
10/04/2017 14:05,45,69.4,63,64.8,108,66.7,2,0,0
10/04/2017 14:10,56,67.5,76,62.8,132,64.8,2,0,0
10/04/2017 14:15,48,67.9,65,63.2,113,65.2,2,0,0
10/04/2017 14:20,51,68.1,70,63.4,121,65.4,2,0,0
10/04/2017 14:25,49,68.4,66,63.7,115,65.7,2,0,0
10/04/2017 14:30,53,69.2,71,64.5,124,66.5,2,0,0
10/04/2017 14:35,47,70.2,63,65.6,110,67.6,2,0,0
10/04/2017 14:40,51,68.6,69,63.8,120,65.8,2,0,0
10/04/2017 14:45,79,68.1,71,62.3,150,65.4,2,0,0
10/04/2017 14:50,80,68.2,71,62.4,151,65.5,2,0,0
10/04/2017 14:55,76,68.1,69,62.3,145,65.3,2,0,0
10/04/2017 15:00,76,67.7,69,61.9,145,64.9,2,0,0
10/04/2017 15:05,77,67.5,70,61.7,147,64.7,2,0,0
10/04/2017 15:10,81,67.4,72,61.6,153,64.7,2,0,0
10/04/2017 15:15,82,67.4,74,61.6,156,64.6,2,0,0
10/04/2017 15:20,82,67.4,73,61.6,155,64.7,2,0,0
10/04/2017 15:25,80,67.5,72,61.7,152,64.8,2,0,0
10/04/2017 15:30,81,67.5,73,61.7,154,64.8,2,0,0
10/04/2017 15:35,83,67.5,75,61.7,158,64.7,2,0,0
10/04/2017 15:40,85,67.5,76,61.7,161,64.8,2,0,0
10/04/2017 15:45,86,67.5,78,61.7,164,64.7,2,0,0
10/04/2017 15:50,83,67.6,75,61.8,158,64.8,2,0,0
10/04/2017 15:55,82,67.7,73,61.9,155,65,2,0,0
10/04/2017 16:00,77,67.7,70,61.9,147,64.9,2,0,0
10/04/2017 16:05,81,67.5,72,61.7,153,64.8,2,0,0
10/04/2017 16:10,85,67.5,76,61.7,161,64.8,2,0,0
10/04/2017 16:15,86,67.3,78,61.5,164,64.5,2,0,0
10/04/2017 16:20,85,67.5,76,61.7,161,64.8,2,0,0
10/04/2017 16:25,82,67.6,74,61.8,156,64.8,2,0,0
10/04/2017 16:30,84,67.8,75,62,159,65.1,2,0,0
10/04/2017 16:35,86,67.8,77,62,163,65.1,2,0,0
10/04/2017 16:40,89,67.7,79,61.9,168,65,2,0,0
10/04/2017 16:45,89,67.5,80,61.7,169,64.8,2,0,0
10/04/2017 16:50,88,67.4,79,61.6,167,64.7,2,0,0
10/04/2017 16:55,87,67.8,79,62,166,65,2,0,0
10/04/2017 17:00,87,67.7,79,61.9,166,64.9,2,0,0
10/04/2017 17:05,89,67.6,80,61.8,169,64.9,2,0,0
10/04/2017 17:10,95,67.6,86,61.8,181,64.8,2,0,0
10/04/2017 17:15,97,67.3,87,61.5,184,64.6,2,0,0
10/04/2017 17:20,95,67.1,86,61.3,181,64.3,2,0,0
10/04/2017 17:25,93,67,84,61.2,177,64.2,2,0,0
10/04/2017 17:30,91,66.7,82,60.9,173,63.9,2,0,0
10/04/2017 17:35,91,66.7,81,60.9,172,64,2,0,0
10/04/2017 17:40,92,66.3,83,60.7,175,63.6,2,0,0
10/04/2017 17:45,91,66.1,81,60.5,172,63.5,2,0,0
10/04/2017 17:50,88,66.3,79,60.7,167,63.7,2,0,0
10/04/2017 17:55,85,65.9,77,60.3,162,63.2,2,0,0
10/04/2017 18:00,83,66.4,74,60.8,157,63.8,2,0,0
10/04/2017 18:05,82,66.6,73,60.8,155,63.9,2,0,0
10/04/2017 18:10,85,66.8,76,61,161,64.1,2,0,0
10/04/2017 18:15,83,66.8,74,61,157,64.1,2,0,0
10/04/2017 18:20,83,67.1,74,61.3,157,64.4,2,0,0
10/04/2017 18:25,80,67.3,71,61.5,151,64.6,2,0,0
10/04/2017 18:30,78,67.6,70,61.8,148,64.9,2,0,0
10/04/2017 18:35,76,67.6,68,61.8,144,64.9,2,0,0
10/04/2017 18:40,76,67.9,68,62.1,144,65.2,2,0,0
10/04/2017 18:45,75,68,68,62.2,143,65.2,2,0,0
10/04/2017 18:50,72,68.2,64,62.4,136,65.5,2,0,0
10/04/2017 18:55,70,68.4,62,62.6,132,65.7,2,0,0
10/04/2017 19:00,65,68.7,58,62.9,123,66,2,0,0
10/04/2017 19:05,63,69.2,57,63.2,120,66.3,2,0,0
10/04/2017 19:10,65,69.1,58,63.1,123,66.3,2,0,0
10/04/2017 19:15,63,69.4,57,63.4,120,66.5,2,0,0
10/04/2017 19:20,61,69.5,55,63.5,116,66.7,2,0,0
10/04/2017 19:25,57,69.7,52,63.7,109,66.8,2,0,0
10/04/2017 19:30,54,69.9,48,63.9,102,67.1,2,0,0
10/04/2017 19:35,53,69.9,47,63.9,100,67.1,2,0,0
10/04/2017 19:40,51,70,46,64,97,67.2,2,0,0
10/04/2017 19:45,48,70.1,44,64.1,92,67.2,2,0,0
10/04/2017 19:50,46,70.2,42,64.2,88,67.3,2,0,0
10/04/2017 19:55,45,70.2,40,64.2,85,67.4,2,0,0
10/04/2017 20:00,43,70.1,38,64.1,81,67.3,2,0,0
10/04/2017 20:05,41,70.3,37,64.3,78,67.5,2,0,0
10/04/2017 20:10,43,70.2,39,64.2,82,67.3,2,0,0
10/04/2017 20:15,42,70.3,37,64.3,79,67.5,2,0,0
10/04/2017 20:20,41,70.3,37,64.3,78,67.5,2,0,0
10/04/2017 20:25,39,70.4,35,64.4,74,67.6,2,0,0
10/04/2017 20:30,38,70.4,35,64.4,73,67.5,2,0,0
10/04/2017 20:35,38,70.3,34,64.3,72,67.5,2,0,0
10/04/2017 20:40,38,70.3,35,64.3,73,67.4,2,0,0
10/04/2017 20:45,38,70.2,34,64.2,72,67.4,2,0,0
10/04/2017 20:50,38,70.3,35,64.3,73,67.4,2,0,0
10/04/2017 20:55,37,70.2,33,64.2,70,67.4,2,0,0
10/04/2017 21:00,35,70.1,32,64.1,67,67.2,2,0,0
10/04/2017 21:05,36,70.2,33,64.2,69,67.3,2,0,0
10/04/2017 21:10,37,70.2,33,64.2,70,67.4,2,0,0
10/04/2017 21:15,37,70.2,34,64.2,71,67.3,2,0,0
10/04/2017 21:20,36,70.1,32,64.1,68,67.3,2,0,0
10/04/2017 21:25,35,70.1,32,64.1,67,67.2,2,0,0
10/04/2017 21:30,36,70.2,32,64.2,68,67.4,2,0,0
10/04/2017 21:35,34,69.9,30,63.9,64,67.1,2,0,0
10/04/2017 21:40,34,70.2,30,64.2,64,67.4,2,0,0
10/04/2017 21:45,34,70.2,30,64.2,64,67.4,2,0,0
10/04/2017 21:50,32,70.2,28,64.2,60,67.4,2,0,0
10/04/2017 21:55,31,70.3,27,64.3,58,67.5,2,0,0
10/04/2017 22:00,28,70.3,26,64.3,54,67.4,2,0,0
10/04/2017 22:05,28,70.2,25,64.2,53,67.4,2,0,0
10/04/2017 22:10,27,70.1,25,64.1,52,67.2,2,0,0
10/04/2017 22:15,28,70.1,25,64.1,53,67.3,2,0,0
10/04/2017 22:20,26,70.2,24,64.2,50,67.3,2,0,0
10/04/2017 22:25,26,70.1,23,64.1,49,67.3,2,0,0
10/04/2017 22:30,24,70.1,21,64.1,45,67.3,2,0,0
10/04/2017 22:35,23,70,21,64,44,67.1,2,0,0
10/04/2017 22:40,23,70.1,20,64.1,43,67.3,2,0,0
10/04/2017 22:45,22,70,20,64,42,67.1,2,0,0
10/04/2017 22:50,21,70,19,64,40,67.2,2,0,0
10/04/2017 22:55,18,70.1,17,64.1,35,67.2,2,0,0
10/04/2017 23:00,18,70.1,16,64.1,34,67.3,2,0,0
10/04/2017 23:05,17,70.2,16,64.2,33,67.3,2,0,0
10/04/2017 23:10,17,70.1,15,64.1,32,67.3,2,0,0
10/04/2017 23:15,17,70.2,15,64.2,32,67.4,2,0,0
10/04/2017 23:20,16,70.1,14,64.1,30,67.3,2,0,0
10/04/2017 23:25,14,70.3,13,64.3,27,67.4,2,0,0
10/04/2017 23:30,14,70.1,12,64.1,26,67.3,2,0,0
10/04/2017 23:35,14,70.2,13,64.2,27,67.3,2,0,0
10/04/2017 23:40,13,70.1,12,64.1,25,67.2,2,0,0
10/04/2017 23:45,13,70.2,11,64.2,24,67.5,2,0,0
10/04/2017 23:50,12,70.1,11,64.1,23,67.2,2,0,0
10/04/2017 23:55,11,70,9,64,20,67.3,2,0,0
10/05/2017 0:00,10,70.4,9,64.4,19,67.6,2,0,0
10/05/2017 0:05,9,70.3,8,64.3,17,67.5,2,0,0
10/05/2017 0:10,10,70.2,9,64.2,19,67.4,2,0,0
10/05/2017 0:15,10,70.1,9,64.1,19,67.3,2,0,0
10/05/2017 0:20,10,70.1,9,64.1,19,67.3,2,0,0
10/05/2017 0:25,11,70,9,64,20,67.3,2,0,0
10/05/2017 0:30,10,70,9,64,19,67.2,2,0,0
10/05/2017 0:35,9,70,9,64,18,67,2,0,0
10/05/2017 0:40,9,70,8,64,17,67.2,2,0,0
10/05/2017 0:45,8,69.9,8,63.9,16,66.9,2,0,0
10/05/2017 0:50,8,69.9,7,63.9,15,67.1,2,0,0
10/05/2017 0:55,8,69.8,7,63.8,15,67,2,0,0
10/05/2017 1:00,7,69.9,6,63.9,13,67.1,2,0,0
10/05/2017 1:05,7,70,6,64,13,67.2,2,0,0
10/05/2017 1:10,7,70,6,64,13,67.2,2,0,0
10/05/2017 1:15,6,70,6,64,12,67,2,0,0
10/05/2017 1:20,6,70.2,6,64.2,12,67.2,2,0,0
10/05/2017 1:25,6,70,5,64,11,67.3,2,0,0
10/05/2017 1:30,6,70,5,64,11,67.3,2,0,0
10/05/2017 1:35,6,70.3,5,64.3,11,67.6,2,0,0
10/05/2017 1:40,6,70.1,6,64.1,12,67.1,2,0,0
10/05/2017 1:45,6,70,5,64,11,67.3,2,0,0
10/05/2017 1:50,5,70,5,64,10,67,2,0,0
10/05/2017 1:55,5,70,5,64,10,67,2,0,0
10/05/2017 2:00,5,70.1,5,64.1,10,67.1,2,0,0
10/05/2017 2:05,5,69.9,5,63.9,10,66.9,2,0,0
10/05/2017 2:10,5,70,5,64,10,67,2,0,0
10/05/2017 2:15,5,70.1,5,64.1,10,67.1,2,0,0
10/05/2017 2:20,5,70,4,64,9,67.3,2,0,0
10/05/2017 2:25,5,70,4,64,9,67.3,2,0,0
10/05/2017 2:30,5,70,4,64,9,67.3,2,0,0
10/05/2017 2:35,5,70,5,64,10,67,2,0,0
10/05/2017 2:40,5,70.1,4,64.1,9,67.4,2,0,0
10/05/2017 2:45,5,70,4,64,9,67.3,2,0,0
10/05/2017 2:50,5,70.1,4,64.1,9,67.4,2,0,0
10/05/2017 2:55,4,70,4,64,8,67,2,0,0
10/05/2017 3:00,4,70,4,64,8,67,2,0,0
10/05/2017 3:05,4,69.9,4,63.9,8,66.9,2,0,0
10/05/2017 3:10,4,69.9,4,63.9,8,66.9,2,0,0
10/05/2017 3:15,5,70,4,64,9,67.3,2,0,0
10/05/2017 3:20,5,69.9,5,63.9,10,66.9,2,0,0
10/05/2017 3:25,5,69.9,5,63.9,10,66.9,2,0,0
10/05/2017 3:30,5,69.9,5,63.9,10,66.9,2,0,0
10/05/2017 3:35,6,70,5,64,11,67.3,2,0,0
10/05/2017 3:40,6,69.9,6,63.9,12,66.9,2,0,0
10/05/2017 3:45,6,69.7,6,63.7,12,66.7,2,0,0
10/05/2017 3:50,6,70,6,64,12,67,2,0,0
10/05/2017 3:55,6,69.8,5,63.8,11,67.1,2,0,0
10/05/2017 4:00,6,69.9,5,63.9,11,67.2,2,0,0
10/05/2017 4:05,6,69.8,6,63.8,12,66.8,2,0,0
10/05/2017 4:10,6,69.7,6,63.7,12,66.7,2,0,0
10/05/2017 4:15,7,69.8,6,63.8,13,67,2,0,0
10/05/2017 4:20,7,69.9,7,63.9,14,66.9,2,0,0
10/05/2017 4:25,8,69.9,7,63.9,15,67.1,2,0,0
10/05/2017 4:30,8,69.7,7,63.7,15,66.9,2,0,0
10/05/2017 4:35,9,69.8,8,63.8,17,67,2,0,0
10/05/2017 4:40,11,69.7,9,63.7,20,67,2,0,0
10/05/2017 4:45,11,69.8,10,63.8,21,66.9,2,0,0
10/05/2017 4:50,11,69.7,10,63.7,21,66.8,2,0,0
10/05/2017 4:55,12,69.7,10,63.7,22,67,2,0,0
10/05/2017 5:00,11,69.6,10,63.6,21,66.7,2,0,0
10/05/2017 5:05,12,69.4,10,63.4,22,66.7,2,0,0
10/05/2017 5:10,13,69.5,12,63.5,25,66.6,2,0,0
10/05/2017 5:15,16,69.6,14,63.6,30,66.8,2,0,0
10/05/2017 5:20,16,69.4,15,63.4,31,66.5,2,0,0
10/05/2017 5:25,17,69.4,16,63.4,33,66.5,2,0,0
10/05/2017 5:30,18,69.4,16,63.4,34,66.6,2,0,0
10/05/2017 5:35,20,69.4,18,63.4,38,66.6,2,0,0
10/05/2017 5:40,23,69.4,20,63.4,43,66.6,2,0,0
10/05/2017 5:45,60,68,80,63.2,140,65.3,2,0,0
10/05/2017 5:50,70,66.8,92,62,162,64.1,2,0,0
10/05/2017 5:55,61,66.3,82,61.4,143,63.5,2,0,0
10/05/2017 6:00,56,67.6,77,62.8,133,64.8,2,0,0
10/05/2017 6:05,59,67.2,79,62.4,138,64.5,2,0,0
10/05/2017 6:10,78,68,101,63.2,179,65.3,2,0,0
10/05/2017 6:15,60,67.2,81,62.3,141,64.3,2,0,0
10/05/2017 6:20,66,67.4,87,62.5,153,64.6,2,0,0
10/05/2017 6:25,61,67.2,82,62.4,143,64.5,2,0,0
10/05/2017 6:30,65,66.9,86,62,151,64.1,2,0,0
10/05/2017 6:35,74,67.5,97,62.7,171,64.8,2,0,0
10/05/2017 6:40,75,67.5,97,62.6,172,64.7,2,0,0
10/05/2017 6:45,68,66.8,90,61.9,158,64,2,0,0
10/05/2017 6:50,77,66.5,100,61.5,177,63.6,2,0,0
10/05/2017 6:55,81,67.3,104,62.4,185,64.6,2,0,0
10/05/2017 7:00,63,67,85,62,148,64.1,2,0,0
10/05/2017 7:05,70,67.2,91,62.2,161,64.4,2,0,0
10/05/2017 7:10,78,67.9,101,63,179,65.2,2,0,0
10/05/2017 7:15,72,68.8,93,64.1,165,66.1,2,0,0
10/05/2017 7:20,78,67.5,101,62.6,179,64.7,2,0,0
10/05/2017 7:25,88,66.5,112,61.5,200,63.7,2,0,0
10/05/2017 7:30,79,67.3,102,62.5,181,64.6,2,0,0
10/05/2017 7:35,81,66.7,104,61.8,185,64,2,0,0
10/05/2017 7:40,80,67.5,102,62.6,182,64.8,2,0,0
10/05/2017 7:45,89,68.1,113,63.3,202,65.4,2,0,0
10/05/2017 7:50,82,68.8,105,64.1,187,66.2,2,0,0
10/05/2017 7:55,89,68.1,114,63.2,203,65.3,2,0,0
10/05/2017 8:00,86,68.5,110,63.7,196,65.8,2,0,0
10/05/2017 8:05,84,68.1,107,63.3,191,65.4,2,0,0
10/05/2017 8:10,85,67.9,107,63,192,65.2,2,0,0
10/05/2017 8:15,86,68.1,110,63.3,196,65.4,2,0,0
10/05/2017 8:20,90,66.6,113,61.6,203,63.8,2,0,0
10/05/2017 8:25,82,67.4,106,62.5,188,64.6,2,0,0
10/05/2017 8:30,78,66.7,101,61.8,179,63.9,2,0,0
10/05/2017 8:35,84,66.1,107,61.1,191,63.3,2,0,0
10/05/2017 8:40,79,66.3,103,61.3,182,63.5,2,0,0
10/05/2017 8:45,81,66.1,102,61.2,183,63.4,2,0,0
10/05/2017 8:50,81,67.3,104,62.4,185,64.5,2,0,0
10/05/2017 8:55,84,66.3,107,61.3,191,63.4,2,0,0
10/05/2017 9:00,84,66.3,106,61.3,190,63.5,2,0,0
10/05/2017 9:05,78,65.9,98,60.8,176,63.1,2,0,0
10/05/2017 9:10,57,65.9,77,60.9,134,63.1,2,0,0
10/05/2017 9:15,74,66.3,95,61.4,169,63.5,2,0,0
10/05/2017 9:20,63,65.9,83,61,146,63.1,2,0,0
10/05/2017 9:25,62,66.5,81,61.6,143,63.7,2,0,0
10/05/2017 9:30,60,67.3,80,62.4,140,64.5,1,0,0
10/05/2017 9:35,64,66.5,84,61.6,148,63.7,1,0,0
10/05/2017 9:40,72,65.2,92,60.2,164,62.4,1,0,0
10/05/2017 9:45,76,65.4,97,60.4,173,62.6,1,0,0
10/05/2017 9:50,83,65.1,104,60.1,187,62.3,1,0,0
10/05/2017 9:55,74,64.2,95,59.1,169,61.3,1,0,0
10/05/2017 10:00,66,64.9,86,59.9,152,62.1,1,0,0
10/05/2017 10:05,70,65.7,90,60.7,160,62.9,1,0,0
10/05/2017 10:10,75,66.7,96,61.8,171,64,1,0,0
10/05/2017 10:15,62,67.7,81,62.9,143,65,1,0,0
10/05/2017 10:20,74,65.5,94,60.5,168,62.7,1,0,0
10/05/2017 10:25,73,67.5,92,62.6,165,64.8,1,0,0
10/05/2017 10:30,57,67.1,75,62.2,132,64.3,1,0,0
10/05/2017 10:35,63,67,83,62.1,146,64.2,1,0,0
10/05/2017 10:40,70,65.9,90,61,160,63.1,1,0,0
10/05/2017 10:45,54,66.6,73,61.7,127,63.8,1,0,0
10/05/2017 10:50,64,67.3,84,62.5,148,64.6,1,0,0
10/05/2017 10:55,59,67.3,78,62.5,137,64.5,1,0,0
10/05/2017 11:00,69,67.4,88,62.7,157,64.8,1,0,0
10/05/2017 11:05,57,67.7,74,62.9,131,65,1,0,0
10/05/2017 11:10,61,67.5,80,62.8,141,64.8,1,0,0
10/05/2017 11:15,73,67.9,93,63.3,166,65.3,1,0,0
10/05/2017 11:20,52,68.6,70,64,122,65.9,1,0,0
10/05/2017 11:25,75,68.5,95,63.9,170,65.9,1,0,0
10/05/2017 11:30,81,67.7,101,63,182,65.1,1,0,0
10/05/2017 11:35,70,67,89,62.3,159,64.3,1,0,0
10/05/2017 11:40,73,65.6,92,60.7,165,62.9,1,0,0
10/05/2017 11:45,84,66.9,103,62.1,187,64.3,1,0,0
10/05/2017 11:50,83,67.3,103,62.6,186,64.7,1,0,0
10/05/2017 11:55,78,68.2,97,63.6,175,65.6,1,0,0
10/05/2017 12:00,77,67.6,97,62.9,174,64.9,1,0,0
10/05/2017 12:05,59,68.5,78,64,137,65.9,1,0,0
10/05/2017 12:10,62,70.4,80,66,142,67.9,1,0,0
10/05/2017 12:15,66,69.1,85,64.5,151,66.6,1,0,0
10/05/2017 12:20,58,68.7,77,64,135,66,1,0,0
10/05/2017 12:25,57,67.8,76,63,133,65.1,1,0,0
10/05/2017 12:30,50,66.8,68,62,118,64.1,1,0,0
10/05/2017 12:35,57,67.6,74,62.8,131,64.9,1,0,0
10/05/2017 12:40,46,67.8,64,63.1,110,65,1,0,0
10/05/2017 12:45,61,67.9,79,63.1,140,65.2,1,0,0
10/05/2017 12:50,51,69.4,69,64.8,120,66.8,1,0,0
10/05/2017 12:55,55,68.9,73,64.3,128,66.3,1,0,0
10/05/2017 13:00,44,68.7,61,64.1,105,66,1,0,0
10/05/2017 13:05,50,68.9,68,64.3,118,66.2,1,0,0
10/05/2017 13:10,56,69,73,64.4,129,66.4,1,0,0
10/05/2017 13:15,42,70.3,58,65.8,100,67.7,1,0,0
10/05/2017 13:20,48,69.5,66,65,114,66.9,1,0,0
10/05/2017 13:25,61,67.4,80,62.6,141,64.7,1,0,0
10/05/2017 13:30,72,67.2,92,62.4,164,64.5,1,0,0
10/05/2017 13:35,62,66.6,82,61.8,144,63.9,1,0,0
10/05/2017 13:40,53,66.7,71,61.9,124,63.9,1,0,0
10/05/2017 13:45,45,68.6,62,64,107,65.9,1,0,0
10/05/2017 13:50,39,69.1,56,64.5,95,66.4,1,0,0
10/05/2017 13:55,50,69.2,67,64.6,117,66.6,2,0,0
10/05/2017 14:00,48,68.8,66,64.2,114,66.1,2,0,0
10/05/2017 14:05,46,68.7,63,64,109,66,2,0,0
10/05/2017 14:10,49,67.7,67,62.9,116,64.9,2,0,0
10/05/2017 14:15,51,67.1,70,62.3,121,64.4,2,0,0
10/05/2017 14:20,50,67.2,67,62.4,117,64.4,2,0,0
10/05/2017 14:25,57,66.5,76,61.7,133,63.7,2,0,0
10/05/2017 14:30,49,67.2,68,62.4,117,64.4,2,0,0
10/05/2017 14:35,53,66.9,72,62.1,125,64.1,2,0,0
10/05/2017 14:40,50,68,67,63.3,117,65.3,2,0,0
10/05/2017 14:45,61,68,78,63.3,139,65.4,2,0,0
10/05/2017 14:50,55,68.9,73,64.3,128,66.3,2,0,0
10/05/2017 14:55,49,67.1,67,62.3,116,64.4,2,0,0
10/05/2017 15:00,47,66.4,65,61.6,112,63.6,2,0,0
10/05/2017 15:05,42,68.2,59,63.5,101,65.5,2,0,0
10/05/2017 15:10,53,69.5,71,64.9,124,66.9,2,0,0
10/05/2017 15:15,55,70.1,72,65.5,127,67.5,2,0,0
10/05/2017 15:20,52,69.3,70,64.8,122,66.7,2,0,0
10/05/2017 15:25,66,68.7,85,64,151,66.1,2,0,0
10/05/2017 15:30,54,69,73,64.4,127,66.4,2,0,0
10/05/2017 15:35,61,69.9,79,65.4,140,67.3,2,0,0
10/05/2017 15:40,76,69.7,97,65.2,173,67.2,2,0,0
10/05/2017 15:45,66,69.3,85,64.7,151,66.7,2,0,0
10/05/2017 15:50,62,69.3,79,64.7,141,66.8,2,0,0
10/05/2017 15:55,67,68.7,85,64,152,66.1,2,0,0
10/05/2017 16:00,68,68.2,87,63.6,155,65.6,2,0,0
10/05/2017 16:05,58,69.2,77,64.6,135,66.6,2,0,0
10/05/2017 16:10,69,69.8,88,65.3,157,67.3,2,0,0
10/05/2017 16:15,67,70.2,85,65.8,152,67.8,2,0,0
10/05/2017 16:20,67,70,86,65.5,153,67.5,2,0,0
10/05/2017 16:25,59,69.2,78,64.7,137,66.6,2,0,0
10/05/2017 16:30,61,69.8,80,65.2,141,67.2,2,0,0
10/05/2017 16:35,54,69.8,72,65.2,126,67.2,2,0,0
10/05/2017 16:40,59,68.6,77,63.8,136,65.9,2,0,0
10/05/2017 16:45,52,68.2,72,63.5,124,65.5,2,0,0
10/05/2017 16:50,59,67.2,78,62.5,137,64.5,2,0,0
10/05/2017 16:55,53,67.9,71,63.1,124,65.2,2,0,0
10/05/2017 17:00,57,68.8,75,64.2,132,66.2,2,0,0
10/05/2017 17:05,47,68.8,66,64.2,113,66.1,2,0,0
10/05/2017 17:10,51,69.3,69,64.7,120,66.6,2,0,0
10/05/2017 17:15,54,70.1,73,65.6,127,67.5,2,0,0
10/05/2017 17:20,55,70.7,73,66.3,128,68.2,2,0,0
10/05/2017 17:25,58,69.9,77,65.4,135,67.3,2,0,0
10/05/2017 17:30,52,70.5,70,66.1,122,68,2,0,0
10/05/2017 17:35,59,69.7,77,65.3,136,67.2,2,0,0
10/05/2017 17:40,49,69.7,68,65.1,117,67,2,0,0
10/05/2017 17:45,65,69.1,85,64.4,150,66.4,2,0,0
10/05/2017 17:50,51,69.7,69,65.1,120,67.1,2,0,0
10/05/2017 17:55,54,67.7,74,62.9,128,64.9,2,0,0
10/05/2017 18:00,56,66.1,76,61.3,132,63.3,2,0,0
10/05/2017 18:05,51,67.6,69,62.7,120,64.8,2,0,0
10/05/2017 18:10,49,67.1,67,62.3,116,64.3,2,0,0
10/05/2017 18:15,48,69.4,66,64.7,114,66.7,2,0,0
10/05/2017 18:20,53,69.5,71,64.9,124,66.9,2,0,0
10/05/2017 18:25,52,68.7,71,64,123,65.9,2,0,0
10/05/2017 18:30,52,68.8,70,64.2,122,66.2,2,0,0
10/05/2017 18:35,48,70.3,66,65.8,114,67.7,2,0,0
10/05/2017 18:40,46,68.9,63,64.3,109,66.2,2,0,0
10/05/2017 18:45,50,69.6,68,65,118,66.9,2,0,0
10/05/2017 18:50,53,70.4,72,65.9,125,67.8,2,0,0
10/05/2017 18:55,49,69.4,67,64.8,116,66.7,2,0,0
10/05/2017 19:00,47,70.2,65,65.7,112,67.6,2,0,0
10/05/2017 19:05,42,70,60,65.5,102,67.3,2,0,0
10/05/2017 19:10,47,69.3,64,64.7,111,66.6,2,0,0
10/05/2017 19:15,41,68.9,57,64.2,98,66.1,2,0,0
10/05/2017 19:20,44,68.9,61,64.2,105,66.2,2,0,0
10/05/2017 19:25,48,68.1,66,63.3,114,65.4,2,0,0
10/05/2017 19:30,46,67.7,62,62.9,108,65,2,0,0
10/05/2017 19:35,47,68.1,64,63.3,111,65.3,2,0,0
10/05/2017 19:40,49,69.3,67,64.6,116,66.6,2,0,0
10/05/2017 19:45,42,69.9,60,65.3,102,67.2,2,0,0
10/05/2017 19:50,41,69.6,59,65,100,66.9,2,0,0
10/05/2017 19:55,39,68.3,56,63.6,95,65.5,2,0,0
10/05/2017 20:00,37,66.7,54,61.8,91,63.8,2,0,0
10/05/2017 20:05,33,68.6,50,63.9,83,65.8,2,0,0
10/05/2017 20:10,33,68.2,50,63.5,83,65.4,2,0,0
10/05/2017 20:15,34,68.1,50,63.5,84,65.4,2,0,0
10/05/2017 20:20,36,68.6,53,64,89,65.8,2,0,0
10/05/2017 20:25,38,69.7,55,65.1,93,67,2,0,0
10/05/2017 20:30,40,69.8,57,65.2,97,67.1,2,0,0
10/05/2017 20:35,32,70,49,65.4,81,67.2,2,0,0
10/05/2017 20:40,35,70.4,51,65.8,86,67.7,2,0,0
10/05/2017 20:45,36,70.3,52,65.8,88,67.6,2,0,0
10/05/2017 20:50,40,69.6,57,65,97,66.9,2,0,0
10/05/2017 20:55,33,69.7,50,65.1,83,66.9,2,0,0
10/05/2017 21:00,30,69.4,46,64.8,76,66.6,2,0,0
10/05/2017 21:05,33,69.1,49,64.5,82,66.4,2,0,0
10/05/2017 21:10,31,68.5,47,63.8,78,65.7,2,0,0
10/05/2017 21:15,28,68.1,44,63.4,72,65.2,2,0,0
10/05/2017 21:20,42,68.7,59,64.1,101,66,2,0,0
10/05/2017 21:25,25,69,41,64.4,66,66.2,2,0,0
10/05/2017 21:30,25,69.3,41,64.7,66,66.4,2,0,0
10/05/2017 21:35,25,69.1,42,64.5,67,66.2,2,0,0
10/05/2017 21:40,19,69.2,35,64.6,54,66.2,2,0,0
10/05/2017 21:45,25,68.5,41,63.8,66,65.6,2,0,0
10/05/2017 21:50,27,68.8,43,64.2,70,66,2,0,0
10/05/2017 21:55,21,69.1,37,64.5,58,66.2,2,0,0
10/05/2017 22:00,20,69.4,36,64.8,56,66.4,2,0,0
10/05/2017 22:05,22,69.4,39,64.8,61,66.5,2,0,0
10/05/2017 22:10,28,69,44,64.4,72,66.2,2,0,0
10/05/2017 22:15,22,69.1,38,64.5,60,66.2,2,0,0
10/05/2017 22:20,22,69.4,38,64.8,60,66.5,2,0,0
10/05/2017 22:25,22,69.8,38,65.3,60,66.9,2,0,0
10/05/2017 22:30,23,69.2,39,64.6,62,66.3,2,0,0
10/05/2017 22:35,19,69.3,35,64.7,54,66.3,2,0,0
10/05/2017 22:40,20,69,36,64.4,56,66,2,0,0
10/05/2017 22:45,23,69.4,39,64.8,62,66.5,2,0,0
10/05/2017 22:50,15,69.3,30,64.7,45,66.3,2,0,0
10/05/2017 22:55,18,69.3,33,64.7,51,66.4,2,0,0
10/05/2017 23:00,23,69,39,64.4,62,66.1,2,0,0
10/05/2017 23:05,21,68.9,37,64.3,58,66,2,0,0
10/05/2017 23:10,23,69.3,39,64.7,62,66.4,2,0,0
10/05/2017 23:15,22,69.2,38,64.6,60,66.3,2,0,0
10/05/2017 23:20,23,69,39,64.4,62,66.1,2,0,0
10/05/2017 23:25,18,68.9,34,64.2,52,65.8,2,0,0
10/05/2017 23:30,21,69.2,36,64.6,57,66.3,2,0,0
10/05/2017 23:35,24,69.4,40,64.8,64,66.6,2,0,0
10/05/2017 23:40,20,69.2,35,64.6,55,66.3,2,0,0
10/05/2017 23:45,21,69.4,36,64.8,57,66.5,2,0,0
10/05/2017 23:50,21,69.6,36,65,57,66.7,2,0,0
10/05/2017 23:55,19,69.2,35,64.6,54,66.2,2,0,0
10/06/2017 0:00,16,69.3,32,64.7,48,66.3,2,0,0
10/06/2017 0:05,12,69.4,27,64.8,39,66.2,2,0,0
10/06/2017 0:10,15,69.4,30,64.8,45,66.3,2,0,0
10/06/2017 0:15,8,69.4,24,64.8,32,66,2,0,0
10/06/2017 0:20,15,69.4,31,64.8,46,66.3,2,0,0
10/06/2017 0:25,11,69.2,26,64.5,37,65.9,2,0,0
10/06/2017 0:30,15,69.3,31,64.7,46,66.2,2,0,0
10/06/2017 0:35,9,69.3,25,64.7,34,65.9,2,0,0
10/06/2017 0:40,11,69.3,26,64.7,37,66.1,2,0,0
10/06/2017 0:45,7,69.2,22,64.5,29,65.7,2,0,0
10/06/2017 0:50,11,69.4,27,64.8,38,66.1,2,0,0
10/06/2017 0:55,8,69.4,23,64.8,31,66,2,0,0
10/06/2017 1:00,8,69.4,24,64.8,32,65.9,2,0,0
10/06/2017 1:05,11,69.3,27,64.7,38,66,2,0,0
10/06/2017 1:10,6,69.1,21,64.4,27,65.5,2,0,0
10/06/2017 1:15,5,69.3,21,64.6,26,65.5,2,0,0
10/06/2017 1:20,15,69.3,22,64.7,37,66.5,2,0,0
10/06/2017 1:25,6,69.4,21,64.7,27,65.8,2,0,0
10/06/2017 1:30,9,69.4,24,64.8,33,66.1,2,0,0
10/06/2017 1:35,12,69.4,27,64.8,39,66.3,2,0,0
10/06/2017 1:40,5,69.4,21,64.8,26,65.7,2,0,0
10/06/2017 1:45,5,69.4,21,64.8,26,65.7,2,0,0
10/06/2017 1:50,5,69.4,20,64.8,25,65.7,2,0,0
10/06/2017 1:55,6,69.4,21,64.7,27,65.8,2,0,0
10/06/2017 2:00,5,69.4,20,64.8,25,65.7,2,0,0
10/06/2017 2:05,5,69.3,20,64.7,25,65.6,2,0,0
10/06/2017 2:10,8,69.3,24,64.7,32,65.9,2,0,0
10/06/2017 2:15,6,69.2,22,64.5,28,65.5,2,0,0
10/06/2017 2:20,9,69.3,24,64.7,33,66,2,0,0
10/06/2017 2:25,6,69.4,22,64.8,28,65.8,2,0,0
10/06/2017 2:30,8,69.2,23,64.5,31,65.7,2,0,0
10/06/2017 2:35,6,69.3,21,64.7,27,65.7,2,0,0
10/06/2017 2:40,9,69.2,24,64.6,33,65.9,2,0,0
10/06/2017 2:45,11,69.4,26,64.8,37,66.1,2,0,0
10/06/2017 2:50,11,69.4,27,64.8,38,66.1,2,0,0
10/06/2017 2:55,9,69.4,25,64.8,34,66,2,0,0
10/06/2017 3:00,12,69.3,28,64.7,40,66.1,2,0,0
10/06/2017 3:05,9,69.3,25,64.7,34,65.9,2,0,0
10/06/2017 3:10,12,69.2,28,64.6,40,66,2,0,0
10/06/2017 3:15,13,69.2,29,64.6,42,66,2,0,0
10/06/2017 3:20,8,69.3,23,64.7,31,65.9,2,0,0
10/06/2017 3:25,12,69.4,28,64.8,40,66.2,2,0,0
10/06/2017 3:30,15,69.6,30,65,45,66.6,2,0,0
10/06/2017 3:35,12,69.6,28,65,40,66.4,2,0,0
10/06/2017 3:40,11,69.4,27,64.8,38,66.2,2,0,0
10/06/2017 3:45,18,69.4,34,64.8,52,66.4,2,0,0
10/06/2017 3:50,13,69.5,29,64.9,42,66.3,2,0,0
10/06/2017 3:55,14,69.4,30,64.8,44,66.3,2,0,0
10/06/2017 4:00,15,69.4,31,64.8,46,66.3,2,0,0
10/06/2017 4:05,11,69.3,26,64.7,37,66.1,2,0,0
10/06/2017 4:10,21,69.2,37,64.6,58,66.3,2,0,0
10/06/2017 4:15,19,69.3,36,64.7,55,66.3,2,0,0
10/06/2017 4:20,22,69.3,38,64.7,60,66.4,2,0,0
10/06/2017 4:25,23,68.8,40,64.2,63,65.9,2,0,0
10/06/2017 4:30,24,69.4,40,64.7,64,66.5,2,0,0
10/06/2017 4:35,23,69.2,39,64.6,62,66.3,2,0,0
10/06/2017 4:40,40,69.3,58,64.6,98,66.6,2,0,0
10/06/2017 4:45,42,70.1,59,65.5,101,67.4,2,0,0
10/06/2017 4:50,40,67.7,57,62.9,97,64.9,2,0,0
10/06/2017 4:55,41,67.2,60,62.3,101,64.3,2,0,0
10/06/2017 5:00,39,68,57,63.3,96,65.2,2,0,0
10/06/2017 5:05,44,67.8,62,63,106,65,2,0,0
10/06/2017 5:10,49,69.1,67,64.4,116,66.4,2,0,0
10/06/2017 5:15,48,66.7,67,61.9,115,63.9,2,0,0
10/06/2017 5:20,56,68.2,76,63.5,132,65.5,2,0,0
10/06/2017 5:25,50,68.1,69,63.5,119,65.4,2,0,0
10/06/2017 5:30,58,69.5,77,64.9,135,66.9,2,0,0
10/06/2017 5:35,49,69.4,69,64.9,118,66.8,2,0,0
10/06/2017 5:40,70,69.2,92,64.6,162,66.6,2,0,0
10/06/2017 5:45,63,68.3,84,63.6,147,65.6,2,0,0
10/06/2017 5:50,72,69.2,94,64.5,166,66.5,2,0,0
10/06/2017 5:55,56,68.2,75,63.4,131,65.5,2,0,0
10/06/2017 6:00,60,68.9,81,64.2,141,66.2,2,0,0
10/06/2017 6:05,59,67.2,80,62.3,139,64.4,2,0,0
10/06/2017 6:10,57,67.1,78,62.2,135,64.3,2,0,0
10/06/2017 6:15,68,67.1,90,62.2,158,64.3,2,0,0
10/06/2017 6:20,70,67.6,92,62.7,162,64.8,2,0,0
10/06/2017 6:25,59,67,80,62,139,64.1,2,0,0
10/06/2017 6:30,61,66.1,83,61.1,144,63.2,2,0,0
10/06/2017 6:35,70,66.5,93,61.5,163,63.6,2,0,0
10/06/2017 6:40,71,67.4,93,62.4,164,64.6,2,0,0
10/06/2017 6:45,69,67.7,90,62.8,159,64.9,2,0,0
10/06/2017 6:50,60,65.9,81,60.9,141,63,2,0,0
10/06/2017 6:55,75,66.7,96,61.7,171,63.9,2,0,0
10/06/2017 7:00,67,67.3,88,62.5,155,64.6,2,0,0
10/06/2017 7:05,68,67.5,89,62.7,157,64.7,2,0,0
10/06/2017 7:10,59,66.3,80,61.4,139,63.5,2,0,0
10/06/2017 7:15,80,67.8,103,63,183,65.1,2,0,0
10/06/2017 7:20,83,67.1,105,62.2,188,64.4,2,0,0
10/06/2017 7:25,82,67.1,105,62.2,187,64.3,2,0,0
10/06/2017 7:30,76,65.7,98,60.7,174,62.9,2,0,0
10/06/2017 7:35,85,67,109,62.1,194,64.2,2,0,0
10/06/2017 7:40,83,66.9,107,62,190,64.1,2,0,0
10/06/2017 7:45,80,67.5,102,62.7,182,64.8,2,0,0
10/06/2017 7:50,83,68.5,106,63.8,189,65.8,2,0,0
10/06/2017 7:55,73,67.8,95,63,168,65.1,2,0,0
10/06/2017 8:00,67,68.4,89,63.6,156,65.6,2,0,0
10/06/2017 8:05,91,67.2,115,62.3,206,64.4,2,0,0
10/06/2017 8:10,82,67.3,103,62.4,185,64.6,2,0,0
10/06/2017 8:15,84,67.7,107,62.9,191,65,2,0,0
10/06/2017 8:20,72,67.9,93,63.2,165,65.2,2,0,0
10/06/2017 8:25,79,66.8,101,61.8,180,64,2,0,0
10/06/2017 8:30,74,65.4,95,60.4,169,62.6,2,0,0
10/06/2017 8:35,87,65.5,110,60.5,197,62.7,2,0,0
10/06/2017 8:40,80,66.1,102,61.2,182,63.3,2,0,0
10/06/2017 8:45,81,66.3,103,61.3,184,63.5,2,0,0
10/06/2017 8:50,74,66.3,96,61.4,170,63.5,2,0,0
10/06/2017 8:55,80,65,101,59.9,181,62.1,2,0,0
10/06/2017 9:00,73,66.3,92,61.4,165,63.6,2,0,0
10/06/2017 9:05,68,65.7,88,60.6,156,62.8,2,0,0
10/06/2017 9:10,72,64.7,94,59.6,166,61.8,2,0,0
10/06/2017 9:15,59,65,78,59.9,137,62.1,2,0,0
10/06/2017 9:20,69,65.7,88,60.8,157,62.9,2,0,0
10/06/2017 9:25,57,66.3,76,61.6,133,63.6,2,0,0
10/06/2017 9:30,57,67.8,77,63,134,65,1,0,0
10/06/2017 9:35,63,66.9,83,62.2,146,64.2,1,0,0
10/06/2017 9:40,62,68.2,81,63.6,143,65.6,1,0,0
10/06/2017 9:45,67,68.1,87,63.3,154,65.4,1,0,0
10/06/2017 9:50,58,67.2,77,62.4,135,64.5,1,0,0
10/06/2017 9:55,64,66,83,61.1,147,63.3,1,0,0
10/06/2017 10:00,52,65.7,72,60.8,124,62.8,1,0,0
10/06/2017 10:05,51,66,69,61.2,120,63.3,1,0,0
10/06/2017 10:10,50,66.7,69,61.9,119,63.9,1,0,0
10/06/2017 10:15,83,61.1,106,55.7,189,58.1,1,0,0
10/06/2017 10:20,76,59.6,96,54,172,56.5,1,0,0
10/06/2017 10:25,61,64.5,79,59.5,140,61.7,1,0,0
10/06/2017 10:30,62,65.1,82,60.3,144,62.4,1,0,0
10/06/2017 10:35,60,65.5,78,60.7,138,62.8,1,0,0
10/06/2017 10:40,65,65.6,85,60.8,150,62.9,1,0,0
10/06/2017 10:45,62,65.8,80,61.1,142,63.1,1,0,0
10/06/2017 10:50,59,67.1,78,62.4,137,64.4,1,0,0
10/06/2017 10:55,66,66.4,86,61.6,152,63.7,1,0,0
10/06/2017 11:00,57,67.8,77,63.1,134,65.1,1,0,0
10/06/2017 11:05,68,67.8,86,63,154,65.1,1,0,0
10/06/2017 11:10,57,68.3,75,63.5,132,65.6,1,0,0
10/06/2017 11:15,51,68.2,68,63.4,119,65.5,1,0,0
10/06/2017 11:20,75,67.8,95,63,170,65.1,1,0,0
10/06/2017 11:25,72,69.1,91,64.5,163,66.6,1,0,0
10/06/2017 11:30,67,68.9,87,64.2,154,66.2,1,0,0
10/06/2017 11:35,74,69.8,94,65.2,168,67.2,1,0,0
10/06/2017 11:40,57,69.2,75,64.6,132,66.6,1,0,0
10/06/2017 11:45,64,69.5,82,64.9,146,66.9,1,0,0
10/06/2017 11:50,71,69,90,64.4,161,66.5,1,0,0
10/06/2017 11:55,64,69.4,83,64.8,147,66.8,1,0,0
10/06/2017 12:00,57,68.4,75,63.7,132,65.7,1,0,0
10/06/2017 12:05,56,68.7,74,64.1,130,66.1,1,0,0
10/06/2017 12:10,57,69.4,75,64.8,132,66.8,1,0,0
10/06/2017 12:15,62,70,80,65.4,142,67.4,1,0,0
10/06/2017 12:20,45,69.3,62,64.7,107,66.6,1,0,0
10/06/2017 12:25,41,68.9,58,64.3,99,66.2,1,0,0
10/06/2017 12:30,65,68.5,85,63.7,150,65.8,1,0,0
10/06/2017 12:35,73,69,94,64.4,167,66.4,1,0,0
10/06/2017 12:40,61,68.5,80,63.9,141,65.9,1,0,0
10/06/2017 12:45,54,69.3,72,64.7,126,66.6,1,0,0
10/06/2017 12:50,55,69.8,74,65.3,129,67.2,1,0,0
10/06/2017 12:55,60,68.9,79,64.4,139,66.3,1,0,0
10/06/2017 13:00,64,69.8,83,65.3,147,67.2,1,0,0
10/06/2017 13:05,43,69.9,61,65.4,104,67.3,1,0,0
10/06/2017 13:10,65,68.3,85,63.6,150,65.7,1,0,0
10/06/2017 13:15,67,68.7,86,64.1,153,66.1,1,0,0
10/06/2017 13:20,61,69,80,64.4,141,66.4,1,0,0
10/06/2017 13:25,50,67.4,69,62.7,119,64.7,1,0,0
10/06/2017 13:30,56,68.7,75,64.1,131,66.1,1,0,0
10/06/2017 13:35,59,68,78,63.2,137,65.3,1,0,0
10/06/2017 13:40,52,69,71,64.3,123,66.3,1,0,0
10/06/2017 13:45,55,70,73,65.4,128,67.4,1,0,0
10/06/2017 13:50,53,69.8,71,65.3,124,67.2,2,0,0
10/06/2017 13:55,52,70.4,70,65.9,122,67.8,2,0,0
10/06/2017 14:00,53,70,72,65.4,125,67.3,2,0,0
10/06/2017 14:05,55,70.1,73,65.5,128,67.5,2,0,0
10/06/2017 14:10,50,70.7,68,66.2,118,68.1,2,0,0
10/06/2017 14:15,49,70.5,67,66,116,67.9,2,0,0
10/06/2017 14:20,53,70.6,71,66.2,124,68.1,2,0,0
10/06/2017 14:25,57,69.2,76,64.6,133,66.5,2,0,0
10/06/2017 14:30,48,69.8,66,65.3,114,67.2,2,0,0
10/06/2017 14:35,59,69.9,77,65.4,136,67.3,2,0,0
10/06/2017 14:40,57,69.9,76,65.3,133,67.2,2,0,0
10/06/2017 14:45,54,70.2,72,65.7,126,67.6,2,0,0
10/06/2017 14:50,48,70.9,66,66.5,114,68.4,2,0,0
10/06/2017 14:55,61,71,79,66.7,140,68.6,2,0,0
10/06/2017 15:00,65,68.9,84,64.5,149,66.4,2,0,0
10/06/2017 15:05,63,68.7,82,64.2,145,66.1,2,0,0
10/06/2017 15:10,61,68.2,80,63.6,141,65.6,2,0,0
10/06/2017 15:15,64,69.1,82,64.5,146,66.5,2,0,0
10/06/2017 15:20,61,69.6,78,65.1,139,67,2,0,0
10/06/2017 15:25,66,69.6,85,65.1,151,67,2,0,0
10/06/2017 15:30,63,69.7,82,65.2,145,67.2,2,0,0
10/06/2017 15:35,64,69.6,82,65.1,146,67.1,2,0,0
10/06/2017 15:40,61,69.3,80,64.7,141,66.7,2,0,0
10/06/2017 15:45,64,69.1,83,64.5,147,66.5,2,0,0
10/06/2017 15:50,65,68.8,84,64.2,149,66.2,2,0,0
10/06/2017 15:55,63,68.4,81,63.7,144,65.8,2,0,0
10/06/2017 16:00,60,69,77,64.4,137,66.4,2,0,0
10/06/2017 16:05,70,68.8,89,64.2,159,66.2,2,0,0
10/06/2017 16:10,67,68.9,86,64.4,153,66.4,2,0,0
10/06/2017 16:15,53,68.8,71,64.2,124,66.2,2,0,0
10/06/2017 16:20,61,69.7,80,65.3,141,67.2,2,0,0
10/06/2017 16:25,77,69.3,96,64.8,173,66.8,2,0,0
10/06/2017 16:30,56,68.8,74,64.3,130,66.2,2,0,0
10/06/2017 16:35,64,69.2,83,64.6,147,66.6,2,0,0
10/06/2017 16:40,64,69.3,84,64.8,148,66.7,2,0,0
10/06/2017 16:45,62,69.3,81,64.8,143,66.7,2,0,0
10/06/2017 16:50,62,68.8,81,64.2,143,66.2,2,0,0
10/06/2017 16:55,64,66.9,83,62.1,147,64.2,2,0,0
10/06/2017 17:00,52,68.5,69,63.8,121,65.8,2,0,0
10/06/2017 17:05,52,69.6,70,65.1,122,67,2,0,0
10/06/2017 17:10,61,69.8,80,65.4,141,67.3,2,0,0
10/06/2017 17:15,57,69.4,76,64.9,133,66.8,2,0,0
10/06/2017 17:20,59,69.6,78,65.1,137,67.1,2,0,0
10/06/2017 17:25,63,69.4,82,64.8,145,66.8,2,0,0
10/06/2017 17:30,55,69.1,74,64.5,129,66.4,2,0,0
10/06/2017 17:35,60,70.1,78,65.5,138,67.5,2,0,0
10/06/2017 17:40,55,70,72,65.4,127,67.4,2,0,0
10/06/2017 17:45,65,69.8,85,65.3,150,67.3,2,0,0
10/06/2017 17:50,63,70.1,81,65.5,144,67.5,2,0,0
10/06/2017 17:55,54,69.5,73,64.9,127,66.8,2,0,0
10/06/2017 18:00,55,70.1,74,65.6,129,67.5,2,0,0
10/06/2017 18:05,41,68.8,59,64.3,100,66.2,2,0,0
10/06/2017 18:10,54,68.3,73,63.7,127,65.6,2,0,0
10/06/2017 18:15,59,67.2,78,62.5,137,64.5,2,0,0
10/06/2017 18:20,44,68.5,63,63.9,107,65.8,2,0,0
10/06/2017 18:25,54,68.9,72,64.3,126,66.3,2,0,0
10/06/2017 18:30,43,69.7,61,65.2,104,67,2,0,0
10/06/2017 18:35,51,70.7,70,66.2,121,68.1,2,0,0
10/06/2017 18:40,45,70.1,63,65.5,108,67.4,2,0,0
10/06/2017 18:45,56,69.8,76,65.2,132,67.2,2,0,0
10/06/2017 18:50,53,70.2,71,65.8,124,67.6,2,0,0
10/06/2017 18:55,41,69.5,58,65,99,66.8,2,0,0
10/06/2017 19:00,44,69.3,61,64.6,105,66.6,2,0,0
10/06/2017 19:05,62,68.1,80,63.4,142,65.5,2,0,0
10/06/2017 19:10,44,69.3,60,64.8,104,66.7,2,0,0
10/06/2017 19:15,55,69.8,72,65.3,127,67.2,2,0,0
10/06/2017 19:20,48,68.6,64,64,112,65.9,2,0,0
10/06/2017 19:25,55,69.5,74,65,129,66.9,2,0,0
10/06/2017 19:30,47,69.6,66,65,113,66.9,2,0,0
10/06/2017 19:35,53,68.4,71,63.8,124,65.8,2,0,0
10/06/2017 19:40,45,68.7,62,64,107,66,2,0,0
10/06/2017 19:45,43,68.2,59,63.4,102,65.5,2,0,0
10/06/2017 19:50,42,68.8,59,64.2,101,66.1,2,0,0
10/06/2017 19:55,41,68.4,59,63.7,100,65.6,2,0,0
10/06/2017 20:00,50,68.3,68,63.5,118,65.5,2,0,0
10/06/2017 20:05,41,68.5,58,63.8,99,65.7,2,0,0
10/06/2017 20:10,37,69.4,55,64.7,92,66.6,2,0,0
10/06/2017 20:15,42,68.8,59,64.1,101,66,2,0,0
10/06/2017 20:20,49,68.8,68,64.2,117,66.2,2,0,0
10/06/2017 20:25,46,68.1,64,63.4,110,65.3,2,0,0
10/06/2017 20:30,43,68.7,59,64,102,66,2,0,0
10/06/2017 20:35,39,68.8,56,64.2,95,66.1,2,0,0
10/06/2017 20:40,44,68.6,61,63.9,105,65.9,2,0,0
10/06/2017 20:45,37,68.7,54,64.1,91,66,2,0,0
10/06/2017 20:50,18,69.1,34,64.5,52,66.1,2,0,0
10/06/2017 20:55,9,69.3,24,64.7,33,66,2,0,0
10/06/2017 21:00,45,68.7,62,64,107,66,2,0,0
10/06/2017 21:05,50,66.5,69,61.7,119,63.7,2,0,0
10/06/2017 21:10,32,68.1,49,63.4,81,65.3,2,0,0
10/06/2017 21:15,26,68.9,42,64.2,68,66,2,0,0
10/06/2017 21:20,35,68.4,52,63.7,87,65.6,2,0,0
10/06/2017 21:25,30,69,46,64.4,76,66.2,2,0,0
10/06/2017 21:30,35,68.8,51,64.1,86,66,2,0,0
10/06/2017 21:35,30,69.1,47,64.5,77,66.3,2,0,0
10/06/2017 21:40,35,68.4,51,63.8,86,65.7,2,0,0
10/06/2017 21:45,32,69.3,50,64.7,82,66.5,2,0,0
10/06/2017 21:50,31,69.1,47,64.5,78,66.3,2,0,0
10/06/2017 21:55,36,69.5,53,64.9,89,66.7,2,0,0
10/06/2017 22:00,32,69,48,64.3,80,66.2,2,0,0
10/06/2017 22:05,34,68.1,51,63.3,85,65.2,2,0,0
10/06/2017 22:10,34,68.6,50,63.8,84,65.8,2,0,0
10/06/2017 22:15,33,69.3,49,64.6,82,66.5,2,0,0
10/06/2017 22:20,33,69.6,50,64.9,83,66.8,2,0,0
10/06/2017 22:25,33,68.8,49,64.2,82,66,2,0,0
10/06/2017 22:30,35,69.3,51,64.7,86,66.6,2,0,0
10/06/2017 22:35,30,69.2,46,64.5,76,66.4,2,0,0
10/06/2017 22:40,27,68.8,43,64.2,70,65.9,2,0,0
10/06/2017 22:45,26,69.1,42,64.5,68,66.3,2,0,0
10/06/2017 22:50,24,68.9,40,64.3,64,66,2,0,0
10/06/2017 22:55,19,68.8,35,64.2,54,65.8,2,0,0
10/06/2017 23:00,26,69.1,43,64.5,69,66.2,2,0,0
10/06/2017 23:05,21,69.3,37,64.7,58,66.4,2,0,0
10/06/2017 23:10,19,69.3,35,64.7,54,66.3,2,0,0
10/06/2017 23:15,22,69.7,38,65.1,60,66.8,2,0,0
10/06/2017 23:20,24,69.8,40,65.2,64,66.9,2,0,0
10/06/2017 23:25,24,69.7,39,65.1,63,66.9,2,0,0
10/06/2017 23:30,24,69.7,40,65.1,64,66.8,2,0,0
10/06/2017 23:35,33,69.7,49,65.1,82,66.9,2,0,0
10/06/2017 23:40,31,69.8,48,65.2,79,67,2,0,0
10/06/2017 23:45,25,69.8,40,65.2,65,66.9,2,0,0
10/06/2017 23:50,23,69.6,39,65,62,66.7,2,0,0
10/06/2017 23:55,24,69.5,39,64.9,63,66.7,2,0,0
10/07/2017 0:00,16,69.3,32,64.7,48,66.3,2,0,0
10/07/2017 0:05,19,69.3,35,64.7,54,66.3,2,0,0
10/07/2017 0:10,20,69.3,35,64.7,55,66.4,2,0,0
10/07/2017 0:15,19,69.1,35,64.5,54,66.1,2,0,0
10/07/2017 0:20,17,69.3,32,64.7,49,66.3,2,0,0
10/07/2017 0:25,17,69.3,32,64.7,49,66.3,2,0,0
10/07/2017 0:30,15,69.3,30,64.7,45,66.3,2,0,0
10/07/2017 0:35,15,69.3,30,64.7,45,66.2,2,0,0
10/07/2017 0:40,15,69.2,30,64.5,45,66.1,2,0,0
10/07/2017 0:45,13,69.1,28,64.5,41,66,2,0,0
10/07/2017 0:50,15,69.1,30,64.5,45,66,2,0,0
10/07/2017 0:55,15,69.1,31,64.4,46,65.9,2,0,0
10/07/2017 1:00,15,69.2,30,64.6,45,66.2,2,0,0
10/07/2017 1:05,10,69.2,25,64.6,35,65.9,2,0,0
10/07/2017 1:10,9,69.2,24,64.6,33,65.9,2,0,0
10/07/2017 1:15,8,69.1,24,64.5,32,65.6,2,0,0
10/07/2017 1:20,10,69.2,25,64.5,35,65.9,2,0,0
10/07/2017 1:25,9,69.2,25,64.6,34,65.8,2,0,0
10/07/2017 1:30,10,69,25,64.4,35,65.7,2,0,0
10/07/2017 1:35,8,69.1,24,64.5,32,65.6,2,0,0
10/07/2017 1:40,11,69.1,27,64.5,38,65.8,2,0,0
10/07/2017 1:45,12,68.9,21,64.3,33,66,2,0,0
10/07/2017 1:50,10,69.1,25,64.5,35,65.8,2,0,0
10/07/2017 1:55,10,69.2,26,64.6,36,65.9,2,0,0
10/07/2017 2:00,11,69.3,26,64.7,37,66,2,0,0
10/07/2017 2:05,9,69.3,24,64.7,33,66,2,0,0
10/07/2017 2:10,8,69.3,23,64.7,31,65.9,2,0,0
10/07/2017 2:15,11,69.3,26,64.7,37,66,2,0,0
10/07/2017 2:20,9,69.4,24,64.8,33,66,2,0,0
10/07/2017 2:25,9,69.2,24,64.6,33,65.9,2,0,0
10/07/2017 2:30,12,69.2,21,64.5,33,66.2,2,0,0
10/07/2017 2:35,7,69.2,22,64.6,29,65.7,2,0,0
10/07/2017 2:40,8,69.3,23,64.7,31,65.8,2,0,0
10/07/2017 2:45,10,69.3,26,64.7,36,66,2,0,0
10/07/2017 2:50,9,69.2,24,64.5,33,65.8,2,0,0
10/07/2017 2:55,7,69.1,22,64.4,29,65.5,2,0,0
10/07/2017 3:00,7,69.2,22,64.6,29,65.7,2,0,0
10/07/2017 3:05,6,69.3,21,64.7,27,65.7,2,0,0
10/07/2017 3:10,9,69.3,25,64.7,34,65.9,2,0,0
10/07/2017 3:15,7,69.3,22,64.7,29,65.8,2,0,0
10/07/2017 3:20,7,69.3,22,64.7,29,65.8,2,0,0
10/07/2017 3:25,7,69.2,22,64.6,29,65.7,2,0,0
10/07/2017 3:30,8,69.3,23,64.7,31,65.9,2,0,0
10/07/2017 3:35,6,69.3,21,64.7,27,65.7,2,0,0
10/07/2017 3:40,8,69.3,23,64.7,31,65.9,2,0,0
10/07/2017 3:45,11,69.2,27,64.6,38,66,2,0,0
10/07/2017 3:50,9,69.2,25,64.5,34,65.8,2,0,0
10/07/2017 3:55,11,69.2,27,64.6,38,66,2,0,0
10/07/2017 4:00,8,68.8,24,64.2,32,65.4,2,0,0
10/07/2017 4:05,9,69.1,24,64.5,33,65.8,2,0,0
10/07/2017 4:10,10,69,25,64.4,35,65.7,2,0,0
10/07/2017 4:15,11,69.1,27,64.4,38,65.8,2,0,0
10/07/2017 4:20,14,69.3,30,64.7,44,66.1,2,0,0
10/07/2017 4:25,14,69.3,29,64.7,43,66.2,2,0,0
10/07/2017 4:30,14,69.3,30,64.7,44,66.2,2,0,0
10/07/2017 4:35,12,69,27,64.4,39,65.8,2,0,0
10/07/2017 4:40,17,69.2,32,64.6,49,66.2,2,0,0
10/07/2017 4:45,16,69.3,32,64.7,48,66.2,2,0,0
10/07/2017 4:50,11,69.2,27,64.6,38,65.9,2,0,0
10/07/2017 4:55,14,69.1,29,64.5,43,66,2,0,0
10/07/2017 5:00,14,69.3,30,64.7,44,66.1,2,0,0
10/07/2017 5:05,15,69.2,31,64.6,46,66.1,2,0,0
10/07/2017 5:10,17,68.9,33,64.3,50,65.9,2,0,0
10/07/2017 5:15,22,68.9,38,64.3,60,66,2,0,0
10/07/2017 5:20,22,69.2,37,64.5,59,66.3,2,0,0
10/07/2017 5:25,23,69.1,40,64.4,63,66.1,2,0,0
10/07/2017 5:30,16,69,31,64.4,47,66,2,0,0
10/07/2017 5:35,18,69,34,64.4,52,66,2,0,0
10/07/2017 5:40,21,69.3,36,64.7,57,66.4,2,0,0
10/07/2017 5:45,20,69.1,36,64.4,56,66.1,2,0,0
10/07/2017 5:50,24,68.6,41,63.9,65,65.7,2,0,0
10/07/2017 5:55,19,68.8,35,64.2,54,65.8,2,0,0
10/07/2017 6:00,18,69.2,33,64.5,51,66.2,2,0,0
10/07/2017 6:05,23,69.1,40,64.4,63,66.1,2,0,0
10/07/2017 6:10,24,68.5,41,63.8,65,65.6,2,0,0
10/07/2017 6:15,25,68.9,41,64.2,66,66,2,0,0
10/07/2017 6:20,24,68.9,40,64.2,64,66,2,0,0
10/07/2017 6:25,21,69.1,37,64.4,58,66.1,2,0,0
10/07/2017 6:30,20,68.9,36,64.3,56,65.9,2,0,0
10/07/2017 6:35,30,67.7,46,62.9,76,64.8,2,0,0
10/07/2017 6:40,29,68,45,63.2,74,65.1,2,0,0
10/07/2017 6:45,37,67.7,54,62.9,91,64.8,2,0,0
10/07/2017 6:50,33,67.5,49,62.7,82,64.6,2,0,0
10/07/2017 6:55,27,67.1,43,62.3,70,64.1,2,0,0
10/07/2017 7:00,27,68.2,43,63.5,70,65.3,2,0,0
10/07/2017 7:05,32,68.5,49,63.8,81,65.6,2,0,0
10/07/2017 7:10,27,69,43,64.4,70,66.2,2,0,0
10/07/2017 7:15,37,68,54,63.3,91,65.2,2,0,0
10/07/2017 7:20,32,68.6,48,63.9,80,65.8,2,0,0
10/07/2017 7:25,38,69.7,55,65.2,93,67,2,0,0
10/07/2017 7:30,32,69.8,49,65.2,81,67,2,0,0
10/07/2017 7:35,36,69.4,54,64.7,90,66.6,2,0,0
10/07/2017 7:40,50,68.9,68,64.2,118,66.2,2,0,0
10/07/2017 7:45,48,67.8,66,62.9,114,65,2,0,0
10/07/2017 7:50,49,69.4,67,64.8,116,66.7,2,0,0
10/07/2017 7:55,47,69.5,63,64.9,110,66.8,2,0,0
10/07/2017 8:00,40,68.9,57,64.3,97,66.2,2,0,0
10/07/2017 8:05,41,68.3,58,63.6,99,65.5,2,0,0
10/07/2017 8:10,33,69.2,50,64.6,83,66.4,2,0,0
10/07/2017 8:15,43,68.3,61,63.6,104,65.5,2,0,0
10/07/2017 8:20,41,69.1,58,64.5,99,66.4,2,0,0
10/07/2017 8:25,44,68.8,61,64.1,105,66.1,2,0,0
10/07/2017 8:30,46,67.9,64,63.2,110,65.2,2,0,0
10/07/2017 8:35,53,69,71,64.4,124,66.4,2,0,0
10/07/2017 8:40,62,69.3,81,64.8,143,66.7,2,0,0
10/07/2017 8:45,55,70.1,72,65.6,127,67.6,2,0,0
10/07/2017 8:50,59,69.8,76,65.2,135,67.2,2,0,0
10/07/2017 8:55,49,68.6,67,63.9,116,65.9,2,0,0
10/07/2017 9:00,51,67.8,70,63,121,65,2,0,0
10/07/2017 9:05,51,68,69,63.3,120,65.3,2,0,0
10/07/2017 9:10,50,68.5,67,63.9,117,65.8,2,0,0
10/07/2017 9:15,57,69.6,75,65,132,67,2,0,0
10/07/2017 9:20,58,69.6,76,65,134,67,2,0,0
10/07/2017 9:25,54,70.6,72,66.1,126,68,2,0,0
10/07/2017 9:30,57,70.5,75,66.1,132,68,2,0,0
10/07/2017 9:35,59,70.9,78,66.4,137,68.3,2,0,0
10/07/2017 9:40,55,69.9,74,65.4,129,67.3,2,0,0
10/07/2017 9:45,53,68.8,70,64.1,123,66.1,2,0,0
10/07/2017 9:50,63,68.6,82,63.9,145,66,2,0,0
10/07/2017 9:55,65,68.1,85,63.3,150,65.4,2,0,0
10/07/2017 10:00,60,68,79,63.2,139,65.3,2,0,0
10/07/2017 10:05,63,68.2,82,63.4,145,65.5,2,0,0
10/07/2017 10:10,61,68,80,63.3,141,65.3,2,0,0
10/07/2017 10:15,58,68.1,77,63.4,135,65.4,2,0,0
10/07/2017 10:20,63,67.4,82,62.7,145,64.7,2,0,0
10/07/2017 10:25,60,67.7,79,63,139,65,2,0,0
10/07/2017 10:30,62,67.1,81,62.4,143,64.4,2,0,0
10/07/2017 10:35,71,67.2,90,62.4,161,64.5,2,0,0
10/07/2017 10:40,64,67.7,84,62.9,148,65,2,0,0
10/07/2017 10:45,62,67.5,82,62.8,144,64.8,2,0,0
10/07/2017 10:50,58,67.9,77,63.1,135,65.2,2,0,0
10/07/2017 10:55,67,67.4,86,62.6,153,64.7,2,0,0
10/07/2017 11:00,59,66.7,77,61.9,136,64,2,0,0
10/07/2017 11:05,64,66.1,83,61.3,147,63.4,2,0,0
10/07/2017 11:10,59,66.8,77,62,136,64.1,2,0,0
10/07/2017 11:15,67,67.7,87,63,154,65,2,0,0
10/07/2017 11:20,58,68.4,76,63.8,134,65.7,2,0,0
10/07/2017 11:25,68,68.9,86,64.3,154,66.3,2,0,0
10/07/2017 11:30,59,68.1,78,63.4,137,65.4,2,0,0
10/07/2017 11:35,70,67.5,90,62.7,160,64.8,2,0,0
10/07/2017 11:40,63,67.7,82,62.9,145,65,2,0,0
10/07/2017 11:45,72,67.4,90,62.7,162,64.8,2,0,0
10/07/2017 11:50,73,67.3,93,62.6,166,64.7,2,0,0
10/07/2017 11:55,70,67.9,89,63.2,159,65.2,2,0,0
10/07/2017 12:00,58,67.9,76,63.2,134,65.3,2,0,0
10/07/2017 12:05,60,68,78,63.3,138,65.3,2,0,0
10/07/2017 12:10,60,68.2,79,63.5,139,65.5,2,0,0
10/07/2017 12:15,59,68.1,77,63.4,136,65.4,2,0,0
10/07/2017 12:20,64,68.9,82,64.3,146,66.3,2,0,0
10/07/2017 12:25,55,68.7,73,64.1,128,66.1,2,0,0
10/07/2017 12:30,61,68.2,80,63.6,141,65.6,2,0,0
10/07/2017 12:35,62,67.9,81,63.2,143,65.3,2,0,0
10/07/2017 12:40,56,67.7,74,63,130,65,2,0,0
10/07/2017 12:45,59,68.1,77,63.4,136,65.4,2,0,0
10/07/2017 12:50,50,68.3,68,63.6,118,65.6,2,0,0
10/07/2017 12:55,56,69.2,73,64.7,129,66.7,2,0,0
10/07/2017 13:00,54,68.6,72,64,126,65.9,2,0,0
10/07/2017 13:05,56,68.7,74,64.1,130,66.1,2,0,0
10/07/2017 13:10,53,68.8,71,64.2,124,66.1,2,0,0
10/07/2017 13:15,70,68,89,63.3,159,65.4,2,0,0
10/07/2017 13:20,57,67.9,76,63.3,133,65.3,2,0,0
10/07/2017 13:25,73,67.7,92,62.9,165,65,2,0,0
10/07/2017 13:30,57,68,76,63.3,133,65.3,2,0,0
10/07/2017 13:35,55,67.6,74,62.8,129,64.9,2,0,0
10/07/2017 13:40,73,67.7,93,62.9,166,65,2,0,0
10/07/2017 13:45,64,67.3,83,62.5,147,64.6,2,0,0
10/07/2017 13:50,56,68.1,75,63.4,131,65.5,2,0,0
10/07/2017 13:55,67,67.4,87,62.6,154,64.7,2,0,0
10/07/2017 14:00,58,67.7,76,63,134,65.1,2,0,0
10/07/2017 14:05,57,67.9,74,63.1,131,65.2,2,0,0
10/07/2017 14:10,68,68.3,86,63.7,154,65.7,2,0,0
10/07/2017 14:15,60,68,78,63.3,138,65.3,2,0,0
10/07/2017 14:20,67,68.5,86,63.9,153,65.9,2,0,0
10/07/2017 14:25,59,68.1,77,63.4,136,65.4,2,0,0
10/07/2017 14:30,72,66.8,93,61.9,165,64,2,0,0
10/07/2017 14:35,68,67.1,87,62.3,155,64.4,2,0,0
10/07/2017 14:40,60,67,80,62.2,140,64.3,2,0,0
10/07/2017 14:45,58,68.1,76,63.4,134,65.4,2,0,0
10/07/2017 14:50,70,68.1,90,63.4,160,65.4,2,0,0
10/07/2017 14:55,59,68.5,77,63.8,136,65.9,2,0,0
10/07/2017 15:00,52,68.7,70,64.1,122,66.1,2,0,0
10/07/2017 15:05,55,68.5,73,63.8,128,65.8,2,0,0
10/07/2017 15:10,65,67.7,84,62.9,149,65,2,0,0
10/07/2017 15:15,53,68.1,71,63.4,124,65.4,2,0,0
10/07/2017 15:20,63,67.9,82,63.2,145,65.3,2,0,0
10/07/2017 15:25,65,67.4,83,62.7,148,64.8,2,0,0
10/07/2017 15:30,63,67.8,82,63,145,65.1,2,0,0
10/07/2017 15:35,60,67.9,79,63.1,139,65.2,2,0,0
10/07/2017 15:40,66,67.8,84,63,150,65.1,2,0,0
10/07/2017 15:45,69,68.6,89,63.9,158,65.9,2,0,0
10/07/2017 15:50,71,68.8,90,64.2,161,66.3,2,0,0
10/07/2017 15:55,63,68.8,82,64.3,145,66.3,2,0,0
10/07/2017 16:00,57,68.6,75,64,132,66,2,0,0
10/07/2017 16:05,60,69.3,77,64.8,137,66.8,2,0,0
10/07/2017 16:10,53,68.6,71,64,124,66,2,0,0
10/07/2017 16:15,64,68.3,83,63.7,147,65.7,2,0,0
10/07/2017 16:20,59,68.2,76,63.5,135,65.5,2,0,0
10/07/2017 16:25,48,68.7,66,64,114,66,2,0,0
10/07/2017 16:30,59,67.3,78,62.6,137,64.6,2,0,0
10/07/2017 16:35,61,67.5,80,62.8,141,64.8,2,0,0
10/07/2017 16:40,46,67,64,62.2,110,64.2,2,0,0
10/07/2017 16:45,55,67.7,73,63,128,65,2,0,0
10/07/2017 16:50,53,67.8,70,63,123,65.1,2,0,0
10/07/2017 16:55,47,67.6,64,62.8,111,64.8,2,0,0
10/07/2017 17:00,49,67.8,67,63.1,116,65.1,2,0,0
10/07/2017 17:05,44,68.4,62,63.7,106,65.7,2,0,0
10/07/2017 17:10,61,68.2,80,63.6,141,65.6,2,0,0
10/07/2017 17:15,52,68.8,71,64.2,123,66.2,2,0,0
10/07/2017 17:20,51,67.6,69,62.9,120,64.9,2,0,0
10/07/2017 17:25,51,68,69,63.3,120,65.3,2,0,0
10/07/2017 17:30,48,68.1,65,63.4,113,65.4,2,0,0
10/07/2017 17:35,53,67.9,71,63.1,124,65.2,2,0,0
10/07/2017 17:40,62,67.3,81,62.5,143,64.6,2,0,0
10/07/2017 17:45,57,66.8,76,62,133,64,2,0,0
10/07/2017 17:50,63,67.5,81,62.7,144,64.8,2,0,0
10/07/2017 17:55,52,67.2,71,62.4,123,64.4,2,0,0
10/07/2017 18:00,53,68.8,70,64.2,123,66.2,2,0,0
10/07/2017 18:05,66,68.6,84,64,150,66,2,0,0
10/07/2017 18:10,56,68.8,75,64.2,131,66.2,2,0,0
10/07/2017 18:15,56,68.5,73,63.7,129,65.8,2,0,0
10/07/2017 18:20,61,68,80,63.3,141,65.3,2,0,0
10/07/2017 18:25,52,68,71,63.2,123,65.2,2,0,0
10/07/2017 18:30,58,68.8,77,64.2,135,66.2,2,0,0
10/07/2017 18:35,59,67.9,78,63.1,137,65.2,2,0,0
10/07/2017 18:40,61,68.9,80,64.3,141,66.3,2,0,0
10/07/2017 18:45,53,69.6,71,65,124,66.9,2,0,0
10/07/2017 18:50,54,69.3,72,64.7,126,66.7,2,0,0
10/07/2017 18:55,57,69.1,75,64.5,132,66.5,2,0,0
10/07/2017 19:00,47,68,66,63.3,113,65.3,2,0,0
10/07/2017 19:05,57,68.3,75,63.6,132,65.6,2,0,0
10/07/2017 19:10,45,69,63,64.4,108,66.3,2,0,0
10/07/2017 19:15,57,68.2,76,63.5,133,65.5,2,0,0
10/07/2017 19:20,51,67.6,69,62.8,120,64.8,2,0,0
10/07/2017 19:25,43,68.1,59,63.4,102,65.4,2,0,0
10/07/2017 19:30,55,67.6,74,62.8,129,64.8,2,0,0
10/07/2017 19:35,47,68.1,64,63.4,111,65.4,2,0,0
10/07/2017 19:40,43,68.3,61,63.5,104,65.5,2,0,0
10/07/2017 19:45,37,68.7,53,64,90,65.9,2,0,0
10/07/2017 19:50,37,69,54,64.3,91,66.2,2,0,0
10/07/2017 19:55,40,68.6,57,63.9,97,65.9,2,0,0
10/07/2017 20:00,42,69,59,64.4,101,66.3,2,0,0
10/07/2017 20:05,42,68.9,60,64.3,102,66.2,2,0,0
10/07/2017 20:10,40,69,56,64.4,96,66.3,2,0,0
10/07/2017 20:15,42,68.2,59,63.5,101,65.5,2,0,0
10/07/2017 20:20,41,68.5,57,63.9,98,65.8,2,0,0
10/07/2017 20:25,39,68.6,55,63.9,94,65.8,2,0,0
10/07/2017 20:30,38,69,54,64.4,92,66.3,2,0,0
10/07/2017 20:35,40,69.6,58,65,98,66.9,2,0,0
10/07/2017 20:40,40,69,57,64.4,97,66.3,2,0,0
10/07/2017 20:45,41,68.5,58,63.8,99,65.7,2,0,0
10/07/2017 20:50,41,68.4,57,63.7,98,65.6,2,0,0
10/07/2017 20:55,43,68.8,60,64.2,103,66.1,2,0,0
10/07/2017 21:00,30,69.2,46,64.5,76,66.4,2,0,0
10/07/2017 21:05,35,68.8,51,64.2,86,66.1,2,0,0
10/07/2017 21:10,32,68.6,47,63.9,79,65.8,2,0,0
10/07/2017 21:15,34,68.9,50,64.2,84,66.1,2,0,0
10/07/2017 21:20,37,69.4,53,64.7,90,66.6,2,0,0
10/07/2017 21:25,34,68.5,51,63.9,85,65.7,2,0,0
10/07/2017 21:30,38,69.3,55,64.7,93,66.6,2,0,0
10/07/2017 21:35,29,69.4,45,64.8,74,66.6,2,0,0
10/07/2017 21:40,28,69.6,43,65,71,66.8,2,0,0
10/07/2017 21:45,41,69.9,58,65.3,99,67.2,2,0,0
10/07/2017 21:50,39,69.8,56,65.3,95,67.1,2,0,0
10/07/2017 21:55,33,69.3,49,64.7,82,66.6,2,0,0
10/07/2017 22:00,38,69.4,54,64.8,92,66.7,2,0,0
10/07/2017 22:05,30,69.1,46,64.5,76,66.3,2,0,0
10/07/2017 22:10,35,69.1,50,64.5,85,66.4,2,0,0
10/07/2017 22:15,31,68.9,47,64.2,78,66.1,2,0,0
10/07/2017 22:20,30,69.3,46,64.7,76,66.6,2,0,0
10/07/2017 22:25,30,69.2,46,64.6,76,66.4,2,0,0
10/07/2017 22:30,29,69.2,45,64.6,74,66.4,2,0,0
10/07/2017 22:35,27,69.2,42,64.5,69,66.4,2,0,0
10/07/2017 22:40,30,68.8,46,64.2,76,66,2,0,0
10/07/2017 22:45,30,69.2,45,64.6,75,66.4,2,0,0
10/07/2017 22:50,28,69.1,44,64.5,72,66.3,2,0,0
10/07/2017 22:55,29,69.3,44,64.7,73,66.5,2,0,0
10/07/2017 23:00,30,68.9,46,64.3,76,66.1,2,0,0
10/07/2017 23:05,34,69.1,49,64.4,83,66.3,2,0,0
10/07/2017 23:10,27,69.3,43,64.7,70,66.4,2,0,0
10/07/2017 23:15,26,69.4,42,64.8,68,66.5,2,0,0
10/07/2017 23:20,26,69.4,42,64.8,68,66.6,2,0,0
10/07/2017 23:25,29,69.8,45,65.3,74,67.1,2,0,0
10/07/2017 23:30,28,69.7,44,65.2,72,66.9,2,0,0
10/07/2017 23:35,31,69.6,47,65,78,66.9,2,0,0
10/07/2017 23:40,24,69.7,39,65.2,63,66.9,2,0,0
10/07/2017 23:45,21,69.5,36,64.9,57,66.6,2,0,0
10/07/2017 23:50,19,69.5,35,64.9,54,66.5,2,0,0
10/07/2017 23:55,21,69.3,36,64.7,57,66.4,2,0,0
10/08/2017 0:00,18,69.3,34,64.7,52,66.3,2,0,0
10/08/2017 0:05,18,69.3,33,64.6,51,66.3,2,0,0
10/08/2017 0:10,16,69.1,31,64.5,47,66.1,2,0,0
10/08/2017 0:15,17,69.5,32,64.9,49,66.5,2,0,0
10/08/2017 0:20,20,69.5,36,64.9,56,66.6,2,0,0
10/08/2017 0:25,14,69.6,29,65,43,66.5,2,0,0
10/08/2017 0:30,16,69.2,31,64.5,47,66.1,2,0,0
10/08/2017 0:35,15,69.3,30,64.7,45,66.2,2,0,0
10/08/2017 0:40,13,69.3,28,64.7,41,66.2,2,0,0
10/08/2017 0:45,15,69.5,30,64.9,45,66.4,2,0,0
10/08/2017 0:50,14,68.7,29,64,43,65.6,2,0,0
10/08/2017 0:55,14,69.1,29,64.5,43,66,2,0,0
10/08/2017 1:00,14,69.2,29,64.6,43,66.1,2,0,0
10/08/2017 1:05,12,69.3,27,64.7,39,66.1,2,0,0
10/08/2017 1:10,12,69.5,26,64.9,38,66.3,2,0,0
10/08/2017 1:15,15,69.3,30,64.7,45,66.2,2,0,0
10/08/2017 1:20,10,69.3,25,64.7,35,66,2,0,0
10/08/2017 1:25,9,69.3,24,64.7,33,65.9,2,0,0
10/08/2017 1:30,10,69.2,26,64.5,36,65.8,2,0,0
10/08/2017 1:35,11,69.2,26,64.6,37,66,2,0,0
10/08/2017 1:40,10,69.2,25,64.6,35,65.9,2,0,0
10/08/2017 1:45,22,69.3,26,64.7,48,66.8,2,0,0
10/08/2017 1:50,7,69.3,23,64.7,30,65.8,2,0,0
10/08/2017 1:55,8,69.2,23,64.6,31,65.8,2,0,0
10/08/2017 2:00,6,69.3,21,64.7,27,65.7,2,0,0
10/08/2017 2:05,7,69.3,22,64.7,29,65.8,2,0,0
10/08/2017 2:10,8,69.4,24,64.8,32,65.9,2,0,0
10/08/2017 2:15,10,69.3,25,64.7,35,66.1,2,0,0
10/08/2017 2:20,10,69.3,25,64.7,35,66,2,0,0
10/08/2017 2:25,7,69.2,22,64.6,29,65.7,2,0,0
10/08/2017 2:30,11,69.2,27,64.5,38,65.9,2,0,0
10/08/2017 2:35,11,69.2,26,64.6,37,66,2,0,0
10/08/2017 2:40,10,69.3,25,64.7,35,66,2,0,0
10/08/2017 2:45,7,69.3,22,64.7,29,65.8,2,0,0
10/08/2017 2:50,6,69.4,21,64.8,27,65.8,2,0,0
10/08/2017 2:55,9,69.4,24,64.8,33,66,2,0,0
10/08/2017 3:00,10,69.4,25,64.8,35,66.1,2,0,0
10/08/2017 3:05,7,69.5,22,64.9,29,66,2,0,0
10/08/2017 3:10,10,69.4,25,64.8,35,66.1,2,0,0
10/08/2017 3:15,8,69.4,24,64.8,32,66,2,0,0
10/08/2017 3:20,8,69.4,23,64.8,31,66,2,0,0
10/08/2017 3:25,8,69,24,64.4,32,65.5,2,0,0
10/08/2017 3:30,8,69.2,23,64.6,31,65.8,2,0,0
10/08/2017 3:35,6,69.3,22,64.7,28,65.7,2,0,0
10/08/2017 3:40,13,69.2,21,64.5,34,66.3,2,0,0
10/08/2017 3:45,7,69.2,22,64.6,29,65.7,2,0,0
10/08/2017 3:50,12,69.3,21,64.7,33,66.4,2,0,0
10/08/2017 3:55,7,69.2,22,64.6,29,65.7,2,0,0
10/08/2017 4:00,7,69.2,22,64.5,29,65.7,2,0,0
10/08/2017 4:05,7,69.2,22,64.5,29,65.7,2,0,0
10/08/2017 4:10,9,69.3,24,64.7,33,65.9,2,0,0
10/08/2017 4:15,6,69.4,21,64.8,27,65.8,2,0,0
10/08/2017 4:20,9,69.3,25,64.7,34,65.9,2,0,0
10/08/2017 4:25,8,69.3,23,64.7,31,65.9,2,0,0
10/08/2017 4:30,14,69.3,30,64.7,44,66.2,2,0,0
10/08/2017 4:35,13,69.4,28,64.7,41,66.2,2,0,0
10/08/2017 4:40,11,69.3,26,64.7,37,66.1,2,0,0
10/08/2017 4:45,14,69.3,30,64.7,44,66.2,2,0,0
10/08/2017 4:50,13,69.3,28,64.7,41,66.1,2,0,0
10/08/2017 4:55,10,69.3,26,64.7,36,66,2,0,0
10/08/2017 5:00,13,69.2,28,64.6,41,66,2,0,0
10/08/2017 5:05,19,69.4,35,64.8,54,66.4,2,0,0
10/08/2017 5:10,15,69,30,64.4,45,65.9,2,0,0
10/08/2017 5:15,12,69.2,28,64.6,40,66,2,0,0
10/08/2017 5:20,16,69.2,31,64.6,47,66.2,2,0,0
10/08/2017 5:25,16,69.4,32,64.8,48,66.3,2,0,0
10/08/2017 5:30,16,69.4,32,64.8,48,66.3,2,0,0
10/08/2017 5:35,17,69.4,33,64.8,50,66.4,2,0,0
10/08/2017 5:40,15,69.3,31,64.7,46,66.2,2,0,0
10/08/2017 5:45,15,69.2,30,64.6,45,66.1,2,0,0
10/08/2017 5:50,17,69.4,33,64.8,50,66.3,2,0,0
10/08/2017 5:55,20,69.4,36,64.8,56,66.5,2,0,0
10/08/2017 6:00,16,69.4,32,64.8,48,66.3,2,0,0
10/08/2017 6:05,19,69.1,35,64.5,54,66.1,2,0,0
10/08/2017 6:10,15,69.2,31,64.5,46,66,2,0,0
10/08/2017 6:15,19,69,34,64.4,53,66,2,0,0
10/08/2017 6:20,16,69.2,32,64.6,48,66.1,2,0,0
10/08/2017 6:25,17,69.3,33,64.7,50,66.3,2,0,0
10/08/2017 6:30,15,69.3,31,64.7,46,66.2,2,0,0
10/08/2017 6:35,21,69.6,37,65,58,66.6,2,0,0
10/08/2017 6:40,21,69.6,37,65,58,66.7,2,0,0
10/08/2017 6:45,18,69.5,34,64.9,52,66.5,2,0,0
10/08/2017 6:50,19,69.2,35,64.5,54,66.2,2,0,0
10/08/2017 6:55,15,69.3,30,64.7,45,66.2,2,0,0
10/08/2017 7:00,15,69.4,30,64.8,45,66.3,2,0,0
10/08/2017 7:05,18,69.3,33,64.7,51,66.4,2,0,0
10/08/2017 7:10,14,69.3,30,64.7,44,66.1,2,0,0
10/08/2017 7:15,18,69.3,33,64.7,51,66.3,2,0,0
10/08/2017 7:20,11,69.4,27,64.8,38,66.1,2,0,0
10/08/2017 7:25,17,69.4,33,64.8,50,66.4,2,0,0
10/08/2017 7:30,20,69.6,35,65,55,66.7,2,0,0
10/08/2017 7:35,24,69.4,40,64.8,64,66.5,2,0,0
10/08/2017 7:40,19,69.4,35,64.8,54,66.4,2,0,0
10/08/2017 7:45,16,69.3,32,64.7,48,66.2,2,0,0
10/08/2017 7:50,21,69.3,36,64.7,57,66.4,2,0,0
10/08/2017 7:55,31,69,47,64.3,78,66.2,2,0,0
10/08/2017 8:00,24,69.3,39,64.6,63,66.4,2,0,0
10/08/2017 8:05,19,69.1,35,64.5,54,66.1,2,0,0
10/08/2017 8:10,25,69.2,42,64.5,67,66.3,2,0,0
10/08/2017 8:15,27,69.2,43,64.6,70,66.4,2,0,0
10/08/2017 8:20,32,68.5,48,63.8,80,65.7,2,0,0
10/08/2017 8:25,36,68.7,52,64,88,65.9,2,0,0
10/08/2017 8:30,33,69.3,50,64.7,83,66.5,2,0,0
10/08/2017 8:35,39,69,55,64.4,94,66.3,2,0,0
10/08/2017 8:40,35,68.8,51,64.2,86,66.1,2,0,0
10/08/2017 8:45,45,68.5,62,63.8,107,65.8,2,0,0
10/08/2017 8:50,39,69.5,55,64.9,94,66.8,2,0,0
10/08/2017 8:55,38,69,54,64.3,92,66.2,2,0,0
10/08/2017 9:00,38,68.9,55,64.2,93,66.1,2,0,0
10/08/2017 9:05,46,68.9,64,64.3,110,66.2,2,0,0
10/08/2017 9:10,45,69.5,62,64.9,107,66.8,2,0,0
10/08/2017 9:15,46,69.6,64,65,110,66.9,2,0,0
10/08/2017 9:20,39,69.8,56,65.3,95,67.1,2,0,0
10/08/2017 9:25,45,69.1,63,64.4,108,66.4,2,0,0
10/08/2017 9:30,55,69.6,74,65,129,67,2,0,0
10/08/2017 9:35,56,69.9,75,65.4,131,67.3,2,0,0
10/08/2017 9:40,58,69.7,78,65.1,136,67.1,2,0,0
10/08/2017 9:45,49,69.7,67,65.1,116,67.1,2,0,0
10/08/2017 9:50,61,68.8,81,64.1,142,66.1,2,0,0
10/08/2017 9:55,52,69.2,70,64.6,122,66.5,2,0,0
10/08/2017 10:00,67,68.9,86,64.2,153,66.2,2,0,0
10/08/2017 10:05,63,69.1,82,64.4,145,66.4,2,0,0
10/08/2017 10:10,54,68.7,72,64,126,66,2,0,0
10/08/2017 10:15,65,68.2,85,63.4,150,65.5,2,0,0
10/08/2017 10:20,54,68.9,73,64.2,127,66.2,2,0,0
10/08/2017 10:25,56,68.7,74,64,130,66,2,0,0
10/08/2017 10:30,60,68.8,79,64.1,139,66.1,2,0,0
10/08/2017 10:35,65,69.3,82,64.7,147,66.7,2,0,0
10/08/2017 10:40,62,68,81,63.3,143,65.3,2,0,0
10/08/2017 10:45,70,67.9,90,63.1,160,65.2,2,0,0
10/08/2017 10:50,67,68.2,86,63.5,153,65.6,2,0,0
10/08/2017 10:55,73,68.1,92,63.4,165,65.5,2,0,0
10/08/2017 11:00,64,67.9,83,63.2,147,65.2,2,0,0
10/08/2017 11:05,57,67.9,75,63.1,132,65.2,2,0,0
10/08/2017 11:10,60,68,80,63.3,140,65.3,2,0,0
10/08/2017 11:15,70,67.8,91,63.1,161,65.1,2,0,0
10/08/2017 11:20,70,67.5,91,62.7,161,64.8,2,0,0
10/08/2017 11:25,63,67.3,82,62.5,145,64.6,2,0,0
10/08/2017 11:30,67,67.6,86,62.8,153,64.9,2,0,0
10/08/2017 11:35,66,67.7,87,62.9,153,65,2,0,0
10/08/2017 11:40,70,68.1,90,63.4,160,65.5,2,0,0
10/08/2017 11:45,69,68.5,89,63.7,158,65.8,2,0,0
10/08/2017 11:50,61,68.7,79,64,140,66,2,0,0
10/08/2017 11:55,79,68.6,100,63.9,179,66,2,0,0
10/08/2017 12:00,68,67.7,89,62.9,157,65,2,0,0
10/08/2017 12:05,66,68.3,84,63.6,150,65.6,2,0,0
10/08/2017 12:10,69,68.3,88,63.6,157,65.6,2,0,0
10/08/2017 12:15,65,68.4,84,63.8,149,65.8,2,0,0
10/08/2017 12:20,65,69.1,84,64.5,149,66.5,2,0,0
10/08/2017 12:25,66,69.3,84,64.7,150,66.7,2,0,0
10/08/2017 12:30,58,68.9,76,64.3,134,66.3,2,0,0
10/08/2017 12:35,54,69.1,72,64.5,126,66.4,2,0,0
10/08/2017 12:40,60,69,78,64.4,138,66.4,2,0,0
10/08/2017 12:45,61,68.9,79,64.3,140,66.3,2,0,0
10/08/2017 12:50,71,68.5,90,63.9,161,65.9,2,0,0
10/08/2017 12:55,65,68,85,63.2,150,65.3,2,0,0
10/08/2017 13:00,56,68.7,74,64.1,130,66.1,2,0,0
10/08/2017 13:05,58,68.9,77,64.3,135,66.3,2,0,0
10/08/2017 13:10,55,68.3,73,63.7,128,65.7,2,0,0
10/08/2017 13:15,67,67.5,87,62.8,154,64.8,2,0,0
10/08/2017 13:20,40,67.7,57,63,97,65,2,0,0
10/08/2017 13:25,46,68.3,63,63.6,109,65.6,2,0,0
10/08/2017 13:30,63,68,82,63.2,145,65.3,2,0,0
10/08/2017 13:35,69,68,89,63.3,158,65.3,2,0,0
10/08/2017 13:40,61,67.9,79,63.2,140,65.2,2,0,0
10/08/2017 13:45,56,67.9,74,63.1,130,65.2,2,0,0
10/08/2017 13:50,55,67.8,74,63,129,65.1,2,0,0
10/08/2017 13:55,58,68.2,76,63.5,134,65.5,2,0,0
10/08/2017 14:00,62,68.4,82,63.7,144,65.7,2,0,0
10/08/2017 14:05,56,68.4,75,63.8,131,65.8,2,0,0
10/08/2017 14:10,51,69.1,70,64.5,121,66.4,2,0,0
10/08/2017 14:15,46,68.6,64,64,110,65.9,2,0,0
10/08/2017 14:20,55,68.3,74,63.7,129,65.7,2,0,0
10/08/2017 14:25,51,67.9,69,63.2,120,65.2,2,0,0
10/08/2017 14:30,52,68.1,71,63.4,123,65.4,2,0,0
10/08/2017 14:35,59,67.9,77,63.1,136,65.2,2,0,0
10/08/2017 14:40,54,68.1,72,63.4,126,65.4,2,0,0
10/08/2017 14:45,49,68.6,66,64,115,66,2,0,0
10/08/2017 14:50,56,67.4,74,62.6,130,64.7,2,0,0
10/08/2017 14:55,57,68.2,75,63.5,132,65.5,2,0,0
10/08/2017 15:00,59,68.6,77,64,136,66,2,0,0
10/08/2017 15:05,64,68.8,82,64.2,146,66.2,2,0,0
10/08/2017 15:10,53,69.9,70,65.3,123,67.3,2,0,0
10/08/2017 15:15,55,69,72,64.4,127,66.4,2,0,0
10/08/2017 15:20,60,69,79,64.3,139,66.3,2,0,0
10/08/2017 15:25,56,69.1,75,64.5,131,66.5,2,0,0
10/08/2017 15:30,61,69.1,80,64.5,141,66.5,2,0,0
10/08/2017 15:35,55,69.4,74,64.8,129,66.8,2,0,0
10/08/2017 15:40,61,69.1,80,64.4,141,66.4,2,0,0
10/08/2017 15:45,63,69,82,64.3,145,66.3,2,0,0
10/08/2017 15:50,60,68.9,79,64.3,139,66.3,2,0,0
10/08/2017 15:55,52,69,70,64.4,122,66.3,2,0,0
10/08/2017 16:00,52,69,69,64.4,121,66.4,2,0,0
10/08/2017 16:05,47,69.3,65,64.7,112,66.6,2,0,0
10/08/2017 16:10,44,68.8,60,64.2,104,66.2,2,0,0
10/08/2017 16:15,50,69.8,67,65.2,117,67.2,2,0,0
10/08/2017 16:20,43,69.9,60,65.4,103,67.3,2,0,0
10/08/2017 16:25,49,69.6,66,65,115,67,2,0,0
10/08/2017 16:30,51,70.3,69,65.8,120,67.7,2,0,0
10/08/2017 16:35,48,70,66,65.5,114,67.4,2,0,0
10/08/2017 16:40,58,70,76,65.4,134,67.4,2,0,0
10/08/2017 16:45,44,68.9,62,64.2,106,66.2,2,0,0
10/08/2017 16:50,43,69.6,59,65,102,66.9,2,0,0
10/08/2017 16:55,41,69.6,58,65,99,66.9,2,0,0
10/08/2017 17:00,40,69.4,57,64.8,97,66.7,2,0,0
10/08/2017 17:05,40,69.6,57,65,97,66.9,2,0,0
10/08/2017 17:10,47,69.4,64,64.8,111,66.8,2,0,0
10/08/2017 17:15,47,70,64,65.5,111,67.4,2,0,0
10/08/2017 17:20,47,69.1,64,64.5,111,66.4,2,0,0
10/08/2017 17:25,47,69.5,64,65,111,66.9,2,0,0
10/08/2017 17:30,47,70,63,65.5,110,67.4,2,0,0
10/08/2017 17:35,42,70.1,59,65.6,101,67.5,2,0,0
10/08/2017 17:40,47,70,65,65.5,112,67.4,2,0,0
10/08/2017 17:45,46,69.4,64,64.8,110,66.7,2,0,0
10/08/2017 17:50,45,69.8,62,65.2,107,67.2,2,0,0
10/08/2017 17:55,46,69.7,64,65.1,110,67,2,0,0
10/08/2017 18:00,50,68.6,69,63.9,119,65.9,2,0,0
10/08/2017 18:05,47,68.3,64,63.5,111,65.5,2,0,0
10/08/2017 18:10,51,68.9,68,64.3,119,66.3,2,0,0
10/08/2017 18:15,55,69,73,64.4,128,66.4,2,0,0
10/08/2017 18:20,49,69.7,66,65.2,115,67.1,2,0,0
10/08/2017 18:25,59,69.8,78,65.3,137,67.2,2,0,0
10/08/2017 18:30,48,70,66,65.5,114,67.4,2,0,0
10/08/2017 18:35,54,69.4,72,64.8,126,66.8,2,0,0
10/08/2017 18:40,59,69.6,77,65,136,67,2,0,0
10/08/2017 18:45,55,69.7,73,65.1,128,67.1,2,0,0
10/08/2017 18:50,45,69.8,61,65.3,106,67.2,2,0,0
10/08/2017 18:55,51,68.8,70,64.1,121,66.1,2,0,0
10/08/2017 19:00,51,69.3,68,64.6,119,66.6,2,0,0
10/08/2017 19:05,50,69.8,67,65.2,117,67.2,2,0,0
10/08/2017 19:10,40,69.1,58,64.5,98,66.4,2,0,0
10/08/2017 19:15,56,68.3,74,63.6,130,65.6,2,0,0
10/08/2017 19:20,55,68.8,74,64.1,129,66.1,2,0,0
10/08/2017 19:25,49,69.2,66,64.6,115,66.6,2,0,0
10/08/2017 19:30,52,69.1,69,64.5,121,66.4,2,0,0
10/08/2017 19:35,52,68.5,70,63.9,122,65.8,2,0,0
10/08/2017 19:40,60,68.3,78,63.6,138,65.7,2,0,0
10/08/2017 19:45,49,67.9,66,63.2,115,65.2,2,0,0
10/08/2017 19:50,44,68.4,61,63.7,105,65.6,2,0,0
10/08/2017 19:55,32,68.7,48,64,80,65.9,2,0,0
10/08/2017 20:00,35,69.2,52,64.6,87,66.4,2,0,0
10/08/2017 20:05,36,69,52,64.3,88,66.2,2,0,0
10/08/2017 20:10,27,69.1,43,64.5,70,66.3,2,0,0
10/08/2017 20:15,30,69.1,46,64.5,76,66.3,2,0,0
10/08/2017 20:20,27,68.6,43,63.9,70,65.7,2,0,0
10/08/2017 20:25,37,68.5,54,63.8,91,65.7,2,0,0
10/08/2017 20:30,32,69,49,64.4,81,66.2,2,0,0
10/08/2017 20:35,32,68.8,49,64.2,81,66,2,0,0
10/08/2017 20:40,29,69,45,64.4,74,66.2,2,0,0
10/08/2017 20:45,26,68.8,42,64.1,68,65.9,2,0,0
10/08/2017 20:50,27,69,42,64.4,69,66.2,2,0,0
10/08/2017 20:55,26,69.3,41,64.7,67,66.5,2,0,0
10/08/2017 21:00,21,69.4,36,64.8,57,66.5,2,0,0
10/08/2017 21:05,36,69,53,64.3,89,66.2,2,0,0
10/08/2017 21:10,24,69.2,40,64.5,64,66.3,2,0,0
10/08/2017 21:15,26,69.2,42,64.6,68,66.4,2,0,0
10/08/2017 21:20,27,69.1,43,64.5,70,66.3,2,0,0
10/08/2017 21:25,28,69,44,64.3,72,66.1,2,0,0
10/08/2017 21:30,25,68.8,40,64.2,65,66,2,0,0
10/08/2017 21:35,23,69,39,64.3,62,66,2,0,0
10/08/2017 21:40,21,69.1,37,64.5,58,66.1,2,0,0
10/08/2017 21:45,26,69.4,41,64.7,67,66.5,2,0,0
10/08/2017 21:50,22,69.2,38,64.5,60,66.2,2,0,0
10/08/2017 21:55,16,69.2,32,64.6,48,66.1,2,0,0
10/08/2017 22:00,23,69.5,39,64.9,62,66.6,2,0,0
10/08/2017 22:05,29,69.7,44,65.1,73,66.9,2,0,0
10/08/2017 22:10,24,69.4,40,64.7,64,66.5,2,0,0
10/08/2017 22:15,26,69.1,42,64.5,68,66.2,2,0,0
10/08/2017 22:20,20,69.3,36,64.7,56,66.3,2,0,0
10/08/2017 22:25,17,69.3,33,64.7,50,66.2,2,0,0
10/08/2017 22:30,25,69.2,42,64.6,67,66.3,2,0,0
10/08/2017 22:35,24,69,39,64.4,63,66.1,2,0,0
10/08/2017 22:40,21,69.3,37,64.7,58,66.4,2,0,0
10/08/2017 22:45,20,69.1,35,64.5,55,66.2,2,0,0
10/08/2017 22:50,20,69.3,36,64.7,56,66.4,2,0,0
10/08/2017 22:55,21,69.2,37,64.6,58,66.3,2,0,0
10/08/2017 23:00,21,69.3,37,64.7,58,66.3,2,0,0
10/08/2017 23:05,24,69.3,39,64.7,63,66.5,2,0,0
10/08/2017 23:10,31,69.1,46,64.4,77,66.3,2,0,0
10/08/2017 23:15,19,69.3,35,64.7,54,66.3,2,0,0
10/08/2017 23:20,23,69.4,38,64.8,61,66.5,2,0,0
10/08/2017 23:25,20,69.5,36,64.9,56,66.6,2,0,0
10/08/2017 23:30,21,69.4,36,64.8,57,66.5,2,0,0
10/08/2017 23:35,22,69.5,37,64.9,59,66.6,2,0,0
10/08/2017 23:40,17,69.5,33,64.9,50,66.5,2,0,0
10/08/2017 23:45,15,69.1,30,64.5,45,66,2,0,0
10/08/2017 23:50,18,69.3,34,64.7,52,66.3,2,0,0
10/08/2017 23:55,16,68.9,32,64.3,48,65.9,2,0,0
