5 Minutes,Lane 1 Flow (Veh/5 Minutes),Lane 1 Speed (mph),Lane 2 Flow (Veh/5 Minutes),Lane 2 Speed (mph),Flow (Veh/5 Minutes),Speed (mph),# Lane Points,% Observed,Holiday
10/09/2017 0:00,12,69.3,28,64.7,40,66.1,2,0,1
10/09/2017 0:05,12,69.3,27,64.7,39,66.1,2,0,1
10/09/2017 0:10,11,69.3,27,64.7,38,66.1,2,0,1
10/09/2017 0:15,11,69.4,26,64.8,37,66.1,2,0,1
10/09/2017 0:20,13,69.3,28,64.7,41,66.2,2,0,1
10/09/2017 0:25,11,69.4,26,64.8,37,66.2,2,0,1
10/09/2017 0:30,11,69.5,26,64.9,37,66.2,2,0,1
10/09/2017 0:35,7,69.5,22,64.9,29,66,2,0,1
10/09/2017 0:40,8,69.4,23,64.8,31,66,2,0,1
10/09/2017 0:45,10,69.4,25,64.8,35,66.1,2,0,1
10/09/2017 0:50,11,69.2,27,64.6,38,65.9,2,0,1
10/09/2017 0:55,8,69,24,64.4,32,65.5,2,0,1
10/09/2017 1:00,8,69.2,24,64.6,32,65.8,2,0,1
10/09/2017 1:05,8,69.2,24,64.6,32,65.8,2,0,1
10/09/2017 1:10,6,69.2,21,64.6,27,65.6,2,0,1
10/09/2017 1:15,7,69.3,22,64.7,29,65.8,2,0,1
10/09/2017 1:20,6,69.2,21,64.5,27,65.5,2,0,1
10/09/2017 1:25,6,69.2,21,64.6,27,65.7,2,0,1
10/09/2017 1:30,14,69.3,22,64.7,36,66.5,2,0,1
10/09/2017 1:35,5,69.4,20,64.8,25,65.7,2,0,1
10/09/2017 1:40,8,69.3,23,64.7,31,65.9,2,0,1
10/09/2017 1:45,6,69.1,21,64.4,27,65.5,2,0,1
10/09/2017 1:50,7,69.1,22,64.4,29,65.6,2,0,1
10/09/2017 1:55,10,69,25,64.4,35,65.7,2,0,1
10/09/2017 2:00,6,69.1,21,64.5,27,65.5,2,0,1
10/09/2017 2:05,5,69.3,21,64.7,26,65.6,2,0,1
10/09/2017 2:10,5,69.3,20,64.7,25,65.7,2,0,1
10/09/2017 2:15,11,69.3,21,64.7,32,66.3,2,0,1
10/09/2017 2:20,6,69.2,22,64.6,28,65.6,2,0,1
10/09/2017 2:25,6,69.3,21,64.7,27,65.7,2,0,1
10/09/2017 2:30,7,69.3,22,64.7,29,65.8,2,0,1
10/09/2017 2:35,9,69.3,24,64.7,33,66,2,0,1
10/09/2017 2:40,9,69.3,24,64.7,33,66,2,0,1
10/09/2017 2:45,9,69.2,24,64.6,33,65.8,2,0,1
10/09/2017 2:50,9,69.3,25,64.7,34,65.9,2,0,1
10/09/2017 2:55,6,69.4,21,64.8,27,65.8,2,0,1
10/09/2017 3:00,9,69.4,25,64.8,34,66.1,2,0,1
10/09/2017 3:05,7,69.4,23,64.8,30,65.8,2,0,1
10/09/2017 3:10,6,69.3,22,64.7,28,65.7,2,0,1
10/09/2017 3:15,11,69.4,26,64.8,37,66.2,2,0,1
10/09/2017 3:20,9,69.3,24,64.7,33,66,2,0,1
10/09/2017 3:25,9,69.4,24,64.8,33,66,2,0,1
10/09/2017 3:30,12,69.2,28,64.5,40,65.9,2,0,1
10/09/2017 3:35,12,69.3,28,64.7,40,66.1,2,0,1
10/09/2017 3:40,11,69.3,26,64.7,37,66.1,2,0,1
10/09/2017 3:45,13,69.2,29,64.6,42,66,2,0,1
10/09/2017 3:50,12,69.3,28,64.6,40,66,2,0,1
10/09/2017 3:55,12,69,28,64.4,40,65.8,2,0,1
10/09/2017 4:00,13,68.8,28,64.1,41,65.6,2,0,1
10/09/2017 4:05,17,68.4,33,63.8,50,65.4,2,0,1
10/09/2017 4:10,19,68.7,35,64.1,54,65.7,2,0,1
10/09/2017 4:15,21,69.1,37,64.5,58,66.1,2,0,1
10/09/2017 4:20,27,69.1,43,64.5,70,66.3,2,0,1
10/09/2017 4:25,27,69.3,43,64.7,70,66.4,2,0,1
10/09/2017 4:30,29,69.3,46,64.6,75,66.4,2,0,1
10/09/2017 4:35,33,69.3,50,64.7,83,66.5,2,0,1
10/09/2017 4:40,33,68.8,51,64.2,84,66,2,0,1
10/09/2017 4:45,39,67.9,57,63.2,96,65.1,2,0,1
10/09/2017 4:50,45,68.9,64,64.3,109,66.2,2,0,1
10/09/2017 4:55,41,69.5,60,65,101,66.8,2,0,1
10/09/2017 5:00,48,69.1,66,64.5,114,66.4,2,0,1
10/09/2017 5:05,49,69.7,67,65.1,116,67.1,2,0,1
10/09/2017 5:10,54,69.1,75,64.4,129,66.3,2,0,1
10/09/2017 5:15,49,68.9,69,64.2,118,66.2,2,0,1
10/09/2017 5:20,58,69.2,78,64.6,136,66.6,2,0,1
10/09/2017 5:25,55,68.7,76,64,131,66,2,0,1
10/09/2017 5:30,54,69.2,75,64.6,129,66.5,2,0,1
10/09/2017 5:35,60,68.4,81,63.8,141,65.8,2,0,1
10/09/2017 5:40,59,69,79,64.3,138,66.3,2,0,1
10/09/2017 5:45,58,69.8,78,65.3,136,67.2,2,0,1
10/09/2017 5:50,64,68.7,85,64,149,66,2,0,1
10/09/2017 5:55,59,69,79,64.3,138,66.3,2,0,1
10/09/2017 6:00,63,68.8,84,64.1,147,66.1,2,0,1
10/09/2017 6:05,57,68,78,63.2,135,65.2,2,0,1
10/09/2017 6:10,60,67.8,80,63,140,65.1,2,0,1
10/09/2017 6:15,69,66.8,92,61.9,161,64,2,0,1
10/09/2017 6:20,75,66.2,97,61.2,172,63.4,2,0,1
10/09/2017 6:25,66,65.8,88,60.8,154,62.9,2,0,1
10/09/2017 6:30,65,66.4,86,61.4,151,63.6,2,0,1
10/09/2017 6:35,62,66.1,83,61.1,145,63.2,2,0,1
10/09/2017 6:40,72,65.5,94,60.4,166,62.6,2,0,1
10/09/2017 6:45,69,64.7,90,59.6,159,61.8,2,0,1
10/09/2017 6:50,71,65,93,59.9,164,62.1,2,0,1
10/09/2017 6:55,61,66.5,82,61.5,143,63.6,2,0,1
10/09/2017 7:00,71,66.7,93,61.7,164,63.9,2,0,1
10/09/2017 7:05,77,66.4,98,61.3,175,63.6,2,0,1
10/09/2017 7:10,73,67.1,95,62.2,168,64.4,2,0,1
10/09/2017 7:15,77,67.5,99,62.6,176,64.7,2,0,1
10/09/2017 7:20,79,66.6,103,61.6,182,63.8,2,0,1
10/09/2017 7:25,79,67.2,102,62.2,181,64.4,2,0,1
10/09/2017 7:30,69,66.7,91,61.8,160,63.9,2,0,1
10/09/2017 7:35,73,67.4,95,62.6,168,64.7,2,0,1
10/09/2017 7:40,62,67.8,82,63,144,65,2,0,1
10/09/2017 7:45,71,67.9,93,63.1,164,65.2,2,0,1
10/09/2017 7:50,67,68.6,88,63.8,155,65.9,2,0,1
10/09/2017 7:55,72,68.1,93,63.3,165,65.4,2,0,1
10/09/2017 8:00,74,68.6,95,63.8,169,65.9,2,0,1
10/09/2017 8:05,72,68.5,93,63.6,165,65.7,2,0,1
10/09/2017 8:10,77,67.9,97,63,174,65.1,2,0,1
10/09/2017 8:15,66,68,88,63.2,154,65.2,2,0,1
10/09/2017 8:20,72,68.1,93,63.3,165,65.4,2,0,1
10/09/2017 8:25,78,66.7,100,61.8,178,63.9,2,0,1
10/09/2017 8:30,78,66.9,99,62,177,64.1,2,0,1
10/09/2017 8:35,72,66.4,95,61.5,167,63.6,2,0,1
10/09/2017 8:40,78,65.9,100,60.9,178,63,2,0,1
10/09/2017 8:45,83,67.2,105,62.4,188,64.5,2,0,1
10/09/2017 8:50,75,67,96,62.1,171,64.2,2,0,1
10/09/2017 8:55,73,66.7,95,61.8,168,64,2,0,1
10/09/2017 9:00,66,66.6,87,61.7,153,63.8,2,0,1
10/09/2017 9:05,80,67.5,101,62.7,181,64.8,2,0,1
10/09/2017 9:10,64,67,84,62.1,148,64.2,2,0,1
10/09/2017 9:15,59,67,79,62.2,138,64.3,2,0,1
10/09/2017 9:20,65,66.6,85,61.7,150,63.8,2,0,1
10/09/2017 9:25,62,67.9,81,63.2,143,65.3,2,0,1
10/09/2017 9:30,64,67.8,83,63.1,147,65.1,2,0,1
10/09/2017 9:35,62,67.2,83,62.5,145,64.5,2,0,1
10/09/2017 9:40,67,66.4,87,61.6,154,63.7,2,0,1
10/09/2017 9:45,72,66.4,92,61.6,164,63.7,2,0,1
10/09/2017 9:50,66,69,60,63,126,66.1,2,0,1
10/09/2017 9:55,48,68.8,65,64.2,113,66.1,2,0,1
10/09/2017 10:00,65,67.9,83,63.2,148,65.3,2,0,1
10/09/2017 10:05,62,69.3,55,63.3,117,66.5,2,0,1
10/09/2017 10:10,62,69.2,55,63.2,117,66.4,2,0,1
10/09/2017 10:15,62,67.1,81,62.2,143,64.3,2,0,1
10/09/2017 10:20,62,69.1,55,63.1,117,66.3,2,0,1
10/09/2017 10:25,53,65.2,72,60.3,125,62.4,2,0,1
10/09/2017 10:30,64,67,83,62.4,147,64.4,2,0,1
10/09/2017 10:35,58,64.2,79,59.3,137,61.3,2,0,1
10/09/2017 10:40,60,66,79,61.2,139,63.2,2,0,1
10/09/2017 10:45,62,69,55,63,117,66.2,2,0,1
10/09/2017 10:50,72,70.5,91,66.3,163,68.2,2,0,1
10/09/2017 10:55,69,69.7,88,65.3,157,67.2,2,0,1
10/09/2017 11:00,58,68.1,77,63.6,135,65.5,2,0,1
10/09/2017 11:05,70,68.7,92,64.2,162,66.1,2,0,1
10/09/2017 11:10,59,68.6,53,62.8,112,65.9,2,0,1
10/09/2017 11:15,47,70.7,65,66.2,112,68.1,2,0,1
10/09/2017 11:20,50,68.6,68,63.9,118,65.9,2,0,1
10/09/2017 11:25,41,68.7,57,64,98,65.9,2,0,1
10/09/2017 11:30,60,69,53,63,113,66.2,2,0,1
10/09/2017 11:35,58,68.4,76,63.5,134,65.6,2,0,1
10/09/2017 11:40,51,68.7,70,63.9,121,65.9,2,0,1
10/09/2017 11:45,50,68.1,67,63.4,117,65.4,2,0,1
10/09/2017 11:50,48,68.3,66,63.5,114,65.5,2,0,1
10/09/2017 11:55,61,69.3,55,63.3,116,66.5,2,0,1
10/09/2017 12:00,60,69.2,53,63.2,113,66.4,2,0,1
10/09/2017 12:05,47,68.7,65,64.1,112,66,2,0,1
10/09/2017 12:10,63,69.1,57,63.1,120,66.2,2,0,1
10/09/2017 12:15,63,69.2,56,63.2,119,66.4,2,0,1
10/09/2017 12:20,49,70.4,66,65.8,115,67.8,2,0,1
10/09/2017 12:25,42,69.5,59,64.9,101,66.8,2,0,1
10/09/2017 12:30,49,68.7,67,64.1,116,66,2,0,1
10/09/2017 12:35,45,69.3,64,64.7,109,66.6,2,0,1
10/09/2017 12:40,63,69.2,57,63.2,120,66.3,2,0,1
10/09/2017 12:45,45,70.9,62,66.4,107,68.3,2,0,1
10/09/2017 12:50,50,69.9,68,65.4,118,67.3,2,0,1
10/09/2017 12:55,64,69.3,57,63.3,121,66.5,2,0,1
10/09/2017 13:00,44,70.9,61,66.4,105,68.3,2,0,1
10/09/2017 13:05,49,70.7,66,66.2,115,68.1,2,0,1
10/09/2017 13:10,45,70.8,62,66.3,107,68.2,2,0,1
10/09/2017 13:15,44,71,61,66.5,105,68.4,2,0,1
10/09/2017 13:20,45,71.3,62,66.8,107,68.7,2,0,1
10/09/2017 13:25,53,71.7,72,67.3,125,69.2,2,0,1
10/09/2017 13:30,56,68.9,74,64.3,130,66.3,2,0,1
10/09/2017 13:35,50,69.4,67,64.8,117,66.8,2,0,1
10/09/2017 13:40,55,69.1,72,64.5,127,66.5,2,0,1
10/09/2017 13:45,45,69.5,62,64.9,107,66.8,2,0,1
10/09/2017 13:50,56,70.3,74,65.7,130,67.7,2,0,1
10/09/2017 13:55,56,70.1,73,65.5,129,67.5,2,0,1
10/09/2017 14:00,43,70.1,60,65.5,103,67.4,2,0,1
10/09/2017 14:05,46,69.2,64,64.5,110,66.5,2,0,1
10/09/2017 14:10,53,69.7,71,65.2,124,67.1,2,0,1
10/09/2017 14:15,56,68.6,75,63.9,131,65.9,2,0,1
10/09/2017 14:20,53,68.3,72,63.6,125,65.6,2,0,1
10/09/2017 14:25,44,68.1,62,63.4,106,65.3,2,0,1
10/09/2017 14:30,44,68.2,61,63.5,105,65.5,2,0,1
10/09/2017 14:35,52,69.1,70,64.5,122,66.4,2,0,1
10/09/2017 14:40,49,67.9,68,63.2,117,65.2,2,0,1
10/09/2017 14:45,45,67.9,63,63.2,108,65.1,2,0,1
10/09/2017 14:50,44,68.9,61,64.3,105,66.2,2,0,1
10/09/2017 14:55,47,67.5,65,62.8,112,64.7,2,0,1
10/09/2017 15:00,48,68.3,66,63.6,114,65.6,2,0,1
10/09/2017 15:05,43,67.9,60,63.2,103,65.2,2,0,1
10/09/2017 15:10,55,68.3,73,63.6,128,65.6,2,0,1
10/09/2017 15:15,48,67.5,66,62.8,114,64.8,2,0,1
10/09/2017 15:20,63,67.4,81,62.6,144,64.7,2,0,1
10/09/2017 15:25,49,68.5,67,63.9,116,65.8,2,0,1
10/09/2017 15:30,61,67.4,79,62.7,140,64.8,2,0,1
10/09/2017 15:35,59,68.8,76,64.3,135,66.3,2,0,1
10/09/2017 15:40,56,68.4,74,63.7,130,65.8,2,0,1
10/09/2017 15:45,61,68.7,80,64.1,141,66.1,2,0,1
10/09/2017 15:50,62,68.1,81,63.5,143,65.5,2,0,1
10/09/2017 15:55,65,67.5,84,62.8,149,64.9,2,0,1
10/09/2017 16:00,55,68.9,74,64.3,129,66.3,2,0,1
10/09/2017 16:05,52,68.9,69,64.2,121,66.2,2,0,1
10/09/2017 16:10,64,68.8,84,64.2,148,66.2,2,0,1
10/09/2017 16:15,50,68.8,68,64.2,118,66.1,2,0,1
10/09/2017 16:20,59,69.3,77,64.7,136,66.7,2,0,1
10/09/2017 16:25,60,68.8,79,64.2,139,66.2,2,0,1
10/09/2017 16:30,51,68.4,68,63.8,119,65.8,2,0,1
10/09/2017 16:35,60,68.3,78,63.6,138,65.6,2,0,1
10/09/2017 16:40,59,69.1,76,64.4,135,66.4,2,0,1
10/09/2017 16:45,58,69,76,64.3,134,66.4,2,0,1
10/09/2017 16:50,47,68.6,65,63.9,112,65.9,2,0,1
10/09/2017 16:55,48,69.2,65,64.6,113,66.5,2,0,1
10/09/2017 17:00,42,69.5,59,64.8,101,66.8,2,0,1
10/09/2017 17:05,45,68.1,63,63.4,108,65.4,2,0,1
10/09/2017 17:10,53,69,72,64.4,125,66.3,2,0,1
10/09/2017 17:15,60,68.6,79,63.9,139,65.9,2,0,1
10/09/2017 17:20,41,69.1,59,64.5,100,66.4,2,0,1
10/09/2017 17:25,49,69.4,67,64.8,116,66.8,2,0,1
10/09/2017 17:30,48,69.2,67,64.5,115,66.5,2,0,1
10/09/2017 17:35,56,69.1,74,64.5,130,66.5,2,0,1
10/09/2017 17:40,46,68.9,64,64.2,110,66.1,2,0,1
10/09/2017 17:45,49,70.6,66,66.1,115,68,2,0,1
10/09/2017 17:50,48,69.2,65,64.5,113,66.5,2,0,1
10/09/2017 17:55,51,69.3,69,64.7,120,66.7,2,0,1
10/09/2017 18:00,41,69.4,58,64.8,99,66.7,2,0,1
10/09/2017 18:05,45,69,62,64.3,107,66.3,2,0,1
10/09/2017 18:10,45,67.5,62,62.7,107,64.7,2,0,1
10/09/2017 18:15,52,68.1,70,63.4,122,65.4,2,0,1
10/09/2017 18:20,51,68,70,63.2,121,65.2,2,0,1
10/09/2017 18:25,37,68.3,55,63.6,92,65.5,2,0,1
10/09/2017 18:30,41,69.3,58,64.7,99,66.6,2,0,1
10/09/2017 18:35,47,68.7,66,64,113,66,2,0,1
10/09/2017 18:40,36,68.8,52,64.1,88,66,2,0,1
10/09/2017 18:45,39,69.3,55,64.7,94,66.6,2,0,1
10/09/2017 18:50,38,69.7,54,65.1,92,67,2,0,1
10/09/2017 18:55,43,68.4,60,63.7,103,65.7,2,0,1
10/09/2017 19:00,34,68.7,51,64.1,85,65.9,2,0,1
10/09/2017 19:05,39,69.4,56,64.8,95,66.7,2,0,1
10/09/2017 19:10,34,69.4,51,64.8,85,66.6,2,0,1
10/09/2017 19:15,38,69.1,55,64.4,93,66.3,2,0,1
10/09/2017 19:20,39,68.8,56,64.2,95,66.1,2,0,1
10/09/2017 19:25,36,69.2,53,64.6,89,66.4,2,0,1
10/09/2017 19:30,37,68.6,54,64,91,65.9,2,0,1
10/09/2017 19:35,34,69.6,51,64.9,85,66.8,2,0,1
10/09/2017 19:40,31,69.7,48,65.1,79,66.9,2,0,1
10/09/2017 19:45,35,70.3,51,65.8,86,67.6,2,0,1
10/09/2017 19:50,27,69.3,44,64.7,71,66.4,2,0,1
10/09/2017 19:55,33,70.1,49,65.5,82,67.4,2,0,1
10/09/2017 20:00,36,69.6,52,65.1,88,66.9,2,0,1
10/09/2017 20:05,31,69,48,64.4,79,66.2,2,0,1
10/09/2017 20:10,23,69,39,64.4,62,66.1,2,0,1
10/09/2017 20:15,36,69.7,52,65.2,88,67,2,0,1
10/09/2017 20:20,33,69.9,49,65.3,82,67.1,2,0,1
10/09/2017 20:25,28,69.9,43,65.3,71,67.1,2,0,1
10/09/2017 20:30,33,68.7,49,64.1,82,66,2,0,1
10/09/2017 20:35,30,68.5,47,63.9,77,65.7,2,0,1
10/09/2017 20:40,29,68.6,46,63.9,75,65.7,2,0,1
10/09/2017 20:45,31,68.7,48,64.1,79,65.9,2,0,1
10/09/2017 20:50,32,69.5,49,64.9,81,66.7,2,0,1
10/09/2017 20:55,24,69.7,40,65.1,64,66.8,2,0,1
10/09/2017 21:00,29,69.6,46,65,75,66.7,2,0,1
10/09/2017 21:05,22,69.3,39,64.7,61,66.3,2,0,1
10/09/2017 21:10,24,68.8,40,64.1,64,65.9,2,0,1
10/09/2017 21:15,28,68.9,44,64.3,72,66.1,2,0,1
10/09/2017 21:20,27,69.4,43,64.7,70,66.5,2,0,1
10/09/2017 21:25,24,69.2,40,64.5,64,66.3,2,0,1
10/09/2017 21:30,24,69.1,40,64.5,64,66.2,2,0,1
10/09/2017 21:35,28,68.6,44,64,72,65.8,2,0,1
10/09/2017 21:40,20,69.1,36,64.5,56,66.1,2,0,1
10/09/2017 21:45,26,69.5,43,64.9,69,66.6,2,0,1
10/09/2017 21:50,26,69.7,42,65.2,68,66.9,2,0,1
10/09/2017 21:55,18,69.5,33,64.9,51,66.5,2,0,1
10/09/2017 22:00,20,69.4,36,64.8,56,66.5,2,0,1
10/09/2017 22:05,23,69.4,39,64.8,62,66.5,2,0,1
10/09/2017 22:10,23,69.6,39,65,62,66.7,2,0,1
10/09/2017 22:15,18,69.4,34,64.8,52,66.4,2,0,1
10/09/2017 22:20,17,69.4,33,64.8,50,66.4,2,0,1
10/09/2017 22:25,18,69,34,64.4,52,66,2,0,1
10/09/2017 22:30,15,69.2,30,64.6,45,66.1,2,0,1
10/09/2017 22:35,23,69.3,38,64.7,61,66.4,2,0,1
10/09/2017 22:40,18,69.1,33,64.5,51,66.1,2,0,1
10/09/2017 22:45,19,68.8,35,64.2,54,65.8,2,0,1
10/09/2017 22:50,19,69.1,34,64.5,53,66.2,2,0,1
10/09/2017 22:55,16,69.2,32,64.7,48,66.2,2,0,1
10/09/2017 23:00,13,69.3,29,64.7,42,66.1,2,0,1
10/09/2017 23:05,17,69.5,33,64.9,50,66.4,2,0,1
10/09/2017 23:10,14,69.4,30,64.8,44,66.3,2,0,1
10/09/2017 23:15,12,69,27,64.4,39,65.8,2,0,1
10/09/2017 23:20,12,69.2,28,64.6,40,66,2,0,1
10/09/2017 23:25,9,69.2,24,64.6,33,65.8,2,0,1
10/09/2017 23:30,10,69.1,26,64.5,36,65.8,2,0,1
10/09/2017 23:35,12,69.2,28,64.5,40,65.9,2,0,1
10/09/2017 23:40,13,69.3,29,64.7,42,66.2,2,0,1
10/09/2017 23:45,14,69.3,29,64.7,43,66.2,2,0,1
10/09/2017 23:50,11,69.3,27,64.7,38,66,2,0,1
10/09/2017 23:55,13,69.3,28,64.7,41,66.2,2,0,1
10/10/2017 0:00,10,69.3,25,64.7,35,66.1,2,0,0
10/10/2017 0:05,9,69.1,24,64.5,33,65.8,2,0,0
10/10/2017 0:10,8,69.1,24,64.5,32,65.7,2,0,0
10/10/2017 0:15,7,69.3,22,64.7,29,65.8,2,0,0
10/10/2017 0:20,11,69.1,27,64.5,38,65.8,2,0,0
10/10/2017 0:25,7,69.2,22,64.6,29,65.7,2,0,0
10/10/2017 0:30,9,69,24,64.4,33,65.6,2,0,0
10/10/2017 0:35,10,69.1,25,64.5,35,65.8,2,0,0
10/10/2017 0:40,8,69.2,23,64.7,31,65.8,2,0,0
10/10/2017 0:45,8,69.3,24,64.7,32,65.9,2,0,0
10/10/2017 0:50,7,69.4,22,64.8,29,65.9,2,0,0
10/10/2017 0:55,10,69.4,20,64.8,30,66.3,2,0,0
10/10/2017 1:00,8,69.3,23,64.7,31,65.9,2,0,0
10/10/2017 1:05,7,69.3,23,64.7,30,65.8,2,0,0
10/10/2017 1:10,7,69.3,23,64.7,30,65.8,2,0,0
10/10/2017 1:15,10,69.2,20,64.5,30,66.1,2,0,0
10/10/2017 1:20,6,69.3,21,64.7,27,65.7,2,0,0
10/10/2017 1:25,6,69.3,21,64.7,27,65.7,2,0,0
10/10/2017 1:30,8,69.3,23,64.7,31,65.9,2,0,0
10/10/2017 1:35,8,69.3,24,64.7,32,65.9,2,0,0
10/10/2017 1:40,6,69.4,21,64.8,27,65.8,2,0,0
10/10/2017 1:45,6,69.1,21,64.5,27,65.5,2,0,0
10/10/2017 1:50,10,69.2,20,64.5,30,66.1,2,0,0
10/10/2017 1:55,9,69.2,24,64.6,33,65.9,2,0,0
10/10/2017 2:00,6,69.2,22,64.6,28,65.6,2,0,0
10/10/2017 2:05,12,69.3,21,64.7,33,66.3,2,0,0
10/10/2017 2:10,7,69.1,22,64.5,29,65.6,2,0,0
10/10/2017 2:15,10,69.2,20,64.6,30,66.1,2,0,0
10/10/2017 2:20,10,69.3,20,64.7,30,66.2,2,0,0
10/10/2017 2:25,8,69.3,23,64.7,31,65.9,2,0,0
10/10/2017 2:30,6,69.3,21,64.6,27,65.7,2,0,0
10/10/2017 2:35,9,69.2,25,64.6,34,65.8,2,0,0
10/10/2017 2:40,8,69.4,24,64.8,32,66,2,0,0
10/10/2017 2:45,8,69.4,24,64.8,32,65.9,2,0,0
10/10/2017 2:50,8,69.4,23,64.8,31,66,2,0,0
10/10/2017 2:55,10,69.4,26,64.8,36,66,2,0,0
10/10/2017 3:00,9,69.4,24,64.8,33,66.1,2,0,0
10/10/2017 3:05,9,69.4,24,64.8,33,66.1,2,0,0
10/10/2017 3:10,10,69.2,25,64.5,35,65.9,2,0,0
10/10/2017 3:15,10,68.8,25,64.2,35,65.5,2,0,0
10/10/2017 3:20,10,68.9,25,64.2,35,65.6,2,0,0
10/10/2017 3:25,9,69.1,24,64.5,33,65.8,2,0,0
10/10/2017 3:30,10,69.2,25,64.6,35,65.9,2,0,0
10/10/2017 3:35,14,69.1,30,64.5,44,66,2,0,0
10/10/2017 3:40,15,69.1,30,64.5,45,66.1,2,0,0
10/10/2017 3:45,11,69.3,26,64.7,37,66,2,0,0
10/10/2017 3:50,14,69.3,31,64.6,45,66.1,2,0,0
10/10/2017 3:55,13,69.1,29,64.5,42,65.9,2,0,0
10/10/2017 4:00,12,68.8,27,64.2,39,65.6,2,0,0
10/10/2017 4:05,15,69,31,64.4,46,65.9,2,0,0
10/10/2017 4:10,18,69.2,33,64.6,51,66.2,2,0,0
10/10/2017 4:15,20,69.6,36,65,56,66.6,2,0,0
10/10/2017 4:20,25,69.4,41,64.8,66,66.6,2,0,0
10/10/2017 4:25,21,69.6,37,65,58,66.6,2,0,0
10/10/2017 4:30,25,69.6,41,65,66,66.8,2,0,0
10/10/2017 4:35,34,69.4,51,64.8,85,66.7,2,0,0
10/10/2017 4:40,38,69.8,55,65.3,93,67.1,2,0,0
10/10/2017 4:45,38,69.8,56,65.3,94,67.1,2,0,0
10/10/2017 4:50,39,69.6,57,65,96,66.9,2,0,0
10/10/2017 4:55,35,69.9,52,65.3,87,67.2,2,0,0
10/10/2017 5:00,41,70.1,60,65.5,101,67.4,2,0,0
10/10/2017 5:05,44,68.8,63,64.2,107,66.1,2,0,0
10/10/2017 5:10,44,69.9,64,65.4,108,67.2,2,0,0
10/10/2017 5:15,48,68.8,67,64.2,115,66.2,2,0,0
10/10/2017 5:20,54,69.9,74,65.3,128,67.2,2,0,0
10/10/2017 5:25,56,69.6,76,65.1,132,67,2,0,0
10/10/2017 5:30,59,67.6,80,62.8,139,64.8,2,0,0
10/10/2017 5:35,63,67.7,84,63,147,65,2,0,0
10/10/2017 5:40,54,67.9,74,63.1,128,65.2,2,0,0
10/10/2017 5:45,70,67.4,91,62.6,161,64.7,2,0,0
10/10/2017 5:50,75,66.9,98,62,173,64.1,2,0,0
10/10/2017 5:55,63,67.5,84,62.6,147,64.7,2,0,0
10/10/2017 6:00,59,67.3,79,62.4,138,64.5,2,0,0
10/10/2017 6:05,59,67.4,81,62.5,140,64.6,2,0,0
10/10/2017 6:10,72,66.8,94,61.9,166,64,2,0,0
10/10/2017 6:15,63,67.4,84,62.5,147,64.6,2,0,0
10/10/2017 6:20,63,66.1,84,61.1,147,63.2,2,0,0
10/10/2017 6:25,62,65.1,83,60,145,62.2,2,0,0
10/10/2017 6:30,68,66.1,89,61.1,157,63.3,2,0,0
10/10/2017 6:35,64,66.6,85,61.7,149,63.8,2,0,0
10/10/2017 6:40,77,67.6,99,62.7,176,64.9,2,0,0
10/10/2017 6:45,73,64.8,96,59.6,169,61.8,2,0,0
10/10/2017 6:50,71,66.8,92,61.7,163,63.9,2,0,0
10/10/2017 6:55,70,67.3,91,62.4,161,64.5,2,0,0
10/10/2017 7:00,65,66.5,86,61.5,151,63.6,2,0,0
10/10/2017 7:05,68,66.6,90,61.7,158,63.8,2,0,0
10/10/2017 7:10,76,68.1,99,63.3,175,65.4,2,0,0
10/10/2017 7:15,80,67.6,102,62.8,182,64.9,2,0,0
10/10/2017 7:20,83,66.9,106,62,189,64.1,2,0,0
10/10/2017 7:25,81,68.4,104,63.6,185,65.7,2,0,0
10/10/2017 7:30,75,68.7,98,64,173,66,2,0,0
10/10/2017 7:35,85,67.3,108,62.4,193,64.5,2,0,0
10/10/2017 7:40,90,67.3,113,62.4,203,64.6,2,0,0
10/10/2017 7:45,90,61.9,113,56.4,203,58.8,2,0,0
10/10/2017 7:50,78,48.7,99,41.7,177,44.8,2,0,0
10/10/2017 7:55,76,42.7,97,35.1,173,38.4,2,0,0
10/10/2017 8:00,74,53.4,97,47,171,49.8,2,0,0
10/10/2017 8:05,79,60.7,103,55.1,182,57.5,2,0,0
10/10/2017 8:10,76,64.2,99,58.9,175,61.2,2,0,0
10/10/2017 8:15,71,65.4,92,60.3,163,62.5,2,0,0
10/10/2017 8:20,75,64.8,98,59.6,173,61.8,2,0,0
10/10/2017 8:25,80,65.6,103,60.5,183,62.8,2,0,0
10/10/2017 8:30,77,66,99,61,176,63.2,2,0,0
10/10/2017 8:35,84,65,107,59.9,191,62.1,2,0,0
10/10/2017 8:40,87,65.3,111,60.2,198,62.4,2,0,0
10/10/2017 8:45,75,64.9,97,59.7,172,62,2,0,0
10/10/2017 8:50,84,62.7,107,57.3,191,59.7,2,0,0
10/10/2017 8:55,88,61.6,111,56.1,199,58.6,2,0,0
10/10/2017 9:00,80,61.7,102,56.2,182,58.6,2,0,0
10/10/2017 9:05,81,62.1,104,56.7,185,59,2,0,0
10/10/2017 9:10,83,63.3,105,58,188,60.3,2,0,0
10/10/2017 9:15,74,64.4,97,59.2,171,61.4,2,0,0
10/10/2017 9:20,61,63.2,81,58,142,60.3,2,0,0
10/10/2017 9:25,60,63.6,80,58.5,140,60.7,2,0,0
10/10/2017 9:30,67,64.6,88,59.4,155,61.6,2,0,0
10/10/2017 9:35,53,64.3,73,59.3,126,61.4,2,0,0
10/10/2017 9:40,58,65.6,76,60.6,134,62.8,2,0,0
10/10/2017 9:45,62,67.1,82,62.2,144,64.3,2,0,0
10/10/2017 9:50,67,67.1,87,62.2,154,64.3,2,0,0
10/10/2017 9:55,59,67.8,78,63,137,65,2,0,0
10/10/2017 10:00,51,67.6,69,62.8,120,64.9,2,0,0
10/10/2017 10:05,62,69,81,64.4,143,66.4,2,0,0
10/10/2017 10:10,47,69.2,64,64.6,111,66.5,2,0,0
10/10/2017 10:15,62,68.1,81,63.5,143,65.5,2,0,0
10/10/2017 10:20,63,67.8,82,63.2,145,65.2,2,0,0
10/10/2017 10:25,63,66.3,83,61.5,146,63.6,2,0,0
10/10/2017 10:30,64,67.5,84,62.8,148,64.8,2,0,0
10/10/2017 10:35,72,65.6,92,60.7,164,62.8,2,0,0
10/10/2017 10:40,69,65.1,89,60.1,158,62.3,2,0,0
10/10/2017 10:45,61,65.1,80,60.1,141,62.3,2,0,0
10/10/2017 10:50,69,65,89,60,158,62.2,2,0,0
10/10/2017 10:55,60,65.6,80,60.6,140,62.8,2,0,0
10/10/2017 11:00,65,65.3,85,60.3,150,62.5,2,0,0
10/10/2017 11:05,67,65.3,88,60.3,155,62.5,2,0,0
10/10/2017 11:10,54,66.3,72,61.4,126,63.5,2,0,0
10/10/2017 11:15,65,67.1,84,62.3,149,64.4,2,0,0
10/10/2017 11:20,66,66,86,61.1,152,63.2,2,0,0
10/10/2017 11:25,59,66.8,78,62,137,64.1,2,0,0
10/10/2017 11:30,52,66.8,70,62,122,64,2,0,0
10/10/2017 11:35,56,67.9,76,63.1,132,65.1,2,0,0
10/10/2017 11:40,54,67.6,73,62.8,127,64.8,2,0,0
10/10/2017 11:45,54,66.9,73,62.1,127,64.1,2,0,0
10/10/2017 11:50,54,67.2,73,62.5,127,64.5,2,0,0
10/10/2017 11:55,48,68.1,65,63.4,113,65.4,2,0,0
10/10/2017 12:00,47,68.3,66,63.6,113,65.6,2,0,0
10/10/2017 12:05,45,69.3,63,64.8,108,66.7,2,0,0
10/10/2017 12:10,47,68.7,65,64.1,112,66,2,0,0
10/10/2017 12:15,53,68.8,70,64.1,123,66.2,2,0,0
10/10/2017 12:20,53,68.3,71,63.5,124,65.6,2,0,0
10/10/2017 12:25,50,68.7,68,64,118,66,2,0,0
10/10/2017 12:30,59,68.6,78,63.8,137,65.9,2,0,0
10/10/2017 12:35,55,67.4,73,62.5,128,64.6,2,0,0
10/10/2017 12:40,55,67.5,72,62.7,127,64.8,2,0,0
10/10/2017 12:45,52,69.2,69,64.5,121,66.5,2,0,0
10/10/2017 12:50,55,69.1,73,64.5,128,66.5,2,0,0
10/10/2017 12:55,44,69,62,64.4,106,66.3,2,0,0
10/10/2017 13:00,50,68.7,68,64.1,118,66,2,0,0
10/10/2017 13:05,46,68.3,63,63.6,109,65.6,2,0,0
10/10/2017 13:10,41,67.8,57,63,98,65,2,0,0
10/10/2017 13:15,43,68.2,60,63.5,103,65.5,2,0,0
10/10/2017 13:20,48,67.5,66,62.7,114,64.7,2,0,0
10/10/2017 13:25,52,66.7,71,61.9,123,63.9,2,0,0
10/10/2017 13:30,57,66,76,61.2,133,63.3,2,0,0
10/10/2017 13:35,50,67.4,68,62.6,118,64.6,2,0,0
10/10/2017 13:40,48,65.6,67,60.6,115,62.7,2,0,0
10/10/2017 13:45,48,67.7,67,62.9,115,64.9,2,0,0
10/10/2017 13:50,64,67.9,84,63.1,148,65.2,2,0,0
10/10/2017 13:55,50,68.7,67,63.9,117,66,2,0,0
10/10/2017 14:00,48,68.3,66,63.6,114,65.6,2,0,0
10/10/2017 14:05,51,69.2,69,64.5,120,66.5,2,0,0
10/10/2017 14:10,51,68.4,69,63.6,120,65.6,2,0,0
10/10/2017 14:15,47,68.9,64,64.2,111,66.2,2,0,0
10/10/2017 14:20,54,68.4,73,63.6,127,65.6,2,0,0
10/10/2017 14:25,59,67,79,62.2,138,64.3,2,0,0
10/10/2017 14:30,54,67.8,72,63.1,126,65.1,2,0,0
10/10/2017 14:35,45,67.9,62,63.1,107,65.1,2,0,0
10/10/2017 14:40,41,69,58,64.4,99,66.3,2,0,0
10/10/2017 14:45,44,68.4,63,63.7,107,65.7,2,0,0
10/10/2017 14:50,50,68.7,67,64,117,66,2,0,0
10/10/2017 14:55,47,69.7,63,65,110,67,2,0,0
10/10/2017 15:00,51,69.5,68,64.9,119,66.9,2,0,0
10/10/2017 15:05,52,70.3,69,65.8,121,67.7,2,0,0
10/10/2017 15:10,51,68.3,69,63.7,120,65.6,2,0,0
10/10/2017 15:15,51,68.3,70,63.7,121,65.6,2,0,0
10/10/2017 15:20,64,69.3,83,64.7,147,66.7,2,0,0
10/10/2017 15:25,59,69.1,78,64.4,137,66.4,2,0,0
10/10/2017 15:30,53,70.3,71,65.7,124,67.7,2,0,0
10/10/2017 15:35,50,70.1,68,65.5,118,67.4,2,0,0
10/10/2017 15:40,43,69.4,61,64.7,104,66.6,2,0,0
10/10/2017 15:45,59,69.4,77,64.8,136,66.8,2,0,0
10/10/2017 15:50,64,68.5,83,63.8,147,65.8,2,0,0
10/10/2017 15:55,61,69.1,80,64.5,141,66.5,2,0,0
10/10/2017 16:00,51,68.6,69,64,120,65.9,2,0,0
10/10/2017 16:05,63,69.6,83,65,146,67,2,0,0
10/10/2017 16:10,69,70.2,88,65.8,157,67.7,2,0,0
10/10/2017 16:15,56,70,73,65.5,129,67.5,2,0,0
10/10/2017 16:20,60,69.9,78,65.3,138,67.3,2,0,0
10/10/2017 16:25,63,69.2,81,64.6,144,66.6,2,0,0
10/10/2017 16:30,52,70.7,70,66.2,122,68.1,2,0,0
10/10/2017 16:35,60,70.8,77,66.3,137,68.3,2,0,0
10/10/2017 16:40,57,71.6,74,67.2,131,69.1,2,0,0
10/10/2017 16:45,63,70.9,82,66.4,145,68.4,2,0,0
10/10/2017 16:50,66,70.1,86,65.6,152,67.6,2,0,0
10/10/2017 16:55,59,69.9,77,65.3,136,67.3,2,0,0
10/10/2017 17:00,52,68.7,69,64,121,66,2,0,0
10/10/2017 17:05,54,68.8,72,64.1,126,66.1,2,0,0
10/10/2017 17:10,61,68.5,79,63.9,140,65.9,2,0,0
10/10/2017 17:15,52,69.3,70,64.8,122,66.7,2,0,0
10/10/2017 17:20,57,69.2,76,64.6,133,66.6,2,0,0
10/10/2017 17:25,56,69.2,74,64.6,130,66.6,2,0,0
10/10/2017 17:30,50,69.4,68,64.8,118,66.7,2,0,0
10/10/2017 17:35,46,69.4,64,64.8,110,66.7,2,0,0
10/10/2017 17:40,53,69,70,64.3,123,66.3,2,0,0
10/10/2017 17:45,51,69.7,69,65.1,120,67.1,2,0,0
10/10/2017 17:50,51,70.6,69,66,120,67.9,2,0,0
10/10/2017 17:55,54,70,73,65.4,127,67.3,2,0,0
10/10/2017 18:00,50,69.5,67,64.9,117,66.9,2,0,0
10/10/2017 18:05,51,69.7,69,65.2,120,67.1,2,0,0
10/10/2017 18:10,46,68.9,63,64.2,109,66.2,2,0,0
10/10/2017 18:15,55,68.7,73,64,128,66,2,0,0
10/10/2017 18:20,55,69.2,73,64.5,128,66.5,2,0,0
10/10/2017 18:25,56,69.1,74,64.4,130,66.4,2,0,0
10/10/2017 18:30,46,69.6,64,65,110,66.9,2,0,0
10/10/2017 18:35,55,69.1,74,64.5,129,66.5,2,0,0
10/10/2017 18:40,50,69.2,68,64.5,118,66.5,2,0,0
10/10/2017 18:45,52,69.3,69,64.7,121,66.6,2,0,0
10/10/2017 18:50,53,68.7,71,64,124,66,2,0,0
10/10/2017 18:55,50,68.5,68,63.8,118,65.8,2,0,0
10/10/2017 19:00,54,68.6,73,63.9,127,65.9,2,0,0
10/10/2017 19:05,46,68.5,64,63.8,110,65.7,2,0,0
10/10/2017 19:10,55,69.2,73,64.5,128,66.5,2,0,0
10/10/2017 19:15,52,68.5,71,63.8,123,65.8,2,0,0
10/10/2017 19:20,52,68.5,69,63.8,121,65.8,2,0,0
10/10/2017 19:25,58,68.1,76,63.3,134,65.4,2,0,0
10/10/2017 19:30,46,68.8,63,64.2,109,66.2,2,0,0
10/10/2017 19:35,49,69.4,65,64.8,114,66.8,2,0,0
10/10/2017 19:40,44,69.7,61,65.1,105,67,2,0,0
10/10/2017 19:45,43,68.5,60,63.7,103,65.7,2,0,0
10/10/2017 19:50,34,69.2,50,64.6,84,66.5,2,0,0
10/10/2017 19:55,38,68.4,55,63.7,93,65.6,2,0,0
10/10/2017 20:00,36,69.4,53,64.8,89,66.7,2,0,0
10/10/2017 20:05,31,69.5,47,64.9,78,66.7,2,0,0
10/10/2017 20:10,32,69.6,48,65,80,66.8,2,0,0
10/10/2017 20:15,31,69.7,47,65.1,78,66.9,2,0,0
10/10/2017 20:20,31,69.7,47,65.1,78,66.9,2,0,0
10/10/2017 20:25,34,68.8,51,64.2,85,66,2,0,0
10/10/2017 20:30,32,68.4,49,63.7,81,65.6,2,0,0
10/10/2017 20:35,37,69.2,55,64.6,92,66.5,2,0,0
10/10/2017 20:40,34,67.8,50,63.1,84,65,2,0,0
10/10/2017 20:45,34,68.7,50,64.1,84,66,2,0,0
10/10/2017 20:50,33,69.1,49,64.5,82,66.4,2,0,0
10/10/2017 20:55,34,69.3,50,64.7,84,66.6,2,0,0
10/10/2017 21:00,25,69.2,41,64.6,66,66.3,2,0,0
10/10/2017 21:05,26,69.5,41,64.9,67,66.7,2,0,0
10/10/2017 21:10,23,69.6,40,65,63,66.6,2,0,0
10/10/2017 21:15,26,69.4,43,64.8,69,66.6,2,0,0
10/10/2017 21:20,23,69.4,39,64.8,62,66.5,2,0,0
10/10/2017 21:25,24,69.3,41,64.7,65,66.4,2,0,0
10/10/2017 21:30,20,69.5,36,64.9,56,66.5,2,0,0
10/10/2017 21:35,26,69.4,42,64.8,68,66.6,2,0,0
10/10/2017 21:40,25,69.6,40,65,65,66.8,2,0,0
10/10/2017 21:45,23,69.8,39,65.3,62,67,2,0,0
10/10/2017 21:50,21,69.8,37,65.2,58,66.9,2,0,0
10/10/2017 21:55,26,70,42,65.4,68,67.1,2,0,0
10/10/2017 22:00,25,69.7,41,65.2,66,66.9,2,0,0
10/10/2017 22:05,21,69.5,36,64.9,57,66.5,2,0,0
10/10/2017 22:10,20,69.1,36,64.4,56,66.1,2,0,0
10/10/2017 22:15,20,69.1,36,64.5,56,66.1,2,0,0
10/10/2017 22:20,19,69.4,35,64.8,54,66.4,2,0,0
10/10/2017 22:25,19,69,35,64.4,54,66,2,0,0
10/10/2017 22:30,19,68.6,35,64,54,65.6,2,0,0
10/10/2017 22:35,20,68.8,36,64.2,56,65.8,2,0,0
10/10/2017 22:40,19,69.2,34,64.5,53,66.2,2,0,0
10/10/2017 22:45,18,68.9,33,64.3,51,65.9,2,0,0
10/10/2017 22:50,15,69.1,31,64.5,46,66,2,0,0
10/10/2017 22:55,16,69.3,31,64.7,47,66.3,2,0,0
10/10/2017 23:00,19,69,35,64.3,54,66,2,0,0
10/10/2017 23:05,11,69.2,26,64.5,37,65.9,2,0,0
10/10/2017 23:10,17,69.2,33,64.6,50,66.2,2,0,0
10/10/2017 23:15,16,69.2,32,64.6,48,66.1,2,0,0
10/10/2017 23:20,15,69.3,30,64.7,45,66.2,2,0,0
10/10/2017 23:25,17,69.1,33,64.5,50,66,2,0,0
10/10/2017 23:30,19,68.8,34,64.2,53,65.9,2,0,0
10/10/2017 23:35,18,69,34,64.4,52,66,2,0,0
10/10/2017 23:40,18,69.5,34,64.9,52,66.5,2,0,0
10/10/2017 23:45,13,69.4,28,64.8,41,66.3,2,0,0
10/10/2017 23:50,15,69.5,30,64.9,45,66.5,2,0,0
10/10/2017 23:55,16,69.5,32,64.9,48,66.4,2,0,0
10/11/2017 0:00,14,69.3,30,64.7,44,66.2,2,0,0
10/11/2017 0:05,12,69.4,27,64.8,39,66.3,2,0,0
10/11/2017 0:10,12,69.4,28,64.8,40,66.2,2,0,0
10/11/2017 0:15,12,69.5,27,64.9,39,66.3,2,0,0
10/11/2017 0:20,10,69.5,26,64.9,36,66.2,2,0,0
10/11/2017 0:25,11,69.3,27,64.7,38,66.1,2,0,0
10/11/2017 0:30,9,69.3,24,64.7,33,66,2,0,0
10/11/2017 0:35,8,69.3,24,64.7,32,65.9,2,0,0
10/11/2017 0:40,12,69.4,27,64.8,39,66.2,2,0,0
10/11/2017 0:45,8,69.5,23,64.9,31,66.1,2,0,0
10/11/2017 0:50,7,69.4,22,64.8,29,65.9,2,0,0
10/11/2017 0:55,8,69.4,24,64.7,32,65.9,2,0,0
10/11/2017 1:00,5,69.4,20,64.8,25,65.7,2,0,0
10/11/2017 1:05,12,69.2,27,64.6,39,66,2,0,0
10/11/2017 1:10,8,69.3,23,64.7,31,65.9,2,0,0
10/11/2017 1:15,6,69.4,21,64.8,27,65.8,2,0,0
10/11/2017 1:20,8,69.4,23,64.8,31,66,2,0,0
10/11/2017 1:25,8,69.2,23,64.5,31,65.7,2,0,0
10/11/2017 1:30,12,69.1,28,64.4,40,65.8,2,0,0
10/11/2017 1:35,9,69.1,25,64.5,34,65.7,2,0,0
10/11/2017 1:40,7,68.9,23,64.3,30,65.4,2,0,0
10/11/2017 1:45,7,69.1,22,64.4,29,65.6,2,0,0
10/11/2017 1:50,5,69.2,20,64.5,25,65.5,2,0,0
10/11/2017 1:55,10,69.2,25,64.6,35,65.9,2,0,0
10/11/2017 2:00,9,69,25,64.4,34,65.6,2,0,0
10/11/2017 2:05,9,68.2,26,63.4,35,64.6,2,0,0
10/11/2017 2:10,7,68.5,23,63.7,30,64.9,2,0,0
10/11/2017 2:15,12,68,27,63.3,39,64.7,2,0,0
10/11/2017 2:20,9,68.7,24,64.1,33,65.3,2,0,0
10/11/2017 2:25,10,68.7,26,64,36,65.3,2,0,0
10/11/2017 2:30,8,68.9,24,64.2,32,65.4,2,0,0
10/11/2017 2:35,11,69.1,27,64.4,38,65.8,2,0,0
10/11/2017 2:40,9,69.2,25,64.5,34,65.8,2,0,0
10/11/2017 2:45,15,69.1,30,64.5,45,66,2,0,0
10/11/2017 2:50,10,69.2,25,64.6,35,65.9,2,0,0
10/11/2017 2:55,10,69.3,25,64.7,35,66.1,2,0,0
10/11/2017 3:00,10,69,25,64.4,35,65.7,2,0,0
10/11/2017 3:05,12,68.9,28,64.2,40,65.6,2,0,0
10/11/2017 3:10,14,68.7,30,64.1,44,65.5,2,0,0
10/11/2017 3:15,12,68.9,28,64.2,40,65.6,2,0,0
10/11/2017 3:20,11,69.1,26,64.4,37,65.8,2,0,0
10/11/2017 3:25,9,69,25,64.4,34,65.6,2,0,0
10/11/2017 3:30,16,69,33,64.3,49,65.8,2,0,0
10/11/2017 3:35,12,69.2,28,64.5,40,65.9,2,0,0
10/11/2017 3:40,17,69.4,33,64.8,50,66.3,2,0,0
10/11/2017 3:45,12,69.4,28,64.8,40,66.2,2,0,0
10/11/2017 3:50,19,69.2,35,64.5,54,66.2,2,0,0
10/11/2017 3:55,16,68.8,32,64.1,48,65.7,2,0,0
10/11/2017 4:00,18,68.1,34,63.3,52,65,2,0,0
10/11/2017 4:05,17,68,33,63.3,50,64.9,2,0,0
10/11/2017 4:10,20,68.7,36,64,56,65.7,2,0,0
10/11/2017 4:15,22,68.8,38,64.1,60,65.8,2,0,0
10/11/2017 4:20,18,69,34,64.4,52,66,2,0,0
10/11/2017 4:25,22,69.3,39,64.7,61,66.3,2,0,0
10/11/2017 4:30,23,69.3,40,64.7,63,66.3,2,0,0
10/11/2017 4:35,32,69,50,64.3,82,66.1,2,0,0
10/11/2017 4:40,33,68.7,50,64,83,65.9,2,0,0
10/11/2017 4:45,39,67,56,62.3,95,64.2,2,0,0
10/11/2017 4:50,35,68.6,53,64,88,65.8,2,0,0
10/11/2017 4:55,36,68.3,54,63.6,90,65.5,2,0,0
10/11/2017 5:00,40,69.6,58,65,98,66.9,2,0,0
10/11/2017 5:05,43,68.8,62,64.2,105,66.1,2,0,0
10/11/2017 5:10,46,68.4,65,63.8,111,65.7,2,0,0
10/11/2017 5:15,55,67.2,74,62.4,129,64.4,2,0,0
10/11/2017 5:20,51,68.7,72,64.1,123,66,2,0,0
10/11/2017 5:25,52,69.4,72,64.9,124,66.8,2,0,0
10/11/2017 5:30,58,70.3,78,65.8,136,67.7,2,0,0
10/11/2017 5:35,64,68.9,85,64.2,149,66.2,2,0,0
10/11/2017 5:40,65,67.8,87,63,152,65.1,2,0,0
10/11/2017 5:45,63,67.6,85,62.8,148,64.9,2,0,0
10/11/2017 5:50,75,67.9,97,63.2,172,65.2,2,0,0
10/11/2017 5:55,73,66.9,96,62.1,169,64.2,2,0,0
10/11/2017 6:00,67,66.8,89,61.9,156,64,2,0,0
10/11/2017 6:05,59,66.6,78,61.8,137,63.9,2,0,0
10/11/2017 6:10,71,66.4,93,61.5,164,63.6,2,0,0
10/11/2017 6:15,51,67.1,71,62.2,122,64.2,2,0,0
10/11/2017 6:20,63,67.9,84,63.1,147,65.2,2,0,0
10/11/2017 6:25,72,67,95,62,167,64.2,2,0,0
10/11/2017 6:30,60,67.2,81,62.3,141,64.4,2,0,0
10/11/2017 6:35,68,67.4,90,62.5,158,64.6,2,0,0
10/11/2017 6:40,65,66.9,88,61.9,153,64,2,0,0
10/11/2017 6:45,80,66.9,103,62,183,64.1,2,0,0
10/11/2017 6:50,74,67.3,97,62.4,171,64.5,2,0,0
10/11/2017 6:55,68,67.9,89,63.1,157,65.2,2,0,0
10/11/2017 7:00,62,68,84,63.1,146,65.2,2,0,0
10/11/2017 7:05,71,66.8,93,61.8,164,64,2,0,0
10/11/2017 7:10,70,65.9,93,60.9,163,63,2,0,0
10/11/2017 7:15,73,66.8,96,61.9,169,64,2,0,0
10/11/2017 7:20,73,67.2,96,62.3,169,64.4,2,0,0
10/11/2017 7:25,79,67.8,101,63,180,65.1,2,0,0
10/11/2017 7:30,75,68.8,97,64,172,66.1,2,0,0
10/11/2017 7:35,73,68.4,95,63.6,168,65.7,2,0,0
10/11/2017 7:40,88,67.4,113,62.5,201,64.7,2,0,0
10/11/2017 7:45,83,67.8,106,62.9,189,65.1,2,0,0
10/11/2017 7:50,90,67.7,114,62.8,204,64.9,2,0,0
10/11/2017 7:55,88,68.5,112,63.6,200,65.8,2,0,0
10/11/2017 8:00,77,68.5,99,63.7,176,65.8,2,0,0
10/11/2017 8:05,81,68.1,102,63.3,183,65.5,2,0,0
10/11/2017 8:10,78,68.4,100,63.6,178,65.7,2,0,0
10/11/2017 8:15,82,67.8,106,62.9,188,65,2,0,0
10/11/2017 8:20,86,67.9,109,63.1,195,65.2,2,0,0
10/11/2017 8:25,83,65.2,106,60.1,189,62.3,2,0,0
10/11/2017 8:30,85,66.1,108,61.1,193,63.3,2,0,0
10/11/2017 8:35,80,66.2,103,61.3,183,63.4,2,0,0
10/11/2017 8:40,81,66.3,103,61.4,184,63.5,2,0,0
10/11/2017 8:45,80,65.2,102,60.1,182,62.4,2,0,0
10/11/2017 8:50,84,66,107,61,191,63.2,2,0,0
10/11/2017 8:55,90,65.9,112,60.8,202,63.1,2,0,0
10/11/2017 9:00,73,65.8,94,60.8,167,63,2,0,0
10/11/2017 9:05,76,65.9,99,60.9,175,63.1,2,0,0
10/11/2017 9:10,71,66.9,92,61.9,163,64.1,2,0,0
10/11/2017 9:15,69,66.4,91,61.4,160,63.5,2,0,0
10/11/2017 9:20,76,66.7,97,61.8,173,64,2,0,0
10/11/2017 9:25,69,67.1,89,62.2,158,64.3,2,0,0
10/11/2017 9:30,66,66.7,88,61.8,154,63.9,2,0,0
10/11/2017 9:35,73,66.6,94,61.7,167,63.8,2,0,0
10/11/2017 9:40,76,65.5,97,60.5,173,62.7,2,0,0
10/11/2017 9:45,63,65.8,83,60.8,146,63,2,0,0
10/11/2017 9:50,76,66,97,61,173,63.2,2,0,0
10/11/2017 9:55,63,66,83,61,146,63.1,2,0,0
10/11/2017 10:00,73,66.5,93,61.5,166,63.7,2,0,0
10/11/2017 10:05,69,66.5,89,61.6,158,63.7,2,0,0
10/11/2017 10:10,63,65.8,83,60.8,146,63,2,0,0
10/11/2017 10:15,76,64.8,98,59.8,174,61.9,2,0,0
10/11/2017 10:20,72,65,92,60,164,62.2,2,0,0
10/11/2017 10:25,63,66.4,82,61.5,145,63.6,2,0,0
10/11/2017 10:30,52,66.5,70,61.6,122,63.7,2,0,0
10/11/2017 10:35,60,65.8,79,60.9,139,63,2,0,0
10/11/2017 10:40,60,65.3,79,60.4,139,62.5,2,0,0
10/11/2017 10:45,59,66,77,61.1,136,63.2,2,0,0
10/11/2017 10:50,64,65.2,83,60.3,147,62.5,2,0,0
10/11/2017 10:55,53,65.3,71,60.4,124,62.5,2,0,0
10/11/2017 11:00,64,66.3,83,61.4,147,63.5,2,0,0
10/11/2017 11:05,62,67,80,62.1,142,64.2,2,0,0
10/11/2017 11:10,50,67.6,67,62.8,117,64.9,2,0,0
10/11/2017 11:15,60,66.6,79,61.8,139,63.9,2,0,0
10/11/2017 11:20,61,66.8,80,62,141,64.1,2,0,0
10/11/2017 11:25,59,67.7,77,62.9,136,65,2,0,0
10/11/2017 11:30,56,67.1,75,62.3,131,64.3,2,0,0
10/11/2017 11:35,55,66.7,74,62,129,64,2,0,0
10/11/2017 11:40,59,67.3,76,62.6,135,64.7,2,0,0
10/11/2017 11:45,55,67.2,74,62.4,129,64.5,2,0,0
10/11/2017 11:50,55,66,74,61.1,129,63.2,2,0,0
10/11/2017 11:55,58,66.9,77,62.2,135,64.2,2,0,0
10/11/2017 12:00,49,68,67,63.3,116,65.3,2,0,0
10/11/2017 12:05,52,67.7,70,63,122,65,2,0,0
10/11/2017 12:10,47,69,65,64.4,112,66.3,2,0,0
10/11/2017 12:15,60,68.9,79,64.3,139,66.3,2,0,0
10/11/2017 12:20,51,70,69,65.4,120,67.4,2,0,0
10/11/2017 12:25,44,69.2,61,64.5,105,66.5,2,0,0
10/11/2017 12:30,45,69.3,63,64.7,108,66.6,2,0,0
10/11/2017 12:35,42,69.4,59,64.7,101,66.7,2,0,0
10/11/2017 12:40,48,69.2,66,64.5,114,66.5,2,0,0
10/11/2017 12:45,52,70.7,70,66.2,122,68.1,2,0,0
10/11/2017 12:50,49,70.2,67,65.6,116,67.5,2,0,0
10/11/2017 12:55,49,69.2,66,64.6,115,66.6,2,0,0
10/11/2017 13:00,44,69.9,62,65.4,106,67.3,2,0,0
10/11/2017 13:05,51,70.2,69,65.6,120,67.6,2,0,0
10/11/2017 13:10,55,70.1,73,65.5,128,67.5,2,0,0
10/11/2017 13:15,52,69.2,70,64.6,122,66.6,2,0,0
10/11/2017 13:20,43,69.7,60,65.1,103,67,2,0,0
10/11/2017 13:25,55,67.5,73,62.7,128,64.8,2,0,0
10/11/2017 13:30,61,68.6,79,64,140,66,2,0,0
10/11/2017 13:35,51,67.8,68,63.1,119,65.1,2,0,0
10/11/2017 13:40,55,69.1,72,64.4,127,66.4,2,0,0
10/11/2017 13:45,56,68.5,75,63.7,131,65.8,2,0,0
10/11/2017 13:50,53,69.4,71,64.8,124,66.8,2,0,0
10/11/2017 13:55,48,68.7,65,64.1,113,66,2,0,0
10/11/2017 14:00,46,69,63,64.4,109,66.3,2,0,0
10/11/2017 14:05,47,69.1,64,64.5,111,66.4,2,0,0
10/11/2017 14:10,47,68.9,64,64.2,111,66.2,2,0,0
10/11/2017 14:15,48,68.9,66,64.2,114,66.2,2,0,0
10/11/2017 14:20,53,68.5,71,63.8,124,65.8,2,0,0
10/11/2017 14:25,56,68,74,63.2,130,65.3,2,0,0
10/11/2017 14:30,56,67.7,74,62.9,130,65,2,0,0
10/11/2017 14:35,48,69.3,66,64.6,114,66.6,2,0,0
10/11/2017 14:40,46,69.4,64,64.7,110,66.7,2,0,0
10/11/2017 14:45,51,70,69,65.5,120,67.4,2,0,0
10/11/2017 14:50,52,69.6,69,65,121,67,2,0,0
10/11/2017 14:55,49,69.8,67,65.2,116,67.2,2,0,0
10/11/2017 15:00,43,68.4,60,63.6,103,65.6,2,0,0
10/11/2017 15:05,52,67.5,70,62.6,122,64.7,2,0,0
10/11/2017 15:10,51,67,69,62.1,120,64.2,2,0,0
10/11/2017 15:15,49,65.1,67,60,116,62.1,2,0,0
10/11/2017 15:20,56,64.9,76,59.9,132,62,2,0,0
10/11/2017 15:25,51,67.8,69,63,120,65.1,2,0,0
10/11/2017 15:30,60,68.4,77,63.6,137,65.7,2,0,0
10/11/2017 15:35,55,68.1,74,63.4,129,65.4,2,0,0
10/11/2017 15:40,58,68.7,77,64.1,135,66.1,2,0,0
10/11/2017 15:45,57,67.7,75,62.8,132,64.9,2,0,0
10/11/2017 15:50,58,67.9,75,63.1,133,65.2,2,0,0
10/11/2017 15:55,49,67.8,67,63.1,116,65.1,2,0,0
10/11/2017 16:00,60,67.7,79,62.9,139,65,2,0,0
10/11/2017 16:05,55,67.8,72,63.1,127,65.1,2,0,0
10/11/2017 16:10,49,68.3,68,63.6,117,65.6,2,0,0
10/11/2017 16:15,58,68.5,75,63.9,133,65.9,2,0,0
10/11/2017 16:20,47,68.4,65,63.7,112,65.7,2,0,0
10/11/2017 16:25,50,68,68,63.3,118,65.3,2,0,0
10/11/2017 16:30,45,69.3,62,64.7,107,66.6,2,0,0
10/11/2017 16:35,47,67.2,66,62.3,113,64.3,2,0,0
10/11/2017 16:40,50,67.6,67,62.7,117,64.8,2,0,0
10/11/2017 16:45,49,68.9,67,64.2,116,66.1,2,0,0
10/11/2017 16:50,42,68,59,63.2,101,65.2,2,0,0
10/11/2017 16:55,45,67.8,62,63,107,65,2,0,0
10/11/2017 17:00,44,67.8,61,63,105,65,2,0,0
10/11/2017 17:05,43,67.8,61,63,104,65,2,0,0
10/11/2017 17:10,40,69.3,58,64.7,98,66.6,2,0,0
10/11/2017 17:15,46,69.2,63,64.6,109,66.5,2,0,0
10/11/2017 17:20,55,68.6,74,63.9,129,65.9,2,0,0
10/11/2017 17:25,46,69,64,64.3,110,66.3,2,0,0
10/11/2017 17:30,47,68.6,64,63.8,111,65.9,2,0,0
10/11/2017 17:35,51,69.1,70,64.4,121,66.4,2,0,0
10/11/2017 17:40,42,69.6,59,65,101,67,2,0,0
10/11/2017 17:45,52,69.6,70,65.1,122,67,2,0,0
10/11/2017 17:50,50,69.5,68,64.9,118,66.8,2,0,0
10/11/2017 17:55,47,69.9,64,65.4,111,67.3,2,0,0
10/11/2017 18:00,50,69.8,67,65.3,117,67.2,2,0,0
10/11/2017 18:05,50,70.4,68,65.9,118,67.8,2,0,0
10/11/2017 18:10,53,69.7,70,65.1,123,67.1,2,0,0
10/11/2017 18:15,45,70.4,62,65.8,107,67.8,2,0,0
10/11/2017 18:20,52,71.4,70,66.9,122,68.8,2,0,0
10/11/2017 18:25,43,70.2,60,65.7,103,67.6,2,0,0
10/11/2017 18:30,45,69.3,62,64.7,107,66.7,2,0,0
10/11/2017 18:35,49,70,67,65.5,116,67.4,2,0,0
10/11/2017 18:40,43,69.4,61,64.8,104,66.7,2,0,0
10/11/2017 18:45,48,69,66,64.4,114,66.3,2,0,0
10/11/2017 18:50,49,69,66,64.4,115,66.3,2,0,0
10/11/2017 18:55,51,69.3,69,64.7,120,66.7,2,0,0
10/11/2017 19:00,45,69.3,62,64.7,107,66.6,2,0,0
10/11/2017 19:05,40,69.2,57,64.5,97,66.4,2,0,0
10/11/2017 19:10,46,68.3,64,63.5,110,65.5,2,0,0
10/11/2017 19:15,38,67.9,56,63,94,65,2,0,0
10/11/2017 19:20,48,67.7,66,62.9,114,64.9,2,0,0
10/11/2017 19:25,37,68,54,63.2,91,65.2,2,0,0
10/11/2017 19:30,47,67.8,65,63,112,65,2,0,0
10/11/2017 19:35,34,69.1,50,64.4,84,66.3,2,0,0
10/11/2017 19:40,36,69.2,53,64.5,89,66.4,2,0,0
10/11/2017 19:45,37,68.9,53,64.2,90,66.1,2,0,0
10/11/2017 19:50,30,69.5,47,64.9,77,66.7,2,0,0
10/11/2017 19:55,30,69.6,47,65,77,66.8,2,0,0
10/11/2017 20:00,32,69.6,49,65,81,66.9,2,0,0
10/11/2017 20:05,36,69.5,52,64.9,88,66.8,2,0,0
10/11/2017 20:10,34,69.6,51,65,85,66.9,2,0,0
10/11/2017 20:15,27,69.8,43,65.3,70,67,2,0,0
10/11/2017 20:20,38,69.4,55,64.8,93,66.7,2,0,0
10/11/2017 20:25,32,69.2,48,64.6,80,66.4,2,0,0
10/11/2017 20:30,32,69.5,48,64.9,80,66.7,2,0,0
10/11/2017 20:35,36,69.6,53,65,89,66.8,2,0,0
10/11/2017 20:40,30,69.8,46,65.3,76,67.1,2,0,0
10/11/2017 20:45,32,69.5,49,64.9,81,66.7,2,0,0
10/11/2017 20:50,29,69.8,45,65.2,74,67,2,0,0
10/11/2017 20:55,29,70.2,45,65.7,74,67.5,2,0,0
10/11/2017 21:00,33,69.3,49,64.7,82,66.6,2,0,0
10/11/2017 21:05,24,69.5,39,64.9,63,66.6,2,0,0
10/11/2017 21:10,21,69,37,64.3,58,66,2,0,0
10/11/2017 21:15,25,69.2,42,64.6,67,66.3,2,0,0
10/11/2017 21:20,24,69.3,40,64.7,64,66.4,2,0,0
10/11/2017 21:25,22,69,39,64.3,61,66,2,0,0
10/11/2017 21:30,32,69.5,48,64.9,80,66.7,2,0,0
10/11/2017 21:35,22,69.1,38,64.4,60,66.1,2,0,0
10/11/2017 21:40,33,69.4,49,64.8,82,66.7,2,0,0
10/11/2017 21:45,25,69.6,41,65,66,66.8,2,0,0
10/11/2017 21:50,26,70.1,42,65.6,68,67.3,2,0,0
10/11/2017 21:55,30,69.8,46,65.2,76,67,2,0,0
10/11/2017 22:00,24,69.6,40,65,64,66.8,2,0,0
10/11/2017 22:05,29,69.3,45,64.6,74,66.4,2,0,0
10/11/2017 22:10,23,69.3,39,64.7,62,66.4,2,0,0
10/11/2017 22:15,19,69.4,34,64.8,53,66.5,2,0,0
10/11/2017 22:20,25,69.4,41,64.8,66,66.5,2,0,0
10/11/2017 22:25,18,69.4,33,64.8,51,66.4,2,0,0
10/11/2017 22:30,21,69.6,36,65,57,66.7,2,0,0
10/11/2017 22:35,15,69.6,30,65,45,66.5,2,0,0
10/11/2017 22:40,19,69.8,35,65.2,54,66.8,2,0,0
10/11/2017 22:45,19,69.4,35,64.8,54,66.5,2,0,0
10/11/2017 22:50,24,69.8,40,65.2,64,66.9,2,0,0
10/11/2017 22:55,18,68.9,33,64.3,51,65.9,2,0,0
10/11/2017 23:00,16,69.2,32,64.6,48,66.1,2,0,0
10/11/2017 23:05,14,69.1,30,64.5,44,65.9,2,0,0
10/11/2017 23:10,13,69,29,64.4,42,65.8,2,0,0
10/11/2017 23:15,13,69.2,28,64.6,41,66,2,0,0
10/11/2017 23:20,13,69,28,64.4,41,65.9,2,0,0
10/11/2017 23:25,18,69.2,34,64.6,52,66.2,2,0,0
10/11/2017 23:30,18,69.1,34,64.5,52,66.1,2,0,0
10/11/2017 23:35,15,69.3,30,64.7,45,66.2,2,0,0
10/11/2017 23:40,15,69.3,30,64.7,45,66.2,2,0,0
10/11/2017 23:45,14,69,29,64.3,43,65.8,2,0,0
10/11/2017 23:50,16,68.3,31,63.6,47,65.2,2,0,0
10/11/2017 23:55,15,68.9,31,64.2,46,65.7,2,0,0
10/12/2017 0:00,10,69.3,25,64.7,35,66.1,2,0,0
10/12/2017 0:05,11,69.3,26,64.7,37,66.1,2,0,0
10/12/2017 0:10,13,69.4,28,64.8,41,66.3,2,0,0
10/12/2017 0:15,7,69.2,22,64.6,29,65.7,2,0,0
10/12/2017 0:20,10,69.4,25,64.8,35,66.1,2,0,0
10/12/2017 0:25,8,69.3,23,64.7,31,65.9,2,0,0
10/12/2017 0:30,12,69.6,27,65,39,66.4,2,0,0
10/12/2017 0:35,8,69.4,24,64.8,32,65.9,2,0,0
10/12/2017 0:40,10,69.4,26,64.8,36,66.1,2,0,0
10/12/2017 0:45,6,69.4,21,64.8,27,65.8,2,0,0
10/12/2017 0:50,7,69.4,22,64.8,29,66,2,0,0
10/12/2017 0:55,9,69.4,24,64.8,33,66.1,2,0,0
10/12/2017 1:00,6,69.5,21,64.9,27,65.9,2,0,0
10/12/2017 1:05,7,69.2,22,64.6,29,65.7,2,0,0
10/12/2017 1:10,7,69.2,22,64.6,29,65.7,2,0,0
10/12/2017 1:15,4,69.3,20,64.7,24,65.4,2,0,0
10/12/2017 1:20,5,69.3,21,64.7,26,65.5,2,0,0
10/12/2017 1:25,12,69.3,21,64.7,33,66.4,2,0,0
10/12/2017 1:30,8,69.3,23,64.7,31,65.9,2,0,0
10/12/2017 1:35,11,69.4,26,64.8,37,66.1,2,0,0
10/12/2017 1:40,6,69.4,21,64.8,27,65.8,2,0,0
10/12/2017 1:45,6,69.3,21,64.7,27,65.7,2,0,0
10/12/2017 1:50,6,69.3,21,64.7,27,65.8,2,0,0
10/12/2017 1:55,8,69.4,24,64.8,32,66,2,0,0
10/12/2017 2:00,8,69.4,19,64.8,27,66.1,2,0,0
10/12/2017 2:05,6,69.2,21,64.5,27,65.6,2,0,0
10/12/2017 2:10,12,69.3,21,64.7,33,66.4,2,0,0
10/12/2017 2:15,7,69.3,22,64.7,29,65.8,2,0,0
10/12/2017 2:20,8,69.3,24,64.7,32,65.8,2,0,0
10/12/2017 2:25,8,69.2,23,64.5,31,65.7,2,0,0
10/12/2017 2:30,6,69.2,21,64.5,27,65.6,2,0,0
10/12/2017 2:35,8,69.3,23,64.7,31,65.8,2,0,0
10/12/2017 2:40,8,69.4,23,64.8,31,66,2,0,0
10/12/2017 2:45,12,69.3,27,64.7,39,66.1,2,0,0
10/12/2017 2:50,9,69.5,24,64.9,33,66.1,2,0,0
10/12/2017 2:55,11,69.6,27,65,38,66.3,2,0,0
10/12/2017 3:00,11,69.6,26,65,37,66.4,2,0,0
10/12/2017 3:05,10,69.6,26,65,36,66.3,2,0,0
10/12/2017 3:10,11,69.6,26,65,37,66.3,2,0,0
10/12/2017 3:15,11,69.2,27,64.6,38,65.9,2,0,0
10/12/2017 3:20,9,69.1,25,64.5,34,65.7,2,0,0
10/12/2017 3:25,12,68.8,27,64.2,39,65.6,2,0,0
10/12/2017 3:30,15,68.8,30,64.2,45,65.7,2,0,0
10/12/2017 3:35,9,68.9,25,64.2,34,65.5,2,0,0
10/12/2017 3:40,11,68.8,27,64.1,38,65.5,2,0,0
10/12/2017 3:45,10,69.1,25,64.4,35,65.8,2,0,0
10/12/2017 3:50,18,69.1,34,64.5,52,66.1,2,0,0
10/12/2017 3:55,12,69.4,27,64.8,39,66.2,2,0,0
10/12/2017 4:00,15,69.2,31,64.6,46,66.1,2,0,0
10/12/2017 4:05,15,69.3,31,64.7,46,66.2,2,0,0
10/12/2017 4:10,17,69.4,33,64.8,50,66.3,2,0,0
10/12/2017 4:15,16,69.3,32,64.7,48,66.3,2,0,0
10/12/2017 4:20,24,69.5,40,64.9,64,66.6,2,0,0
10/12/2017 4:25,29,69.3,47,64.7,76,66.4,2,0,0
10/12/2017 4:30,24,69.2,41,64.6,65,66.3,2,0,0
10/12/2017 4:35,26,69.5,43,65,69,66.7,2,0,0
10/12/2017 4:40,36,69.6,54,65,90,66.8,2,0,0
10/12/2017 4:45,38,69.4,57,64.8,95,66.7,2,0,0
10/12/2017 4:50,33,69.4,51,64.8,84,66.6,2,0,0
10/12/2017 4:55,37,69.9,55,65.4,92,67.2,2,0,0
10/12/2017 5:00,41,69.8,59,65.2,100,67.1,2,0,0
10/12/2017 5:05,44,70.3,63,65.8,107,67.6,2,0,0
10/12/2017 5:10,43,70.3,63,65.8,106,67.6,2,0,0
10/12/2017 5:15,51,70.8,70,66.4,121,68.3,2,0,0
10/12/2017 5:20,52,70.6,71,66.2,123,68.1,2,0,0
10/12/2017 5:25,50,69.3,70,64.7,120,66.6,2,0,0
10/12/2017 5:30,57,69,78,64.4,135,66.4,2,0,0
10/12/2017 5:35,62,69.7,83,65.1,145,67.1,2,0,0
10/12/2017 5:40,63,68.7,85,64.1,148,66.1,2,0,0
10/12/2017 5:45,65,69.9,86,65.4,151,67.3,2,0,0
10/12/2017 5:50,61,68.7,82,64,143,66,2,0,0
10/12/2017 5:55,64,68.1,86,63.4,150,65.4,2,0,0
10/12/2017 6:00,52,66.8,72,61.9,124,63.9,2,0,0
10/12/2017 6:05,65,68,87,63.2,152,65.2,2,0,0
10/12/2017 6:10,64,69.3,85,64.6,149,66.6,2,0,0
10/12/2017 6:15,68,69,89,64.3,157,66.3,2,0,0
10/12/2017 6:20,67,68.2,89,63.4,156,65.5,2,0,0
10/12/2017 6:25,60,68.8,81,64.1,141,66.1,2,0,0
10/12/2017 6:30,73,67.5,95,62.6,168,64.7,2,0,0
10/12/2017 6:35,61,68.3,81,63.5,142,65.6,2,0,0
10/12/2017 6:40,66,67.4,88,62.5,154,64.6,2,0,0
10/12/2017 6:45,64,68.2,86,63.5,150,65.5,2,0,0
10/12/2017 6:50,74,68.8,96,64,170,66.1,2,0,0
10/12/2017 6:55,72,69.6,93,64.9,165,66.9,2,0,0
10/12/2017 7:00,53,68.1,73,63.4,126,65.4,2,0,0
10/12/2017 7:05,60,67.3,81,62.5,141,64.5,2,0,0
10/12/2017 7:10,71,67.7,92,62.9,163,65,2,0,0
10/12/2017 7:15,83,67.6,106,62.8,189,64.9,2,0,0
10/12/2017 7:20,85,67.9,108,63.2,193,65.3,2,0,0
10/12/2017 7:25,91,67.9,115,63.1,206,65.2,2,0,0
10/12/2017 7:30,78,67.7,101,62.9,179,65,2,0,0
10/12/2017 7:35,100,67.6,125,62.8,225,64.9,2,0,0
10/12/2017 7:40,101,66.5,126,61.6,227,63.8,2,0,0
10/12/2017 7:45,87,67.3,110,62.4,197,64.6,2,0,0
10/12/2017 7:50,93,68,118,63.2,211,65.3,2,0,0
10/12/2017 7:55,84,67.3,107,62.5,191,64.6,2,0,0
10/12/2017 8:00,85,67.2,108,62.3,193,64.5,2,0,0
10/12/2017 8:05,94,67.5,118,62.7,212,64.8,2,0,0
10/12/2017 8:10,86,67.1,109,62.1,195,64.3,2,0,0
10/12/2017 8:15,98,66.1,123,61,221,63.3,2,0,0
10/12/2017 8:20,88,65.6,113,60.5,201,62.8,2,0,0
10/12/2017 8:25,80,66,102,61,182,63.2,2,0,0
10/12/2017 8:30,94,66.6,118,61.7,212,63.9,2,0,0
10/12/2017 8:35,84,66.1,106,61.1,190,63.3,2,0,0
10/12/2017 8:40,82,65.9,105,60.8,187,63,2,0,0
10/12/2017 8:45,75,64.6,97,59.4,172,61.7,2,0,0
10/12/2017 8:50,81,66.1,103,61.1,184,63.3,2,0,0
10/12/2017 8:55,78,65.4,100,60.3,178,62.6,2,0,0
10/12/2017 9:00,81,65.2,103,60.1,184,62.3,2,0,0
10/12/2017 9:05,74,64.1,95,59,169,61.2,2,0,0
10/12/2017 9:10,80,65.1,102,60.1,182,62.3,2,0,0
10/12/2017 9:15,73,65.4,94,60.4,167,62.6,2,0,0
10/12/2017 9:20,73,64.8,93,59.8,166,62,2,0,0
10/12/2017 9:25,68,66.4,87,61.4,155,63.6,2,0,0
10/12/2017 9:30,78,67,98,62.1,176,64.3,2,0,0
10/12/2017 9:35,68,66.2,89,61.2,157,63.4,2,0,0
10/12/2017 9:40,56,66.8,75,61.9,131,64,2,0,0
10/12/2017 9:45,64,65.8,83,60.8,147,63,2,0,0
10/12/2017 9:50,60,64.8,80,59.9,140,62,2,0,0
10/12/2017 9:55,70,65,89,59.9,159,62.1,2,0,0
10/12/2017 10:00,57,65,76,60,133,62.1,2,0,0
10/12/2017 10:05,65,65.3,85,60.4,150,62.5,2,0,0
10/12/2017 10:10,74,64.9,95,60,169,62.1,2,0,0
10/12/2017 10:15,59,65.4,78,60.5,137,62.6,2,0,0
10/12/2017 10:20,63,65.8,82,60.8,145,63,2,0,0
10/12/2017 10:25,56,67.6,74,62.8,130,64.9,2,0,0
10/12/2017 10:30,55,67.9,73,63.1,128,65.1,2,0,0
10/12/2017 10:35,50,67.3,68,62.6,118,64.6,2,0,0
10/12/2017 10:40,62,67.1,82,62.3,144,64.4,2,0,0
10/12/2017 10:45,58,68.5,78,63.9,136,65.8,2,0,0
10/12/2017 10:50,54,68,72,63.3,126,65.3,2,0,0
10/12/2017 10:55,55,68,74,63.3,129,65.3,2,0,0
10/12/2017 11:00,56,67.8,74,63.1,130,65.2,2,0,0
10/12/2017 11:05,60,67.9,78,63.2,138,65.2,2,0,0
10/12/2017 11:10,59,68,78,63.2,137,65.3,2,0,0
10/12/2017 11:15,58,68,77,63.2,135,65.3,2,0,0
10/12/2017 11:20,66,68.5,85,63.8,151,65.8,2,0,0
10/12/2017 11:25,44,67.2,61,62.4,105,64.4,2,0,0
10/12/2017 11:30,56,68.4,75,63.8,131,65.8,2,0,0
10/12/2017 11:35,60,67.2,79,62.4,139,64.5,2,0,0
10/12/2017 11:40,63,68.4,81,63.7,144,65.8,2,0,0
10/12/2017 11:45,52,67.9,70,63.1,122,65.2,2,0,0
10/12/2017 11:50,54,68.6,71,63.9,125,65.9,2,0,0
10/12/2017 11:55,58,68.6,77,63.9,135,65.9,2,0,0
10/12/2017 12:00,56,68,74,63.3,130,65.3,2,0,0
10/12/2017 12:05,51,66.8,70,62,121,64,2,0,0
10/12/2017 12:10,51,68.4,67,63.7,118,65.7,2,0,0
10/12/2017 12:15,57,67.5,76,62.7,133,64.8,2,0,0
10/12/2017 12:20,49,69.4,67,64.8,116,66.7,2,0,0
10/12/2017 12:25,56,69.3,73,64.7,129,66.7,2,0,0
10/12/2017 12:30,64,69,83,64.4,147,66.4,2,0,0
10/12/2017 12:35,55,68.2,73,63.5,128,65.5,2,0,0
10/12/2017 12:40,62,67.7,81,63,143,65.1,2,0,0
10/12/2017 12:45,48,67.6,66,62.9,114,64.9,2,0,0
10/12/2017 12:50,58,67.8,76,63.1,134,65.1,2,0,0
10/12/2017 12:55,54,67.9,73,63.2,127,65.2,2,0,0
10/12/2017 13:00,37,68.6,53,64,90,65.9,2,0,0
10/12/2017 13:05,49,68.4,67,63.7,116,65.7,2,0,0
10/12/2017 13:10,43,67.2,60,62.5,103,64.4,2,0,0
10/12/2017 13:15,51,66.8,70,62,121,64,2,0,0
10/12/2017 13:20,49,68.7,67,64.1,116,66.1,2,0,0
10/12/2017 13:25,54,69.3,72,64.7,126,66.7,2,0,0
10/12/2017 13:30,48,67.6,66,62.8,114,64.8,2,0,0
10/12/2017 13:35,48,67.7,66,63,114,65,2,0,0
10/12/2017 13:40,52,67.2,71,62.4,123,64.4,2,0,0
10/12/2017 13:45,57,67.6,75,62.8,132,64.9,2,0,0
10/12/2017 13:50,58,66.5,77,61.6,135,63.7,2,0,0
10/12/2017 13:55,58,66.8,76,61.9,134,64,2,0,0
10/12/2017 14:00,51,66.9,69,62.1,120,64.1,2,0,0
10/12/2017 14:05,52,66.1,70,61.3,122,63.4,2,0,0
10/12/2017 14:10,53,66.5,70,61.7,123,63.7,2,0,0
10/12/2017 14:15,57,66.9,74,62.1,131,64.2,2,0,0
10/12/2017 14:20,50,67.7,68,62.9,118,64.9,2,0,0
10/12/2017 14:25,65,66.9,85,62.1,150,64.2,2,0,0
10/12/2017 14:30,55,67.2,73,62.4,128,64.5,2,0,0
10/12/2017 14:35,53,67.5,71,62.8,124,64.8,2,0,0
10/12/2017 14:40,52,66.9,70,62.1,122,64.2,2,0,0
10/12/2017 14:45,55,67,72,62.2,127,64.3,2,0,0
10/12/2017 14:50,46,69.2,63,64.6,109,66.5,2,0,0
10/12/2017 14:55,49,68.3,67,63.6,116,65.6,2,0,0
10/12/2017 15:00,60,68.4,79,63.7,139,65.8,2,0,0
10/12/2017 15:05,48,68.9,65,64.2,113,66.2,2,0,0
10/12/2017 15:10,61,69.1,79,64.5,140,66.5,2,0,0
10/12/2017 15:15,52,69.7,70,65.2,122,67.1,2,0,0
10/12/2017 15:20,51,69.3,69,64.7,120,66.7,2,0,0
10/12/2017 15:25,51,68.3,69,63.6,120,65.6,2,0,0
10/12/2017 15:30,49,67.9,66,63.2,115,65.2,2,0,0
10/12/2017 15:35,50,69.2,68,64.7,118,66.6,2,0,0
10/12/2017 15:40,47,68.2,65,63.5,112,65.5,2,0,0
10/12/2017 15:45,61,68.2,80,63.5,141,65.6,2,0,0
10/12/2017 15:50,57,67.5,75,62.8,132,64.8,2,0,0
10/12/2017 15:55,58,67.9,76,63.2,134,65.2,2,0,0
10/12/2017 16:00,55,68.7,72,64.1,127,66.1,2,0,0
10/12/2017 16:05,53,70,70,65.4,123,67.4,2,0,0
10/12/2017 16:10,64,67.7,84,62.9,148,65,2,0,0
10/12/2017 16:15,57,66.8,75,61.9,132,64,2,0,0
10/12/2017 16:20,51,68.5,69,63.7,120,65.7,2,0,0
10/12/2017 16:25,52,68.4,70,63.6,122,65.6,2,0,0
10/12/2017 16:30,46,68.4,63,63.6,109,65.6,2,0,0
10/12/2017 16:35,52,67.7,70,62.8,122,64.9,2,0,0
10/12/2017 16:40,51,69.1,68,64.4,119,66.4,2,0,0
10/12/2017 16:45,53,69.6,71,65,124,66.9,2,0,0
10/12/2017 16:50,53,69.4,71,64.6,124,66.6,2,0,0
10/12/2017 16:55,51,68.7,69,63.9,120,66,2,0,0
10/12/2017 17:00,60,69,78,64.4,138,66.4,2,0,0
10/12/2017 17:05,54,69.1,71,64.5,125,66.5,2,0,0
10/12/2017 17:10,50,69.3,68,64.7,118,66.6,2,0,0
10/12/2017 17:15,48,67.7,65,62.9,113,64.9,2,0,0
10/12/2017 17:20,56,67.6,74,62.8,130,64.9,2,0,0
10/12/2017 17:25,51,67.2,69,62.4,120,64.5,2,0,0
10/12/2017 17:30,47,68.5,66,63.8,113,65.8,2,0,0
10/12/2017 17:35,57,68.9,76,64.3,133,66.3,2,0,0
10/12/2017 17:40,49,68.4,67,63.7,116,65.7,2,0,0
10/12/2017 17:45,39,68.9,56,64.3,95,66.2,2,0,0
10/12/2017 17:50,50,69.3,68,64.7,118,66.6,2,0,0
10/12/2017 17:55,44,69,61,64.4,105,66.3,2,0,0
10/12/2017 18:00,46,69,63,64.4,109,66.3,2,0,0
10/12/2017 18:05,57,69.1,76,64.5,133,66.5,2,0,0
10/12/2017 18:10,59,69.9,77,65.3,136,67.3,2,0,0
10/12/2017 18:15,45,70.5,62,66,107,67.9,2,0,0
10/12/2017 18:20,42,70.9,59,66.4,101,68.3,2,0,0
10/12/2017 18:25,41,68.8,58,64.1,99,66,2,0,0
10/12/2017 18:30,46,69.5,64,64.9,110,66.9,2,0,0
10/12/2017 18:35,46,69.8,63,65.2,109,67.2,2,0,0
10/12/2017 18:40,41,69.5,58,64.9,99,66.8,2,0,0
10/12/2017 18:45,41,70.2,57,65.6,98,67.5,2,0,0
10/12/2017 18:50,46,70.2,62,65.6,108,67.5,2,0,0
10/12/2017 18:55,39,69.3,56,64.7,95,66.6,2,0,0
10/12/2017 19:00,43,68,61,63.3,104,65.2,2,0,0
10/12/2017 19:05,45,67.8,63,63.1,108,65.1,2,0,0
10/12/2017 19:10,45,68.2,63,63.5,108,65.5,2,0,0
10/12/2017 19:15,44,67.4,61,62.6,105,64.6,2,0,0
10/12/2017 19:20,39,67.7,56,62.9,95,64.9,2,0,0
10/12/2017 19:25,49,66.9,67,62,116,64,2,0,0
10/12/2017 19:30,47,67.6,66,62.8,113,64.8,2,0,0
10/12/2017 19:35,49,68.4,66,63.7,115,65.7,2,0,0
10/12/2017 19:40,47,68.4,66,63.7,113,65.7,2,0,0
10/12/2017 19:45,38,68.9,55,64.1,93,66.1,2,0,0
10/12/2017 19:50,33,69.4,50,64.8,83,66.6,2,0,0
10/12/2017 19:55,37,69.7,53,65,90,66.9,2,0,0
10/12/2017 20:00,32,70,48,65.4,80,67.2,2,0,0
10/12/2017 20:05,31,69.3,47,64.6,78,66.4,2,0,0
10/12/2017 20:10,39,69.4,56,64.7,95,66.7,2,0,0
10/12/2017 20:15,36,68.9,53,64.3,89,66.2,2,0,0
10/12/2017 20:20,35,69.1,51,64.5,86,66.4,2,0,0
10/12/2017 20:25,26,68.5,42,63.8,68,65.6,2,0,0
10/12/2017 20:30,34,68.5,51,63.9,85,65.7,2,0,0
10/12/2017 20:35,37,69.6,54,65,91,66.9,2,0,0
10/12/2017 20:40,38,69,54,64.4,92,66.3,2,0,0
10/12/2017 20:45,35,69.8,51,65.2,86,67.1,2,0,0
10/12/2017 20:50,31,70.1,48,65.5,79,67.3,2,0,0
10/12/2017 20:55,38,69.5,54,64.8,92,66.8,2,0,0
10/12/2017 21:00,34,69.1,51,64.4,85,66.3,2,0,0
10/12/2017 21:05,29,69,46,64.3,75,66.1,2,0,0
10/12/2017 21:10,27,68.7,44,64,71,65.8,2,0,0
10/12/2017 21:15,33,69.2,49,64.5,82,66.4,2,0,0
10/12/2017 21:20,36,67.8,53,63.1,89,65,2,0,0
10/12/2017 21:25,31,68.4,48,63.7,79,65.5,2,0,0
10/12/2017 21:30,29,68.7,44,64.1,73,65.9,2,0,0
10/12/2017 21:35,35,69.2,51,64.6,86,66.5,2,0,0
10/12/2017 21:40,34,69.3,50,64.7,84,66.6,2,0,0
10/12/2017 21:45,31,69,47,64.4,78,66.2,2,0,0
10/12/2017 21:50,30,69.1,46,64.5,76,66.3,2,0,0
10/12/2017 21:55,29,68.9,46,64.2,75,66,2,0,0
10/12/2017 22:00,26,69.2,42,64.5,68,66.3,2,0,0
10/12/2017 22:05,25,69.6,41,65,66,66.7,2,0,0
10/12/2017 22:10,22,68.2,37,63.5,59,65.2,2,0,0
10/12/2017 22:15,23,68.7,39,64.1,62,65.8,2,0,0
10/12/2017 22:20,22,69.3,38,64.7,60,66.4,2,0,0
10/12/2017 22:25,28,69.6,44,65,72,66.8,2,0,0
10/12/2017 22:30,20,69.4,36,64.8,56,66.4,2,0,0
10/12/2017 22:35,24,69.5,39,64.9,63,66.6,2,0,0
10/12/2017 22:40,23,68.8,39,64.2,62,65.9,2,0,0
10/12/2017 22:45,25,69.6,41,65,66,66.8,2,0,0
10/12/2017 22:50,20,69.7,36,65.1,56,66.7,2,0,0
10/12/2017 22:55,20,69.2,37,64.6,57,66.2,2,0,0
10/12/2017 23:00,17,69.1,33,64.5,50,66,2,0,0
10/12/2017 23:05,17,69.3,32,64.7,49,66.3,2,0,0
10/12/2017 23:10,13,69.3,28,64.7,41,66.2,2,0,0
10/12/2017 23:15,16,69.4,31,64.8,47,66.4,2,0,0
10/12/2017 23:20,15,69.3,30,64.7,45,66.3,2,0,0
10/12/2017 23:25,19,69.3,35,64.7,54,66.4,2,0,0
10/12/2017 23:30,21,69.6,36,65,57,66.7,2,0,0
10/12/2017 23:35,20,69.4,36,64.8,56,66.5,2,0,0
10/12/2017 23:40,21,69.4,37,64.8,58,66.4,2,0,0
10/12/2017 23:45,16,69.2,31,64.6,47,66.1,2,0,0
10/12/2017 23:50,12,69.3,27,64.6,39,66.1,2,0,0
10/12/2017 23:55,13,69.2,29,64.6,42,66.1,2,0,0
10/13/2017 0:00,15,69.3,31,64.7,46,66.2,2,0,0
10/13/2017 0:05,14,69.5,29,64.9,43,66.4,2,0,0
10/13/2017 0:10,12,69.5,28,64.9,40,66.3,2,0,0
10/13/2017 0:15,12,69.4,26,64.8,38,66.3,2,0,0
10/13/2017 0:20,10,69.4,26,64.8,36,66.1,2,0,0
10/13/2017 0:25,10,69.3,25,64.7,35,66,2,0,0
10/13/2017 0:30,10,69.1,25,64.5,35,65.8,2,0,0
10/13/2017 0:35,9,69.3,25,64.7,34,65.9,2,0,0
10/13/2017 0:40,13,69.4,28,64.8,41,66.3,2,0,0
10/13/2017 0:45,17,69.5,23,64.9,40,66.9,2,0,0
10/13/2017 0:50,7,69.4,23,64.8,30,65.8,2,0,0
10/13/2017 0:55,9,69.3,24,64.7,33,66,2,0,0
10/13/2017 1:00,11,69.2,27,64.6,38,66,2,0,0
10/13/2017 1:05,8,69.3,23,64.7,31,65.9,2,0,0
10/13/2017 1:10,18,69.4,23,64.8,41,66.8,2,0,0
10/13/2017 1:15,9,69.3,24,64.7,33,66,2,0,0
10/13/2017 1:20,8,69.3,23,64.7,31,65.9,2,0,0
10/13/2017 1:25,7,69.7,22,65.1,29,66.2,2,0,0
10/13/2017 1:30,7,69.1,22,64.5,29,65.6,2,0,0
10/13/2017 1:35,9,68.9,24,64.3,33,65.5,2,0,0
10/13/2017 1:40,8,69.1,23,64.5,31,65.7,2,0,0
10/13/2017 1:45,10,69.3,25,64.7,35,66,2,0,0
10/13/2017 1:50,7,69.2,22,64.6,29,65.7,2,0,0
10/13/2017 1:55,9,69.4,24,64.8,33,66.1,2,0,0
10/13/2017 2:00,10,69.5,25,64.9,35,66.2,2,0,0
10/13/2017 2:05,6,69.4,21,64.8,27,65.8,2,0,0
10/13/2017 2:10,7,69.4,22,64.8,29,65.9,2,0,0
10/13/2017 2:15,7,69.3,22,64.7,29,65.8,2,0,0
10/13/2017 2:20,7,69.4,22,64.8,29,65.9,2,0,0
10/13/2017 2:25,11,69.1,27,64.5,38,65.8,2,0,0
10/13/2017 2:30,8,69.3,23,64.7,31,65.9,2,0,0
10/13/2017 2:35,11,69.4,26,64.8,37,66.1,2,0,0
10/13/2017 2:40,8,69.2,24,64.6,32,65.8,2,0,0
10/13/2017 2:45,8,69.3,24,64.7,32,65.9,2,0,0
10/13/2017 2:50,9,69.2,24,64.5,33,65.8,2,0,0
10/13/2017 2:55,8,69.4,24,64.8,32,66,2,0,0
10/13/2017 3:00,13,69.5,29,64.9,42,66.3,2,0,0
10/13/2017 3:05,8,69.5,24,64.9,32,66,2,0,0
10/13/2017 3:10,10,69.5,25,64.9,35,66.2,2,0,0
10/13/2017 3:15,13,69.4,29,64.8,42,66.3,2,0,0
10/13/2017 3:20,10,69.5,26,64.9,36,66.2,2,0,0
10/13/2017 3:25,11,69.3,27,64.7,38,66,2,0,0
10/13/2017 3:30,14,69.4,30,64.8,44,66.3,2,0,0
10/13/2017 3:35,13,68.8,29,64.2,42,65.6,2,0,0
10/13/2017 3:40,12,69.2,27,64.6,39,66,2,0,0
10/13/2017 3:45,12,69.4,27,64.8,39,66.2,2,0,0
10/13/2017 3:50,16,69.5,31,64.9,47,66.5,2,0,0
10/13/2017 3:55,15,69.6,30,65,45,66.5,2,0,0
10/13/2017 4:00,20,69.6,36,65,56,66.6,2,0,0
10/13/2017 4:05,19,69.5,34,64.9,53,66.6,2,0,0
10/13/2017 4:10,21,69.2,37,64.6,58,66.2,2,0,0
10/13/2017 4:15,19,69,35,64.4,54,66,2,0,0
10/13/2017 4:20,21,69.3,37,64.7,58,66.4,2,0,0
10/13/2017 4:25,25,69.3,41,64.7,66,66.5,2,0,0
10/13/2017 4:30,28,69.6,45,65,73,66.8,2,0,0
10/13/2017 4:35,30,69.1,47,64.4,77,66.3,2,0,0
10/13/2017 4:40,38,69.7,55,65.1,93,67,2,0,0
10/13/2017 4:45,34,69.3,52,64.7,86,66.5,2,0,0
10/13/2017 4:50,32,68.6,49,63.9,81,65.8,2,0,0
10/13/2017 4:55,39,69.4,57,64.8,96,66.7,2,0,0
10/13/2017 5:00,33,69.4,51,64.8,84,66.6,2,0,0
10/13/2017 5:05,40,69.5,58,64.9,98,66.8,2,0,0
10/13/2017 5:10,43,69.5,61,64.9,104,66.8,2,0,0
10/13/2017 5:15,43,69.1,61,64.5,104,66.4,2,0,0
10/13/2017 5:20,55,68.8,76,64.1,131,66.1,2,0,0
10/13/2017 5:25,56,68.4,76,63.7,132,65.7,2,0,0
10/13/2017 5:30,58,67.4,78,62.7,136,64.7,2,0,0
10/13/2017 5:35,50,68.1,71,63.4,121,65.4,2,0,0
10/13/2017 5:40,63,68.6,85,64,148,66,2,0,0
10/13/2017 5:45,60,69.1,80,64.5,140,66.5,2,0,0
10/13/2017 5:50,65,69.4,87,64.8,152,66.8,2,0,0
10/13/2017 5:55,66,68.3,88,63.6,154,65.7,2,0,0
10/13/2017 6:00,53,66.6,73,61.7,126,63.7,2,0,0
10/13/2017 6:05,66,66.8,88,61.9,154,64,2,0,0
10/13/2017 6:10,58,67.4,80,62.5,138,64.5,2,0,0
10/13/2017 6:15,60,67.2,81,62.3,141,64.4,2,0,0
10/13/2017 6:20,57,67.4,77,62.5,134,64.6,2,0,0
10/13/2017 6:25,69,67.2,91,62.3,160,64.4,2,0,0
10/13/2017 6:30,54,67.2,74,62.2,128,64.3,2,0,0
10/13/2017 6:35,75,66.8,97,61.7,172,63.9,2,0,0
10/13/2017 6:40,63,67.2,84,62.2,147,64.3,2,0,0
10/13/2017 6:45,63,67,85,62,148,64.1,2,0,0
10/13/2017 6:50,63,66.5,84,61.5,147,63.6,2,0,0
10/13/2017 6:55,76,66.9,98,61.9,174,64.1,2,0,0
10/13/2017 7:00,69,66.2,91,61.2,160,63.4,2,0,0
10/13/2017 7:05,68,66.6,89,61.6,157,63.8,2,0,0
10/13/2017 7:10,65,67.3,87,62.4,152,64.5,2,0,0
10/13/2017 7:15,73,66.2,94,61.2,167,63.4,2,0,0
10/13/2017 7:20,63,65.2,85,60.1,148,62.3,2,0,0
10/13/2017 7:25,76,65.8,98,60.8,174,63,2,0,0
10/13/2017 7:30,72,66.3,95,61.3,167,63.4,2,0,0
10/13/2017 7:35,79,66.2,101,61.1,180,63.3,2,0,0
10/13/2017 7:40,77,67.1,100,62.1,177,64.3,2,0,0
10/13/2017 7:45,85,67,108,62,193,64.2,2,0,0
10/13/2017 7:50,71,67.2,93,62.3,164,64.4,2,0,0
10/13/2017 7:55,80,67.4,102,62.5,182,64.7,2,0,0
10/13/2017 8:00,80,67.3,102,62.5,182,64.6,2,0,0
10/13/2017 8:05,80,67.9,102,63.1,182,65.2,2,0,0
10/13/2017 8:10,77,67,99,62.1,176,64.3,2,0,0
10/13/2017 8:15,85,66,108,61.1,193,63.3,2,0,0
10/13/2017 8:20,85,66.1,108,61.2,193,63.4,2,0,0
10/13/2017 8:25,77,66.2,99,61.3,176,63.4,2,0,0
10/13/2017 8:30,80,66.9,102,62,182,64.1,2,0,0
10/13/2017 8:35,81,66.7,104,61.8,185,63.9,2,0,0
10/13/2017 8:40,75,66.5,97,61.6,172,63.7,2,0,0
10/13/2017 8:45,64,66.4,84,61.5,148,63.6,2,0,0
10/13/2017 8:50,72,65.2,92,60.2,164,62.4,2,0,0
10/13/2017 8:55,68,65.3,88,60.3,156,62.5,2,0,0
10/13/2017 9:00,71,65.5,91,60.5,162,62.7,2,0,0
10/13/2017 9:05,74,66.7,94,61.8,168,64,2,0,0
10/13/2017 9:10,64,66.1,83,61.1,147,63.3,2,0,0
10/13/2017 9:15,69,66.2,89,61.2,158,63.4,2,0,0
10/13/2017 9:20,66,66.6,87,61.7,153,63.8,2,0,0
10/13/2017 9:25,66,65.2,86,60.2,152,62.4,2,0,0
10/13/2017 9:30,60,65.3,78,60.2,138,62.4,2,0,0
10/13/2017 9:35,64,66.2,83,61.3,147,63.4,2,0,0
10/13/2017 9:40,65,67.1,84,62.2,149,64.3,2,0,0
10/13/2017 9:45,67,66.6,86,61.7,153,63.8,2,0,0
10/13/2017 9:50,58,67.2,78,62.4,136,64.4,2,0,0
10/13/2017 9:55,66,66.3,86,61.4,152,63.5,2,0,0
10/13/2017 10:00,55,68,74,63.4,129,65.4,2,0,0
10/13/2017 10:05,66,65.8,85,61,151,63.1,2,0,0
10/13/2017 10:10,63,66.2,82,61.4,145,63.5,2,0,0
10/13/2017 10:15,59,65.2,79,60.4,138,62.4,2,0,0
10/13/2017 10:20,66,65.7,85,60.8,151,63,2,0,0
10/13/2017 10:25,59,65.5,78,60.6,137,62.7,2,0,0
10/13/2017 10:30,58,65.9,76,61.1,134,63.2,2,0,0
10/13/2017 10:35,58,67.6,77,62.9,135,64.9,2,0,0
10/13/2017 10:40,56,66.8,75,62,131,64,2,0,0
10/13/2017 10:45,67,68.7,86,64.1,153,66.1,2,0,0
10/13/2017 10:50,58,68.5,77,63.9,135,65.9,2,0,0
10/13/2017 10:55,64,67.7,83,63.1,147,65.1,2,0,0
10/13/2017 11:00,59,68.6,77,64,136,66,2,0,0
10/13/2017 11:05,59,68.8,77,64.2,136,66.2,2,0,0
10/13/2017 11:10,70,67.6,90,62.8,160,64.9,2,0,0
10/13/2017 11:15,61,67.5,79,62.7,140,64.8,2,0,0
10/13/2017 11:20,67,67.7,86,63,153,65.1,2,0,0
10/13/2017 11:25,59,65.9,78,61.1,137,63.2,2,0,0
10/13/2017 11:30,65,67.7,84,63,149,65.1,2,0,0
10/13/2017 11:35,56,68.7,73,64.1,129,66.1,2,0,0
10/13/2017 11:40,61,68,81,63.3,142,65.3,2,0,0
10/13/2017 11:45,66,68.3,85,63.6,151,65.7,2,0,0
10/13/2017 11:50,48,68,66,63.3,114,65.3,2,0,0
10/13/2017 11:55,68,67.4,87,62.7,155,64.8,2,0,0
10/13/2017 12:00,68,67.7,88,63,156,65,2,0,0
10/13/2017 12:05,50,67.7,68,62.9,118,64.9,2,0,0
10/13/2017 12:10,47,67.4,64,62.7,111,64.7,2,0,0
10/13/2017 12:15,54,68,73,63.3,127,65.3,2,0,0
10/13/2017 12:20,48,68.5,66,63.9,114,65.8,2,0,0
10/13/2017 12:25,49,68.3,66,63.7,115,65.7,2,0,0
10/13/2017 12:30,60,67.7,78,63,138,65,2,0,0
10/13/2017 12:35,56,67.4,74,62.7,130,64.8,2,0,0
10/13/2017 12:40,60,67.2,79,62.5,139,64.6,2,0,0
10/13/2017 12:45,50,68.1,67,63.5,117,65.5,2,0,0
10/13/2017 12:50,54,67.9,72,63.2,126,65.2,2,0,0
10/13/2017 12:55,49,67.3,67,62.5,116,64.5,2,0,0
10/13/2017 13:00,48,68.3,66,63.7,114,65.6,2,0,0
10/13/2017 13:05,53,67.8,71,63.1,124,65.1,2,0,0
10/13/2017 13:10,58,69,76,64.4,134,66.4,2,0,0
10/13/2017 13:15,62,68.6,81,63.9,143,66,2,0,0
10/13/2017 13:20,48,68.4,65,63.7,113,65.7,2,0,0
10/13/2017 13:25,51,68.6,68,64.1,119,66,2,0,0
10/13/2017 13:30,55,68,73,63.4,128,65.4,2,0,0
10/13/2017 13:35,53,67.5,71,62.8,124,64.8,2,0,0
10/13/2017 13:40,52,68.5,70,63.9,122,65.8,2,0,0
10/13/2017 13:45,57,68.8,75,64.2,132,66.2,2,0,0
10/13/2017 13:50,53,67,72,62.3,125,64.3,2,0,0
10/13/2017 13:55,54,67.6,72,63,126,65,2,0,0
10/13/2017 14:00,44,68,61,63.4,105,65.4,2,0,0
10/13/2017 14:05,53,67.7,71,63,124,65,2,0,0
10/13/2017 14:10,52,68,71,63.2,123,65.2,2,0,0
10/13/2017 14:15,59,68,78,63.3,137,65.3,2,0,0
10/13/2017 14:20,56,66.8,74,62,130,64.1,2,0,0
10/13/2017 14:25,66,67.1,85,62.3,151,64.4,2,0,0
10/13/2017 14:30,61,67.7,80,62.9,141,65,2,0,0
10/13/2017 14:35,52,65.9,70,60.9,122,63,2,0,0
10/13/2017 14:40,53,67.5,71,62.8,124,64.8,2,0,0
10/13/2017 14:45,56,67.7,74,63,130,65.1,2,0,0
10/13/2017 14:50,60,68.3,77,63.6,137,65.7,2,0,0
10/13/2017 14:55,48,68.1,66,63.5,114,65.4,2,0,0
10/13/2017 15:00,53,68.6,71,63.9,124,65.9,2,0,0
10/13/2017 15:05,62,68.3,80,63.7,142,65.7,2,0,0
10/13/2017 15:10,62,68.7,80,64.1,142,66.1,2,0,0
10/13/2017 15:15,60,68.2,79,63.5,139,65.6,2,0,0
10/13/2017 15:20,59,67.7,77,62.9,136,65,2,0,0
10/13/2017 15:25,62,66.9,81,62,143,64.1,2,0,0
10/13/2017 15:30,57,67.1,76,62.3,133,64.4,2,0,0
10/13/2017 15:35,62,65.8,81,60.8,143,63,2,0,0
10/13/2017 15:40,55,66.6,74,61.8,129,63.8,2,0,0
10/13/2017 15:45,67,66.6,87,61.8,154,63.9,2,0,0
10/13/2017 15:50,60,68,78,63.3,138,65.4,2,0,0
10/13/2017 15:55,69,68,88,63.2,157,65.3,2,0,0
10/13/2017 16:00,72,68.5,91,63.8,163,65.9,2,0,0
10/13/2017 16:05,63,68.6,82,63.9,145,66,2,0,0
10/13/2017 16:10,65,68.7,84,64.1,149,66.1,2,0,0
10/13/2017 16:15,67,65.3,85,60.3,152,62.5,2,0,0
10/13/2017 16:20,61,67.5,78,62.7,139,64.8,2,0,0
10/13/2017 16:25,50,67.2,68,62.4,118,64.4,2,0,0
10/13/2017 16:30,52,66.6,70,61.7,122,63.8,2,0,0
10/13/2017 16:35,60,66.3,79,61.4,139,63.5,2,0,0
10/13/2017 16:40,51,67.1,69,62.2,120,64.3,2,0,0
10/13/2017 16:45,51,67.7,70,62.8,121,64.8,2,0,0
10/13/2017 16:50,57,68.5,76,63.8,133,65.8,2,0,0
10/13/2017 16:55,54,68.8,71,64.1,125,66.1,2,0,0
10/13/2017 17:00,47,68,64,63.3,111,65.3,2,0,0
10/13/2017 17:05,57,68.7,75,64,132,66,2,0,0
10/13/2017 17:10,62,68.1,81,63.4,143,65.4,2,0,0
10/13/2017 17:15,63,69.6,83,65,146,66.9,2,0,0
10/13/2017 17:20,90,67.6,80,61.8,170,64.9,2,0,0
10/13/2017 17:25,89,67.4,79,61.6,168,64.7,2,0,0
10/13/2017 17:30,54,68.9,71,64.3,125,66.3,2,0,0
10/13/2017 17:35,56,69.2,74,64.6,130,66.6,2,0,0
10/13/2017 17:40,50,68.9,68,64.3,118,66.2,2,0,0
10/13/2017 17:45,56,68.4,73,63.7,129,65.7,2,0,0
10/13/2017 17:50,60,68.5,79,63.8,139,65.8,2,0,0
10/13/2017 17:55,58,69.2,77,64.6,135,66.6,2,0,0
10/13/2017 18:00,47,69.7,65,65.1,112,67,2,0,0
10/13/2017 18:05,60,69.6,78,65,138,67,2,0,0
10/13/2017 18:10,57,68.2,76,63.5,133,65.5,2,0,0
10/13/2017 18:15,44,68.8,60,64.2,104,66.1,2,0,0
10/13/2017 18:20,48,67.3,67,62.5,115,64.5,2,0,0
10/13/2017 18:25,36,67.4,53,62.5,89,64.5,2,0,0
10/13/2017 18:30,45,67,62,62.2,107,64.2,2,0,0
10/13/2017 18:35,46,67.6,63,62.9,109,64.9,2,0,0
10/13/2017 18:40,47,67.2,64,62.4,111,64.5,2,0,0
10/13/2017 18:45,50,67.2,66,62.3,116,64.4,2,0,0
10/13/2017 18:50,46,66.6,63,61.7,109,63.8,2,0,0
10/13/2017 18:55,50,67.2,68,62.3,118,64.3,2,0,0
10/13/2017 19:00,56,67.4,74,62.6,130,64.7,2,0,0
10/13/2017 19:05,42,67.7,58,63,100,65,2,0,0
10/13/2017 19:10,52,67.4,70,62.6,122,64.6,2,0,0
10/13/2017 19:15,45,68.7,62,64.1,107,66,2,0,0
10/13/2017 19:20,50,68.9,67,64.3,117,66.3,2,0,0
10/13/2017 19:25,45,68.4,63,63.7,108,65.7,2,0,0
10/13/2017 19:30,51,68.6,70,64,121,66,2,0,0
10/13/2017 19:35,43,69,60,64.4,103,66.3,2,0,0
10/13/2017 19:40,61,69.3,80,64.7,141,66.7,2,0,0
10/13/2017 19:45,49,68.8,66,64.2,115,66.2,2,0,0
10/13/2017 19:50,52,68,70,63.3,122,65.3,2,0,0
10/13/2017 19:55,51,68,68,63.3,119,65.3,2,0,0
10/13/2017 20:00,45,68.2,62,63.6,107,65.5,2,0,0
10/13/2017 20:05,36,68.1,53,63.4,89,65.3,2,0,0
10/13/2017 20:10,36,68.7,52,64,88,65.9,2,0,0
10/13/2017 20:15,42,68.8,59,64,101,66,2,0,0
10/13/2017 20:20,41,68.9,57,64.2,98,66.1,2,0,0
10/13/2017 20:25,41,69.3,58,64.7,99,66.6,2,0,0
10/13/2017 20:30,46,68.8,63,64.1,109,66,2,0,0
10/13/2017 20:35,36,69.4,52,64.7,88,66.6,2,0,0
10/13/2017 20:40,36,69.3,53,64.7,89,66.6,2,0,0
10/13/2017 20:45,33,70.1,50,65.6,83,67.4,2,0,0
10/13/2017 20:50,41,69.7,58,65.1,99,67,2,0,0
10/13/2017 20:55,43,69.6,59,65.1,102,67,2,0,0
10/13/2017 21:00,43,68.5,59,63.8,102,65.8,2,0,0
10/13/2017 21:05,32,69.3,49,64.7,81,66.6,2,0,0
10/13/2017 21:10,35,69.7,51,65.1,86,67,2,0,0
10/13/2017 21:15,33,69.4,49,64.8,82,66.6,2,0,0
10/13/2017 21:20,32,69.7,48,65.1,80,67,2,0,0
10/13/2017 21:25,36,68.9,52,64.3,88,66.2,2,0,0
10/13/2017 21:30,26,69.1,42,64.5,68,66.2,2,0,0
10/13/2017 21:35,33,69.1,50,64.4,83,66.3,2,0,0
10/13/2017 21:40,34,69.5,51,64.9,85,66.7,2,0,0
10/13/2017 21:45,30,68.4,46,63.7,76,65.5,2,0,0
10/13/2017 21:50,31,68.4,48,63.7,79,65.5,2,0,0
10/13/2017 21:55,34,68.4,51,63.7,85,65.6,2,0,0
10/13/2017 22:00,34,68.3,51,63.6,85,65.5,2,0,0
10/13/2017 22:05,32,68.5,49,63.8,81,65.6,2,0,0
10/13/2017 22:10,32,69,48,64.3,80,66.2,2,0,0
10/13/2017 22:15,31,69.3,47,64.7,78,66.5,2,0,0
10/13/2017 22:20,26,69.7,42,65.1,68,66.8,2,0,0
10/13/2017 22:25,33,69.2,49,64.6,82,66.5,2,0,0
10/13/2017 22:30,31,69.4,47,64.7,78,66.6,2,0,0
10/13/2017 22:35,29,69.7,46,65.1,75,66.9,2,0,0
10/13/2017 22:40,31,69.7,47,65.1,78,66.9,2,0,0
10/13/2017 22:45,30,68.6,46,63.9,76,65.8,2,0,0
10/13/2017 22:50,33,68.7,50,64,83,65.9,2,0,0
10/13/2017 22:55,27,69.2,43,64.6,70,66.4,2,0,0
10/13/2017 23:00,27,69.5,43,64.9,70,66.6,2,0,0
10/13/2017 23:05,26,69.3,42,64.7,68,66.5,2,0,0
10/13/2017 23:10,30,69.3,46,64.7,76,66.5,2,0,0
10/13/2017 23:15,28,69.4,44,64.8,72,66.6,2,0,0
10/13/2017 23:20,29,69.1,45,64.5,74,66.3,2,0,0
10/13/2017 23:25,34,69.1,50,64.5,84,66.3,2,0,0
10/13/2017 23:30,35,68.2,52,63.5,87,65.4,2,0,0
10/13/2017 23:35,37,68.9,53,64.2,90,66.2,2,0,0
10/13/2017 23:40,39,68,56,63.2,95,65.2,2,0,0
10/13/2017 23:45,40,68.5,57,63.9,97,65.8,2,0,0
10/13/2017 23:50,28,69,44,64.3,72,66.1,2,0,0
10/13/2017 23:55,30,69,47,64.3,77,66.1,2,0,0
10/14/2017 0:00,24,69.3,40,64.7,64,66.5,2,0,0
10/14/2017 0:05,25,68.9,41,64.3,66,66,2,0,0
10/14/2017 0:10,24,69,39,64.3,63,66.1,2,0,0
10/14/2017 0:15,22,69,38,64.3,60,66,2,0,0
10/14/2017 0:20,17,69.1,33,64.5,50,66.1,2,0,0
10/14/2017 0:25,16,69.2,31,64.6,47,66.2,2,0,0
10/14/2017 0:30,19,68.3,35,63.5,54,65.2,2,0,0
10/14/2017 0:35,17,68.6,32,63.8,49,65.5,2,0,0
10/14/2017 0:40,14,68.7,29,64.1,43,65.6,2,0,0
10/14/2017 0:45,12,69,27,64.4,39,65.8,2,0,0
10/14/2017 0:50,11,69.2,27,64.6,38,65.9,2,0,0
10/14/2017 0:55,10,69.3,26,64.7,36,66,2,0,0
10/14/2017 1:00,18,69.4,33,64.8,51,66.4,2,0,0
10/14/2017 1:05,10,69.3,26,64.7,36,66,2,0,0
10/14/2017 1:10,9,69.2,24,64.6,33,65.9,2,0,0
10/14/2017 1:15,8,69.3,23,64.7,31,65.9,2,0,0
10/14/2017 1:20,14,69.2,29,64.5,43,66,2,0,0
10/14/2017 1:25,9,69.3,25,64.7,34,65.9,2,0,0
10/14/2017 1:30,9,69.1,24,64.5,33,65.7,2,0,0
10/14/2017 1:35,13,69.3,28,64.7,41,66.1,2,0,0
10/14/2017 1:40,13,69.2,29,64.6,42,66,2,0,0
10/14/2017 1:45,7,69.2,22,64.6,29,65.7,2,0,0
10/14/2017 1:50,6,69.2,21,64.6,27,65.6,2,0,0
10/14/2017 1:55,7,69.2,23,64.6,30,65.7,2,0,0
10/14/2017 2:00,8,69.3,23,64.7,31,65.9,2,0,0
10/14/2017 2:05,10,69.3,25,64.7,35,66,2,0,0
10/14/2017 2:10,9,69.4,25,64.8,34,66,2,0,0
10/14/2017 2:15,7,69.3,22,64.7,29,65.8,2,0,0
10/14/2017 2:20,11,69.3,26,64.7,37,66.1,2,0,0
10/14/2017 2:25,7,69.1,22,64.5,29,65.6,2,0,0
10/14/2017 2:30,7,69.2,23,64.5,30,65.6,2,0,0
10/14/2017 2:35,11,69.2,26,64.6,37,66,2,0,0
10/14/2017 2:40,9,69.3,24,64.7,33,65.9,2,0,0
10/14/2017 2:45,9,69.3,25,64.7,34,65.9,2,0,0
10/14/2017 2:50,7,69,23,64.4,30,65.5,2,0,0
10/14/2017 2:55,8,69.2,23,64.6,31,65.8,2,0,0
10/14/2017 3:00,7,69.3,22,64.7,29,65.8,2,0,0
10/14/2017 3:05,9,69.4,24,64.8,33,66.1,2,0,0
10/14/2017 3:10,8,69.3,24,64.7,32,65.8,2,0,0
10/14/2017 3:15,11,69.3,27,64.7,38,66,2,0,0
10/14/2017 3:20,9,69.2,24,64.5,33,65.8,2,0,0
10/14/2017 3:25,7,69,22,64.4,29,65.5,2,0,0
10/14/2017 3:30,9,69.1,24,64.5,33,65.8,2,0,0
10/14/2017 3:35,8,69.2,24,64.6,32,65.7,2,0,0
10/14/2017 3:40,9,69,25,64.4,34,65.6,2,0,0
10/14/2017 3:45,8,69.2,23,64.6,31,65.8,2,0,0
10/14/2017 3:50,7,69.2,23,64.6,30,65.7,2,0,0
10/14/2017 3:55,10,68.9,26,64.3,36,65.6,2,0,0
10/14/2017 4:00,9,69,25,64.4,34,65.6,2,0,0
10/14/2017 4:05,9,69.1,25,64.5,34,65.7,2,0,0
10/14/2017 4:10,10,69.2,26,64.5,36,65.8,2,0,0
10/14/2017 4:15,9,69.2,24,64.6,33,65.9,2,0,0
10/14/2017 4:20,15,69.3,31,64.7,46,66.2,2,0,0
10/14/2017 4:25,11,69.3,27,64.7,38,66.1,2,0,0
10/14/2017 4:30,16,69.2,31,64.6,47,66.2,2,0,0
10/14/2017 4:35,16,69.2,32,64.6,48,66.2,2,0,0
10/14/2017 4:40,15,69.3,30,64.7,45,66.2,2,0,0
10/14/2017 4:45,18,69.2,34,64.6,52,66.2,2,0,0
10/14/2017 4:50,16,69.4,31,64.8,47,66.3,2,0,0
10/14/2017 4:55,18,69.4,34,64.8,52,66.4,2,0,0
10/14/2017 5:00,16,69.3,32,64.7,48,66.2,2,0,0
10/14/2017 5:05,17,68.5,32,63.9,49,65.5,2,0,0
10/14/2017 5:10,16,68.8,32,64.2,48,65.7,2,0,0
10/14/2017 5:15,19,68.9,34,64.2,53,65.9,2,0,0
10/14/2017 5:20,17,69,33,64.4,50,66,2,0,0
10/14/2017 5:25,18,69.1,34,64.5,52,66.1,2,0,0
10/14/2017 5:30,17,69.2,33,64.5,50,66.1,2,0,0
10/14/2017 5:35,20,69,36,64.4,56,66.1,2,0,0
10/14/2017 5:40,18,69.1,34,64.5,52,66.1,2,0,0
10/14/2017 5:45,21,69.1,37,64.4,58,66.1,2,0,0
10/14/2017 5:50,19,69,35,64.4,54,66,2,0,0
10/14/2017 5:55,16,69.1,32,64.5,48,66,2,0,0
10/14/2017 6:00,17,69.1,33,64.5,50,66.1,2,0,0
10/14/2017 6:05,23,69.4,40,64.8,63,66.5,2,0,0
10/14/2017 6:10,23,69.3,39,64.7,62,66.4,2,0,0
10/14/2017 6:15,27,69,43,64.4,70,66.2,2,0,0
10/14/2017 6:20,21,69.3,36,64.7,57,66.4,2,0,0
10/14/2017 6:25,22,68.4,38,63.8,60,65.5,2,0,0
10/14/2017 6:30,23,68.4,38,63.8,61,65.5,2,0,0
10/14/2017 6:35,24,68.7,41,64,65,65.7,2,0,0
10/14/2017 6:40,33,68.8,50,64.2,83,66,2,0,0
10/14/2017 6:45,38,68.1,55,63.3,93,65.3,2,0,0
10/14/2017 6:50,36,67.9,52,63.2,88,65.1,2,0,0
10/14/2017 6:55,27,68.6,43,63.9,70,65.7,2,0,0
10/14/2017 7:00,31,67.7,48,63,79,64.8,2,0,0
10/14/2017 7:05,24,68,40,63.3,64,65.1,2,0,0
10/14/2017 7:10,29,67.6,45,62.9,74,64.7,2,0,0
10/14/2017 7:15,29,67.9,46,63.1,75,65,2,0,0
10/14/2017 7:20,30,68.4,47,63.7,77,65.6,2,0,0
10/14/2017 7:25,35,68.6,53,63.9,88,65.8,2,0,0
10/14/2017 7:30,26,69.1,42,64.5,68,66.2,2,0,0
10/14/2017 7:35,35,68.8,52,64.1,87,66,2,0,0
10/14/2017 7:40,40,69.2,56,64.5,96,66.5,2,0,0
10/14/2017 7:45,43,69.7,61,65.1,104,67,2,0,0
10/14/2017 7:50,40,69.4,57,64.8,97,66.7,2,0,0
10/14/2017 7:55,42,68.7,59,64.1,101,66,2,0,0
10/14/2017 8:00,35,69.1,52,64.5,87,66.4,2,0,0
10/14/2017 8:05,34,69.5,52,64.9,86,66.7,2,0,0
10/14/2017 8:10,38,69.9,55,65.4,93,67.2,2,0,0
10/14/2017 8:15,41,70.1,58,65.5,99,67.4,2,0,0
10/14/2017 8:20,39,70.2,57,65.7,96,67.5,2,0,0
10/14/2017 8:25,38,69.5,55,64.9,93,66.8,2,0,0
10/14/2017 8:30,50,69.4,67,64.8,117,66.8,2,0,0
10/14/2017 8:35,48,70,65,65.5,113,67.4,2,0,0
10/14/2017 8:40,46,69.9,64,65.4,110,67.2,2,0,0
10/14/2017 8:45,49,69.5,65,64.9,114,66.9,2,0,0
10/14/2017 8:50,47,69.4,65,64.8,112,66.8,2,0,0
10/14/2017 8:55,45,67.8,64,63.1,109,65.1,2,0,0
10/14/2017 9:00,46,69.3,63,64.7,109,66.6,2,0,0
10/14/2017 9:05,51,69,69,64.3,120,66.3,2,0,0
10/14/2017 9:10,41,69,58,64.4,99,66.3,2,0,0
10/14/2017 9:15,55,70.3,73,65.8,128,67.8,2,0,0
10/14/2017 9:20,49,69.7,67,65,116,67,2,0,0
10/14/2017 9:25,51,68.2,70,63.5,121,65.5,2,0,0
10/14/2017 9:30,54,69.3,72,64.7,126,66.7,2,0,0
10/14/2017 9:35,46,69.4,63,64.8,109,66.8,2,0,0
10/14/2017 9:40,51,69.6,70,65,121,66.9,2,0,0
10/14/2017 9:45,59,69.4,77,64.8,136,66.8,2,0,0
10/14/2017 9:50,55,69,73,64.3,128,66.3,2,0,0
10/14/2017 9:55,57,70.4,75,65.9,132,67.9,2,0,0
10/14/2017 10:00,60,69.3,77,64.7,137,66.7,2,0,0
10/14/2017 10:05,55,68.7,73,64.1,128,66.1,2,0,0
10/14/2017 10:10,62,68,81,63.3,143,65.3,2,0,0
10/14/2017 10:15,60,67.9,79,63.1,139,65.2,2,0,0
10/14/2017 10:20,62,69,81,64.3,143,66.3,2,0,0
10/14/2017 10:25,62,69.1,81,64.5,143,66.5,2,0,0
10/14/2017 10:30,66,68.4,84,63.7,150,65.8,2,0,0
10/14/2017 10:35,52,68.9,71,64.2,123,66.2,2,0,0
10/14/2017 10:40,62,68.8,80,64.2,142,66.2,2,0,0
10/14/2017 10:45,66,69.1,85,64.6,151,66.6,2,0,0
10/14/2017 10:50,61,69,80,64.4,141,66.4,2,0,0
10/14/2017 10:55,66,68.3,86,63.6,152,65.6,2,0,0
10/14/2017 11:00,62,68.2,80,63.5,142,65.6,2,0,0
10/14/2017 11:05,64,68.1,82,63.4,146,65.4,2,0,0
10/14/2017 11:10,64,67.5,83,62.8,147,64.8,2,0,0
10/14/2017 11:15,65,67.6,83,62.8,148,64.9,2,0,0
10/14/2017 11:20,59,67.5,79,62.7,138,64.7,2,0,0
10/14/2017 11:25,46,68.6,63,63.9,109,65.9,2,0,0
10/14/2017 11:30,56,68.9,73,64.2,129,66.2,2,0,0
10/14/2017 11:35,57,68.3,76,63.6,133,65.6,2,0,0
10/14/2017 11:40,56,69.1,74,64.5,130,66.5,2,0,0
10/14/2017 11:45,54,69.1,72,64.5,126,66.5,2,0,0
10/14/2017 11:50,58,69.2,77,64.6,135,66.5,2,0,0
10/14/2017 11:55,52,68.8,70,64.2,122,66.1,2,0,0
10/14/2017 12:00,56,69,74,64.4,130,66.4,2,0,0
10/14/2017 12:05,62,69.4,80,64.8,142,66.8,2,0,0
10/14/2017 12:10,58,69.3,76,64.8,134,66.8,2,0,0
10/14/2017 12:15,68,67.6,87,62.8,155,64.9,2,0,0
10/14/2017 12:20,64,68,82,63.2,146,65.3,2,0,0
10/14/2017 12:25,60,67.6,78,62.8,138,64.9,2,0,0
10/14/2017 12:30,67,69.1,85,64.4,152,66.5,2,0,0
10/14/2017 12:35,56,69.2,75,64.6,131,66.6,2,0,0
10/14/2017 12:40,67,69.3,86,64.7,153,66.7,2,0,0
10/14/2017 12:45,63,68.8,81,64.2,144,66.2,2,0,0
10/14/2017 12:50,58,68.1,77,63.4,135,65.4,2,0,0
10/14/2017 12:55,53,67.6,71,62.9,124,64.9,2,0,0
10/14/2017 13:00,55,67.7,72,63,127,65,2,0,0
10/14/2017 13:05,59,67.5,78,62.7,137,64.8,2,0,0
10/14/2017 13:10,55,67.9,73,63.2,128,65.2,2,0,0
10/14/2017 13:15,51,68,68,63.3,119,65.4,2,0,0
10/14/2017 13:20,57,68.4,75,63.7,132,65.8,2,0,0
10/14/2017 13:25,65,68.9,84,64.3,149,66.3,2,0,0
10/14/2017 13:30,63,68.6,82,63.9,145,65.9,2,0,0
10/14/2017 13:35,65,69.1,84,64.5,149,66.5,2,0,0
10/14/2017 13:40,67,69.3,86,64.7,153,66.7,2,0,0
10/14/2017 13:45,65,68.4,85,63.8,150,65.8,2,0,0
10/14/2017 13:50,63,68.8,82,64.3,145,66.3,2,0,0
10/14/2017 13:55,59,68.4,77,63.7,136,65.7,2,0,0
10/14/2017 14:00,62,68.1,80,63.4,142,65.4,2,0,0
10/14/2017 14:05,55,68.5,74,63.9,129,65.9,2,0,0
10/14/2017 14:10,55,68.6,72,64,127,66,2,0,0
10/14/2017 14:15,59,68.4,78,63.8,137,65.8,2,0,0
10/14/2017 14:20,56,68.8,73,64.3,129,66.3,2,0,0
10/14/2017 14:25,53,68.7,72,64.1,125,66,2,0,0
10/14/2017 14:30,54,68.1,72,63.4,126,65.4,2,0,0
10/14/2017 14:35,50,68.6,68,63.9,118,65.9,2,0,0
10/14/2017 14:40,66,69.1,85,64.5,151,66.5,2,0,0
10/14/2017 14:45,59,69.1,76,64.5,135,66.5,2,0,0
10/14/2017 14:50,53,69.4,71,64.8,124,66.8,2,0,0
10/14/2017 14:55,56,69.4,74,64.9,130,66.9,2,0,0
10/14/2017 15:00,55,68.4,73,63.7,128,65.7,2,0,0
10/14/2017 15:05,48,68.5,66,63.8,114,65.8,2,0,0
10/14/2017 15:10,60,68.9,78,64.2,138,66.2,2,0,0
10/14/2017 15:15,64,68.4,83,63.8,147,65.8,2,0,0
10/14/2017 15:20,66,68.4,84,63.7,150,65.7,2,0,0
10/14/2017 15:25,53,68.4,70,63.7,123,65.7,2,0,0
10/14/2017 15:30,65,68.4,83,63.6,148,65.7,2,0,0
10/14/2017 15:35,62,68.3,81,63.6,143,65.7,2,0,0
10/14/2017 15:40,61,69,79,64.3,140,66.4,2,0,0
10/14/2017 15:45,53,68.3,71,63.6,124,65.6,2,0,0
10/14/2017 15:50,50,68.8,68,64.2,118,66.1,2,0,0
10/14/2017 15:55,45,69,63,64.3,108,66.3,2,0,0
10/14/2017 16:00,39,69.2,55,64.6,94,66.5,2,0,0
10/14/2017 16:05,56,69,73,64.5,129,66.4,2,0,0
10/14/2017 16:10,57,69.3,75,64.7,132,66.7,2,0,0
10/14/2017 16:15,62,69.1,81,64.5,143,66.5,2,0,0
10/14/2017 16:20,70,69,89,64.5,159,66.5,2,0,0
10/14/2017 16:25,54,68.5,72,63.8,126,65.8,2,0,0
10/14/2017 16:30,55,69.1,73,64.5,128,66.5,2,0,0
10/14/2017 16:35,64,69,82,64.4,146,66.4,2,0,0
10/14/2017 16:40,57,69,75,64.4,132,66.4,2,0,0
10/14/2017 16:45,64,68.6,82,63.9,146,66,2,0,0
10/14/2017 16:50,50,68,67,63.3,117,65.3,2,0,0
10/14/2017 16:55,44,68.4,62,63.8,106,65.7,2,0,0
10/14/2017 17:00,55,68.5,74,63.9,129,65.9,2,0,0
10/14/2017 17:05,51,68.7,69,64.1,120,66.1,2,0,0
10/14/2017 17:10,54,68.3,72,63.5,126,65.6,2,0,0
10/14/2017 17:15,54,68.2,73,63.4,127,65.5,2,0,0
10/14/2017 17:20,57,68.3,74,63.6,131,65.6,2,0,0
10/14/2017 17:25,69,67.2,89,62.3,158,64.4,2,0,0
10/14/2017 17:30,40,67.9,57,63.1,97,65.1,2,0,0
10/14/2017 17:35,51,67.9,68,63.2,119,65.2,2,0,0
10/14/2017 17:40,41,67.6,59,62.9,100,64.9,2,0,0
10/14/2017 17:45,38,67.4,55,62.7,93,64.6,2,0,0
10/14/2017 17:50,52,67.5,70,62.7,122,64.8,2,0,0
10/14/2017 17:55,55,68.3,73,63.6,128,65.6,2,0,0
10/14/2017 18:00,53,68.2,71,63.6,124,65.5,2,0,0
10/14/2017 18:05,48,69.5,65,65,113,66.9,2,0,0
10/14/2017 18:10,50,69.6,68,65.1,118,67,2,0,0
10/14/2017 18:15,50,69.3,68,64.8,118,66.7,2,0,0
10/14/2017 18:20,55,69.8,73,65.2,128,67.2,2,0,0
10/14/2017 18:25,43,69.4,61,64.8,104,66.7,2,0,0
10/14/2017 18:30,54,69.5,72,64.9,126,66.9,2,0,0
10/14/2017 18:35,49,69.1,67,64.5,116,66.5,2,0,0
10/14/2017 18:40,52,69.8,71,65.3,123,67.2,2,0,0
10/14/2017 18:45,48,70.4,66,65.9,114,67.8,2,0,0
10/14/2017 18:50,45,70.1,62,65.5,107,67.4,2,0,0
10/14/2017 18:55,47,68.8,65,64.1,112,66,2,0,0
10/14/2017 19:00,50,68.7,67,64,117,66,2,0,0
10/14/2017 19:05,51,68.7,68,64,119,66,2,0,0
10/14/2017 19:10,46,68.6,64,63.9,110,65.9,2,0,0
10/14/2017 19:15,47,69.4,64,64.8,111,66.7,2,0,0
10/14/2017 19:20,44,68.5,62,63.8,106,65.8,2,0,0
10/14/2017 19:25,42,69.7,59,65,101,66.9,2,0,0
10/14/2017 19:30,43,70.1,60,65.5,103,67.5,2,0,0
10/14/2017 19:35,44,69.7,61,65.1,105,67,2,0,0
10/14/2017 19:40,44,69,62,64.4,106,66.3,2,0,0
10/14/2017 19:45,35,68.8,52,64.1,87,66,2,0,0
10/14/2017 19:50,38,68.8,55,64.2,93,66.1,2,0,0
10/14/2017 19:55,40,68.9,56,64.2,96,66.2,2,0,0
10/14/2017 20:00,31,69.6,47,65,78,66.8,2,0,0
10/14/2017 20:05,37,69.6,54,65,91,66.9,2,0,0
10/14/2017 20:10,35,69.1,52,64.5,87,66.3,2,0,0
10/14/2017 20:15,32,69.9,48,65.3,80,67.1,2,0,0
10/14/2017 20:20,33,68.9,49,64.2,82,66.1,2,0,0
10/14/2017 20:25,32,69.5,48,64.9,80,66.8,2,0,0
10/14/2017 20:30,23,69.7,39,65.2,62,66.9,2,0,0
10/14/2017 20:35,32,69.4,48,64.8,80,66.7,2,0,0
10/14/2017 20:40,25,69.4,40,64.8,65,66.6,2,0,0
10/14/2017 20:45,38,69.3,55,64.7,93,66.5,2,0,0
10/14/2017 20:50,26,69.3,42,64.7,68,66.4,2,0,0
10/14/2017 20:55,35,68.8,51,64.2,86,66.1,2,0,0
10/14/2017 21:00,31,68.2,47,63.5,78,65.3,2,0,0
10/14/2017 21:05,37,69.1,53,64.4,90,66.3,2,0,0
10/14/2017 21:10,28,69.3,44,64.7,72,66.5,2,0,0
10/14/2017 21:15,25,69,42,64.4,67,66.1,2,0,0
10/14/2017 21:20,41,69.3,57,64.7,98,66.6,2,0,0
10/14/2017 21:25,30,69.1,47,64.5,77,66.3,2,0,0
10/14/2017 21:30,26,69.5,42,64.9,68,66.6,2,0,0
10/14/2017 21:35,29,69.6,45,65,74,66.8,2,0,0
10/14/2017 21:40,39,69.6,56,65,95,66.9,2,0,0
10/14/2017 21:45,28,69.4,45,64.8,73,66.6,2,0,0
10/14/2017 21:50,35,69.8,52,65.2,87,67,2,0,0
10/14/2017 21:55,38,69.6,53,65,91,66.9,2,0,0
10/14/2017 22:00,24,69.6,39,65,63,66.8,2,0,0
10/14/2017 22:05,29,68.9,45,64.2,74,66,2,0,0
10/14/2017 22:10,25,69.1,41,64.4,66,66.2,2,0,0
10/14/2017 22:15,32,68.9,47,64.3,79,66.2,2,0,0
10/14/2017 22:20,32,69.1,48,64.5,80,66.3,2,0,0
10/14/2017 22:25,23,68.9,39,64.2,62,65.9,2,0,0
10/14/2017 22:30,29,69.3,45,64.7,74,66.5,2,0,0
10/14/2017 22:35,31,69,48,64.4,79,66.2,2,0,0
10/14/2017 22:40,32,68.9,48,64.2,80,66.1,2,0,0
10/14/2017 22:45,30,69.2,46,64.5,76,66.4,2,0,0
10/14/2017 22:50,33,69.2,49,64.6,82,66.4,2,0,0
10/14/2017 22:55,29,69.3,44,64.7,73,66.5,2,0,0
10/14/2017 23:00,20,69.5,35,64.9,55,66.6,2,0,0
10/14/2017 23:05,23,69.4,39,64.8,62,66.5,2,0,0
10/14/2017 23:10,22,69.3,39,64.7,61,66.3,2,0,0
10/14/2017 23:15,25,69.1,41,64.5,66,66.2,2,0,0
10/14/2017 23:20,27,69.5,42,64.9,69,66.7,2,0,0
10/14/2017 23:25,14,69.4,30,64.8,44,66.3,2,0,0
10/14/2017 23:30,29,69.3,46,64.7,75,66.5,2,0,0
10/14/2017 23:35,26,69.5,42,64.9,68,66.7,2,0,0
10/14/2017 23:40,22,69.5,38,64.9,60,66.6,2,0,0
10/14/2017 23:45,25,68.7,40,64,65,65.8,2,0,0
10/14/2017 23:50,20,69.2,36,64.5,56,66.2,2,0,0
10/14/2017 23:55,14,69.2,30,64.6,44,66.1,2,0,0
10/15/2017 0:00,16,69.3,32,64.7,48,66.3,2,0,0
10/15/2017 0:05,15,69.4,31,64.8,46,66.3,2,0,0
10/15/2017 0:10,19,69.3,34,64.7,53,66.4,2,0,0
10/15/2017 0:15,18,69.1,35,64.5,53,66.1,2,0,0
10/15/2017 0:20,14,69.2,29,64.6,43,66.1,2,0,0
10/15/2017 0:25,15,69.2,30,64.6,45,66.2,2,0,0
10/15/2017 0:30,25,69.3,41,64.7,66,66.4,2,0,0
10/15/2017 0:35,10,69.4,26,64.8,36,66,2,0,0
10/15/2017 0:40,10,69.4,25,64.8,35,66.1,2,0,0
10/15/2017 0:45,12,69.3,28,64.7,40,66.1,2,0,0
10/15/2017 0:50,11,69.2,26,64.6,37,66,2,0,0
10/15/2017 0:55,11,69.3,27,64.7,38,66.1,2,0,0
10/15/2017 1:00,18,69.2,33,64.6,51,66.2,2,0,0
10/15/2017 1:05,10,69.3,25,64.7,35,66,2,0,0
10/15/2017 1:10,13,69.3,28,64.7,41,66.2,2,0,0
10/15/2017 1:15,12,69.3,28,64.7,40,66,2,0,0
10/15/2017 1:20,10,69.3,25,64.7,35,66,2,0,0
10/15/2017 1:25,10,69.2,26,64.6,36,65.9,2,0,0
10/15/2017 1:30,8,69.1,23,64.5,31,65.7,2,0,0
10/15/2017 1:35,6,69.3,21,64.7,27,65.7,2,0,0
10/15/2017 1:40,22,69.4,26,64.8,48,66.9,2,0,0
10/15/2017 1:45,7,69.4,22,64.8,29,65.9,2,0,0
10/15/2017 1:50,10,69.4,25,64.8,35,66.1,2,0,0
10/15/2017 1:55,8,69.3,23,64.7,31,65.9,2,0,0
10/15/2017 2:00,8,69.3,23,64.7,31,65.9,2,0,0
10/15/2017 2:05,10,69.3,25,64.7,35,66,2,0,0
10/15/2017 2:10,9,69.3,24,64.7,33,65.9,2,0,0
10/15/2017 2:15,7,69.3,23,64.7,30,65.8,2,0,0
10/15/2017 2:20,13,69.5,28,64.9,41,66.3,2,0,0
10/15/2017 2:25,10,69.3,25,64.7,35,66,2,0,0
10/15/2017 2:30,8,69.3,23,64.6,31,65.8,2,0,0
10/15/2017 2:35,8,69.2,24,64.6,32,65.8,2,0,0
10/15/2017 2:40,9,69.3,24,64.7,33,66,2,0,0
10/15/2017 2:45,10,69.2,25,64.6,35,65.9,2,0,0
10/15/2017 2:50,8,69.3,23,64.7,31,65.9,2,0,0
10/15/2017 2:55,9,69.3,24,64.7,33,66,2,0,0
10/15/2017 3:00,7,69.2,22,64.6,29,65.7,2,0,0
10/15/2017 3:05,5,69.2,20,64.6,25,65.5,2,0,0
10/15/2017 3:10,9,69.3,24,64.7,33,65.9,2,0,0
10/15/2017 3:15,8,69.2,23,64.6,31,65.8,2,0,0
10/15/2017 3:20,5,69.3,21,64.7,26,65.6,2,0,0
10/15/2017 3:25,5,69.2,21,64.6,26,65.5,2,0,0
10/15/2017 3:30,8,69.3,24,64.7,32,65.9,2,0,0
10/15/2017 3:35,7,69.3,22,64.7,29,65.8,2,0,0
10/15/2017 3:40,9,69.3,24,64.7,33,66,2,0,0
10/15/2017 3:45,8,69.4,23,64.8,31,66,2,0,0
10/15/2017 3:50,13,69.5,28,64.9,41,66.4,2,0,0
10/15/2017 3:55,7,69.4,22,64.8,29,65.9,2,0,0
10/15/2017 4:00,8,69.3,24,64.7,32,65.9,2,0,0
10/15/2017 4:05,10,69.2,26,64.5,36,65.8,2,0,0
10/15/2017 4:10,6,69.3,21,64.7,27,65.7,2,0,0
10/15/2017 4:15,8,69.3,23,64.7,31,65.8,2,0,0
10/15/2017 4:20,10,69.3,25,64.7,35,66,2,0,0
10/15/2017 4:25,11,69.2,26,64.6,37,66,2,0,0
10/15/2017 4:30,9,69.3,24,64.7,33,66,2,0,0
10/15/2017 4:35,13,69.4,28,64.7,41,66.2,2,0,0
10/15/2017 4:40,17,69.3,33,64.7,50,66.3,2,0,0
10/15/2017 4:45,11,69.2,27,64.6,38,66,2,0,0
10/15/2017 4:50,9,69.3,25,64.7,34,65.9,2,0,0
10/15/2017 4:55,14,69.1,29,64.4,43,65.9,2,0,0
10/15/2017 5:00,11,69.2,27,64.5,38,65.9,2,0,0
10/15/2017 5:05,13,69.2,28,64.6,41,66,2,0,0
10/15/2017 5:10,14,69.3,29,64.7,43,66.2,2,0,0
10/15/2017 5:15,12,69.3,27,64.7,39,66.2,2,0,0
10/15/2017 5:20,16,69.2,31,64.5,47,66.1,2,0,0
10/15/2017 5:25,14,69.1,29,64.5,43,66,2,0,0
10/15/2017 5:30,15,69.1,31,64.5,46,66,2,0,0
10/15/2017 5:35,14,69.3,30,64.7,44,66.1,2,0,0
10/15/2017 5:40,19,69.3,35,64.7,54,66.3,2,0,0
10/15/2017 5:45,18,69.4,33,64.7,51,66.4,2,0,0
10/15/2017 5:50,17,69.4,32,64.7,49,66.3,2,0,0
10/15/2017 5:55,20,69.4,36,64.7,56,66.4,2,0,0
10/15/2017 6:00,15,69.2,30,64.5,45,66.1,2,0,0
10/15/2017 6:05,9,69.3,25,64.7,34,65.9,2,0,0
10/15/2017 6:10,12,68.7,28,64,40,65.4,2,0,0
10/15/2017 6:15,12,69.1,27,64.5,39,65.9,2,0,0
10/15/2017 6:20,12,69.2,27,64.6,39,66,2,0,0
10/15/2017 6:25,20,69.1,36,64.5,56,66.1,2,0,0
10/15/2017 6:30,22,69.2,38,64.6,60,66.3,2,0,0
10/15/2017 6:35,22,69.1,38,64.5,60,66.2,2,0,0
10/15/2017 6:40,14,69.3,30,64.7,44,66.2,2,0,0
10/15/2017 6:45,22,69.2,38,64.6,60,66.3,2,0,0
10/15/2017 6:50,24,68.9,41,64.2,65,65.9,2,0,0
10/15/2017 6:55,23,69.3,39,64.6,62,66.3,2,0,0
10/15/2017 7:00,16,69,31,64.4,47,66,2,0,0
10/15/2017 7:05,20,69.1,36,64.4,56,66.1,2,0,0
10/15/2017 7:10,20,69.2,36,64.6,56,66.2,2,0,0
10/15/2017 7:15,24,69.2,40,64.6,64,66.4,2,0,0
10/15/2017 7:20,31,69.1,47,64.5,78,66.3,2,0,0
10/15/2017 7:25,22,68.9,38,64.2,60,65.9,2,0,0
10/15/2017 7:30,25,69.2,41,64.6,66,66.3,2,0,0
10/15/2017 7:35,21,69.2,37,64.6,58,66.3,2,0,0
10/15/2017 7:40,29,69.3,45,64.7,74,66.5,2,0,0
10/15/2017 7:45,35,69.2,52,64.6,87,66.4,2,0,0
10/15/2017 7:50,32,69.3,50,64.6,82,66.4,2,0,0
10/15/2017 7:55,32,69.5,49,64.9,81,66.7,2,0,0
10/15/2017 8:00,30,69.5,47,64.9,77,66.7,2,0,0
10/15/2017 8:05,21,69.2,38,64.6,59,66.2,2,0,0
10/15/2017 8:10,25,69.4,41,64.8,66,66.6,2,0,0
10/15/2017 8:15,31,69.4,47,64.7,78,66.6,2,0,0
10/15/2017 8:20,30,69.5,47,64.9,77,66.7,2,0,0
10/15/2017 8:25,39,69.4,56,64.8,95,66.6,2,0,0
10/15/2017 8:30,25,69.2,41,64.6,66,66.3,2,0,0
10/15/2017 8:35,43,69,60,64.4,103,66.3,2,0,0
10/15/2017 8:40,34,68.9,50,64.3,84,66.2,2,0,0
10/15/2017 8:45,38,69,55,64.3,93,66.2,2,0,0
10/15/2017 8:50,34,69.3,51,64.7,85,66.5,2,0,0
10/15/2017 8:55,42,69,60,64.4,102,66.3,2,0,0
10/15/2017 9:00,31,69.8,47,65.2,78,67.1,2,0,0
10/15/2017 9:05,46,69.9,64,65.3,110,67.3,2,0,0
10/15/2017 9:10,44,69.6,62,65,106,66.9,2,0,0
10/15/2017 9:15,47,69.6,64,65,111,66.9,2,0,0
10/15/2017 9:20,41,70,58,65.4,99,67.3,2,0,0
10/15/2017 9:25,37,69.7,54,65.1,91,67,2,0,0
10/15/2017 9:30,39,69.4,56,64.8,95,66.7,2,0,0
10/15/2017 9:35,48,69.2,65,64.6,113,66.5,2,0,0
10/15/2017 9:40,45,69.2,63,64.5,108,66.5,2,0,0
10/15/2017 9:45,43,68.9,61,64.3,104,66.2,2,0,0
10/15/2017 9:50,54,68.2,72,63.4,126,65.4,2,0,0
10/15/2017 9:55,52,69.5,72,64.9,124,66.9,2,0,0
10/15/2017 10:00,40,68.8,58,64.2,98,66.1,2,0,0
10/15/2017 10:05,47,68.9,65,64.3,112,66.3,2,0,0
10/15/2017 10:10,52,68.6,70,63.9,122,65.9,2,0,0
10/15/2017 10:15,63,67.7,82,62.9,145,65,2,0,0
10/15/2017 10:20,54,68,72,63.3,126,65.3,2,0,0
10/15/2017 10:25,49,67.7,68,62.9,117,64.9,2,0,0
10/15/2017 10:30,60,67.9,78,63.1,138,65.1,2,0,0
10/15/2017 10:35,55,68,73,63.3,128,65.3,2,0,0
10/15/2017 10:40,58,68.3,77,63.6,135,65.6,2,0,0
10/15/2017 10:45,57,68.8,75,64.2,132,66.2,2,0,0
10/15/2017 10:50,56,68.9,73,64.3,129,66.3,2,0,0
10/15/2017 10:55,61,68.7,80,64,141,66,2,0,0
10/15/2017 11:00,66,68.5,85,63.8,151,65.8,2,0,0
10/15/2017 11:05,60,68.8,78,64.1,138,66.1,2,0,0
10/15/2017 11:10,64,68.7,83,64,147,66,2,0,0
10/15/2017 11:15,69,68.6,88,64,157,66,2,0,0
10/15/2017 11:20,70,68.6,89,63.9,159,66,2,0,0
10/15/2017 11:25,59,69.1,78,64.5,137,66.5,2,0,0
10/15/2017 11:30,59,68.6,77,63.9,136,66,2,0,0
10/15/2017 11:35,58,67.9,77,63.1,135,65.1,2,0,0
10/15/2017 11:40,63,67.5,83,62.8,146,64.8,2,0,0
10/15/2017 11:45,74,68.1,93,63.5,167,65.5,2,0,0
10/15/2017 11:50,68,67.5,87,62.8,155,64.8,2,0,0
10/15/2017 11:55,56,67.8,74,63,130,65.1,2,0,0
10/15/2017 12:00,57,67.6,75,62.8,132,64.9,2,0,0
10/15/2017 12:05,45,68.1,62,63.4,107,65.3,2,0,0
10/15/2017 12:10,39,68.4,57,63.7,96,65.6,2,0,0
10/15/2017 12:15,48,67.3,66,62.5,114,64.5,2,0,0
10/15/2017 12:20,48,68.6,65,63.9,113,65.9,2,0,0
10/15/2017 12:25,45,68.3,62,63.7,107,65.6,2,0,0
10/15/2017 12:30,41,69.1,59,64.6,100,66.4,2,0,0
10/15/2017 12:35,43,69,61,64.5,104,66.3,2,0,0
10/15/2017 12:40,51,68.2,69,63.5,120,65.5,2,0,0
10/15/2017 12:45,53,69,71,64.4,124,66.3,2,0,0
10/15/2017 12:50,55,69.1,73,64.4,128,66.4,2,0,0
10/15/2017 12:55,53,69.2,71,64.6,124,66.6,2,0,0
10/15/2017 13:00,57,69.5,75,64.9,132,66.9,2,0,0
10/15/2017 13:05,48,69.5,65,64.9,113,66.9,2,0,0
10/15/2017 13:10,59,69.5,77,65,136,67,2,0,0
10/15/2017 13:15,63,69.3,82,64.7,145,66.7,2,0,0
10/15/2017 13:20,51,69.2,69,64.6,120,66.5,2,0,0
10/15/2017 13:25,59,68.9,78,64.2,137,66.2,2,0,0
10/15/2017 13:30,55,69.3,74,64.7,129,66.6,2,0,0
10/15/2017 13:35,60,69.6,79,65,139,67,2,0,0
10/15/2017 13:40,59,69.2,76,64.6,135,66.6,2,0,0
10/15/2017 13:45,58,69.2,77,64.6,135,66.6,2,0,0
10/15/2017 13:50,61,68.5,80,63.8,141,65.8,2,0,0
10/15/2017 13:55,59,68.3,77,63.6,136,65.7,2,0,0
10/15/2017 14:00,58,68.7,76,64,134,66.1,2,0,0
10/15/2017 14:05,51,68.2,69,63.6,120,65.6,2,0,0
10/15/2017 14:10,57,68.7,76,64.1,133,66.1,2,0,0
10/15/2017 14:15,53,69.3,69,64.7,122,66.7,2,0,0
10/15/2017 14:20,50,69,66,64.4,116,66.4,2,0,0
10/15/2017 14:25,55,68.8,74,64.1,129,66.1,2,0,0
10/15/2017 14:30,53,69.2,71,64.6,124,66.6,2,0,0
10/15/2017 14:35,50,69.6,68,65.1,118,67,2,0,0
10/15/2017 14:40,56,69.2,74,64.6,130,66.5,2,0,0
10/15/2017 14:45,54,67.9,72,63.2,126,65.3,2,0,0
10/15/2017 14:50,51,68.5,68,63.9,119,65.9,2,0,0
10/15/2017 14:55,61,68.5,80,63.8,141,65.8,2,0,0
10/15/2017 15:00,48,68.4,65,63.7,113,65.7,2,0,0
10/15/2017 15:05,45,69.2,62,64.6,107,66.6,2,0,0
10/15/2017 15:10,42,69.9,60,65.4,102,67.3,2,0,0
10/15/2017 15:15,51,69.4,69,64.8,120,66.8,2,0,0
10/15/2017 15:20,57,69.9,76,65.3,133,67.3,2,0,0
10/15/2017 15:25,54,69.7,72,65.1,126,67,2,0,0
10/15/2017 15:30,56,69.6,74,65,130,67,2,0,0
10/15/2017 15:35,58,70,75,65.5,133,67.5,2,0,0
10/15/2017 15:40,59,70.2,77,65.7,136,67.6,2,0,0
10/15/2017 15:45,56,69.6,74,65,130,67,2,0,0
10/15/2017 15:50,48,70.5,65,66.1,113,68,2,0,0
10/15/2017 15:55,58,70.1,76,65.6,134,67.6,2,0,0
10/15/2017 16:00,50,70,68,65.4,118,67.4,2,0,0
10/15/2017 16:05,48,70.2,65,65.6,113,67.6,2,0,0
10/15/2017 16:10,48,69.9,66,65.3,114,67.2,2,0,0
10/15/2017 16:15,51,70,69,65.4,120,67.3,2,0,0
10/15/2017 16:20,53,69.1,70,64.4,123,66.4,2,0,0
10/15/2017 16:25,60,68.6,77,63.9,137,65.9,2,0,0
10/15/2017 16:30,53,69.2,71,64.5,124,66.5,2,0,0
10/15/2017 16:35,50,69.1,67,64.5,117,66.5,2,0,0
10/15/2017 16:40,57,68.6,76,63.9,133,65.9,2,0,0
10/15/2017 16:45,49,68.9,66,64.3,115,66.2,2,0,0
10/15/2017 16:50,51,69.2,68,64.6,119,66.6,2,0,0
10/15/2017 16:55,54,69.6,71,65.1,125,67,2,0,0
10/15/2017 17:00,46,69.6,63,65.1,109,67,2,0,0
10/15/2017 17:05,58,68.8,77,64.2,135,66.2,2,0,0
10/15/2017 17:10,49,69.1,66,64.5,115,66.5,2,0,0
10/15/2017 17:15,44,69.4,62,64.7,106,66.6,2,0,0
10/15/2017 17:20,45,69,62,64.4,107,66.4,2,0,0
10/15/2017 17:25,47,68.9,64,64.2,111,66.2,2,0,0
10/15/2017 17:30,50,69,67,64.3,117,66.3,2,0,0
10/15/2017 17:35,41,69.5,58,64.9,99,66.8,2,0,0
10/15/2017 17:40,43,68.4,61,63.7,104,65.6,2,0,0
10/15/2017 17:45,37,68.8,54,64.2,91,66.1,2,0,0
10/15/2017 17:50,49,69.5,66,64.9,115,66.9,2,0,0
10/15/2017 17:55,40,69.5,56,64.9,96,66.8,2,0,0
10/15/2017 18:00,47,69.3,65,64.7,112,66.7,2,0,0
10/15/2017 18:05,43,69.4,61,64.8,104,66.7,2,0,0
10/15/2017 18:10,36,69.6,53,65,89,66.9,2,0,0
10/15/2017 18:15,45,68.9,63,64.3,108,66.2,2,0,0
10/15/2017 18:20,41,69.2,59,64.6,100,66.5,2,0,0
10/15/2017 18:25,46,70.1,63,65.5,109,67.4,2,0,0
10/15/2017 18:30,39,70.6,56,66.1,95,67.9,2,0,0
10/15/2017 18:35,51,69.7,69,65.1,120,67,2,0,0
10/15/2017 18:40,45,69.1,62,64.5,107,66.5,2,0,0
10/15/2017 18:45,46,69.4,63,64.8,109,66.7,2,0,0
10/15/2017 18:50,44,69.1,60,64.5,104,66.5,2,0,0
10/15/2017 18:55,50,69.1,69,64.4,119,66.4,2,0,0
10/15/2017 19:00,42,69.7,59,65.1,101,67,2,0,0
10/15/2017 19:05,47,69.5,64,65,111,66.9,2,0,0
10/15/2017 19:10,46,69.6,63,65.1,109,67,2,0,0
10/15/2017 19:15,42,69.4,59,64.8,101,66.7,2,0,0
10/15/2017 19:20,47,69.4,65,64.8,112,66.7,2,0,0
10/15/2017 19:25,40,68.9,56,64.2,96,66.1,2,0,0
10/15/2017 19:30,34,69.2,50,64.6,84,66.5,2,0,0
10/15/2017 19:35,43,68.5,61,63.7,104,65.7,2,0,0
10/15/2017 19:40,42,69.1,59,64.4,101,66.4,2,0,0
10/15/2017 19:45,40,69.4,57,64.8,97,66.7,2,0,0
10/15/2017 19:50,38,69.4,53,64.8,91,66.7,2,0,0
10/15/2017 19:55,44,69.4,60,64.8,104,66.8,2,0,0
10/15/2017 20:00,35,69.6,52,65,87,66.8,2,0,0
10/15/2017 20:05,30,69.7,46,65.1,76,66.9,2,0,0
10/15/2017 20:10,33,69.7,49,65.1,82,67,2,0,0
10/15/2017 20:15,37,69.3,54,64.7,91,66.5,2,0,0
10/15/2017 20:20,32,68.9,49,64.3,81,66.1,2,0,0
10/15/2017 20:25,34,69.5,50,65,84,66.8,2,0,0
10/15/2017 20:30,25,69.9,41,65.3,66,67.1,2,0,0
10/15/2017 20:35,30,69.7,47,65.1,77,66.9,2,0,0
10/15/2017 20:40,32,69.6,49,65,81,66.9,2,0,0
10/15/2017 20:45,22,69.2,38,64.6,60,66.3,2,0,0
10/15/2017 20:50,29,69.6,45,65.1,74,66.9,2,0,0
10/15/2017 20:55,31,68.9,47,64.3,78,66.1,2,0,0
10/15/2017 21:00,28,69.2,44,64.6,72,66.4,2,0,0
10/15/2017 21:05,20,69.6,36,65,56,66.7,2,0,0
10/15/2017 21:10,22,69.5,38,64.9,60,66.6,2,0,0
10/15/2017 21:15,29,69.5,45,64.9,74,66.7,2,0,0
10/15/2017 21:20,30,70,45,65.4,75,67.2,2,0,0
10/15/2017 21:25,27,69.2,43,64.6,70,66.4,2,0,0
10/15/2017 21:30,36,69.3,52,64.7,88,66.6,2,0,0
10/15/2017 21:35,24,69.3,40,64.7,64,66.4,2,0,0
10/15/2017 21:40,33,69.1,49,64.5,82,66.3,2,0,0
10/15/2017 21:45,23,69.2,40,64.6,63,66.3,2,0,0
10/15/2017 21:50,18,69.3,34,64.7,52,66.3,2,0,0
10/15/2017 21:55,20,69.3,36,64.7,56,66.4,2,0,0
10/15/2017 22:00,27,69.1,43,64.5,70,66.3,2,0,0
10/15/2017 22:05,22,69.2,38,64.6,60,66.3,2,0,0
10/15/2017 22:10,22,69.1,38,64.4,60,66.1,2,0,0
10/15/2017 22:15,21,69.4,37,64.8,58,66.5,2,0,0
10/15/2017 22:20,24,69.3,41,64.7,65,66.4,2,0,0
10/15/2017 22:25,20,69.3,36,64.7,56,66.4,2,0,0
10/15/2017 22:30,25,69.6,41,65,66,66.7,2,0,0
10/15/2017 22:35,18,69.5,34,64.9,52,66.4,2,0,0
10/15/2017 22:40,18,69.5,34,64.9,52,66.5,2,0,0
10/15/2017 22:45,19,69.6,34,65,53,66.6,2,0,0
10/15/2017 22:50,22,69.9,38,65.3,60,67,2,0,0
10/15/2017 22:55,18,69.6,33,65,51,66.7,2,0,0
10/15/2017 23:00,19,69.5,34,64.9,53,66.6,2,0,0
10/15/2017 23:05,17,69.3,32,64.7,49,66.3,2,0,0
10/15/2017 23:10,17,69.2,33,64.6,50,66.2,2,0,0
10/15/2017 23:15,18,69.5,34,64.9,52,66.4,2,0,0
10/15/2017 23:20,18,69.4,33,64.8,51,66.4,2,0,0
10/15/2017 23:25,17,68.9,32,64.3,49,65.9,2,0,0
10/15/2017 23:30,21,69.1,37,64.4,58,66.1,2,0,0
10/15/2017 23:35,16,69.2,31,64.5,47,66.1,2,0,0
10/15/2017 23:40,14,69.3,30,64.7,44,66.1,2,0,0
10/15/2017 23:45,15,69.3,31,64.7,46,66.2,2,0,0
10/15/2017 23:50,18,69.3,33,64.7,51,66.3,2,0,0
10/15/2017 23:55,10,69.4,25,64.8,35,66.1,2,0,0
