5 Minutes,Lane 1 Flow (Veh/5 Minutes),Lane 1 Speed (mph),Lane 2 Flow (Veh/5 Minutes),Lane 2 Speed (mph),Flow (Veh/5 Minutes),Speed (mph),# Lane Points,% Observed,Holiday
10/23/2017 0:00,16,69.3,31,64.7,47,66.3,2,0,0
10/23/2017 0:05,13,69.2,28,64.6,41,66,2,0,0
10/23/2017 0:10,15,69.3,30,64.7,45,66.2,2,0,0
10/23/2017 0:15,13,69.4,28,64.8,41,66.3,2,0,0
10/23/2017 0:20,12,69.4,27,64.7,39,66.2,2,0,0
10/23/2017 0:25,10,69.3,25,64.7,35,66,2,0,0
10/23/2017 0:30,10,69.3,25,64.7,35,66.1,2,0,0
10/23/2017 0:35,12,69.3,21,64.7,33,66.4,2,0,0
10/23/2017 0:40,8,69.3,23,64.7,31,65.9,2,0,0
10/23/2017 0:45,9,69.3,24,64.7,33,66,2,0,0
10/23/2017 0:50,19,69.1,24,64.5,43,66.5,2,0,0
10/23/2017 0:55,11,69.4,26,64.8,37,66.1,2,0,0
10/23/2017 1:00,10,69.4,25,64.8,35,66.2,2,0,0
10/23/2017 1:05,5,69.4,20,64.8,25,65.7,2,0,0
10/23/2017 1:10,6,69.5,21,64.9,27,65.9,2,0,0
10/23/2017 1:15,5,69.5,20,64.9,25,65.8,2,0,0
10/23/2017 1:20,9,69.3,24,64.7,33,65.9,2,0,0
10/23/2017 1:25,6,69.3,21,64.7,27,65.7,2,0,0
10/23/2017 1:30,6,69.4,21,64.8,27,65.8,2,0,0
10/23/2017 1:35,5,69.3,20,64.7,25,65.7,2,0,0
10/23/2017 1:40,7,69.3,22,64.7,29,65.8,2,0,0
10/23/2017 1:45,7,69.3,22,64.7,29,65.8,2,0,0
10/23/2017 1:50,5,69.3,21,64.7,26,65.6,2,0,0
10/23/2017 1:55,10,69.3,20,64.7,30,66.3,2,0,0
10/23/2017 2:00,8,69.4,24,64.8,32,65.9,2,0,0
10/23/2017 2:05,7,69.1,22,64.4,29,65.5,2,0,0
10/23/2017 2:10,7,69.1,22,64.5,29,65.6,2,0,0
10/23/2017 2:15,5,69,21,64.4,26,65.2,2,0,0
10/23/2017 2:20,5,69.1,20,64.5,25,65.4,2,0,0
10/23/2017 2:25,7,69.3,22,64.7,29,65.8,2,0,0
10/23/2017 2:30,7,69.3,23,64.7,30,65.8,2,0,0
10/23/2017 2:35,10,69,25,64.4,35,65.7,2,0,0
10/23/2017 2:40,9,69.3,25,64.7,34,65.9,2,0,0
10/23/2017 2:45,8,69.3,23,64.7,31,65.9,2,0,0
10/23/2017 2:50,9,69.2,24,64.6,33,65.9,2,0,0
10/23/2017 2:55,8,69.3,23,64.7,31,65.9,2,0,0
10/23/2017 3:00,9,69.3,24,64.7,33,66,2,0,0
10/23/2017 3:05,7,69.2,23,64.6,30,65.7,2,0,0
10/23/2017 3:10,10,69.2,25,64.5,35,65.9,2,0,0
10/23/2017 3:15,8,69.2,23,64.6,31,65.8,2,0,0
10/23/2017 3:20,9,69.3,24,64.7,33,65.9,2,0,0
10/23/2017 3:25,11,69.4,26,64.8,37,66.2,2,0,0
10/23/2017 3:30,12,69.5,28,64.9,40,66.3,2,0,0
10/23/2017 3:35,10,69.4,26,64.8,36,66.1,2,0,0
10/23/2017 3:40,12,69.4,28,64.7,40,66.1,2,0,0
10/23/2017 3:45,13,69.4,28,64.8,41,66.3,2,0,0
10/23/2017 3:50,13,69.4,29,64.8,42,66.2,2,0,0
10/23/2017 3:55,14,69.5,30,64.9,44,66.4,2,0,0
10/23/2017 4:00,14,69.3,29,64.7,43,66.2,2,0,0
10/23/2017 4:05,16,69.4,32,64.8,48,66.3,2,0,0
10/23/2017 4:10,16,69.4,32,64.8,48,66.3,2,0,0
10/23/2017 4:15,21,69,38,64.4,59,66,2,0,0
10/23/2017 4:20,27,68.9,45,64.2,72,66,2,0,0
10/23/2017 4:25,24,69.1,41,64.5,65,66.2,2,0,0
10/23/2017 4:30,30,69,47,64.3,77,66.2,2,0,0
10/23/2017 4:35,34,68.7,51,64,85,65.9,2,0,0
10/23/2017 4:40,42,69.5,59,64.9,101,66.8,2,0,0
10/23/2017 4:45,40,69.6,58,65,98,66.9,2,0,0
10/23/2017 4:50,41,68.9,59,64.3,100,66.2,2,0,0
10/23/2017 4:55,52,69.2,71,64.6,123,66.5,2,0,0
10/23/2017 5:00,44,69.5,63,64.8,107,66.7,2,0,0
10/23/2017 5:05,55,70.1,74,65.5,129,67.5,2,0,0
10/23/2017 5:10,45,69.3,64,64.7,109,66.6,2,0,0
10/23/2017 5:15,52,69.6,71,64.9,123,66.9,2,0,0
10/23/2017 5:20,49,69.2,68,64.5,117,66.5,2,0,0
10/23/2017 5:25,56,68.8,77,64.1,133,66.1,2,0,0
10/23/2017 5:30,56,69.1,78,64.4,134,66.4,2,0,0
10/23/2017 5:35,60,68.7,82,64,142,66,2,0,0
10/23/2017 5:40,67,66.7,89,61.8,156,63.9,2,0,0
10/23/2017 5:45,73,68.1,96,63.4,169,65.4,2,0,0
10/23/2017 5:50,66,68.5,88,63.7,154,65.8,2,0,0
10/23/2017 5:55,66,68.5,88,63.8,154,65.8,2,0,0
10/23/2017 6:00,56,68.4,77,63.6,133,65.6,2,0,0
10/23/2017 6:05,54,68.3,74,63.5,128,65.5,2,0,0
10/23/2017 6:10,60,68.5,81,63.7,141,65.7,2,0,0
10/23/2017 6:15,59,67.5,80,62.6,139,64.7,2,0,0
10/23/2017 6:20,62,66.4,83,61.3,145,63.5,2,0,0
10/23/2017 6:25,59,67,79,62.1,138,64.2,2,0,0
10/23/2017 6:30,64,66.2,85,61.2,149,63.4,2,0,0
10/23/2017 6:35,61,65.5,82,60.5,143,62.6,2,0,0
10/23/2017 6:40,63,66.8,84,61.9,147,64,2,0,0
10/23/2017 6:45,78,65.9,100,60.9,178,63.1,2,0,0
10/23/2017 6:50,65,66.9,86,61.9,151,64,2,0,0
10/23/2017 6:55,64,66.9,86,61.9,150,64,2,0,0
10/23/2017 7:00,62,67.2,83,62.2,145,64.4,2,0,0
10/23/2017 7:05,67,65.7,88,60.5,155,62.8,2,0,0
10/23/2017 7:10,69,66.6,90,61.6,159,63.8,2,0,0
10/23/2017 7:15,72,66.5,94,61.5,166,63.6,2,0,0
10/23/2017 7:20,79,66,102,60.9,181,63.1,2,0,0
10/23/2017 7:25,77,66.1,99,61,176,63.2,2,0,0
10/23/2017 7:30,67,67.3,90,62.3,157,64.4,2,0,0
10/23/2017 7:35,70,67.5,92,62.6,162,64.7,2,0,0
10/23/2017 7:40,77,67.5,99,62.5,176,64.7,2,0,0
10/23/2017 7:45,77,67.8,100,62.9,177,65.1,2,0,0
10/23/2017 7:50,83,67.3,106,62.3,189,64.5,2,0,0
10/23/2017 7:55,72,67.4,94,62.5,166,64.6,2,0,0
10/23/2017 8:00,84,66.8,107,61.8,191,64,2,0,0
10/23/2017 8:05,73,67.2,95,62.2,168,64.4,2,0,0
10/23/2017 8:10,66,67.4,88,62.4,154,64.5,2,0,0
10/23/2017 8:15,72,67.6,94,62.7,166,64.8,2,0,0
10/23/2017 8:20,94,66.6,118,61.6,212,63.8,2,0,0
10/23/2017 8:25,69,66.8,91,61.7,160,63.9,2,0,0
10/23/2017 8:30,76,65.8,98,60.6,174,62.9,2,0,0
10/23/2017 8:35,91,63.9,114,58.6,205,61,2,0,0
10/23/2017 8:40,89,64.7,111,59.5,200,61.8,2,0,0
10/23/2017 8:45,79,63.9,102,58.7,181,61,2,0,0
10/23/2017 8:50,75,64.7,97,59.5,172,61.8,2,0,0
10/23/2017 8:55,81,65.1,103,60,184,62.3,2,0,0
10/23/2017 9:00,76,66,97,60.9,173,63.1,2,0,0
10/23/2017 9:05,66,66.5,87,61.5,153,63.6,2,0,0
10/23/2017 9:10,60,65.4,80,60.4,140,62.5,2,0,0
10/23/2017 9:15,69,64.6,90,59.6,159,61.7,2,0,0
10/23/2017 9:20,73,65.1,93,60.1,166,62.3,2,0,0
10/23/2017 9:25,70,64.9,92,59.8,162,62,2,0,0
10/23/2017 9:30,62,65,83,60,145,62.1,2,0,0
10/23/2017 9:35,69,64.3,90,59.2,159,61.4,2,0,0
10/23/2017 9:40,60,65.1,80,60.1,140,62.3,2,0,0
10/23/2017 9:45,68,64.6,89,59.6,157,61.8,2,0,0
10/23/2017 9:50,57,64.5,77,59.5,134,61.6,2,0,0
10/23/2017 9:55,70,65.1,91,60.2,161,62.3,2,0,0
10/23/2017 10:00,59,65.5,79,60.6,138,62.7,2,0,0
10/23/2017 10:05,57,66.2,75,61.4,132,63.5,2,0,0
10/23/2017 10:10,65,65.7,84,60.8,149,62.9,2,0,0
10/23/2017 10:15,62,67.1,81,62.3,143,64.4,2,0,0
10/23/2017 10:20,51,66.8,70,62,121,64,2,0,0
10/23/2017 10:25,54,68.3,72,63.6,126,65.6,2,0,0
10/23/2017 10:30,63,66.5,81,61.7,144,63.8,2,0,0
10/23/2017 10:35,57,67.2,76,62.5,133,64.5,2,0,0
10/23/2017 10:40,62,67.3,82,62.6,144,64.6,2,0,0
10/23/2017 10:45,56,67.1,75,62.3,131,64.3,2,0,0
10/23/2017 10:50,55,65.9,74,61,129,63.1,2,0,0
10/23/2017 10:55,46,68.3,63,63.6,109,65.5,2,0,0
10/23/2017 11:00,48,67.9,66,63.2,114,65.2,2,0,0
10/23/2017 11:05,46,68.5,64,63.8,110,65.8,2,0,0
10/23/2017 11:10,57,67.6,75,62.9,132,64.9,2,0,0
10/23/2017 11:15,54,67.7,73,62.9,127,64.9,2,0,0
10/23/2017 11:20,57,67.8,76,63,133,65.1,2,0,0
10/23/2017 11:25,57,66.8,75,62,132,64.1,2,0,0
10/23/2017 11:30,49,67.3,66,62.5,115,64.6,2,0,0
10/23/2017 11:35,52,67.3,70,62.5,122,64.6,2,0,0
10/23/2017 11:40,55,67.3,74,62.4,129,64.5,2,0,0
10/23/2017 11:45,54,67,72,62.2,126,64.2,2,0,0
10/23/2017 11:50,48,67.5,66,62.6,114,64.7,2,0,0
10/23/2017 11:55,55,68.8,74,64,129,66.1,2,0,0
10/23/2017 12:00,44,68.9,61,64.2,105,66.2,2,0,0
10/23/2017 12:05,54,66.2,71,61.4,125,63.5,2,0,0
10/23/2017 12:10,53,67.8,70,63.1,123,65.1,2,0,0
10/23/2017 12:15,51,69.2,69,64.6,120,66.6,2,0,0
10/23/2017 12:20,54,68.1,72,63.5,126,65.5,2,0,0
10/23/2017 12:25,56,68.7,74,64,130,66,2,0,0
10/23/2017 12:30,43,68,61,63.4,104,65.3,2,0,0
10/23/2017 12:35,50,67.2,68,62.4,118,64.4,2,0,0
10/23/2017 12:40,57,68.7,74,64.1,131,66.1,2,0,0
10/23/2017 12:45,47,68.5,63,63.9,110,65.9,2,0,0
10/23/2017 12:50,48,68.1,65,63.4,113,65.4,2,0,0
10/23/2017 12:55,48,67.9,66,63.2,114,65.2,2,0,0
10/23/2017 13:00,54,67.5,72,62.7,126,64.8,2,0,0
10/23/2017 13:05,42,68.3,59,63.6,101,65.5,2,0,0
10/23/2017 13:10,48,68.1,66,63.4,114,65.3,2,0,0
10/23/2017 13:15,53,67.9,71,63.3,124,65.3,2,0,0
10/23/2017 13:20,46,68.5,64,63.8,110,65.8,2,0,0
10/23/2017 13:25,35,69.5,52,64.9,87,66.8,2,0,0
10/23/2017 13:30,48,70.5,65,66,113,67.9,2,0,0
10/23/2017 13:35,44,69.8,62,65.2,106,67.1,2,0,0
10/23/2017 13:40,55,69.8,74,65.2,129,67.2,2,0,0
10/23/2017 13:45,55,69.1,74,64.5,129,66.4,2,0,0
10/23/2017 13:50,51,68,69,63.2,120,65.3,2,0,0
10/23/2017 13:55,42,68.4,59,63.7,101,65.7,2,0,0
10/23/2017 14:00,42,68.8,59,64.2,101,66.1,2,0,0
10/23/2017 14:05,43,68.5,61,63.9,104,65.8,2,0,0
10/23/2017 14:10,45,68.9,63,64.2,108,66.2,2,0,0
10/23/2017 14:15,48,69,66,64.3,114,66.3,2,0,0
10/23/2017 14:20,46,69.5,63,64.8,109,66.8,2,0,0
10/23/2017 14:25,47,69.6,65,65,112,66.9,2,0,0
10/23/2017 14:30,46,69.3,65,64.6,111,66.5,2,0,0
10/23/2017 14:35,49,68.5,67,63.9,116,65.8,2,0,0
10/23/2017 14:40,41,69.9,59,65.3,100,67.2,2,0,0
10/23/2017 14:45,44,68.4,62,63.8,106,65.8,2,0,0
10/23/2017 14:50,55,69,74,64.4,129,66.3,2,0,0
10/23/2017 14:55,47,70.6,64,66.2,111,68.1,2,0,0
10/23/2017 15:00,45,70.6,62,66.1,107,68,2,0,0
10/23/2017 15:05,44,70.3,61,65.7,105,67.6,2,0,0
10/23/2017 15:10,61,70.4,80,65.9,141,67.8,2,0,0
10/23/2017 15:15,60,70,78,65.4,138,67.4,2,0,0
10/23/2017 15:20,52,68,71,63.3,123,65.3,2,0,0
10/23/2017 15:25,63,68.3,82,63.6,145,65.6,2,0,0
10/23/2017 15:30,54,68.2,72,63.5,126,65.5,2,0,0
10/23/2017 15:35,52,68.2,70,63.6,122,65.6,2,0,0
10/23/2017 15:40,59,69.8,78,65.3,137,67.3,2,0,0
10/23/2017 15:45,56,70,74,65.4,130,67.4,2,0,0
10/23/2017 15:50,66,70.3,85,65.7,151,67.7,2,0,0
10/23/2017 15:55,58,70.1,77,65.4,135,67.4,2,0,0
10/23/2017 16:00,53,69.8,71,65.2,124,67.1,2,0,0
10/23/2017 16:05,53,69.6,70,64.9,123,66.9,2,0,0
10/23/2017 16:10,55,69.3,73,64.6,128,66.6,2,0,0
10/23/2017 16:15,53,68.9,71,64.2,124,66.2,2,0,0
10/23/2017 16:20,56,68.7,74,64,130,66,2,0,0
10/23/2017 16:25,53,67.3,72,62.5,125,64.5,2,0,0
10/23/2017 16:30,51,68.6,69,63.8,120,65.8,2,0,0
10/23/2017 16:35,57,69.4,76,64.7,133,66.7,2,0,0
10/23/2017 16:40,50,70.3,68,65.7,118,67.7,2,0,0
10/23/2017 16:45,45,70.4,62,65.9,107,67.8,2,0,0
10/23/2017 16:50,50,69.2,68,64.5,118,66.5,2,0,0
10/23/2017 16:55,54,68.6,72,63.9,126,65.9,2,0,0
10/23/2017 17:00,58,67.7,75,62.8,133,64.9,2,0,0
10/23/2017 17:05,55,67.4,72,62.5,127,64.6,2,0,0
10/23/2017 17:10,56,68.6,75,63.8,131,65.9,2,0,0
10/23/2017 17:15,66,68.8,85,64.1,151,66.1,2,0,0
10/23/2017 17:20,61,68.7,79,64.1,140,66.1,2,0,0
10/23/2017 17:25,49,66.4,67,61.5,116,63.6,2,0,0
10/23/2017 17:30,56,67.6,74,62.9,130,64.9,2,0,0
10/23/2017 17:35,46,68.3,65,63.7,111,65.6,2,0,0
10/23/2017 17:40,53,68.9,70,64.2,123,66.3,2,0,0
10/23/2017 17:45,58,69.4,76,64.8,134,66.8,2,0,0
10/23/2017 17:50,53,69.7,71,65.1,124,67.1,2,0,0
10/23/2017 17:55,50,70,67,65.5,117,67.4,2,0,0
10/23/2017 18:00,47,69,65,64.4,112,66.3,2,0,0
10/23/2017 18:05,48,67.9,66,63.2,114,65.2,2,0,0
10/23/2017 18:10,50,69.1,68,64.4,118,66.4,2,0,0
10/23/2017 18:15,51,68.8,69,64.1,120,66.1,2,0,0
10/23/2017 18:20,53,67.2,71,62.4,124,64.5,2,0,0
10/23/2017 18:25,60,67.2,79,62.4,139,64.5,2,0,0
10/23/2017 18:30,50,67.3,68,62.4,118,64.5,2,0,0
10/23/2017 18:35,46,68,63,63.2,109,65.3,2,0,0
10/23/2017 18:40,49,67.1,67,62.3,116,64.3,2,0,0
10/23/2017 18:45,44,68.3,61,63.6,105,65.5,2,0,0
10/23/2017 18:50,47,67.4,64,62.6,111,64.7,2,0,0
10/23/2017 18:55,45,67.9,61,63.1,106,65.2,2,0,0
10/23/2017 19:00,37,68.7,54,64,91,65.9,2,0,0
10/23/2017 19:05,39,69.7,55,65.2,94,67.1,2,0,0
10/23/2017 19:10,40,68.8,57,64.1,97,66.1,2,0,0
10/23/2017 19:15,43,68.8,61,64.2,104,66.1,2,0,0
10/23/2017 19:20,35,69.3,52,64.7,87,66.6,2,0,0
10/23/2017 19:25,38,68.5,56,63.9,94,65.8,2,0,0
10/23/2017 19:30,33,68.7,50,64.1,83,66,2,0,0
10/23/2017 19:35,36,68.5,52,63.8,88,65.7,2,0,0
10/23/2017 19:40,34,68.6,51,63.9,85,65.8,2,0,0
10/23/2017 19:45,36,68.8,52,64.1,88,66.1,2,0,0
10/23/2017 19:50,29,69.1,46,64.4,75,66.2,2,0,0
10/23/2017 19:55,28,69.6,45,65,73,66.8,2,0,0
10/23/2017 20:00,29,68.8,44,64.1,73,66,2,0,0
10/23/2017 20:05,26,69.1,43,64.5,69,66.2,2,0,0
10/23/2017 20:10,35,69.6,52,65,87,66.9,2,0,0
10/23/2017 20:15,33,68.4,50,63.7,83,65.6,2,0,0
10/23/2017 20:20,30,69.1,46,64.4,76,66.3,2,0,0
10/23/2017 20:25,34,69.5,51,65,85,66.8,2,0,0
10/23/2017 20:30,27,69.3,42,64.7,69,66.5,2,0,0
10/23/2017 20:35,26,69.5,42,64.9,68,66.6,2,0,0
10/23/2017 20:40,30,69.5,47,64.9,77,66.7,2,0,0
10/23/2017 20:45,28,69,44,64.4,72,66.2,2,0,0
10/23/2017 20:50,28,69.2,44,64.6,72,66.4,2,0,0
10/23/2017 20:55,30,68.6,47,64,77,65.8,2,0,0
10/23/2017 21:00,27,68.9,43,64.3,70,66.1,2,0,0
10/23/2017 21:05,31,69.2,47,64.6,78,66.4,2,0,0
10/23/2017 21:10,29,70.1,45,65.5,74,67.3,2,0,0
10/23/2017 21:15,30,69.8,46,65.2,76,67,2,0,0
10/23/2017 21:20,27,69.7,43,65.1,70,66.9,2,0,0
10/23/2017 21:25,24,68.8,39,64.1,63,65.9,2,0,0
10/23/2017 21:30,25,69.3,41,64.7,66,66.4,2,0,0
10/23/2017 21:35,26,69.5,42,64.9,68,66.6,2,0,0
10/23/2017 21:40,18,69.7,34,65.1,52,66.7,2,0,0
10/23/2017 21:45,26,69.6,41,65,67,66.8,2,0,0
10/23/2017 21:50,21,69.8,36,65.2,57,66.9,2,0,0
10/23/2017 21:55,19,69.7,35,65.2,54,66.8,2,0,0
10/23/2017 22:00,21,69.5,36,64.9,57,66.6,2,0,0
10/23/2017 22:05,19,69.2,36,64.5,55,66.1,2,0,0
10/23/2017 22:10,17,69.3,33,64.7,50,66.2,2,0,0
10/23/2017 22:15,21,68.5,37,63.9,58,65.5,2,0,0
10/23/2017 22:20,23,68.9,39,64.3,62,66,2,0,0
10/23/2017 22:25,14,68.8,29,64.2,43,65.7,2,0,0
10/23/2017 22:30,18,68.5,34,63.8,52,65.4,2,0,0
10/23/2017 22:35,15,68.8,31,64.2,46,65.7,2,0,0
10/23/2017 22:40,21,68.6,37,63.9,58,65.6,2,0,0
10/23/2017 22:45,20,68.7,36,64.1,56,65.7,2,0,0
10/23/2017 22:50,19,69,35,64.4,54,66,2,0,0
10/23/2017 22:55,17,69.1,33,64.5,50,66.1,2,0,0
10/23/2017 23:00,22,69.5,38,64.9,60,66.6,2,0,0
10/23/2017 23:05,15,69.4,31,64.8,46,66.3,2,0,0
10/23/2017 23:10,18,69,34,64.4,52,66,2,0,0
10/23/2017 23:15,13,69.3,28,64.7,41,66.2,2,0,0
10/23/2017 23:20,14,69.4,30,64.8,44,66.2,2,0,0
10/23/2017 23:25,14,69.3,29,64.7,43,66.2,2,0,0
10/23/2017 23:30,15,69.3,30,64.7,45,66.3,2,0,0
10/23/2017 23:35,13,69.3,28,64.7,41,66.1,2,0,0
10/23/2017 23:40,16,69.4,31,64.8,47,66.3,2,0,0
10/23/2017 23:45,18,69.4,33,64.8,51,66.4,2,0,0
10/23/2017 23:50,17,69.4,32,64.8,49,66.4,2,0,0
10/23/2017 23:55,11,69.3,27,64.7,38,66,2,0,0
10/24/2017 0:00,12,69.3,27,64.7,39,66.2,2,0,0
10/24/2017 0:05,8,69.3,24,64.7,32,65.9,2,0,0
10/24/2017 0:10,14,69.3,29,64.7,43,66.2,2,0,0
10/24/2017 0:15,7,69.3,22,64.7,29,65.8,2,0,0
10/24/2017 0:20,8,69.3,23,64.7,31,65.8,2,0,0
10/24/2017 0:25,9,69.3,24,64.7,33,65.9,2,0,0
10/24/2017 0:30,7,69.2,23,64.5,30,65.6,2,0,0
10/24/2017 0:35,9,69.2,25,64.6,34,65.8,2,0,0
10/24/2017 0:40,10,69.2,25,64.6,35,65.9,2,0,0
10/24/2017 0:45,8,69.2,23,64.6,31,65.8,2,0,0
10/24/2017 0:50,7,69.2,22,64.6,29,65.7,2,0,0
10/24/2017 0:55,8,69.3,19,64.7,27,66,2,0,0
10/24/2017 1:00,6,69.4,22,64.8,28,65.8,2,0,0
10/24/2017 1:05,6,69.4,21,64.8,27,65.8,2,0,0
10/24/2017 1:10,8,69.4,24,64.8,32,66,2,0,0
10/24/2017 1:15,14,69.5,22,64.9,36,66.7,2,0,0
10/24/2017 1:20,6,69.2,22,64.5,28,65.5,2,0,0
10/24/2017 1:25,6,69.3,21,64.7,27,65.7,2,0,0
10/24/2017 1:30,5,69.2,21,64.6,26,65.5,2,0,0
10/24/2017 1:35,7,69.3,22,64.7,29,65.8,2,0,0
10/24/2017 1:40,8,69.3,19,64.7,27,66.1,2,0,0
10/24/2017 1:45,14,69.1,22,64.5,36,66.3,2,0,0
10/24/2017 1:50,8,69.2,23,64.6,31,65.8,2,0,0
10/24/2017 1:55,5,69.2,20,64.5,25,65.5,2,0,0
10/24/2017 2:00,14,69.2,22,64.6,36,66.4,2,0,0
10/24/2017 2:05,6,69.3,21,64.7,27,65.7,2,0,0
10/24/2017 2:10,7,69.3,22,64.7,29,65.8,2,0,0
10/24/2017 2:15,6,69.3,21,64.7,27,65.7,2,0,0
10/24/2017 2:20,7,68.8,22,64.2,29,65.3,2,0,0
10/24/2017 2:25,9,68.9,24,64.2,33,65.5,2,0,0
10/24/2017 2:30,8,69,24,64.3,32,65.5,2,0,0
10/24/2017 2:35,7,69.1,22,64.5,29,65.6,2,0,0
10/24/2017 2:40,9,69.2,24,64.6,33,65.8,2,0,0
10/24/2017 2:45,9,69.3,24,64.7,33,65.9,2,0,0
10/24/2017 2:50,8,69.3,23,64.7,31,65.9,2,0,0
10/24/2017 2:55,11,69.2,27,64.5,38,65.9,2,0,0
10/24/2017 3:00,7,69.2,23,64.6,30,65.7,2,0,0
10/24/2017 3:05,11,69.2,26,64.6,37,66,2,0,0
10/24/2017 3:10,10,69.2,25,64.6,35,65.9,2,0,0
10/24/2017 3:15,10,68.9,26,64.3,36,65.6,2,0,0
10/24/2017 3:20,10,68.9,26,64.3,36,65.6,2,0,0
10/24/2017 3:25,10,69.2,26,64.5,36,65.8,2,0,0
10/24/2017 3:30,13,69.2,29,64.6,42,66,2,0,0
10/24/2017 3:35,11,69.3,26,64.7,37,66.1,2,0,0
10/24/2017 3:40,13,69.6,28,65,41,66.4,2,0,0
10/24/2017 3:45,13,69.5,28,64.9,41,66.4,2,0,0
10/24/2017 3:50,15,69.5,31,64.9,46,66.4,2,0,0
10/24/2017 3:55,8,69.5,24,64.9,32,66,2,0,0
10/24/2017 4:00,13,69.2,28,64.6,41,66.1,2,0,0
10/24/2017 4:05,14,69.3,29,64.7,43,66.2,2,0,0
10/24/2017 4:10,17,69.4,33,64.8,50,66.3,2,0,0
10/24/2017 4:15,25,69.7,42,65.2,67,66.9,2,0,0
10/24/2017 4:20,21,69.5,39,65,60,66.6,2,0,0
10/24/2017 4:25,28,69.8,45,65.2,73,67,2,0,0
10/24/2017 4:30,27,69.1,44,64.4,71,66.2,2,0,0
10/24/2017 4:35,31,68.2,49,63.5,80,65.3,2,0,0
10/24/2017 4:40,37,69.9,54,65.3,91,67.2,2,0,0
10/24/2017 4:45,45,70.3,62,65.8,107,67.7,2,0,0
10/24/2017 4:50,38,68.9,56,64.2,94,66.1,2,0,0
10/24/2017 4:55,43,70.2,62,65.7,105,67.5,2,0,0
10/24/2017 5:00,39,69.8,58,65.3,97,67.1,2,0,0
10/24/2017 5:05,41,70.6,59,66.1,100,67.9,2,0,0
10/24/2017 5:10,47,69.7,66,65.3,113,67.1,2,0,0
10/24/2017 5:15,48,70.4,67,66.1,115,67.9,2,0,0
10/24/2017 5:20,61,70.2,82,65.7,143,67.6,2,0,0
10/24/2017 5:25,56,69.2,77,64.7,133,66.6,2,0,0
10/24/2017 5:30,54,69.3,75,64.7,129,66.6,2,0,0
10/24/2017 5:35,63,69.6,84,65,147,67,2,0,0
10/24/2017 5:40,73,69.4,96,64.7,169,66.8,2,0,0
10/24/2017 5:45,71,69.8,93,65.2,164,67.2,2,0,0
10/24/2017 5:50,74,69.3,96,64.6,170,66.7,2,0,0
10/24/2017 5:55,59,70.7,79,66.2,138,68.1,2,0,0
10/24/2017 6:00,52,69.3,71,64.6,123,66.6,2,0,0
10/24/2017 6:05,65,67.6,86,62.8,151,64.9,2,0,0
10/24/2017 6:10,66,67,88,62.2,154,64.2,2,0,0
10/24/2017 6:15,65,67,86,62.1,151,64.2,2,0,0
10/24/2017 6:20,65,67.5,87,62.7,152,64.7,2,0,0
10/24/2017 6:25,68,67,89,62.2,157,64.3,2,0,0
10/24/2017 6:30,62,67.3,83,62.4,145,64.5,2,0,0
10/24/2017 6:35,68,67.8,89,62.9,157,65,2,0,0
10/24/2017 6:40,67,67.7,89,62.9,156,65,2,0,0
10/24/2017 6:45,80,67.9,104,63.1,184,65.2,2,0,0
10/24/2017 6:50,70,67.8,92,63,162,65.1,2,0,0
10/24/2017 6:55,64,68.5,85,63.7,149,65.8,2,0,0
10/24/2017 7:00,70,68.5,91,63.8,161,65.9,2,0,0
10/24/2017 7:05,66,68,88,63.3,154,65.3,2,0,0
10/24/2017 7:10,65,67.3,87,62.5,152,64.5,2,0,0
10/24/2017 7:15,84,67.4,106,62.7,190,64.8,2,0,0
10/24/2017 7:20,83,67.2,106,62.4,189,64.5,2,0,0
10/24/2017 7:25,84,67.2,107,62.3,191,64.5,2,0,0
10/24/2017 7:30,87,67.5,110,62.7,197,64.8,2,0,0
10/24/2017 7:35,88,67.8,112,63,200,65.1,2,0,0
10/24/2017 7:40,99,67.6,124,62.8,223,64.9,2,0,0
10/24/2017 7:45,91,67.7,116,62.9,207,65,2,0,0
10/24/2017 7:50,92,66.9,117,62,209,64.1,2,0,0
10/24/2017 7:55,87,66.5,110,61.6,197,63.7,2,0,0
10/24/2017 8:00,79,65.8,101,60.8,180,63,2,0,0
10/24/2017 8:05,82,65,106,59.9,188,62.1,2,0,0
10/24/2017 8:10,77,62.3,99,57,176,59.3,2,0,0
10/24/2017 8:15,77,62.3,98,56.9,175,59.3,2,0,0
10/24/2017 8:20,68,63.9,90,58.7,158,60.9,2,0,0
10/24/2017 8:25,89,64.1,112,59.1,201,61.3,2,0,0
10/24/2017 8:30,72,64.9,93,59.8,165,62,2,0,0
10/24/2017 8:35,69,65.3,89,60.3,158,62.5,2,0,0
10/24/2017 8:40,89,65.4,111,60.4,200,62.6,2,0,0
10/24/2017 8:45,82,63.8,104,58.7,186,61,2,0,0
10/24/2017 8:50,65,63.9,86,58.8,151,61,2,0,0
10/24/2017 8:55,83,65.5,105,60.5,188,62.7,2,0,0
10/24/2017 9:00,63,66.3,84,61.4,147,63.5,2,0,0
10/24/2017 9:05,72,66.5,93,61.7,165,63.8,2,0,0
10/24/2017 9:10,58,67.7,77,63,135,65,2,0,0
10/24/2017 9:15,76,65.9,97,61,173,63.2,2,0,0
10/24/2017 9:20,62,67.2,82,62.4,144,64.5,2,0,0
10/24/2017 9:25,66,66.6,87,61.7,153,63.8,2,0,0
10/24/2017 9:30,82,66.3,102,61.4,184,63.6,2,0,0
10/24/2017 9:35,64,67,84,62.2,148,64.2,2,0,0
10/24/2017 9:40,53,67.4,73,62.6,126,64.6,2,0,0
10/24/2017 9:45,70,67.1,91,62.2,161,64.3,2,0,0
10/24/2017 9:50,75,67.2,95,62.5,170,64.6,2,0,0
10/24/2017 9:55,61,66.5,80,61.7,141,63.8,2,0,0
10/24/2017 10:00,77,65.7,98,60.8,175,63,2,0,0
10/24/2017 10:05,73,66.3,94,61.5,167,63.6,2,0,0
10/24/2017 10:10,73,65.5,95,60.6,168,62.7,2,0,0
10/24/2017 10:15,74,65.7,93,60.8,167,63,2,0,0
10/24/2017 10:20,72,65.3,94,60.4,166,62.6,2,0,0
10/24/2017 10:25,69,65.9,90,61,159,63.2,2,0,0
10/24/2017 10:30,63,66,82,61.2,145,63.3,2,0,0
10/24/2017 10:35,63,67.5,83,62.8,146,64.8,2,0,0
10/24/2017 10:40,66,66.6,87,61.9,153,63.9,2,0,0
10/24/2017 10:45,62,64.8,82,59.9,144,62,2,0,0
10/24/2017 10:50,68,65.2,87,60.3,155,62.5,2,0,0
10/24/2017 10:55,64,65,84,60.1,148,62.2,2,0,0
10/24/2017 11:00,57,66.9,75,62.1,132,64.1,2,0,0
10/24/2017 11:05,56,66.5,75,61.7,131,63.8,2,0,0
10/24/2017 11:10,52,67.1,71,62.4,123,64.4,2,0,0
10/24/2017 11:15,52,67.7,70,62.9,122,64.9,2,0,0
10/24/2017 11:20,62,67.3,80,62.6,142,64.7,2,0,0
10/24/2017 11:25,61,68.2,80,63.4,141,65.5,2,0,0
10/24/2017 11:30,55,65.9,74,61,129,63.1,2,0,0
10/24/2017 11:35,49,67.8,66,63.2,115,65.2,2,0,0
10/24/2017 11:40,51,69.2,68,64.7,119,66.6,2,0,0
10/24/2017 11:45,47,67.6,64,62.9,111,64.9,2,0,0
10/24/2017 11:50,47,66.7,64,62,111,64,2,0,0
10/24/2017 11:55,42,67.8,59,63.1,101,65,2,0,0
10/24/2017 12:00,45,67.5,63,62.8,108,64.8,2,0,0
10/24/2017 12:05,53,68.3,71,63.7,124,65.7,2,0,0
10/24/2017 12:10,55,69.2,74,64.6,129,66.6,2,0,0
10/24/2017 12:15,45,69,62,64.4,107,66.3,2,0,0
10/24/2017 12:20,51,69.1,69,64.5,120,66.5,2,0,0
10/24/2017 12:25,55,70.5,73,66.1,128,68,2,0,0
10/24/2017 12:30,49,70.8,66,66.4,115,68.3,2,0,0
10/24/2017 12:35,56,70.6,74,66.2,130,68.1,2,0,0
10/24/2017 12:40,57,69.3,75,64.9,132,66.8,2,0,0
10/24/2017 12:45,54,68.6,73,64.1,127,66,2,0,0
10/24/2017 12:50,50,68.9,69,64.4,119,66.3,2,0,0
10/24/2017 12:55,53,67.9,70,63.2,123,65.2,2,0,0
10/24/2017 13:00,47,67.9,65,63.2,112,65.2,2,0,0
10/24/2017 13:05,45,69.1,62,64.5,107,66.5,2,0,0
10/24/2017 13:10,52,69.3,70,64.7,122,66.6,2,0,0
10/24/2017 13:15,46,69.9,63,65.4,109,67.3,2,0,0
10/24/2017 13:20,57,69.9,76,65.5,133,67.4,2,0,0
10/24/2017 13:25,42,69.7,60,65.3,102,67.1,2,0,0
10/24/2017 13:30,52,69.8,70,65.3,122,67.2,2,0,0
10/24/2017 13:35,44,68.8,62,64.2,106,66.1,2,0,0
10/24/2017 13:40,44,69.8,60,65.3,104,67.2,2,0,0
10/24/2017 13:45,54,67.6,72,63,126,65,2,0,0
10/24/2017 13:50,48,67.9,65,63.2,113,65.2,2,0,0
10/24/2017 13:55,47,68.6,65,64,112,65.9,2,0,0
10/24/2017 14:00,48,68.1,65,63.4,113,65.4,2,0,0
10/24/2017 14:05,48,67.6,65,62.9,113,64.9,2,0,0
10/24/2017 14:10,45,67.6,63,62.9,108,64.8,2,0,0
10/24/2017 14:15,50,64.6,69,59.7,119,61.7,2,0,0
10/24/2017 14:20,47,64.9,66,60,113,62,2,0,0
10/24/2017 14:25,55,67.8,73,63.1,128,65.1,2,0,0
10/24/2017 14:30,44,69,61,64.5,105,66.4,2,0,0
10/24/2017 14:35,56,68.3,74,63.6,130,65.6,2,0,0
10/24/2017 14:40,54,69.3,73,64.7,127,66.6,2,0,0
10/24/2017 14:45,48,69.9,65,65.4,113,67.3,2,0,0
10/24/2017 14:50,54,68.8,72,64.1,126,66.1,2,0,0
10/24/2017 14:55,50,68.8,68,64.1,118,66.1,2,0,0
10/24/2017 15:00,55,68,74,63.3,129,65.3,2,0,0
10/24/2017 15:05,58,68.1,77,63.4,135,65.4,2,0,0
10/24/2017 15:10,51,69.3,69,64.8,120,66.7,2,0,0
10/24/2017 15:15,60,68.9,79,64.3,139,66.3,2,0,0
10/24/2017 15:20,47,70.4,65,66,112,67.8,2,0,0
10/24/2017 15:25,58,68.3,77,63.7,135,65.7,2,0,0
10/24/2017 15:30,53,68.6,71,63.9,124,65.9,2,0,0
10/24/2017 15:35,60,69.6,80,65.1,140,67,2,0,0
10/24/2017 15:40,58,69,77,64.5,135,66.4,2,0,0
10/24/2017 15:45,61,68,80,63.3,141,65.4,2,0,0
10/24/2017 15:50,53,69,71,64.4,124,66.4,2,0,0
10/24/2017 15:55,58,68.8,76,64.1,134,66.1,2,0,0
10/24/2017 16:00,63,67.5,81,62.8,144,64.8,2,0,0
10/24/2017 16:05,56,67.1,74,62.4,130,64.4,2,0,0
10/24/2017 16:10,57,68.8,76,64.2,133,66.2,2,0,0
10/24/2017 16:15,70,67.4,89,62.7,159,64.8,2,0,0
10/24/2017 16:20,59,66.9,77,62.1,136,64.2,2,0,0
10/24/2017 16:25,54,67.4,72,62.6,126,64.6,2,0,0
10/24/2017 16:30,55,66.9,74,62,129,64.1,2,0,0
10/24/2017 16:35,52,68,69,63.1,121,65.2,2,0,0
10/24/2017 16:40,48,67.5,66,62.7,114,64.7,2,0,0
10/24/2017 16:45,63,68,82,63.3,145,65.3,2,0,0
10/24/2017 16:50,51,67.2,69,62.3,120,64.4,2,0,0
10/24/2017 16:55,48,67.9,66,63.1,114,65.1,2,0,0
10/24/2017 17:00,47,66.9,64,62.1,111,64.1,2,0,0
10/24/2017 17:05,42,67.4,60,62.7,102,64.6,2,0,0
10/24/2017 17:10,53,67.1,70,62.3,123,64.4,2,0,0
10/24/2017 17:15,55,67,74,62.2,129,64.2,2,0,0
10/24/2017 17:20,57,67.8,75,63.1,132,65.1,2,0,0
10/24/2017 17:25,45,68.5,63,63.8,108,65.8,2,0,0
10/24/2017 17:30,43,69.1,61,64.5,104,66.4,2,0,0
10/24/2017 17:35,48,69.1,66,64.5,114,66.4,2,0,0
10/24/2017 17:40,48,69.3,65,64.7,113,66.6,2,0,0
10/24/2017 17:45,50,70.3,67,65.8,117,67.7,2,0,0
10/24/2017 17:50,50,69.8,69,65.2,119,67.1,2,0,0
10/24/2017 17:55,50,69.3,68,64.7,118,66.6,2,0,0
10/24/2017 18:00,46,68.8,64,64.2,110,66.1,2,0,0
10/24/2017 18:05,55,70.4,73,66,128,67.9,2,0,0
10/24/2017 18:10,58,69.6,76,65.1,134,67,2,0,0
10/24/2017 18:15,49,69.5,67,65,116,66.9,2,0,0
10/24/2017 18:20,39,69.6,57,65.1,96,66.9,2,0,0
10/24/2017 18:25,53,69.7,70,65.2,123,67.2,2,0,0
10/24/2017 18:30,50,68.8,68,64.2,118,66.2,2,0,0
10/24/2017 18:35,42,69.3,59,64.7,101,66.6,2,0,0
10/24/2017 18:40,44,69.1,61,64.5,105,66.4,2,0,0
10/24/2017 18:45,42,69.1,58,64.5,100,66.5,2,0,0
10/24/2017 18:50,47,69.3,64,64.8,111,66.7,2,0,0
10/24/2017 18:55,46,68.5,63,63.9,109,65.9,2,0,0
10/24/2017 19:00,44,68.6,62,64,106,65.9,2,0,0
10/24/2017 19:05,42,69.3,59,64.7,101,66.6,2,0,0
10/24/2017 19:10,39,68.1,56,63.4,95,65.3,2,0,0
10/24/2017 19:15,46,69.2,64,64.5,110,66.5,2,0,0
10/24/2017 19:20,42,69,60,64.4,102,66.3,2,0,0
10/24/2017 19:25,39,68.1,56,63.4,95,65.3,2,0,0
10/24/2017 19:30,46,68.2,64,63.5,110,65.5,2,0,0
10/24/2017 19:35,43,67.8,60,63.1,103,65.1,2,0,0
10/24/2017 19:40,35,69.1,52,64.5,87,66.4,2,0,0
10/24/2017 19:45,33,69.4,49,64.7,82,66.6,2,0,0
10/24/2017 19:50,28,68.2,45,63.6,73,65.3,2,0,0
10/24/2017 19:55,29,68.8,46,64.2,75,66,2,0,0
10/24/2017 20:00,29,68.5,45,63.9,74,65.7,2,0,0
10/24/2017 20:05,27,69.1,44,64.5,71,66.2,2,0,0
10/24/2017 20:10,35,69.1,52,64.5,87,66.4,2,0,0
10/24/2017 20:15,34,69.8,51,65.2,85,67.1,2,0,0
10/24/2017 20:20,30,69.3,47,64.7,77,66.5,2,0,0
10/24/2017 20:25,29,68.8,45,64.2,74,66,2,0,0
10/24/2017 20:30,31,68.9,47,64.2,78,66.1,2,0,0
10/24/2017 20:35,21,69.3,37,64.7,58,66.4,2,0,0
10/24/2017 20:40,32,70,48,65.4,80,67.2,2,0,0
10/24/2017 20:45,25,69.6,42,65,67,66.8,2,0,0
10/24/2017 20:50,33,68.9,49,64.3,82,66.2,2,0,0
10/24/2017 20:55,26,69.2,43,64.6,69,66.3,2,0,0
10/24/2017 21:00,21,69.3,37,64.7,58,66.4,2,0,0
10/24/2017 21:05,24,69.6,40,65,64,66.7,2,0,0
10/24/2017 21:10,27,69.3,44,64.7,71,66.4,2,0,0
10/24/2017 21:15,24,69.1,41,64.4,65,66.1,2,0,0
10/24/2017 21:20,31,69,47,64.4,78,66.2,2,0,0
10/24/2017 21:25,27,68.6,43,63.9,70,65.7,2,0,0
10/24/2017 21:30,27,69,44,64.4,71,66.1,2,0,0
10/24/2017 21:35,25,69.1,41,64.5,66,66.3,2,0,0
10/24/2017 21:40,25,68.6,41,64,66,65.7,2,0,0
10/24/2017 21:45,24,69,40,64.4,64,66.2,2,0,0
10/24/2017 21:50,22,69.3,37,64.7,59,66.4,2,0,0
10/24/2017 21:55,21,68.7,37,64,58,65.7,2,0,0
10/24/2017 22:00,27,68.8,44,64.1,71,65.9,2,0,0
10/24/2017 22:05,28,68.9,44,64.2,72,66,2,0,0
10/24/2017 22:10,23,69,40,64.3,63,66,2,0,0
10/24/2017 22:15,22,69.2,38,64.5,60,66.2,2,0,0
10/24/2017 22:20,26,69.1,41,64.5,67,66.3,2,0,0
10/24/2017 22:25,24,69.4,40,64.7,64,66.5,2,0,0
10/24/2017 22:30,19,69.3,34,64.7,53,66.3,2,0,0
10/24/2017 22:35,15,69.3,31,64.7,46,66.2,2,0,0
10/24/2017 22:40,22,68.5,38,63.8,60,65.5,2,0,0
10/24/2017 22:45,21,68.9,37,64.2,58,65.9,2,0,0
10/24/2017 22:50,21,69.1,37,64.4,58,66.1,2,0,0
10/24/2017 22:55,12,69.2,27,64.6,39,66,2,0,0
10/24/2017 23:00,14,69.1,29,64.5,43,66,2,0,0
10/24/2017 23:05,13,69.2,29,64.5,42,66,2,0,0
10/24/2017 23:10,18,69.1,33,64.5,51,66.1,2,0,0
10/24/2017 23:15,17,69.1,32,64.5,49,66.1,2,0,0
10/24/2017 23:20,16,69.1,32,64.5,48,66,2,0,0
10/24/2017 23:25,15,69.2,31,64.6,46,66.1,2,0,0
10/24/2017 23:30,12,69,27,64.3,39,65.7,2,0,0
10/24/2017 23:35,14,69.1,29,64.5,43,66,2,0,0
10/24/2017 23:40,14,69.2,30,64.6,44,66,2,0,0
10/24/2017 23:45,9,69.2,24,64.6,33,65.9,2,0,0
10/24/2017 23:50,12,69.2,27,64.5,39,66,2,0,0
10/24/2017 23:55,10,69.2,26,64.6,36,65.9,2,0,0
10/25/2017 0:00,12,69.3,27,64.7,39,66.2,2,0,0
10/25/2017 0:05,8,69.4,23,64.8,31,66,2,0,0
10/25/2017 0:10,9,69.1,24,64.5,33,65.8,2,0,0
10/25/2017 0:15,11,69.2,27,64.6,38,66,2,0,0
10/25/2017 0:20,8,69.2,23,64.6,31,65.8,2,0,0
10/25/2017 0:25,10,69.3,26,64.7,36,65.9,2,0,0
10/25/2017 0:30,6,69.3,22,64.7,28,65.7,2,0,0
10/25/2017 0:35,10,69.3,26,64.7,36,66,2,0,0
10/25/2017 0:40,11,69.3,26,64.7,37,66.1,2,0,0
10/25/2017 0:45,5,69.3,21,64.7,26,65.6,2,0,0
10/25/2017 0:50,11,69.3,26,64.6,37,66,2,0,0
10/25/2017 0:55,9,69.1,24,64.5,33,65.7,2,0,0
10/25/2017 1:00,6,68.7,21,64.1,27,65.1,2,0,0
10/25/2017 1:05,7,69,22,64.4,29,65.5,2,0,0
10/25/2017 1:10,5,69.2,20,64.6,25,65.5,2,0,0
10/25/2017 1:15,13,69.3,21,64.7,34,66.4,2,0,0
10/25/2017 1:20,10,69.3,20,64.7,30,66.2,2,0,0
10/25/2017 1:25,9,69.3,19,64.7,28,66.1,2,0,0
10/25/2017 1:30,12,69.1,21,64.5,33,66.1,2,0,0
10/25/2017 1:35,8,69.2,24,64.6,32,65.8,2,0,0
10/25/2017 1:40,6,69.2,21,64.6,27,65.6,2,0,0
10/25/2017 1:45,7,69.3,22,64.7,29,65.8,2,0,0
10/25/2017 1:50,12,69.3,21,64.7,33,66.4,2,0,0
10/25/2017 1:55,7,69.4,22,64.8,29,65.9,2,0,0
10/25/2017 2:00,5,69.3,21,64.7,26,65.6,2,0,0
10/25/2017 2:05,4,69.3,20,64.7,24,65.5,2,0,0
10/25/2017 2:10,7,69.2,22,64.5,29,65.7,2,0,0
10/25/2017 2:15,10,69.3,25,64.7,35,66,2,0,0
10/25/2017 2:20,9,69.3,24,64.7,33,65.9,2,0,0
10/25/2017 2:25,7,69.3,23,64.7,30,65.8,2,0,0
10/25/2017 2:30,8,69.1,23,64.5,31,65.7,2,0,0
10/25/2017 2:35,13,68.5,29,63.8,42,65.2,2,0,0
10/25/2017 2:40,7,68.7,23,64,30,65.1,2,0,0
10/25/2017 2:45,11,69.1,26,64.4,37,65.8,2,0,0
10/25/2017 2:50,8,69.3,23,64.7,31,65.8,2,0,0
10/25/2017 2:55,10,69.3,25,64.7,35,66,2,0,0
10/25/2017 3:00,8,69,24,64.4,32,65.6,2,0,0
10/25/2017 3:05,7,69.3,22,64.7,29,65.8,2,0,0
10/25/2017 3:10,11,69.3,26,64.7,37,66.1,2,0,0
10/25/2017 3:15,9,69.1,24,64.5,33,65.7,2,0,0
10/25/2017 3:20,9,69.1,24,64.5,33,65.8,2,0,0
10/25/2017 3:25,8,69.3,24,64.7,32,65.8,2,0,0
10/25/2017 3:30,13,69.1,28,64.5,41,65.9,2,0,0
10/25/2017 3:35,13,69.3,28,64.7,41,66.1,2,0,0
10/25/2017 3:40,13,69,28,64.3,41,65.8,2,0,0
10/25/2017 3:45,13,69.2,28,64.6,41,66.1,2,0,0
10/25/2017 3:50,11,69,26,64.4,37,65.8,2,0,0
10/25/2017 3:55,15,69.2,30,64.6,45,66.1,2,0,0
10/25/2017 4:00,18,69.2,34,64.6,52,66.2,2,0,0
10/25/2017 4:05,15,69.2,31,64.6,46,66.1,2,0,0
10/25/2017 4:10,16,69.2,33,64.6,49,66.1,2,0,0
10/25/2017 4:15,26,69.2,42,64.5,68,66.3,2,0,0
10/25/2017 4:20,23,69.4,39,64.7,62,66.4,2,0,0
10/25/2017 4:25,25,69.3,42,64.7,67,66.4,2,0,0
10/25/2017 4:30,30,68.9,47,64.2,77,66,2,0,0
10/25/2017 4:35,25,68.7,41,64,66,65.8,2,0,0
10/25/2017 4:40,42,67.4,60,62.6,102,64.6,2,0,0
10/25/2017 4:45,37,67.3,55,62.5,92,64.5,2,0,0
10/25/2017 4:50,41,68.1,58,63.4,99,65.3,2,0,0
10/25/2017 4:55,43,67.2,60,62.3,103,64.3,2,0,0
10/25/2017 5:00,40,66.8,58,61.9,98,63.9,2,0,0
10/25/2017 5:05,40,67.8,59,63,99,65,2,0,0
10/25/2017 5:10,43,67.4,62,62.5,105,64.5,2,0,0
10/25/2017 5:15,49,64.7,69,59.6,118,61.7,2,0,0
10/25/2017 5:20,54,62.6,73,57.2,127,59.5,2,0,0
10/25/2017 5:25,57,61.8,76,56.3,133,58.6,2,0,0
10/25/2017 5:30,58,62.4,77,57.1,135,59.4,2,0,0
10/25/2017 5:35,60,53.1,78,46.7,138,49.5,2,0,0
10/25/2017 5:40,61,57.7,76,51.9,137,54.5,2,0,0
10/25/2017 5:45,66,58.9,82,53.2,148,55.7,2,0,0
10/25/2017 5:50,69,57.5,86,51.6,155,54.2,2,0,0
10/25/2017 5:55,70,56.6,87,50.7,157,53.3,2,0,0
10/25/2017 6:00,55,61,71,55.5,126,57.9,2,0,0
10/25/2017 6:05,51,63.9,70,58.6,121,60.8,2,0,0
10/25/2017 6:10,58,65.1,78,59.9,136,62.1,2,0,0
10/25/2017 6:15,66,66.1,87,61.2,153,63.3,2,0,0
10/25/2017 6:20,66,66.9,89,62,155,64.1,2,0,0
10/25/2017 6:25,60,67.4,82,62.4,142,64.5,2,0,0
10/25/2017 6:30,64,67,86,62,150,64.1,2,0,0
10/25/2017 6:35,65,67.8,87,62.9,152,65,2,0,0
10/25/2017 6:40,73,68.3,96,63.5,169,65.6,2,0,0
10/25/2017 6:45,70,67.9,90,63.1,160,65.2,2,0,0
10/25/2017 6:50,71,68.4,94,63.6,165,65.6,2,0,0
10/25/2017 6:55,65,67.8,86,62.9,151,65,2,0,0
10/25/2017 7:00,61,66.9,82,62.1,143,64.1,2,0,0
10/25/2017 7:05,65,67.7,86,62.9,151,65,2,0,0
10/25/2017 7:10,73,66.8,95,61.8,168,64,2,0,0
10/25/2017 7:15,76,67.3,99,62.4,175,64.5,2,0,0
10/25/2017 7:20,74,66.6,96,61.6,170,63.8,2,0,0
10/25/2017 7:25,91,66.5,116,61.5,207,63.7,2,0,0
10/25/2017 7:30,87,66.4,111,61.5,198,63.7,2,0,0
10/25/2017 7:35,95,65.8,120,60.8,215,63,2,0,0
10/25/2017 7:40,91,66.1,115,61.1,206,63.3,2,0,0
10/25/2017 7:45,97,65.8,122,60.8,219,63,2,0,0
10/25/2017 7:50,101,66.4,125,61.4,226,63.6,2,0,0
10/25/2017 7:55,81,65.8,104,60.8,185,63,2,0,0
10/25/2017 8:00,73,64.5,93,59.3,166,61.5,2,0,0
10/25/2017 8:05,75,63.1,97,57.8,172,60.1,2,0,0
10/25/2017 8:10,71,63.3,92,58.1,163,60.4,2,0,0
10/25/2017 8:15,74,65.1,97,60,171,62.2,2,0,0
10/25/2017 8:20,86,65.6,109,60.6,195,62.8,2,0,0
10/25/2017 8:25,80,65.3,102,60.2,182,62.4,2,0,0
10/25/2017 8:30,80,66,101,61,181,63.2,2,0,0
10/25/2017 8:35,74,63.7,96,58.5,170,60.8,2,0,0
10/25/2017 8:40,89,63.8,112,58.6,201,60.9,2,0,0
10/25/2017 8:45,78,64.7,101,59.6,179,61.8,2,0,0
10/25/2017 8:50,81,63.6,104,58.5,185,60.7,2,0,0
10/25/2017 8:55,81,64.4,103,59.4,184,61.6,2,0,0
10/25/2017 9:00,76,65.4,96,60.4,172,62.6,2,0,0
10/25/2017 9:05,82,66.6,104,61.7,186,63.8,2,0,0
10/25/2017 9:10,65,66.1,85,61.2,150,63.3,2,0,0
10/25/2017 9:15,51,67.1,70,62.3,121,64.3,2,0,0
10/25/2017 9:20,50,67,69,62.1,119,64.2,2,0,0
10/25/2017 9:25,54,65.2,73,60.2,127,62.3,2,0,0
10/25/2017 9:30,59,66.6,78,61.7,137,63.8,2,0,0
10/25/2017 9:35,68,65.1,87,60,155,62.2,2,0,0
10/25/2017 9:40,69,65.6,91,60.7,160,62.9,2,0,0
10/25/2017 9:45,62,65.2,82,60.3,144,62.4,2,0,0
10/25/2017 9:50,68,66,88,61.2,156,63.3,2,0,0
10/25/2017 9:55,73,65,92,60.1,165,62.3,2,0,0
10/25/2017 10:00,76,63.8,98,58.7,174,60.9,2,0,0
10/25/2017 10:05,79,65.9,100,61.1,179,63.2,2,0,0
10/25/2017 10:10,74,65.6,95,60.7,169,62.8,2,0,0
10/25/2017 10:15,72,65.2,93,60.3,165,62.5,2,0,0
10/25/2017 10:20,67,66.4,86,61.6,153,63.7,2,0,0
10/25/2017 10:25,72,65.2,93,60.3,165,62.4,2,0,0
10/25/2017 10:30,63,64.6,84,59.7,147,61.8,2,0,0
10/25/2017 10:35,73,64.2,92,59.2,165,61.4,2,0,0
10/25/2017 10:40,51,64.8,70,59.8,121,61.9,2,0,0
10/25/2017 10:45,51,65.2,70,60.3,121,62.4,2,0,0
10/25/2017 10:50,62,65,82,60.1,144,62.2,2,0,0
10/25/2017 10:55,61,66.1,80,61.3,141,63.4,2,0,0
10/25/2017 11:00,52,66.1,71,61.3,123,63.3,2,0,0
10/25/2017 11:05,55,66,73,61.2,128,63.2,2,0,0
10/25/2017 11:10,54,67,72,62.2,126,64.3,2,0,0
10/25/2017 11:15,48,66.6,66,61.8,114,63.8,2,0,0
10/25/2017 11:20,58,66,76,61.2,134,63.3,2,0,0
10/25/2017 11:25,54,67.2,72,62.6,126,64.5,2,0,0
10/25/2017 11:30,59,66.4,78,61.6,137,63.7,2,0,0
10/25/2017 11:35,57,65.6,76,60.8,133,62.9,2,0,0
10/25/2017 11:40,53,65.9,71,61.1,124,63.2,2,0,0
10/25/2017 11:45,48,66.9,65,62.1,113,64.1,2,0,0
10/25/2017 11:50,49,66.6,68,61.9,117,63.9,2,0,0
10/25/2017 11:55,53,67.6,72,62.9,125,64.9,2,0,0
10/25/2017 12:00,52,68.5,70,63.9,122,65.8,2,0,0
10/25/2017 12:05,48,69.1,67,64.5,115,66.4,2,0,0
10/25/2017 12:10,47,69.9,65,65.3,112,67.3,2,0,0
10/25/2017 12:15,57,68.9,76,64.3,133,66.3,2,0,0
10/25/2017 12:20,57,70,76,65.5,133,67.5,2,0,0
10/25/2017 12:25,53,67.9,71,63.3,124,65.3,2,0,0
10/25/2017 12:30,48,68,67,63.4,115,65.3,2,0,0
10/25/2017 12:35,43,67,61,62.2,104,64.2,2,0,0
10/25/2017 12:40,44,68.9,61,64.2,105,66.2,2,0,0
10/25/2017 12:45,58,69.1,76,64.4,134,66.4,2,0,0
10/25/2017 12:50,46,69.7,64,65.2,110,67.1,2,0,0
10/25/2017 12:55,45,69.6,62,65,107,67,2,0,0
10/25/2017 13:00,46,68.6,63,64,109,65.9,2,0,0
10/25/2017 13:05,48,67.9,66,63.2,114,65.2,2,0,0
10/25/2017 13:10,40,67.6,58,62.9,98,64.8,2,0,0
10/25/2017 13:15,52,68.1,70,63.4,122,65.4,2,0,0
10/25/2017 13:20,51,68.5,69,63.9,120,65.9,2,0,0
10/25/2017 13:25,50,66.6,69,61.8,119,63.8,2,0,0
10/25/2017 13:30,49,67.6,67,62.9,116,64.9,2,0,0
10/25/2017 13:35,45,66.2,62,61.5,107,63.5,2,0,0
10/25/2017 13:40,40,67,57,62.2,97,64.2,2,0,0
10/25/2017 13:45,50,68.7,68,64,118,66,2,0,0
10/25/2017 13:50,53,67.4,71,62.6,124,64.7,2,0,0
10/25/2017 13:55,42,68.4,59,63.7,101,65.7,2,0,0
10/25/2017 14:00,50,68.5,69,63.9,119,65.9,2,0,0
10/25/2017 14:05,49,67.8,67,63.1,116,65.1,2,0,0
10/25/2017 14:10,50,66.8,68,62,118,64,2,0,0
10/25/2017 14:15,48,68.3,65,63.6,113,65.6,2,0,0
10/25/2017 14:20,52,67.3,70,62.6,122,64.6,2,0,0
10/25/2017 14:25,47,67.1,66,62.4,113,64.3,2,0,0
10/25/2017 14:30,48,66.8,66,62.1,114,64.1,2,0,0
10/25/2017 14:35,43,66.4,61,61.5,104,63.5,2,0,0
10/25/2017 14:40,46,68.9,63,64.3,109,66.2,2,0,0
10/25/2017 14:45,49,68.3,67,63.6,116,65.6,2,0,0
10/25/2017 14:50,45,68.9,62,64.3,107,66.2,2,0,0
10/25/2017 14:55,49,67.8,66,63.1,115,65.1,2,0,0
10/25/2017 15:00,51,67.4,69,62.7,120,64.7,2,0,0
10/25/2017 15:05,49,65.6,68,60.8,117,62.8,2,0,0
10/25/2017 15:10,41,67,58,62.3,99,64.2,2,0,0
10/25/2017 15:15,54,67.8,72,63.1,126,65.1,2,0,0
10/25/2017 15:20,55,69.5,74,65,129,66.9,2,0,0
10/25/2017 15:25,60,68.1,78,63.4,138,65.5,2,0,0
10/25/2017 15:30,64,68.6,85,63.9,149,65.9,2,0,0
10/25/2017 15:35,56,69.2,75,64.6,131,66.6,2,0,0
10/25/2017 15:40,53,68.9,71,64.3,124,66.3,2,0,0
10/25/2017 15:45,41,51.5,57,45.1,98,47.8,2,0,0
10/25/2017 15:50,44,39.5,62,31.7,106,34.9,2,0,0
10/25/2017 15:55,37,33.2,55,24.7,92,28.1,2,0,0
10/25/2017 16:00,42,30.2,61,21.5,103,25,2,0,0
10/25/2017 16:05,39,28.6,57,19.6,96,23.3,2,0,0
10/25/2017 16:10,41,28,59,18.9,100,22.6,2,0,0
10/25/2017 16:15,56,28.6,76,19.6,132,23.4,2,0,0
10/25/2017 16:20,52,42.6,70,35,122,38.2,2,0,0
10/25/2017 16:25,54,55,72,48.8,126,51.5,2,0,0
10/25/2017 16:30,46,63.3,63,58,109,60.2,2,0,0
10/25/2017 16:35,53,66.4,72,61.5,125,63.6,2,0,0
10/25/2017 16:40,52,67.3,71,62.5,123,64.6,2,0,0
10/25/2017 16:45,49,68.8,68,64.1,117,66.1,2,0,0
10/25/2017 16:50,48,70.2,65,65.7,113,67.6,2,0,0
10/25/2017 16:55,54,69.6,72,65.1,126,67,2,0,0
10/25/2017 17:00,54,69.8,72,65.2,126,67.2,2,0,0
10/25/2017 17:05,59,68.2,79,63.6,138,65.6,2,0,0
10/25/2017 17:10,53,69,70,64.4,123,66.4,2,0,0
10/25/2017 17:15,52,67.7,71,62.9,123,65,2,0,0
10/25/2017 17:20,58,64.2,77,58.9,135,61.2,2,0,0
10/25/2017 17:25,56,60.8,75,55.2,131,57.6,2,0,0
10/25/2017 17:30,51,54.5,69,48.2,120,50.9,2,0,0
10/25/2017 17:35,44,53.5,62,47.2,106,49.8,2,0,0
10/25/2017 17:40,49,59.1,68,53.4,117,55.8,2,0,0
10/25/2017 17:45,48,63.8,67,58.6,115,60.8,2,0,0
10/25/2017 17:50,56,64.1,75,58.9,131,61.1,2,0,0
10/25/2017 17:55,58,62.8,77,57.5,135,59.8,2,0,0
10/25/2017 18:00,46,63.7,64,58.4,110,60.6,2,0,0
10/25/2017 18:05,55,65.6,73,60.6,128,62.7,2,0,0
10/25/2017 18:10,56,66.4,74,61.5,130,63.6,2,0,0
10/25/2017 18:15,56,67.6,74,62.8,130,64.9,2,0,0
10/25/2017 18:20,65,67.4,84,62.6,149,64.7,2,0,0
10/25/2017 18:25,48,67.7,66,62.9,114,64.9,2,0,0
10/25/2017 18:30,46,68.9,64,64.2,110,66.2,2,0,0
10/25/2017 18:35,48,68.8,67,64.2,115,66.1,2,0,0
10/25/2017 18:40,47,69.2,64,64.5,111,66.5,2,0,0
10/25/2017 18:45,47,69.1,64,64.5,111,66.4,2,0,0
10/25/2017 18:50,53,68.7,71,64.1,124,66.1,2,0,0
10/25/2017 18:55,56,68.6,74,63.9,130,65.9,2,0,0
10/25/2017 19:00,53,68.2,71,63.6,124,65.6,2,0,0
10/25/2017 19:05,47,68.9,64,64.3,111,66.2,2,0,0
10/25/2017 19:10,48,69.2,66,64.5,114,66.5,2,0,0
10/25/2017 19:15,50,67.9,68,63.1,118,65.1,2,0,0
10/25/2017 19:20,43,68.8,61,64.2,104,66.1,2,0,0
10/25/2017 19:25,48,66.5,66,61.6,114,63.7,2,0,0
10/25/2017 19:30,38,67.9,55,63.2,93,65.1,2,0,0
10/25/2017 19:35,40,67.6,57,62.8,97,64.8,2,0,0
10/25/2017 19:40,37,69.1,54,64.5,91,66.4,2,0,0
10/25/2017 19:45,39,68.9,55,64.2,94,66.2,2,0,0
10/25/2017 19:50,31,69.6,47,65,78,66.8,2,0,0
10/25/2017 19:55,34,69.8,50,65.2,84,67.1,2,0,0
10/25/2017 20:00,29,68.1,46,63.4,75,65.2,2,0,0
10/25/2017 20:05,34,68.4,51,63.8,85,65.6,2,0,0
10/25/2017 20:10,31,68.1,47,63.4,78,65.2,2,0,0
10/25/2017 20:15,35,69,51,64.4,86,66.2,2,0,0
10/25/2017 20:20,31,69.6,48,65,79,66.8,2,0,0
10/25/2017 20:25,37,69,53,64.4,90,66.3,2,0,0
10/25/2017 20:30,37,69.3,54,64.7,91,66.6,2,0,0
10/25/2017 20:35,32,68.6,49,63.8,81,65.7,2,0,0
10/25/2017 20:40,28,68.1,44,63.4,72,65.3,2,0,0
10/25/2017 20:45,35,68.9,52,64.2,87,66.1,2,0,0
10/25/2017 20:50,35,68.5,52,63.9,87,65.8,2,0,0
10/25/2017 20:55,34,69,50,64.4,84,66.3,2,0,0
10/25/2017 21:00,33,68,49,63.3,82,65.2,2,0,0
10/25/2017 21:05,28,69,45,64.4,73,66.2,2,0,0
10/25/2017 21:10,28,69.7,45,65.1,73,66.8,2,0,0
10/25/2017 21:15,31,70,48,65.5,79,67.2,2,0,0
10/25/2017 21:20,30,69.8,46,65.3,76,67.1,2,0,0
10/25/2017 21:25,33,69.9,49,65.3,82,67.2,2,0,0
10/25/2017 21:30,29,70.1,46,65.6,75,67.3,2,0,0
10/25/2017 21:35,26,69.1,42,64.5,68,66.2,2,0,0
10/25/2017 21:40,35,68.9,52,64.2,87,66.1,2,0,0
10/25/2017 21:45,28,69,45,64.4,73,66.1,2,0,0
10/25/2017 21:50,28,68.7,44,64.1,72,65.9,2,0,0
10/25/2017 21:55,23,69,39,64.3,62,66.1,2,0,0
10/25/2017 22:00,23,68.6,39,64,62,65.7,2,0,0
10/25/2017 22:05,24,69.1,39,64.5,63,66.2,2,0,0
10/25/2017 22:10,25,69.3,41,64.7,66,66.4,2,0,0
10/25/2017 22:15,27,69.7,43,65.1,70,66.9,2,0,0
10/25/2017 22:20,28,69.1,44,64.5,72,66.3,2,0,0
10/25/2017 22:25,24,69.3,40,64.7,64,66.4,2,0,0
10/25/2017 22:30,28,69.7,43,65.1,71,66.9,2,0,0
10/25/2017 22:35,23,69.4,39,64.8,62,66.5,2,0,0
10/25/2017 22:40,16,69.7,32,65.1,48,66.6,2,0,0
10/25/2017 22:45,17,69.4,34,64.8,51,66.3,2,0,0
10/25/2017 22:50,12,69.5,27,64.9,39,66.3,2,0,0
10/25/2017 22:55,17,69.1,32,64.4,49,66,2,0,0
10/25/2017 23:00,18,69,33,64.4,51,66.1,2,0,0
10/25/2017 23:05,23,68.9,38,64.2,61,66,2,0,0
10/25/2017 23:10,19,69.3,35,64.7,54,66.3,2,0,0
10/25/2017 23:15,19,69.3,35,64.7,54,66.3,2,0,0
10/25/2017 23:20,13,69.3,29,64.7,42,66.2,2,0,0
10/25/2017 23:25,17,69,33,64.4,50,65.9,2,0,0
10/25/2017 23:30,18,69.1,34,64.5,52,66.1,2,0,0
10/25/2017 23:35,18,69.2,34,64.6,52,66.2,2,0,0
10/25/2017 23:40,16,69.4,31,64.8,47,66.4,2,0,0
10/25/2017 23:45,15,69.4,30,64.8,45,66.3,2,0,0
10/25/2017 23:50,12,69.4,27,64.7,39,66.2,2,0,0
10/25/2017 23:55,16,69.4,32,64.8,48,66.4,2,0,0
10/26/2017 0:00,14,69.3,30,64.7,44,66.2,2,0,0
10/26/2017 0:05,15,69.4,30,64.8,45,66.3,2,0,0
10/26/2017 0:10,9,69.3,24,64.7,33,66,2,0,0
10/26/2017 0:15,12,69.4,27,64.8,39,66.2,2,0,0
10/26/2017 0:20,10,69.4,25,64.8,35,66.1,2,0,0
10/26/2017 0:25,8,69.4,23,64.8,31,66,2,0,0
10/26/2017 0:30,10,69.3,25,64.7,35,66,2,0,0
10/26/2017 0:35,10,69.2,26,64.6,36,65.9,2,0,0
10/26/2017 0:40,13,68.7,28,64,41,65.5,2,0,0
10/26/2017 0:45,12,69.1,27,64.5,39,65.9,2,0,0
10/26/2017 0:50,8,69.2,24,64.6,32,65.7,2,0,0
10/26/2017 0:55,6,69.2,21,64.5,27,65.6,2,0,0
10/26/2017 1:00,6,69.2,21,64.5,27,65.6,2,0,0
10/26/2017 1:05,7,68.9,23,64.3,30,65.4,2,0,0
10/26/2017 1:10,8,69.2,23,64.5,31,65.7,2,0,0
10/26/2017 1:15,13,69.2,21,64.6,34,66.4,2,0,0
10/26/2017 1:20,10,69.3,20,64.7,30,66.2,2,0,0
10/26/2017 1:25,7,69.4,22,64.8,29,65.9,2,0,0
10/26/2017 1:30,8,69.4,24,64.8,32,65.9,2,0,0
10/26/2017 1:35,8,69.4,23,64.8,31,66,2,0,0
10/26/2017 1:40,6,69.2,21,64.6,27,65.6,2,0,0
10/26/2017 1:45,7,69.3,22,64.7,29,65.8,2,0,0
10/26/2017 1:50,13,69.3,21,64.7,34,66.5,2,0,0
10/26/2017 1:55,6,69.4,22,64.8,28,65.8,2,0,0
10/26/2017 2:00,11,69.2,26,64.6,37,66,2,0,0
10/26/2017 2:05,10,69.4,26,64.8,36,66.1,2,0,0
10/26/2017 2:10,10,68.9,25,64.3,35,65.6,2,0,0
10/26/2017 2:15,8,69.2,23,64.5,31,65.7,2,0,0
10/26/2017 2:20,13,69.2,21,64.6,34,66.4,2,0,0
10/26/2017 2:25,7,69.4,22,64.8,29,65.9,2,0,0
10/26/2017 2:30,8,69.4,23,64.8,31,66,2,0,0
10/26/2017 2:35,11,69.2,27,64.5,38,65.9,2,0,0
10/26/2017 2:40,8,69.3,23,64.7,31,65.9,2,0,0
10/26/2017 2:45,9,69.4,24,64.8,33,66,2,0,0
10/26/2017 2:50,9,69.3,24,64.7,33,66,2,0,0
10/26/2017 2:55,9,69.3,24,64.7,33,66,2,0,0
10/26/2017 3:00,9,69.2,25,64.6,34,65.8,2,0,0
10/26/2017 3:05,12,69.1,28,64.5,40,65.9,2,0,0
10/26/2017 3:10,7,69.2,23,64.6,30,65.7,2,0,0
10/26/2017 3:15,10,69,25,64.4,35,65.7,2,0,0
10/26/2017 3:20,9,69.1,24,64.5,33,65.8,2,0,0
10/26/2017 3:25,9,69.3,24,64.7,33,65.9,2,0,0
10/26/2017 3:30,7,69.4,22,64.8,29,65.9,2,0,0
10/26/2017 3:35,13,69.3,29,64.7,42,66.1,2,0,0
10/26/2017 3:40,14,69.6,29,65,43,66.5,2,0,0
10/26/2017 3:45,13,69.2,29,64.6,42,66,2,0,0
10/26/2017 3:50,15,69.2,30,64.6,45,66.1,2,0,0
10/26/2017 3:55,12,69.4,27,64.7,39,66.2,2,0,0
10/26/2017 4:00,14,69.4,30,64.8,44,66.3,2,0,0
10/26/2017 4:05,17,69.1,33,64.5,50,66,2,0,0
10/26/2017 4:10,19,69.2,35,64.5,54,66.2,2,0,0
10/26/2017 4:15,20,69.2,36,64.6,56,66.3,2,0,0
10/26/2017 4:20,26,68.7,43,64.1,69,65.8,2,0,0
10/26/2017 4:25,23,69.1,39,64.5,62,66.2,2,0,0
10/26/2017 4:30,24,69.2,40,64.5,64,66.3,2,0,0
10/26/2017 4:35,31,69.7,48,65.1,79,66.9,2,0,0
10/26/2017 4:40,32,69.8,50,65.2,82,67,2,0,0
10/26/2017 4:45,51,69.4,70,64.9,121,66.8,2,0,0
10/26/2017 4:50,42,69.5,60,65,102,66.9,2,0,0
10/26/2017 4:55,36,70.1,54,65.6,90,67.4,2,0,0
10/26/2017 5:00,42,70.4,60,65.9,102,67.8,2,0,0
10/26/2017 5:05,40,70.7,58,66.2,98,68,2,0,0
10/26/2017 5:10,41,68.4,60,63.6,101,65.6,2,0,0
10/26/2017 5:15,45,69.5,64,64.9,109,66.8,2,0,0
10/26/2017 5:20,55,69.6,76,65,131,66.9,2,0,0
10/26/2017 5:25,47,68.6,67,63.9,114,65.8,2,0,0
10/26/2017 5:30,53,68.7,73,64,126,66,2,0,0
10/26/2017 5:35,64,67.7,86,63,150,65,2,0,0
10/26/2017 5:40,65,67.1,87,62.3,152,64.3,2,0,0
10/26/2017 5:45,65,66.5,86,61.7,151,63.8,2,0,0
10/26/2017 5:50,78,67,102,62.1,180,64.2,2,0,0
10/26/2017 5:55,60,68,81,63.3,141,65.3,2,0,0
10/26/2017 6:00,64,68.5,84,63.8,148,65.8,2,0,0
10/26/2017 6:05,55,68.8,75,64.1,130,66.1,2,0,0
10/26/2017 6:10,62,68.6,84,63.9,146,65.9,2,0,0
10/26/2017 6:15,61,68.3,82,63.6,143,65.6,2,0,0
10/26/2017 6:20,72,68,95,63.3,167,65.3,2,0,0
10/26/2017 6:25,58,68.6,79,63.9,137,65.9,2,0,0
10/26/2017 6:30,66,68.5,89,63.7,155,65.7,2,0,0
10/26/2017 6:35,62,67.9,82,63.1,144,65.1,2,0,0
10/26/2017 6:40,83,67.6,107,62.8,190,64.9,2,0,0
10/26/2017 6:45,83,66.9,106,62,189,64.1,2,0,0
10/26/2017 6:50,70,68.6,91,63.8,161,65.9,2,0,0
10/26/2017 6:55,66,68.5,87,63.8,153,65.8,2,0,0
10/26/2017 7:00,68,67.7,90,62.9,158,64.9,2,0,0
10/26/2017 7:05,71,67.7,92,62.9,163,65,2,0,0
10/26/2017 7:10,69,67.5,91,62.7,160,64.7,2,0,0
10/26/2017 7:15,74,67.6,95,62.8,169,64.9,2,0,0
10/26/2017 7:20,81,67.7,104,63,185,65.1,2,0,0
10/26/2017 7:25,81,67.9,104,63.1,185,65.2,2,0,0
10/26/2017 7:30,83,67.1,107,62.2,190,64.3,2,0,0
10/26/2017 7:35,91,67.3,115,62.5,206,64.6,2,0,0
10/26/2017 7:40,101,67.2,127,62.3,228,64.5,2,0,0
10/26/2017 7:45,90,68.4,113,63.6,203,65.7,2,0,0
10/26/2017 7:50,91,68.3,115,63.5,206,65.6,2,0,0
10/26/2017 7:55,81,68.8,103,64.1,184,66.2,2,0,0
10/26/2017 8:00,91,67.2,115,62.3,206,64.4,2,0,0
10/26/2017 8:05,77,64.4,99,59.2,176,61.4,2,0,0
10/26/2017 8:10,67,64.6,87,59.4,154,61.7,2,0,0
10/26/2017 8:15,81,65,105,60,186,62.2,2,0,0
10/26/2017 8:20,79,66.9,101,62,180,64.1,2,0,0
10/26/2017 8:25,75,66.6,97,61.8,172,63.9,2,0,0
10/26/2017 8:30,76,65.2,99,60.2,175,62.3,2,0,0
10/26/2017 8:35,80,63.6,103,58.4,183,60.7,2,0,0
10/26/2017 8:40,80,62.4,103,57.2,183,59.5,2,0,0
10/26/2017 8:45,87,63.7,110,58.5,197,60.8,2,0,0
10/26/2017 8:50,83,64.3,105,59.2,188,61.4,2,0,0
10/26/2017 8:55,90,64.7,113,59.7,203,61.9,2,0,0
10/26/2017 9:00,82,64.9,104,59.8,186,62,2,0,0
10/26/2017 9:05,79,65.4,100,60.4,179,62.6,2,0,0
10/26/2017 9:10,73,66.1,94,61.1,167,63.3,2,0,0
10/26/2017 9:15,78,67.6,100,62.8,178,64.9,2,0,0
10/26/2017 9:20,67,67.8,88,63,155,65,2,0,0
10/26/2017 9:25,70,68.4,91,63.7,161,65.7,2,0,0
10/26/2017 9:30,64,67.5,84,62.7,148,64.8,2,0,0
10/26/2017 9:35,73,67.3,94,62.5,167,64.6,2,0,0
10/26/2017 9:40,66,66.4,87,61.5,153,63.6,2,0,0
10/26/2017 9:45,76,66.5,98,61.6,174,63.8,2,0,0
10/26/2017 9:50,69,65.6,90,60.6,159,62.8,2,0,0
10/26/2017 9:55,71,64.7,92,59.6,163,61.8,2,0,0
10/26/2017 10:00,76,64.1,96,59,172,61.3,2,0,0
10/26/2017 10:05,70,66.1,91,61.2,161,63.4,2,0,0
10/26/2017 10:10,68,66.1,88,61.2,156,63.4,2,0,0
10/26/2017 10:15,69,66,89,61.1,158,63.2,2,0,0
10/26/2017 10:20,68,66.2,89,61.3,157,63.4,2,0,0
10/26/2017 10:25,76,65.2,97,60.3,173,62.4,2,0,0
10/26/2017 10:30,65,65.3,85,60.4,150,62.5,2,0,0
10/26/2017 10:35,65,66.2,84,61.5,149,63.6,2,0,0
10/26/2017 10:40,62,66.3,82,61.5,144,63.5,2,0,0
10/26/2017 10:45,60,64.9,80,60,140,62.1,2,0,0
10/26/2017 10:50,51,67.1,70,62.4,121,64.4,2,0,0
10/26/2017 10:55,61,67.1,80,62.3,141,64.4,2,0,0
10/26/2017 11:00,54,68.5,73,63.8,127,65.8,2,0,0
10/26/2017 11:05,55,68.3,74,63.7,129,65.7,2,0,0
10/26/2017 11:10,60,68.2,79,63.6,139,65.6,2,0,0
10/26/2017 11:15,74,68,94,63.3,168,65.4,2,0,0
10/26/2017 11:20,55,68.5,73,63.9,128,65.9,2,0,0
10/26/2017 11:25,55,69.1,73,64.5,128,66.4,2,0,0
10/26/2017 11:30,61,68.6,80,63.9,141,65.9,2,0,0
10/26/2017 11:35,56,66.8,76,62,132,64,2,0,0
10/26/2017 11:40,70,66.1,90,61.2,160,63.3,2,0,0
10/26/2017 11:45,68,65.2,88,60.3,156,62.4,2,0,0
10/26/2017 11:50,60,67.4,79,62.6,139,64.7,2,0,0
10/26/2017 11:55,66,67.8,84,63.1,150,65.2,2,0,0
10/26/2017 12:00,51,66.6,68,61.7,119,63.8,2,0,0
10/26/2017 12:05,61,66.9,80,62.1,141,64.2,2,0,0
10/26/2017 12:10,55,67.4,72,62.7,127,64.8,2,0,0
10/26/2017 12:15,56,65.9,74,61.1,130,63.1,2,0,0
10/26/2017 12:20,58,66.9,77,62.2,135,64.2,2,0,0
10/26/2017 12:25,57,68.4,75,63.8,132,65.8,2,0,0
10/26/2017 12:30,55,67,73,62.4,128,64.4,2,0,0
10/26/2017 12:35,58,65.8,77,61,135,63,2,0,0
10/26/2017 12:40,64,66.9,82,62.3,146,64.3,2,0,0
10/26/2017 12:45,49,67.2,67,62.5,116,64.5,2,0,0
10/26/2017 12:50,60,67.4,79,62.7,139,64.7,2,0,0
10/26/2017 12:55,59,67.8,76,63.2,135,65.2,2,0,0
10/26/2017 13:00,47,67.6,65,62.8,112,64.8,2,0,0
10/26/2017 13:05,58,66.6,77,61.8,135,63.9,2,0,0
10/26/2017 13:10,53,67.1,71,62.4,124,64.4,2,0,0
10/26/2017 13:15,56,66.3,75,61.6,131,63.6,2,0,0
10/26/2017 13:20,55,67.7,73,63,128,65,2,0,0
10/26/2017 13:25,56,67.6,75,62.9,131,64.9,2,0,0
10/26/2017 13:30,41,68.5,58,63.8,99,65.8,2,0,0
10/26/2017 13:35,55,68.7,72,64.2,127,66.1,2,0,0
10/26/2017 13:40,57,68.3,76,63.7,133,65.7,2,0,0
10/26/2017 13:45,51,67.8,69,63.1,120,65.1,2,0,0
10/26/2017 13:50,56,65.9,74,61.1,130,63.2,2,0,0
10/26/2017 13:55,47,67.5,65,62.8,112,64.8,2,0,0
10/26/2017 14:00,46,67.4,63,62.7,109,64.7,2,0,0
10/26/2017 14:05,47,66.1,63,61.3,110,63.4,2,0,0
10/26/2017 14:10,49,67,67,62.3,116,64.3,2,0,0
10/26/2017 14:15,58,68,76,63.4,134,65.4,2,0,0
10/26/2017 14:20,59,66.9,78,62.3,137,64.3,2,0,0
10/26/2017 14:25,58,66.9,76,62.2,134,64.2,2,0,0
10/26/2017 14:30,61,66.7,79,61.9,140,64,2,0,0
10/26/2017 14:35,53,67.6,71,62.9,124,64.9,2,0,0
10/26/2017 14:40,55,67.8,72,63.1,127,65.1,2,0,0
10/26/2017 14:45,56,65.6,75,60.8,131,62.8,2,0,0
10/26/2017 14:50,51,66.3,69,61.5,120,63.5,2,0,0
10/26/2017 14:55,57,67.8,74,63.1,131,65.1,2,0,0
10/26/2017 15:00,44,68.3,62,63.5,106,65.5,2,0,0
10/26/2017 15:05,52,68.4,70,63.8,122,65.8,2,0,0
10/26/2017 15:10,54,68.4,72,63.8,126,65.8,2,0,0
10/26/2017 15:15,50,68.3,68,63.7,118,65.7,2,0,0
10/26/2017 15:20,56,67.8,75,63.2,131,65.1,2,0,0
10/26/2017 15:25,61,66.3,80,61.4,141,63.5,2,0,0
10/26/2017 15:30,62,67.9,81,63.1,143,65.2,2,0,0
10/26/2017 15:35,58,68.1,77,63.4,135,65.4,2,0,0
10/26/2017 15:40,61,68.6,79,63.9,140,65.9,2,0,0
10/26/2017 15:45,65,69.2,84,64.6,149,66.6,2,0,0
10/26/2017 15:50,65,68.6,84,64,149,66,2,0,0
10/26/2017 15:55,58,67.8,76,63.1,134,65.1,2,0,0
10/26/2017 16:00,51,66,69,61.2,120,63.2,2,0,0
10/26/2017 16:05,58,67.7,76,63,134,65,2,0,0
10/26/2017 16:10,55,68.6,73,63.9,128,65.9,2,0,0
10/26/2017 16:15,58,68.5,77,63.9,135,65.8,2,0,0
10/26/2017 16:20,62,69.4,81,64.8,143,66.8,2,0,0
10/26/2017 16:25,53,67.8,71,63.1,124,65.1,2,0,0
10/26/2017 16:30,58,68.2,77,63.5,135,65.5,2,0,0
10/26/2017 16:35,57,67.9,75,63.3,132,65.3,2,0,0
10/26/2017 16:40,55,66.8,74,62.1,129,64.1,2,0,0
10/26/2017 16:45,53,66.2,71,61.3,124,63.4,2,0,0
10/26/2017 16:50,51,66.3,68,61.4,119,63.5,2,0,0
10/26/2017 16:55,52,66.5,70,61.7,122,63.8,2,0,0
10/26/2017 17:00,48,66.3,67,61.4,115,63.5,2,0,0
10/26/2017 17:05,47,65.7,65,60.7,112,62.8,2,0,0
10/26/2017 17:10,50,67.6,68,62.8,118,64.9,2,0,0
10/26/2017 17:15,54,65.8,72,60.8,126,62.9,2,0,0
10/26/2017 17:20,56,64.7,75,59.6,131,61.8,2,0,0
10/26/2017 17:25,53,65.4,72,60.3,125,62.5,2,0,0
10/26/2017 17:30,48,65,67,60,115,62.1,2,0,0
10/26/2017 17:35,45,65.1,63,60,108,62.1,2,0,0
10/26/2017 17:40,55,64.1,74,58.8,129,61,2,0,0
10/26/2017 17:45,46,65.9,64,60.9,110,63,2,0,0
10/26/2017 17:50,49,66.5,67,61.5,116,63.6,2,0,0
10/26/2017 17:55,41,68,58,63.2,99,65.2,2,0,0
10/26/2017 18:00,51,67.4,69,62.7,120,64.7,2,0,0
10/26/2017 18:05,42,68.6,59,64,101,65.9,2,0,0
10/26/2017 18:10,46,68.4,65,63.6,111,65.6,2,0,0
10/26/2017 18:15,47,69.1,64,64.5,111,66.5,2,0,0
10/26/2017 18:20,50,68.5,68,63.9,118,65.8,2,0,0
10/26/2017 18:25,53,69.4,71,64.9,124,66.8,2,0,0
10/26/2017 18:30,43,68.7,60,64,103,66,2,0,0
10/26/2017 18:35,46,68.5,64,63.8,110,65.8,2,0,0
10/26/2017 18:40,54,68.4,72,63.7,126,65.7,2,0,0
10/26/2017 18:45,44,68.4,61,63.8,105,65.7,2,0,0
10/26/2017 18:50,18,63.1,32,58.1,50,59.9,2,0,0
10/26/2017 18:55,26,59.9,40,54.8,66,56.8,2,0,0
10/26/2017 19:00,12,59.2,27,54,39,55.6,2,0,0
10/26/2017 19:05,19,63.2,24,58.2,43,60.4,2,0,0
10/26/2017 19:10,23,64.3,26,59.4,49,61.7,2,0,0
10/26/2017 19:15,22,65.7,26,60.8,48,63.1,2,0,0
10/26/2017 19:20,24,65.8,26,61,50,63.3,2,0,0
10/26/2017 19:25,25,66.3,27,61.5,52,63.8,2,0,0
10/26/2017 19:30,25,66.3,27,61.5,52,63.8,2,0,0
10/26/2017 19:35,18,60.4,33,55.3,51,57.1,2,0,0
10/26/2017 19:40,19,52.3,33,46.7,52,48.8,2,0,0
10/26/2017 19:45,23,54.5,37,49,60,51.1,2,0,0
10/26/2017 19:50,27,60.6,42,55.5,69,57.5,2,0,0
10/26/2017 19:55,35,63.7,50,58.8,85,60.8,2,0,0
10/26/2017 20:00,41,65.2,57,60.2,98,62.3,2,0,0
10/26/2017 20:05,31,66.8,47,62,78,63.9,2,0,0
10/26/2017 20:10,41,67.9,58,63.1,99,65.1,2,0,0
10/26/2017 20:15,30,68.7,47,64,77,65.8,2,0,0
10/26/2017 20:20,38,69.3,55,64.6,93,66.5,2,0,0
10/26/2017 20:25,33,68.9,50,64.3,83,66.1,2,0,0
10/26/2017 20:30,43,68.9,60,64.3,103,66.2,2,0,0
10/26/2017 20:35,32,68.4,49,63.7,81,65.6,2,0,0
10/26/2017 20:40,39,68.6,56,64,95,65.9,2,0,0
10/26/2017 20:45,35,69.1,52,64.4,87,66.3,2,0,0
10/26/2017 20:50,30,69,46,64.3,76,66.2,2,0,0
10/26/2017 20:55,32,69.4,49,64.8,81,66.6,2,0,0
10/26/2017 21:00,31,69.7,48,65.2,79,66.9,2,0,0
10/26/2017 21:05,27,69.2,42,64.6,69,66.4,2,0,0
10/26/2017 21:10,31,69.3,48,64.7,79,66.5,2,0,0
10/26/2017 21:15,31,69,48,64.4,79,66.2,2,0,0
10/26/2017 21:20,29,68.9,46,64.3,75,66.1,2,0,0
10/26/2017 21:25,35,68.9,51,64.2,86,66.1,2,0,0
10/26/2017 21:30,29,69,45,64.3,74,66.2,2,0,0
10/26/2017 21:35,31,69,47,64.3,78,66.2,2,0,0
10/26/2017 21:40,25,69.5,41,64.9,66,66.6,2,0,0
10/26/2017 21:45,35,69.7,52,65.2,87,67,2,0,0
10/26/2017 21:50,24,69.7,40,65.1,64,66.8,2,0,0
10/26/2017 21:55,23,69.6,39,65,62,66.7,2,0,0
10/26/2017 22:00,22,69,38,64.3,60,66,2,0,0
10/26/2017 22:05,25,69.3,41,64.7,66,66.5,2,0,0
10/26/2017 22:10,20,69.7,35,65.1,55,66.8,2,0,0
10/26/2017 22:15,28,69.7,44,65.1,72,66.9,2,0,0
10/26/2017 22:20,24,69.8,39,65.2,63,66.9,2,0,0
10/26/2017 22:25,28,69.4,44,64.8,72,66.6,2,0,0
10/26/2017 22:30,24,69.6,40,65,64,66.7,2,0,0
10/26/2017 22:35,31,69.5,47,64.9,78,66.7,2,0,0
10/26/2017 22:40,28,69.8,44,65.2,72,67,2,0,0
10/26/2017 22:45,19,69.6,35,65,54,66.6,2,0,0
10/26/2017 22:50,23,69.8,39,65.2,62,66.9,2,0,0
10/26/2017 22:55,17,69.7,33,65.1,50,66.6,2,0,0
10/26/2017 23:00,20,69.1,36,64.5,56,66.2,2,0,0
10/26/2017 23:05,22,69.2,38,64.6,60,66.3,2,0,0
10/26/2017 23:10,24,69.4,39,64.8,63,66.5,2,0,0
10/26/2017 23:15,20,68.4,36,63.7,56,65.4,2,0,0
10/26/2017 23:20,16,68.9,31,64.3,47,65.9,2,0,0
10/26/2017 23:25,13,69.1,28,64.4,41,65.9,2,0,0
10/26/2017 23:30,18,69.5,34,64.9,52,66.4,2,0,0
10/26/2017 23:35,22,69.3,38,64.7,60,66.4,2,0,0
10/26/2017 23:40,15,69.3,31,64.7,46,66.2,2,0,0
10/26/2017 23:45,15,69.4,30,64.8,45,66.3,2,0,0
10/26/2017 23:50,14,69.2,29,64.5,43,66.1,2,0,0
10/26/2017 23:55,15,69.2,31,64.5,46,66.1,2,0,0
10/27/2017 0:00,11,69.3,26,64.7,37,66.1,2,0,0
10/27/2017 0:05,12,69.4,28,64.8,40,66.2,2,0,0
10/27/2017 0:10,10,69.4,25,64.8,35,66.2,2,0,0
10/27/2017 0:15,14,69.4,29,64.8,43,66.3,2,0,0
10/27/2017 0:20,16,69.3,31,64.7,47,66.3,2,0,0
10/27/2017 0:25,10,69.3,26,64.7,36,66,2,0,0
10/27/2017 0:30,10,69.2,25,64.6,35,65.9,2,0,0
10/27/2017 0:35,11,69.2,27,64.6,38,66,2,0,0
10/27/2017 0:40,9,69.1,24,64.5,33,65.8,2,0,0
10/27/2017 0:45,9,69.1,24,64.5,33,65.8,2,0,0
10/27/2017 0:50,9,69.2,24,64.6,33,65.8,2,0,0
10/27/2017 0:55,7,69.3,22,64.7,29,65.8,2,0,0
10/27/2017 1:00,11,69.2,21,64.6,32,66.2,2,0,0
10/27/2017 1:05,7,69.2,22,64.6,29,65.7,2,0,0
10/27/2017 1:10,5,69.2,21,64.6,26,65.5,2,0,0
10/27/2017 1:15,6,69.3,21,64.7,27,65.7,2,0,0
10/27/2017 1:20,13,69.3,21,64.7,34,66.5,2,0,0
10/27/2017 1:25,11,69.3,26,64.7,37,66.1,2,0,0
10/27/2017 1:30,7,69.1,23,64.4,30,65.5,2,0,0
10/27/2017 1:35,9,69.2,25,64.6,34,65.8,2,0,0
10/27/2017 1:40,7,69.3,22,64.7,29,65.8,2,0,0
10/27/2017 1:45,5,69.4,21,64.8,26,65.7,2,0,0
10/27/2017 1:50,8,69.4,23,64.8,31,66,2,0,0
10/27/2017 1:55,7,69.4,22,64.8,29,65.9,2,0,0
10/27/2017 2:00,7,68.9,22,64.3,29,65.4,2,0,0
10/27/2017 2:05,8,69.2,23,64.5,31,65.7,2,0,0
10/27/2017 2:10,11,69.2,26,64.6,37,66,2,0,0
10/27/2017 2:15,7,69.1,23,64.5,30,65.6,2,0,0
10/27/2017 2:20,8,69.3,23,64.7,31,65.8,2,0,0
10/27/2017 2:25,8,69.3,23,64.7,31,65.8,2,0,0
10/27/2017 2:30,9,69.3,25,64.7,34,65.9,2,0,0
10/27/2017 2:35,9,69.2,25,64.6,34,65.8,2,0,0
10/27/2017 2:40,11,69.3,26,64.7,37,66.1,2,0,0
10/27/2017 2:45,9,69.3,24,64.7,33,66,2,0,0
10/27/2017 2:50,12,69.2,28,64.5,40,65.9,2,0,0
10/27/2017 2:55,10,69.1,26,64.5,36,65.8,2,0,0
10/27/2017 3:00,8,69,23,64.4,31,65.6,2,0,0
10/27/2017 3:05,9,69.2,25,64.6,34,65.8,2,0,0
10/27/2017 3:10,11,69.3,27,64.7,38,66,2,0,0
10/27/2017 3:15,11,69.1,26,64.5,37,65.9,2,0,0
10/27/2017 3:20,9,68.8,25,64.2,34,65.4,2,0,0
10/27/2017 3:25,14,68.8,29,64.2,43,65.7,2,0,0
10/27/2017 3:30,10,69,26,64.4,36,65.7,2,0,0
10/27/2017 3:35,15,69.2,30,64.5,45,66.1,2,0,0
10/27/2017 3:40,12,69.4,27,64.8,39,66.2,2,0,0
10/27/2017 3:45,13,69.5,28,64.9,41,66.4,2,0,0
10/27/2017 3:50,13,69.2,29,64.6,42,66,2,0,0
10/27/2017 3:55,15,69.3,30,64.7,45,66.3,2,0,0
10/27/2017 4:00,16,69.2,31,64.6,47,66.1,2,0,0
10/27/2017 4:05,19,69.4,35,64.8,54,66.4,2,0,0
10/27/2017 4:10,21,68.9,36,64.3,57,66,2,0,0
10/27/2017 4:15,18,69.2,34,64.6,52,66.2,2,0,0
10/27/2017 4:20,25,69.6,42,65,67,66.7,2,0,0
10/27/2017 4:25,25,69.4,42,64.8,67,66.5,2,0,0
10/27/2017 4:30,28,69.7,44,65.1,72,66.9,2,0,0
10/27/2017 4:35,27,69.7,44,65.1,71,66.9,2,0,0
10/27/2017 4:40,30,70.1,47,65.6,77,67.4,2,0,0
10/27/2017 4:45,36,69.3,53,64.7,89,66.6,2,0,0
10/27/2017 4:50,44,69.2,63,64.7,107,66.6,2,0,0
10/27/2017 4:55,39,69.4,57,64.9,96,66.7,2,0,0
10/27/2017 5:00,41,69.7,60,65.1,101,66.9,2,0,0
10/27/2017 5:05,36,68.7,55,64,91,65.9,2,0,0
10/27/2017 5:10,43,69.6,61,65.1,104,66.9,2,0,0
10/27/2017 5:15,44,68.2,62,63.5,106,65.4,2,0,0
10/27/2017 5:20,50,68.2,70,63.6,120,65.5,2,0,0
10/27/2017 5:25,51,68.3,72,63.6,123,65.6,2,0,0
10/27/2017 5:30,56,67.8,76,63,132,65,2,0,0
10/27/2017 5:35,59,68.4,80,63.7,139,65.7,2,0,0
10/27/2017 5:40,69,68.3,91,63.6,160,65.6,2,0,0
10/27/2017 5:45,68,68.6,90,63.9,158,65.9,2,0,0
10/27/2017 5:50,64,68.9,85,64.2,149,66.2,2,0,0
10/27/2017 5:55,68,68.5,90,63.8,158,65.8,2,0,0
10/27/2017 6:00,57,68.4,78,63.6,135,65.6,2,0,0
10/27/2017 6:05,57,67.7,78,62.9,135,64.9,2,0,0
10/27/2017 6:10,51,67.8,71,62.9,122,64.9,2,0,0
10/27/2017 6:15,60,67.1,80,62.1,140,64.2,2,0,0
10/27/2017 6:20,56,67.6,77,62.6,133,64.7,2,0,0
10/27/2017 6:25,59,67,79,62,138,64.1,2,0,0
10/27/2017 6:30,53,67.9,74,62.9,127,65,2,0,0
10/27/2017 6:35,64,67.4,86,62.4,150,64.5,2,0,0
10/27/2017 6:40,64,66.8,86,61.8,150,63.9,2,0,0
10/27/2017 6:45,70,66.6,92,61.5,162,63.7,2,0,0
10/27/2017 6:50,63,67,83,62,146,64.1,2,0,0
10/27/2017 6:55,61,68.1,80,63.2,141,65.3,2,0,0
10/27/2017 7:00,62,67.6,83,62.7,145,64.8,2,0,0
10/27/2017 7:05,61,67.9,80,63,141,65.1,2,0,0
10/27/2017 7:10,72,67.7,93,62.9,165,65,2,0,0
10/27/2017 7:15,67,66.4,89,61.4,156,63.6,2,0,0
10/27/2017 7:20,69,67,90,62,159,64.1,2,0,0
10/27/2017 7:25,80,67,102,62.1,182,64.2,2,0,0
10/27/2017 7:30,76,67.2,97,62.2,173,64.4,2,0,0
10/27/2017 7:35,83,68.1,106,63.2,189,65.3,2,0,0
10/27/2017 7:40,82,68,105,63.1,187,65.2,2,0,0
10/27/2017 7:45,84,67.1,107,62.2,191,64.4,2,0,0
10/27/2017 7:50,85,67.3,109,62.4,194,64.6,2,0,0
10/27/2017 7:55,73,66.6,95,61.7,168,63.8,2,0,0
10/27/2017 8:00,71,66.7,93,61.7,164,63.9,2,0,0
10/27/2017 8:05,78,66.7,100,61.8,178,64,2,0,0
10/27/2017 8:10,71,66.4,93,61.4,164,63.6,2,0,0
10/27/2017 8:15,73,67,95,62.1,168,64.2,2,0,0
10/27/2017 8:20,79,67.2,101,62.2,180,64.4,2,0,0
10/27/2017 8:25,62,66.2,82,61.1,144,63.3,2,0,0
10/27/2017 8:30,82,65.2,103,60.2,185,62.4,2,0,0
10/27/2017 8:35,81,64.8,104,59.7,185,61.9,2,0,0
10/27/2017 8:40,82,64.3,104,59,186,61.3,2,0,0
10/27/2017 8:45,88,63.4,111,58.1,199,60.5,2,0,0
10/27/2017 8:50,77,64.6,99,59.4,176,61.7,2,0,0
10/27/2017 8:55,75,64,96,58.8,171,61.1,2,0,0
10/27/2017 9:00,74,65.1,95,60,169,62.3,2,0,0
10/27/2017 9:05,71,66.9,93,62,164,64.1,2,0,0
10/27/2017 9:10,62,66.2,83,61.3,145,63.4,2,0,0
10/27/2017 9:15,71,65.3,92,60.3,163,62.5,2,0,0
10/27/2017 9:20,66,63.1,86,58,152,60.2,2,0,0
10/27/2017 9:25,69,63.7,90,58.7,159,60.9,2,0,0
10/27/2017 9:30,63,64.3,83,59.2,146,61.4,2,0,0
10/27/2017 9:35,63,64.7,83,59.7,146,61.9,2,0,0
10/27/2017 9:40,70,65.2,90,60.2,160,62.4,2,0,0
10/27/2017 9:45,70,66.5,91,61.6,161,63.7,2,0,0
10/27/2017 9:50,52,64.5,72,59.4,124,61.5,2,0,0
10/27/2017 9:55,63,64.5,82,59.4,145,61.6,2,0,0
10/27/2017 10:00,66,66.7,85,62,151,64,2,0,0
10/27/2017 10:05,55,66.2,74,61.3,129,63.3,2,0,0
10/27/2017 10:10,59,65.6,77,60.8,136,62.9,2,0,0
10/27/2017 10:15,60,67.6,79,62.9,139,64.9,2,0,0
10/27/2017 10:20,65,65.3,86,60.5,151,62.6,2,0,0
10/27/2017 10:25,64,67.5,83,62.8,147,64.9,2,0,0
10/27/2017 10:30,56,69.9,74,65.5,130,67.4,2,0,0
10/27/2017 10:35,61,68.6,80,64.1,141,66,2,0,0
10/27/2017 10:40,60,68.4,79,63.8,139,65.7,2,0,0
10/27/2017 10:45,59,68.4,79,63.8,138,65.7,2,0,0
10/27/2017 10:50,60,67.8,79,63.2,139,65.2,2,0,0
10/27/2017 10:55,61,66.2,80,61.4,141,63.4,2,0,0
10/27/2017 11:00,55,64.1,75,59.1,130,61.2,2,0,0
10/27/2017 11:05,57,65.6,76,60.7,133,62.8,2,0,0
10/27/2017 11:10,63,66.7,82,61.9,145,64,2,0,0
10/27/2017 11:15,65,66.9,84,62.2,149,64.2,2,0,0
10/27/2017 11:20,61,68,79,63.4,140,65.4,2,0,0
10/27/2017 11:25,66,66.6,85,61.8,151,63.9,2,0,0
10/27/2017 11:30,61,66.8,80,62.1,141,64.1,2,0,0
10/27/2017 11:35,64,67.6,83,62.8,147,64.9,2,0,0
10/27/2017 11:40,69,68,89,63.3,158,65.4,2,0,0
10/27/2017 11:45,55,68.3,73,63.7,128,65.7,2,0,0
10/27/2017 11:50,60,68.4,78,63.7,138,65.8,2,0,0
10/27/2017 11:55,53,67,72,62.3,125,64.3,2,0,0
10/27/2017 12:00,56,67.5,75,62.8,131,64.8,2,0,0
10/27/2017 12:05,51,66.4,69,61.6,120,63.7,2,0,0
10/27/2017 12:10,54,67.4,72,62.7,126,64.7,2,0,0
10/27/2017 12:15,55,66.7,74,62,129,64,2,0,0
10/27/2017 12:20,55,67.4,74,62.8,129,64.8,2,0,0
10/27/2017 12:25,56,66.5,75,61.8,131,63.8,2,0,0
10/27/2017 12:30,47,66.7,66,62,113,64,2,0,0
10/27/2017 12:35,53,65.7,72,60.8,125,62.9,2,0,0
10/27/2017 12:40,53,67.5,71,62.8,124,64.8,2,0,0
10/27/2017 12:45,55,68.6,74,63.9,129,65.9,2,0,0
10/27/2017 12:50,54,69.4,73,64.9,127,66.8,2,0,0
10/27/2017 12:55,57,68,75,63.4,132,65.4,2,0,0
10/27/2017 13:00,46,68.4,63,63.8,109,65.8,2,0,0
10/27/2017 13:05,55,69.1,73,64.6,128,66.5,2,0,0
10/27/2017 13:10,44,69.4,61,64.9,105,66.7,2,0,0
10/27/2017 13:15,56,69.8,74,65.3,130,67.2,2,0,0
10/27/2017 13:20,51,68.9,69,64.2,120,66.2,2,0,0
10/27/2017 13:25,49,67.7,67,63,116,65,2,0,0
10/27/2017 13:30,49,69.1,68,64.5,117,66.4,2,0,0
10/27/2017 13:35,54,68.5,72,63.9,126,65.9,2,0,0
10/27/2017 13:40,54,67.1,73,62.3,127,64.4,2,0,0
10/27/2017 13:45,57,68.4,75,63.6,132,65.7,2,0,0
10/27/2017 13:50,52,68.3,71,63.6,123,65.6,2,0,0
10/27/2017 13:55,50,69.6,68,65,118,67,2,0,0
10/27/2017 14:00,55,69,73,64.3,128,66.3,2,0,0
10/27/2017 14:05,53,69.2,71,64.6,124,66.6,2,0,0
10/27/2017 14:10,54,69.1,73,64.5,127,66.4,2,0,0
10/27/2017 14:15,58,68.8,77,64.2,135,66.1,2,0,0
10/27/2017 14:20,52,68.6,70,63.9,122,65.9,2,0,0
10/27/2017 14:25,56,68.2,74,63.5,130,65.5,2,0,0
10/27/2017 14:30,57,69.5,74,64.9,131,66.9,2,0,0
10/27/2017 14:35,59,68.7,77,64,136,66.1,2,0,0
10/27/2017 14:40,59,68.8,78,64.1,137,66.1,2,0,0
10/27/2017 14:45,54,68.9,71,64.3,125,66.3,2,0,0
10/27/2017 14:50,48,68.6,66,64,114,65.9,2,0,0
10/27/2017 14:55,59,68.4,77,63.7,136,65.8,2,0,0
10/27/2017 15:00,54,69.4,72,64.8,126,66.8,2,0,0
10/27/2017 15:05,60,68.4,80,63.8,140,65.8,2,0,0
10/27/2017 15:10,54,69.5,72,65,126,66.9,2,0,0
10/27/2017 15:15,51,69.2,70,64.7,121,66.6,2,0,0
10/27/2017 15:20,62,70.1,81,65.6,143,67.5,2,0,0
10/27/2017 15:25,63,68.8,83,64.2,146,66.2,2,0,0
10/27/2017 15:30,59,69.2,78,64.6,137,66.6,2,0,0
10/27/2017 15:35,65,69.5,84,64.9,149,66.9,2,0,0
10/27/2017 15:40,59,69.2,77,64.6,136,66.6,2,0,0
10/27/2017 15:45,66,69.2,84,64.5,150,66.6,2,0,0
10/27/2017 15:50,62,68.1,81,63.4,143,65.4,2,0,0
10/27/2017 15:55,61,67.9,79,63.2,140,65.3,2,0,0
10/27/2017 16:00,66,68.2,85,63.5,151,65.5,2,0,0
10/27/2017 16:05,71,68.1,90,63.4,161,65.5,2,0,0
10/27/2017 16:10,70,67.9,90,63.2,160,65.2,2,0,0
10/27/2017 16:15,68,66.9,88,62,156,64.1,2,0,0
10/27/2017 16:20,60,66.8,80,62,140,64.1,2,0,0
10/27/2017 16:25,60,66.9,79,62,139,64.1,2,0,0
10/27/2017 16:30,61,66.1,79,61.1,140,63.3,2,0,0
10/27/2017 16:35,50,65.1,69,60.1,119,62.2,2,0,0
10/27/2017 16:40,71,63.4,91,58.1,162,60.4,2,0,0
10/27/2017 16:45,51,63.8,70,58.6,121,60.8,2,0,0
10/27/2017 16:50,60,64.1,78,58.9,138,61.2,2,0,0
10/27/2017 16:55,51,65.1,69,60.1,120,62.2,2,0,0
10/27/2017 17:00,53,66.2,71,61.3,124,63.4,2,0,0
10/27/2017 17:05,50,64.7,67,59.5,117,61.7,2,0,0
10/27/2017 17:10,51,63.8,69,58.6,120,60.8,2,0,0
10/27/2017 17:15,47,65.4,65,60.2,112,62.4,2,0,0
10/27/2017 17:20,51,67.9,68,63,119,65.1,2,0,0
10/27/2017 17:25,51,67.8,68,63,119,65.1,2,0,0
10/27/2017 17:30,62,68.8,81,64.1,143,66.1,2,0,0
10/27/2017 17:35,53,67.7,72,62.9,125,64.9,2,0,0
10/27/2017 17:40,63,68.4,83,63.7,146,65.7,2,0,0
10/27/2017 17:45,67,68.1,88,63.4,155,65.4,2,0,0
10/27/2017 17:50,59,69.1,79,64.4,138,66.4,2,0,0
10/27/2017 17:55,54,69.1,72,64.3,126,66.4,2,0,0
10/27/2017 18:00,66,68.2,85,63.4,151,65.5,2,0,0
10/27/2017 18:05,68,68.2,88,63.4,156,65.5,2,0,0
10/27/2017 18:10,66,67.4,87,62.5,153,64.6,2,0,0
10/27/2017 18:15,71,66.4,90,61.4,161,63.6,2,0,0
10/27/2017 18:20,58,65.9,77,60.9,135,63.1,2,0,0
10/27/2017 18:25,70,64.9,89,59.8,159,62,2,0,0
10/27/2017 18:30,66,66.2,85,61.2,151,63.4,2,0,0
10/27/2017 18:35,67,63.7,86,58.3,153,60.7,2,0,0
10/27/2017 18:40,59,59.9,79,54.1,138,56.6,2,0,0
10/27/2017 18:45,58,62.9,77,57.5,135,59.8,2,0,0
10/27/2017 18:50,63,65.1,81,60,144,62.3,2,0,0
10/27/2017 18:55,48,67.3,66,62.4,114,64.5,2,0,0
10/27/2017 19:00,55,66.6,73,61.7,128,63.8,2,0,0
10/27/2017 19:05,48,68.2,66,63.5,114,65.4,2,0,0
10/27/2017 19:10,48,69,65,64.4,113,66.3,2,0,0
10/27/2017 19:15,48,68.3,66,63.6,114,65.6,2,0,0
10/27/2017 19:20,49,68.5,66,63.8,115,65.8,2,0,0
10/27/2017 19:25,53,68.2,70,63.4,123,65.5,2,0,0
10/27/2017 19:30,50,68.5,68,63.8,118,65.8,2,0,0
10/27/2017 19:35,46,68.8,64,64.2,110,66.1,2,0,0
10/27/2017 19:40,50,68.7,68,64.1,118,66,2,0,0
10/27/2017 19:45,45,68.8,63,64.1,108,66.1,2,0,0
10/27/2017 19:50,45,68,62,63.2,107,65.2,2,0,0
10/27/2017 19:55,41,68.4,58,63.7,99,65.6,2,0,0
10/27/2017 20:00,32,69,49,64.4,81,66.2,2,0,0
10/27/2017 20:05,43,69.5,60,64.9,103,66.8,2,0,0
10/27/2017 20:10,42,69,58,64.4,100,66.4,2,0,0
10/27/2017 20:15,45,70.1,62,65.6,107,67.5,2,0,0
10/27/2017 20:20,43,69.4,59,64.8,102,66.7,2,0,0
10/27/2017 20:25,38,69,55,64.4,93,66.3,2,0,0
10/27/2017 20:30,35,69.5,50,64.9,85,66.8,2,0,0
10/27/2017 20:35,32,67.7,49,63,81,64.8,2,0,0
10/27/2017 20:40,40,69.1,57,64.5,97,66.4,2,0,0
10/27/2017 20:45,42,68.9,59,64.2,101,66.2,2,0,0
10/27/2017 20:50,38,69.4,54,64.7,92,66.6,2,0,0
10/27/2017 20:55,42,69.8,59,65.2,101,67.1,2,0,0
10/27/2017 21:00,33,69.3,50,64.7,83,66.5,2,0,0
10/27/2017 21:05,36,68.9,53,64.2,89,66.1,2,0,0
10/27/2017 21:10,32,69.2,49,64.6,81,66.5,2,0,0
10/27/2017 21:15,31,69.7,48,65.1,79,66.9,2,0,0
10/27/2017 21:20,39,69.6,56,65,95,66.9,2,0,0
10/27/2017 21:25,40,69.7,57,65.1,97,67,2,0,0
10/27/2017 21:30,39,69.6,55,65,94,66.9,2,0,0
10/27/2017 21:35,31,70.1,48,65.6,79,67.4,2,0,0
10/27/2017 21:40,37,70,54,65.4,91,67.3,2,0,0
10/27/2017 21:45,34,69.3,51,64.6,85,66.5,2,0,0
10/27/2017 21:50,40,69.1,56,64.4,96,66.4,2,0,0
10/27/2017 21:55,40,69.1,56,64.4,96,66.4,2,0,0
10/27/2017 22:00,37,68.1,54,63.4,91,65.3,2,0,0
10/27/2017 22:05,37,68.8,53,64.1,90,66,2,0,0
10/27/2017 22:10,31,68.8,48,64.2,79,66,2,0,0
10/27/2017 22:15,36,69.4,52,64.8,88,66.7,2,0,0
10/27/2017 22:20,30,68.9,47,64.3,77,66.1,2,0,0
10/27/2017 22:25,30,69.1,47,64.5,77,66.3,2,0,0
10/27/2017 22:30,31,69.4,47,64.8,78,66.7,2,0,0
10/27/2017 22:35,28,68.9,45,64.3,73,66.1,2,0,0
10/27/2017 22:40,31,68.8,48,64.2,79,66,2,0,0
10/27/2017 22:45,29,68.9,44,64.2,73,66.1,2,0,0
10/27/2017 22:50,25,69,41,64.4,66,66.1,2,0,0
10/27/2017 22:55,21,69.1,36,64.5,57,66.2,2,0,0
10/27/2017 23:00,29,69.6,44,65,73,66.8,2,0,0
10/27/2017 23:05,27,69.5,43,64.9,70,66.7,2,0,0
10/27/2017 23:10,31,69.5,47,64.9,78,66.7,2,0,0
10/27/2017 23:15,29,69.1,45,64.4,74,66.2,2,0,0
10/27/2017 23:20,31,69.3,47,64.7,78,66.5,2,0,0
10/27/2017 23:25,34,68.8,50,64.1,84,66,2,0,0
10/27/2017 23:30,31,68.9,47,64.3,78,66.2,2,0,0
10/27/2017 23:35,26,68.9,41,64.2,67,66,2,0,0
10/27/2017 23:40,23,69,39,64.4,62,66.1,2,0,0
10/27/2017 23:45,20,69.2,36,64.6,56,66.3,2,0,0
10/27/2017 23:50,20,69.3,36,64.7,56,66.3,2,0,0
10/27/2017 23:55,16,69.2,31,64.5,47,66.1,2,0,0
10/28/2017 0:00,18,69.3,33,64.7,51,66.4,2,0,0
10/28/2017 0:05,16,69.4,31,64.8,47,66.3,2,0,0
10/28/2017 0:10,19,69.5,35,64.9,54,66.5,2,0,0
10/28/2017 0:15,14,69.2,30,64.5,44,66,2,0,0
10/28/2017 0:20,13,69.3,29,64.7,42,66.1,2,0,0
10/28/2017 0:25,17,68.9,32,64.3,49,65.9,2,0,0
10/28/2017 0:30,15,69.1,30,64.5,45,66,2,0,0
10/28/2017 0:35,12,68.8,27,64.2,39,65.6,2,0,0
10/28/2017 0:40,15,69.2,29,64.6,44,66.2,2,0,0
10/28/2017 0:45,18,69.3,24,64.7,42,66.7,2,0,0
10/28/2017 0:50,11,69.3,26,64.7,37,66.1,2,0,0
10/28/2017 0:55,6,69.3,18,64.7,24,65.9,2,0,0
10/28/2017 1:00,3,69.2,19,64.5,22,65.2,2,0,0
10/28/2017 1:05,6,69.2,18,64.5,24,65.7,2,0,0
10/28/2017 1:10,6,69.2,18,64.5,24,65.7,2,0,0
10/28/2017 1:15,6,69.2,18,64.5,24,65.7,2,0,0
10/28/2017 1:20,6,69.2,18,64.5,24,65.7,2,0,0
10/28/2017 1:25,8,68.9,19,64.3,27,65.7,2,0,0
10/28/2017 1:30,6,68.9,18,64.3,24,65.4,2,0,0
10/28/2017 1:35,6,68.9,18,64.3,24,65.4,2,0,0
10/28/2017 1:40,6,68.9,18,64.3,24,65.4,2,0,0
10/28/2017 1:45,6,68.9,18,64.3,24,65.4,2,0,0
10/28/2017 1:50,6,68.9,18,64.3,24,65.4,2,0,0
10/28/2017 1:55,6,68.9,18,64.3,24,65.4,2,0,0
10/28/2017 2:00,6,68.9,18,64.3,24,65.4,2,0,0
10/28/2017 2:05,6,68.9,18,64.3,24,65.4,2,0,0
10/28/2017 2:10,6,68.9,18,64.3,24,65.4,2,0,0
10/28/2017 2:15,6,68.9,18,64.3,24,65.4,2,0,0
10/28/2017 2:20,6,68.9,18,64.3,24,65.4,2,0,0
10/28/2017 2:25,6,68.9,18,64.3,24,65.4,2,0,0
10/28/2017 2:30,6,68.9,18,64.3,24,65.4,2,0,0
10/28/2017 2:35,6,68.9,18,64.3,24,65.4,2,0,0
10/28/2017 2:40,6,68.9,18,64.3,24,65.4,2,0,0
10/28/2017 2:45,6,68.9,18,64.3,24,65.4,2,0,0
10/28/2017 2:50,6,68.9,18,64.3,24,65.4,2,0,0
10/28/2017 2:55,6,68.9,18,64.3,24,65.4,2,0,0
10/28/2017 3:00,6,68.9,18,64.3,24,65.4,2,0,0
10/28/2017 3:05,6,68.9,18,64.3,24,65.4,2,0,0
10/28/2017 3:10,6,68.9,18,64.3,24,65.4,2,0,0
10/28/2017 3:15,6,68.9,18,64.3,24,65.4,2,0,0
10/28/2017 3:20,6,68.9,18,64.3,24,65.4,2,0,0
10/28/2017 3:25,6,68.9,18,64.3,24,65.4,2,0,0
10/28/2017 3:30,5,69.1,20,64.5,25,65.4,2,0,0
10/28/2017 3:35,8,68.9,23,64.3,31,65.5,2,0,0
10/28/2017 3:40,8,69.2,23,64.5,31,65.7,2,0,0
10/28/2017 3:45,8,69.2,24,64.5,32,65.7,2,0,0
10/28/2017 3:50,10,69.2,25,64.6,35,65.9,2,0,0
10/28/2017 3:55,7,69.3,23,64.7,30,65.8,2,0,0
10/28/2017 4:00,9,69.2,24,64.6,33,65.8,2,0,0
10/28/2017 4:05,15,69,22,64.4,37,66.3,2,0,0
10/28/2017 4:10,10,69.2,25,64.5,35,65.9,2,0,0
10/28/2017 4:15,12,69.3,27,64.7,39,66.1,2,0,0
10/28/2017 4:20,13,69.3,28,64.7,41,66.2,2,0,0
10/28/2017 4:25,7,69.4,23,64.8,30,65.9,2,0,0
10/28/2017 4:30,13,68.7,28,64,41,65.5,2,0,0
10/28/2017 4:35,16,69,32,64.3,48,65.9,2,0,0
10/28/2017 4:40,15,68.9,30,64.2,45,65.8,2,0,0
10/28/2017 4:45,21,69.1,36,64.5,57,66.2,2,0,0
10/28/2017 4:50,18,69.2,34,64.6,52,66.2,2,0,0
10/28/2017 4:55,17,69.3,33,64.7,50,66.3,2,0,0
10/28/2017 5:00,20,69.4,35,64.8,55,66.4,2,0,0
10/28/2017 5:05,16,69.4,32,64.8,48,66.3,2,0,0
10/28/2017 5:10,23,69.6,39,65,62,66.7,2,0,0
10/28/2017 5:15,23,69.4,40,64.7,63,66.4,2,0,0
10/28/2017 5:20,18,69.5,34,64.9,52,66.5,2,0,0
10/28/2017 5:25,23,68.7,40,64,63,65.7,2,0,0
10/28/2017 5:30,20,68.5,36,63.8,56,65.5,2,0,0
10/28/2017 5:35,20,69.2,37,64.5,57,66.2,2,0,0
10/28/2017 5:40,23,69.1,40,64.5,63,66.2,2,0,0
10/28/2017 5:45,21,69.2,37,64.6,58,66.2,2,0,0
10/28/2017 5:50,19,69.3,35,64.7,54,66.3,2,0,0
10/28/2017 5:55,26,69.1,42,64.4,68,66.2,2,0,0
10/28/2017 6:00,20,69.1,37,64.5,57,66.1,2,0,0
10/28/2017 6:05,18,68.8,34,64.2,52,65.8,2,0,0
10/28/2017 6:10,19,68.5,35,63.8,54,65.5,2,0,0
10/28/2017 6:15,24,68.4,40,63.8,64,65.5,2,0,0
10/28/2017 6:20,18,68.8,33,64.2,51,65.8,2,0,0
10/28/2017 6:25,25,69.2,41,64.5,66,66.3,2,0,0
10/28/2017 6:30,25,69.2,41,64.6,66,66.4,2,0,0
10/28/2017 6:35,31,69.3,48,64.7,79,66.5,2,0,0
10/28/2017 6:40,24,69.5,40,65,64,66.7,2,0,0
10/28/2017 6:45,27,69.2,44,64.5,71,66.3,2,0,0
10/28/2017 6:50,25,69.2,41,64.6,66,66.4,2,0,0
10/28/2017 6:55,32,69.2,49,64.6,81,66.4,2,0,0
10/28/2017 7:00,29,68,46,63.3,75,65.1,2,0,0
10/28/2017 7:05,31,68.5,49,63.8,80,65.6,2,0,0
10/28/2017 7:10,32,69.1,48,64.5,80,66.3,2,0,0
10/28/2017 7:15,37,68.6,54,63.9,91,65.8,2,0,0
10/28/2017 7:20,35,68.7,52,64.1,87,66,2,0,0
10/28/2017 7:25,42,68.9,60,64.2,102,66.2,2,0,0
10/28/2017 7:30,41,69.8,58,65.3,99,67.2,2,0,0
10/28/2017 7:35,34,69.8,51,65.2,85,67,2,0,0
10/28/2017 7:40,46,69.9,63,65.4,109,67.3,2,0,0
10/28/2017 7:45,47,69.5,64,64.9,111,66.8,2,0,0
10/28/2017 7:50,48,69.8,66,65.3,114,67.2,2,0,0
10/28/2017 7:55,42,69.7,59,65.2,101,67.1,2,0,0
10/28/2017 8:00,43,68.9,60,64.3,103,66.2,2,0,0
10/28/2017 8:05,36,69.4,52,64.8,88,66.7,2,0,0
10/28/2017 8:10,35,69.1,51,64.5,86,66.4,2,0,0
10/28/2017 8:15,49,69.3,67,64.7,116,66.6,2,0,0
10/28/2017 8:20,45,70,63,65.5,108,67.4,2,0,0
10/28/2017 8:25,48,70.5,65,66.1,113,68,2,0,0
10/28/2017 8:30,45,70.3,63,65.8,108,67.6,2,0,0
10/28/2017 8:35,50,69.5,68,64.9,118,66.9,2,0,0
10/28/2017 8:40,52,70.1,71,65.5,123,67.5,2,0,0
10/28/2017 8:45,51,69.6,69,65,120,66.9,2,0,0
10/28/2017 8:50,50,69.3,68,64.7,118,66.6,2,0,0
10/28/2017 8:55,47,69.5,65,64.8,112,66.7,2,0,0
10/28/2017 9:00,50,68.4,68,63.7,118,65.7,2,0,0
10/28/2017 9:05,48,68.8,66,64.1,114,66.1,2,0,0
10/28/2017 9:10,45,67.9,62,63.2,107,65.1,2,0,0
10/28/2017 9:15,49,69,66,64.4,115,66.4,2,0,0
10/28/2017 9:20,48,69.3,66,64.8,114,66.7,2,0,0
10/28/2017 9:25,53,69.1,71,64.5,124,66.4,2,0,0
10/28/2017 9:30,41,68.9,58,64.3,99,66.2,2,0,0
10/28/2017 9:35,58,68.7,77,64,135,66,2,0,0
10/28/2017 9:40,49,68.4,66,63.7,115,65.7,2,0,0
10/28/2017 9:45,55,68.6,73,63.9,128,65.9,2,0,0
10/28/2017 9:50,57,68.4,75,63.7,132,65.8,2,0,0
10/28/2017 9:55,49,69.1,67,64.5,116,66.5,2,0,0
10/28/2017 10:00,58,68.9,76,64.3,134,66.3,2,0,0
10/28/2017 10:05,57,69.3,75,64.8,132,66.8,2,0,0
10/28/2017 10:10,50,69.9,67,65.4,117,67.3,2,0,0
10/28/2017 10:15,61,68.5,80,63.8,141,65.8,2,0,0
10/28/2017 10:20,57,68.6,75,63.9,132,66,2,0,0
10/28/2017 10:25,56,68.8,74,64.2,130,66.2,2,0,0
10/28/2017 10:30,63,67.2,81,62.5,144,64.6,2,0,0
10/28/2017 10:35,64,67.4,84,62.7,148,64.7,2,0,0
10/28/2017 10:40,66,68.1,85,63.4,151,65.5,2,0,0
10/28/2017 10:45,64,69,82,64.4,146,66.4,2,0,0
10/28/2017 10:50,63,69.1,82,64.5,145,66.5,2,0,0
10/28/2017 10:55,57,68.8,75,64.2,132,66.2,2,0,0
10/28/2017 11:00,59,68.6,78,64,137,66,2,0,0
10/28/2017 11:05,70,68.7,90,64,160,66.1,2,0,0
10/28/2017 11:10,61,68.4,80,63.7,141,65.7,2,0,0
10/28/2017 11:15,73,69.1,93,64.5,166,66.5,2,0,0
10/28/2017 11:20,65,69.6,83,65.1,148,67,2,0,0
10/28/2017 11:25,59,69.7,78,65.2,137,67.1,2,0,0
10/28/2017 11:30,68,69.5,87,64.9,155,66.9,2,0,0
10/28/2017 11:35,55,69.6,73,65,128,66.9,2,0,0
10/28/2017 11:40,52,68.9,69,64.3,121,66.3,2,0,0
10/28/2017 11:45,49,69.1,67,64.4,116,66.4,2,0,0
10/28/2017 11:50,55,69.8,74,65.3,129,67.2,2,0,0
10/28/2017 11:55,63,69.8,81,65.2,144,67.2,2,0,0
10/28/2017 12:00,54,69.6,71,65,125,67,2,0,0
10/28/2017 12:05,52,69.6,71,65,123,66.9,2,0,0
10/28/2017 12:10,51,69.2,69,64.5,120,66.5,2,0,0
10/28/2017 12:15,54,69.4,72,64.7,126,66.7,2,0,0
10/28/2017 12:20,62,68.5,81,63.8,143,65.8,2,0,0
10/28/2017 12:25,58,68.4,76,63.6,134,65.7,2,0,0
10/28/2017 12:30,51,67.9,69,63.2,120,65.2,2,0,0
10/28/2017 12:35,52,68.8,71,64.2,123,66.1,2,0,0
10/28/2017 12:40,50,67.8,69,63,119,65,2,0,0
10/28/2017 12:45,53,68.5,72,63.9,125,65.8,2,0,0
10/28/2017 12:50,52,68.4,70,63.8,122,65.8,2,0,0
10/28/2017 12:55,57,68,76,63.3,133,65.3,2,0,0
10/28/2017 13:00,64,68.5,83,63.8,147,65.9,2,0,0
10/28/2017 13:05,54,69,72,64.4,126,66.4,2,0,0
10/28/2017 13:10,61,68.4,79,63.7,140,65.7,2,0,0
10/28/2017 13:15,65,68.2,84,63.5,149,65.6,2,0,0
10/28/2017 13:20,61,68.6,80,64,141,66,2,0,0
10/28/2017 13:25,54,68.6,72,64,126,66,2,0,0
10/28/2017 13:30,60,68.6,79,64,139,66,2,0,0
10/28/2017 13:35,61,69,79,64.4,140,66.4,2,0,0
10/28/2017 13:40,60,69,80,64.4,140,66.4,2,0,0
10/28/2017 13:45,63,69.3,81,64.7,144,66.7,2,0,0
10/28/2017 13:50,59,68.9,79,64.2,138,66.2,2,0,0
10/28/2017 13:55,51,69.6,69,65.1,120,67,2,0,0
10/28/2017 14:00,53,69.5,71,64.9,124,66.9,2,0,0
10/28/2017 14:05,46,68.6,63,63.9,109,65.9,2,0,0
10/28/2017 14:10,52,69.4,69,64.8,121,66.8,2,0,0
10/28/2017 14:15,49,68.6,68,63.9,117,65.9,2,0,0
10/28/2017 14:20,48,69.2,64,64.6,112,66.6,2,0,0
10/28/2017 14:25,58,69.4,76,64.8,134,66.8,2,0,0
10/28/2017 14:30,53,68.5,71,63.8,124,65.8,2,0,0
10/28/2017 14:35,62,68.3,80,63.5,142,65.6,2,0,0
10/28/2017 14:40,55,68.3,73,63.5,128,65.5,2,0,0
10/28/2017 14:45,62,68,81,63.3,143,65.3,2,0,0
10/28/2017 14:50,50,67.6,68,62.8,118,64.9,2,0,0
10/28/2017 14:55,42,68.2,59,63.6,101,65.5,2,0,0
10/28/2017 15:00,51,68.8,69,64.2,120,66.2,2,0,0
10/28/2017 15:05,41,68.4,58,63.7,99,65.7,2,0,0
10/28/2017 15:10,51,68.6,69,63.9,120,65.9,2,0,0
10/28/2017 15:15,55,68.4,73,63.8,128,65.8,2,0,0
10/28/2017 15:20,53,68.8,71,64.1,124,66.1,2,0,0
10/28/2017 15:25,59,69,77,64.4,136,66.4,2,0,0
10/28/2017 15:30,58,68.4,76,63.7,134,65.8,2,0,0
10/28/2017 15:35,57,68.1,74,63.4,131,65.4,2,0,0
10/28/2017 15:40,62,67.8,80,63.1,142,65.2,2,0,0
10/28/2017 15:45,51,67.8,69,63,120,65.1,2,0,0
10/28/2017 15:50,66,67.8,85,63,151,65.1,2,0,0
10/28/2017 15:55,61,67.9,78,63.1,139,65.2,2,0,0
10/28/2017 16:00,65,68.5,84,63.7,149,65.8,2,0,0
10/28/2017 16:05,61,68.9,81,64.2,142,66.2,2,0,0
10/28/2017 16:10,70,68.6,89,63.9,159,66,2,0,0
10/28/2017 16:15,65,68.9,85,64.3,150,66.3,2,0,0
10/28/2017 16:20,63,69.1,82,64.4,145,66.4,2,0,0
10/28/2017 16:25,66,69.3,85,64.6,151,66.7,2,0,0
10/28/2017 16:30,70,69.6,89,64.9,159,67,2,0,0
10/28/2017 16:35,64,69.3,83,64.7,147,66.7,2,0,0
10/28/2017 16:40,60,69.1,79,64.3,139,66.4,2,0,0
10/28/2017 16:45,74,69,94,64.3,168,66.4,2,0,0
10/28/2017 16:50,69,68.5,89,63.7,158,65.8,2,0,0
10/28/2017 16:55,69,68.3,88,63.6,157,65.7,2,0,0
10/28/2017 17:00,58,68,76,63.3,134,65.3,2,0,0
10/28/2017 17:05,62,68.4,82,63.6,144,65.7,2,0,0
10/28/2017 17:10,64,68.8,85,64.1,149,66.2,2,0,0
10/28/2017 17:15,57,68.7,77,64,134,66,2,0,0
10/28/2017 17:20,61,68.5,79,63.8,140,65.8,2,0,0
10/28/2017 17:25,56,68.7,74,64.1,130,66.1,2,0,0
10/28/2017 17:30,54,68.1,72,63.3,126,65.3,2,0,0
10/28/2017 17:35,52,69.2,70,64.5,122,66.5,2,0,0
10/28/2017 17:40,59,69.5,77,64.8,136,66.8,2,0,0
10/28/2017 17:45,51,68.7,70,64,121,66,2,0,0
10/28/2017 17:50,60,68.6,79,63.9,139,65.9,2,0,0
10/28/2017 17:55,59,68.9,76,64.2,135,66.3,2,0,0
10/28/2017 18:00,51,69.6,69,65,120,66.9,2,0,0
10/28/2017 18:05,65,69.7,83,65.1,148,67.1,2,0,0
10/28/2017 18:10,64,69,84,64.4,148,66.4,2,0,0
10/28/2017 18:15,70,68.7,90,64,160,66.1,2,0,0
10/28/2017 18:20,77,68.7,97,64,174,66.1,2,0,0
10/28/2017 18:25,66,67.6,85,62.7,151,64.8,2,0,0
10/28/2017 18:30,62,68.1,81,63.2,143,65.3,2,0,0
10/28/2017 18:35,68,67.4,87,62.5,155,64.6,2,0,0
10/28/2017 18:40,67,68.3,87,63.5,154,65.6,2,0,0
10/28/2017 18:45,63,68.3,81,63.6,144,65.7,2,0,0
10/28/2017 18:50,60,68,79,63.2,139,65.3,2,0,0
10/28/2017 18:55,71,67.4,90,62.6,161,64.7,2,0,0
10/28/2017 19:00,67,67.5,87,62.7,154,64.8,2,0,0
10/28/2017 19:05,55,68.8,74,64.1,129,66.1,2,0,0
10/28/2017 19:10,48,68.7,66,64,114,65.9,2,0,0
10/28/2017 19:15,63,67.7,81,62.9,144,65,2,0,0
10/28/2017 19:20,58,68.6,77,63.9,135,65.9,2,0,0
10/28/2017 19:25,49,68.5,67,63.8,116,65.8,2,0,0
10/28/2017 19:30,49,67.9,67,63.1,116,65.1,2,0,0
10/28/2017 19:35,61,67.4,79,62.6,140,64.7,2,0,0
10/28/2017 19:40,55,67.5,74,62.7,129,64.7,2,0,0
10/28/2017 19:45,39,69,56,64.3,95,66.2,2,0,0
10/28/2017 19:50,42,69.3,59,64.7,101,66.6,2,0,0
10/28/2017 19:55,32,69,49,64.3,81,66.2,2,0,0
10/28/2017 20:00,47,69.4,65,64.7,112,66.7,2,0,0
10/28/2017 20:05,44,69.7,61,65.1,105,67,2,0,0
10/28/2017 20:10,41,69.2,59,64.5,100,66.4,2,0,0
10/28/2017 20:15,41,68.1,58,63.3,99,65.3,2,0,0
10/28/2017 20:20,29,68.6,45,63.9,74,65.8,2,0,0
10/28/2017 20:25,44,68.6,61,63.9,105,65.9,2,0,0
10/28/2017 20:30,37,68.8,53,64.2,90,66.1,2,0,0
10/28/2017 20:35,38,69.2,54,64.6,92,66.5,2,0,0
10/28/2017 20:40,38,69.1,54,64.4,92,66.4,2,0,0
10/28/2017 20:45,37,69,53,64.4,90,66.3,2,0,0
10/28/2017 20:50,38,69.1,55,64.5,93,66.4,2,0,0
10/28/2017 20:55,30,69.7,46,65.2,76,67,2,0,0
10/28/2017 21:00,32,69.7,47,65.2,79,67,2,0,0
10/28/2017 21:05,36,69.8,52,65.3,88,67.1,2,0,0
10/28/2017 21:10,31,68,47,63.3,78,65.1,2,0,0
10/28/2017 21:15,31,68,48,63.3,79,65.2,2,0,0
10/28/2017 21:20,28,68.6,44,63.9,72,65.7,2,0,0
10/28/2017 21:25,31,69,47,64.4,78,66.2,2,0,0
10/28/2017 21:30,36,69.1,52,64.4,88,66.3,2,0,0
10/28/2017 21:35,32,69.5,48,64.9,80,66.7,2,0,0
10/28/2017 21:40,29,69.3,45,64.7,74,66.5,2,0,0
10/28/2017 21:45,36,69.2,53,64.5,89,66.4,2,0,0
10/28/2017 21:50,42,68.7,58,64,100,66,2,0,0
10/28/2017 21:55,37,69.3,55,64.7,92,66.6,2,0,0
10/28/2017 22:00,35,69.4,51,64.8,86,66.7,2,0,0
10/28/2017 22:05,28,69.2,44,64.6,72,66.4,2,0,0
10/28/2017 22:10,41,69.8,58,65.2,99,67.1,2,0,0
10/28/2017 22:15,29,69.4,46,64.8,75,66.6,2,0,0
10/28/2017 22:20,34,69.2,51,64.5,85,66.4,2,0,0
10/28/2017 22:25,27,69.6,43,65,70,66.8,2,0,0
10/28/2017 22:30,30,68.8,47,64.1,77,65.9,2,0,0
10/28/2017 22:35,32,69.7,47,65.2,79,67,2,0,0
10/28/2017 22:40,27,69.6,43,65,70,66.8,2,0,0
10/28/2017 22:45,27,69.7,43,65.1,70,66.8,2,0,0
10/28/2017 22:50,29,69.7,45,65.1,74,66.9,2,0,0
10/28/2017 22:55,28,69.7,45,65.2,73,66.9,2,0,0
10/28/2017 23:00,18,69.4,33,64.8,51,66.4,2,0,0
10/28/2017 23:05,29,69.2,45,64.6,74,66.4,2,0,0
10/28/2017 23:10,30,69.2,46,64.6,76,66.4,2,0,0
10/28/2017 23:15,31,69.8,48,65.2,79,67,2,0,0
10/28/2017 23:20,30,69.8,46,65.3,76,67.1,2,0,0
10/28/2017 23:25,32,69.3,47,64.7,79,66.6,2,0,0
10/28/2017 23:30,37,69.4,53,64.8,90,66.7,2,0,0
10/28/2017 23:35,32,69.4,48,64.8,80,66.6,2,0,0
10/28/2017 23:40,25,69.3,41,64.7,66,66.4,2,0,0
10/28/2017 23:45,29,69.1,45,64.5,74,66.3,2,0,0
10/28/2017 23:50,24,69.6,40,65,64,66.7,2,0,0
10/28/2017 23:55,20,69.6,35,65,55,66.7,2,0,0
10/29/2017 0:00,25,69.3,41,64.7,66,66.5,2,0,0
10/29/2017 0:05,21,69,37,64.4,58,66.1,2,0,0
10/29/2017 0:10,24,69.4,40,64.7,64,66.5,2,0,0
10/29/2017 0:15,18,69.2,33,64.6,51,66.2,2,0,0
10/29/2017 0:20,19,69.5,34,65,53,66.6,2,0,0
10/29/2017 0:25,15,69.5,30,64.9,45,66.4,2,0,0
10/29/2017 0:30,19,69.5,35,64.9,54,66.5,2,0,0
10/29/2017 0:35,18,69.4,33,64.8,51,66.4,2,0,0
10/29/2017 0:40,19,69.1,34,64.5,53,66.1,2,0,0
10/29/2017 0:45,13,69.2,28,64.5,41,66,2,0,0
10/29/2017 0:50,16,68.8,31,64.1,47,65.7,2,0,0
10/29/2017 0:55,17,69,32,64.4,49,66,2,0,0
10/29/2017 1:00,12,69.1,27,64.5,39,65.9,2,0,0
10/29/2017 1:05,13,69.3,29,64.7,42,66.1,2,0,0
10/29/2017 1:10,14,69.3,30,64.7,44,66.2,2,0,0
10/29/2017 1:15,9,69.3,24,64.7,33,65.9,2,0,0
10/29/2017 1:20,13,69.3,28,64.7,41,66.2,2,0,0
10/29/2017 1:25,14,69.3,29,64.7,43,66.2,2,0,0
10/29/2017 1:30,12,69.3,27,64.7,39,66.1,2,0,0
10/29/2017 1:35,9,69.2,24,64.6,33,65.8,2,0,0
10/29/2017 1:40,10,69.3,25,64.7,35,66,2,0,0
10/29/2017 1:45,10,69.4,25,64.8,35,66.1,2,0,0
10/29/2017 1:50,12,69.4,27,64.8,39,66.2,2,0,0
10/29/2017 1:55,10,69.3,25,64.7,35,66,2,0,0
10/29/2017 2:00,13,69.2,28,64.6,41,66,2,0,0
10/29/2017 2:05,13,69.2,28,64.6,41,66.1,2,0,0
10/29/2017 2:10,10,69.4,25,64.8,35,66.1,2,0,0
10/29/2017 2:15,10,69.3,25,64.7,35,66.1,2,0,0
10/29/2017 2:20,13,69.3,28,64.7,41,66.2,2,0,0
10/29/2017 2:25,11,69.2,26,64.6,37,66,2,0,0
10/29/2017 2:30,14,69.1,29,64.4,43,65.9,2,0,0
10/29/2017 2:35,11,69.3,27,64.7,38,66,2,0,0
10/29/2017 2:40,8,69.3,24,64.7,32,65.8,2,0,0
10/29/2017 2:45,9,69.3,24,64.7,33,66,2,0,0
10/29/2017 2:50,6,69.3,21,64.7,27,65.8,2,0,0
10/29/2017 2:55,8,69.4,23,64.8,31,66,2,0,0
10/29/2017 3:00,9,69.4,24,64.8,33,66,2,0,0
10/29/2017 3:05,8,69.3,24,64.7,32,65.9,2,0,0
10/29/2017 3:10,8,69.3,24,64.7,32,65.9,2,0,0
10/29/2017 3:15,8,69.3,24,64.7,32,65.9,2,0,0
10/29/2017 3:20,7,69.3,22,64.7,29,65.8,2,0,0
10/29/2017 3:25,7,69.3,22,64.7,29,65.8,2,0,0
10/29/2017 3:30,8,69.3,24,64.7,32,65.9,2,0,0
10/29/2017 3:35,10,69.3,26,64.7,36,66,2,0,0
10/29/2017 3:40,7,69.4,22,64.8,29,65.9,2,0,0
10/29/2017 3:45,10,69.1,25,64.5,35,65.8,2,0,0
10/29/2017 3:50,7,69.2,22,64.6,29,65.7,2,0,0
10/29/2017 3:55,7,69.1,22,64.4,29,65.5,2,0,0
10/29/2017 4:00,10,69.1,25,64.5,35,65.8,2,0,0
10/29/2017 4:05,10,69.3,26,64.7,36,65.9,2,0,0
10/29/2017 4:10,9,69.3,24,64.7,33,66,2,0,0
10/29/2017 4:15,10,69.2,25,64.6,35,65.9,2,0,0
10/29/2017 4:20,12,69.2,27,64.6,39,66,2,0,0
10/29/2017 4:25,8,69.3,23,64.7,31,65.9,2,0,0
10/29/2017 4:30,11,69.2,26,64.5,37,65.9,2,0,0
10/29/2017 4:35,14,69.3,30,64.7,44,66.2,2,0,0
10/29/2017 4:40,14,69.4,30,64.8,44,66.3,2,0,0
10/29/2017 4:45,15,68.8,30,64.2,45,65.7,2,0,0
10/29/2017 4:50,12,69,28,64.4,40,65.8,2,0,0
10/29/2017 4:55,15,68.8,30,64.2,45,65.7,2,0,0
10/29/2017 5:00,11,68.9,27,64.3,38,65.7,2,0,0
10/29/2017 5:05,10,69,25,64.4,35,65.7,2,0,0
10/29/2017 5:10,10,69.2,26,64.5,36,65.8,2,0,0
10/29/2017 5:15,9,69.3,24,64.7,33,66,2,0,0
10/29/2017 5:20,13,69.2,29,64.6,42,66.1,2,0,0
10/29/2017 5:25,16,69.2,32,64.6,48,66.2,2,0,0
10/29/2017 5:30,14,68.8,30,64.2,44,65.7,2,0,0
10/29/2017 5:35,12,68.9,28,64.2,40,65.6,2,0,0
10/29/2017 5:40,14,69.1,30,64.5,44,65.9,2,0,0
10/29/2017 5:45,13,69.3,29,64.7,42,66.1,2,0,0
10/29/2017 5:50,16,69.3,31,64.7,47,66.3,2,0,0
10/29/2017 5:55,16,69.4,31,64.8,47,66.4,2,0,0
10/29/2017 6:00,11,69.3,27,64.7,38,66.1,2,0,0
10/29/2017 6:05,15,69.2,31,64.5,46,66.1,2,0,0
10/29/2017 6:10,14,69.3,30,64.7,44,66.1,2,0,0
10/29/2017 6:15,13,69,28,64.4,41,65.8,2,0,0
10/29/2017 6:20,13,69.2,28,64.5,41,66,2,0,0
10/29/2017 6:25,15,69.3,30,64.7,45,66.2,2,0,0
10/29/2017 6:30,20,69.2,36,64.6,56,66.2,2,0,0
10/29/2017 6:35,19,69.3,35,64.7,54,66.3,2,0,0
10/29/2017 6:40,17,69.5,33,64.9,50,66.4,2,0,0
10/29/2017 6:45,22,69.6,38,65,60,66.6,2,0,0
10/29/2017 6:50,21,69.6,37,65,58,66.6,2,0,0
10/29/2017 6:55,21,69.1,37,64.5,58,66.1,2,0,0
10/29/2017 7:00,16,69.1,31,64.4,47,66,2,0,0
10/29/2017 7:05,19,69.1,34,64.5,53,66.1,2,0,0
10/29/2017 7:10,16,69.1,31,64.5,47,66.1,2,0,0
10/29/2017 7:15,22,68.8,38,64.2,60,65.9,2,0,0
10/29/2017 7:20,23,68.5,40,63.8,63,65.5,2,0,0
10/29/2017 7:25,18,66.4,34,61.6,52,63.3,2,0,0
10/29/2017 7:30,25,65.2,41,60.3,66,62.2,2,0,0
10/29/2017 7:35,25,67.1,41,62.3,66,64.2,2,0,0
10/29/2017 7:40,33,68.4,49,63.7,82,65.6,2,0,0
10/29/2017 7:45,29,69.1,45,64.5,74,66.3,2,0,0
10/29/2017 7:50,29,68.9,45,64.3,74,66.1,2,0,0
10/29/2017 7:55,29,69.1,45,64.5,74,66.3,2,0,0
10/29/2017 8:00,23,68.6,39,63.9,62,65.7,2,0,0
10/29/2017 8:05,26,68.9,43,64.2,69,66,2,0,0
10/29/2017 8:10,26,68.7,42,64.1,68,65.9,2,0,0
10/29/2017 8:15,27,68.9,43,64.3,70,66.1,2,0,0
10/29/2017 8:20,30,68.7,47,64,77,65.8,2,0,0
10/29/2017 8:25,33,68.9,49,64.3,82,66.2,2,0,0
10/29/2017 8:30,27,69.1,43,64.5,70,66.3,2,0,0
10/29/2017 8:35,29,69.1,45,64.5,74,66.3,2,0,0
10/29/2017 8:40,38,69.4,55,64.8,93,66.7,2,0,0
10/29/2017 8:45,38,68.9,55,64.2,93,66.1,2,0,0
10/29/2017 8:50,37,68.7,54,64,91,65.9,2,0,0
10/29/2017 8:55,32,68.8,49,64.1,81,66,2,0,0
10/29/2017 9:00,32,69.4,49,64.8,81,66.6,2,0,0
10/29/2017 9:05,33,69.4,49,64.8,82,66.7,2,0,0
10/29/2017 9:10,33,69.3,50,64.7,83,66.5,2,0,0
10/29/2017 9:15,35,69.2,52,64.6,87,66.4,2,0,0
10/29/2017 9:20,43,68.1,60,63.4,103,65.4,2,0,0
10/29/2017 9:25,36,69,54,64.3,90,66.2,2,0,0
10/29/2017 9:30,37,69.3,54,64.7,91,66.6,2,0,0
10/29/2017 9:35,39,69.1,56,64.5,95,66.4,2,0,0
10/29/2017 9:40,40,68.8,57,64.1,97,66,2,0,0
10/29/2017 9:45,38,69.3,55,64.7,93,66.6,2,0,0
10/29/2017 9:50,51,69.2,69,64.6,120,66.6,2,0,0
10/29/2017 9:55,46,69.5,63,64.9,109,66.8,2,0,0
10/29/2017 10:00,58,69.5,76,64.9,134,66.9,2,0,0
10/29/2017 10:05,48,69.3,65,64.7,113,66.7,2,0,0
10/29/2017 10:10,50,69.3,67,64.6,117,66.6,2,0,0
10/29/2017 10:15,50,67.7,68,63,118,65,2,0,0
10/29/2017 10:20,59,68.5,76,63.9,135,65.9,2,0,0
10/29/2017 10:25,52,68,70,63.3,122,65.3,2,0,0
10/29/2017 10:30,53,68.4,72,63.7,125,65.7,2,0,0
10/29/2017 10:35,38,68.5,55,63.8,93,65.7,2,0,0
10/29/2017 10:40,52,69.1,70,64.4,122,66.4,2,0,0
10/29/2017 10:45,52,68.7,70,64,122,66,2,0,0
10/29/2017 10:50,59,68.1,77,63.4,136,65.4,2,0,0
10/29/2017 10:55,53,68.4,71,63.8,124,65.8,2,0,0
10/29/2017 11:00,49,69,67,64.5,116,66.4,2,0,0
10/29/2017 11:05,54,69.5,72,65,126,66.9,2,0,0
10/29/2017 11:10,51,69.7,68,65.1,119,67.1,2,0,0
10/29/2017 11:15,56,69.5,75,65,131,66.9,2,0,0
10/29/2017 11:20,68,68.6,87,64,155,66,2,0,0
10/29/2017 11:25,53,69.2,71,64.6,124,66.6,2,0,0
10/29/2017 11:30,60,68.9,78,64.3,138,66.3,2,0,0
10/29/2017 11:35,55,69.8,73,65.2,128,67.2,2,0,0
10/29/2017 11:40,59,69.7,76,65.1,135,67.1,2,0,0
10/29/2017 11:45,61,69.5,79,64.9,140,66.9,2,0,0
10/29/2017 11:50,62,69.4,80,64.8,142,66.8,2,0,0
10/29/2017 11:55,53,69,69,64.3,122,66.4,2,0,0
10/29/2017 12:00,52,68.7,70,64,122,66,2,0,0
10/29/2017 12:05,58,68.8,76,64.1,134,66.1,2,0,0
10/29/2017 12:10,59,68.6,78,63.9,137,65.9,2,0,0
10/29/2017 12:15,60,67.9,79,63.1,139,65.2,2,0,0
10/29/2017 12:20,53,68.6,70,64,123,66,2,0,0
10/29/2017 12:25,59,68.9,77,64.2,136,66.2,2,0,0
10/29/2017 12:30,57,69.1,75,64.5,132,66.5,2,0,0
10/29/2017 12:35,58,68.8,76,64.1,134,66.1,2,0,0
10/29/2017 12:40,64,68.7,83,64,147,66,2,0,0
10/29/2017 12:45,52,68.9,70,64.3,122,66.3,2,0,0
10/29/2017 12:50,55,68.8,73,64.2,128,66.2,2,0,0
10/29/2017 12:55,53,68.5,71,63.8,124,65.8,2,0,0
10/29/2017 13:00,67,68.3,87,63.5,154,65.6,2,0,0
10/29/2017 13:05,55,68.3,73,63.6,128,65.6,2,0,0
10/29/2017 13:10,50,69.2,67,64.5,117,66.5,2,0,0
10/29/2017 13:15,68,68.9,86,64.1,154,66.2,2,0,0
10/29/2017 13:20,61,68.6,80,63.9,141,65.9,2,0,0
10/29/2017 13:25,60,69.1,78,64.5,138,66.5,2,0,0
10/29/2017 13:30,61,69.5,79,65,140,67,2,0,0
10/29/2017 13:35,65,68.8,84,64.1,149,66.2,2,0,0
10/29/2017 13:40,71,69.5,91,64.9,162,66.9,2,0,0
10/29/2017 13:45,72,69.4,91,64.8,163,66.8,2,0,0
10/29/2017 13:50,73,69.5,92,64.8,165,66.9,2,0,0
10/29/2017 13:55,62,69.3,81,64.7,143,66.7,2,0,0
10/29/2017 14:00,54,69.8,71,65.3,125,67.2,2,0,0
10/29/2017 14:05,62,68.9,81,64.2,143,66.3,2,0,0
10/29/2017 14:10,58,69.2,76,64.5,134,66.5,2,0,0
10/29/2017 14:15,60,68.9,78,64.3,138,66.3,2,0,0
10/29/2017 14:20,56,69.1,74,64.4,130,66.4,2,0,0
10/29/2017 14:25,57,68,76,63.2,133,65.3,2,0,0
10/29/2017 14:30,61,68.1,79,63.4,140,65.4,2,0,0
10/29/2017 14:35,57,68.1,75,63.4,132,65.4,2,0,0
10/29/2017 14:40,58,68.4,77,63.6,135,65.7,2,0,0
10/29/2017 14:45,57,68.9,75,64.2,132,66.2,2,0,0
10/29/2017 14:50,70,68.8,88,64.1,158,66.2,2,0,0
10/29/2017 14:55,62,69.1,80,64.4,142,66.4,2,0,0
10/29/2017 15:00,63,69.2,82,64.5,145,66.5,2,0,0
10/29/2017 15:05,68,69.2,87,64.5,155,66.5,2,0,0
10/29/2017 15:10,62,68.6,80,63.9,142,66,2,0,0
10/29/2017 15:15,65,68.9,83,64.2,148,66.3,2,0,0
10/29/2017 15:20,62,68.4,79,63.6,141,65.7,2,0,0
10/29/2017 15:25,55,68.2,73,63.4,128,65.5,2,0,0
10/29/2017 15:30,61,68.5,80,63.8,141,65.8,2,0,0
10/29/2017 15:35,62,69.3,81,64.6,143,66.6,2,0,0
10/29/2017 15:40,69,69,88,64.3,157,66.4,2,0,0
10/29/2017 15:45,58,68.4,77,63.6,135,65.7,2,0,0
10/29/2017 15:50,68,68.9,86,64.3,154,66.3,2,0,0
10/29/2017 15:55,70,68.3,89,63.6,159,65.7,2,0,0
10/29/2017 16:00,56,68.6,74,63.9,130,66,2,0,0
10/29/2017 16:05,68,68.2,87,63.5,155,65.6,2,0,0
10/29/2017 16:10,61,68.8,80,64.1,141,66.2,2,0,0
10/29/2017 16:15,64,69,83,64.3,147,66.4,2,0,0
10/29/2017 16:20,64,68.4,83,63.8,147,65.8,2,0,0
10/29/2017 16:25,71,68.1,91,63.3,162,65.4,2,0,0
10/29/2017 16:30,67,67.5,87,62.7,154,64.8,2,0,0
10/29/2017 16:35,56,67.6,74,62.7,130,64.8,2,0,0
10/29/2017 16:40,64,67.6,83,62.7,147,64.8,2,0,0
10/29/2017 16:45,69,67.9,88,63,157,65.2,2,0,0
10/29/2017 16:50,62,67.8,80,62.9,142,65.1,2,0,0
10/29/2017 16:55,58,68.1,76,63.2,134,65.3,2,0,0
10/29/2017 17:00,53,68.6,70,63.9,123,65.9,2,0,0
10/29/2017 17:05,58,68.9,76,64.2,134,66.2,2,0,0
10/29/2017 17:10,44,69.2,61,64.5,105,66.5,2,0,0
10/29/2017 17:15,57,68.8,76,64.1,133,66.1,2,0,0
10/29/2017 17:20,49,68.4,67,63.6,116,65.6,2,0,0
10/29/2017 17:25,55,68.1,73,63.3,128,65.4,2,0,0
10/29/2017 17:30,46,68.9,63,64.3,109,66.2,2,0,0
10/29/2017 17:35,40,69,58,64.3,98,66.2,2,0,0
10/29/2017 17:40,45,68.6,62,63.9,107,65.9,2,0,0
10/29/2017 17:45,50,69.3,67,64.7,117,66.7,2,0,0
10/29/2017 17:50,53,69,71,64.3,124,66.3,2,0,0
10/29/2017 17:55,44,68.1,61,63.4,105,65.4,2,0,0
10/29/2017 18:00,58,68.8,76,64.1,134,66.2,2,0,0
10/29/2017 18:05,62,69.8,81,65.2,143,67.2,2,0,0
10/29/2017 18:10,58,68.7,76,64,134,66,2,0,0
10/29/2017 18:15,53,69,71,64.3,124,66.3,2,0,0
10/29/2017 18:20,67,68.3,85,63.5,152,65.6,2,0,0
10/29/2017 18:25,59,67.7,78,62.8,137,64.9,2,0,0
10/29/2017 18:30,65,67.9,83,63.1,148,65.2,2,0,0
10/29/2017 18:35,54,67.6,73,62.7,127,64.8,2,0,0
10/29/2017 18:40,47,68.3,64,63.4,111,65.5,2,0,0
10/29/2017 18:45,54,67.7,72,62.8,126,64.9,2,0,0
10/29/2017 18:50,52,67.4,70,62.4,122,64.5,2,0,0
10/29/2017 18:55,47,67.6,65,62.8,112,64.8,2,0,0
10/29/2017 19:00,42,68.7,58,64,100,66,2,0,0
10/29/2017 19:05,48,68.8,65,64.1,113,66.1,2,0,0
10/29/2017 19:10,41,69.3,59,64.8,100,66.6,2,0,0
10/29/2017 19:15,47,69.8,64,65.3,111,67.2,2,0,0
10/29/2017 19:20,54,69.4,71,64.8,125,66.8,2,0,0
10/29/2017 19:25,41,69.3,57,64.7,98,66.6,2,0,0
10/29/2017 19:30,42,69.5,59,64.9,101,66.8,2,0,0
10/29/2017 19:35,38,69.2,55,64.5,93,66.4,2,0,0
10/29/2017 19:40,35,69.1,52,64.4,87,66.3,2,0,0
10/29/2017 19:45,39,68.4,56,63.7,95,65.7,2,0,0
10/29/2017 19:50,33,69.2,49,64.5,82,66.4,2,0,0
10/29/2017 19:55,38,68.8,55,64.2,93,66.1,2,0,0
10/29/2017 20:00,41,68.5,57,63.8,98,65.8,2,0,0
10/29/2017 20:05,34,68.6,51,63.9,85,65.8,2,0,0
10/29/2017 20:10,47,68.9,64,64.2,111,66.2,2,0,0
10/29/2017 20:15,41,68.5,58,63.8,99,65.7,2,0,0
10/29/2017 20:20,43,69,60,64.3,103,66.3,2,0,0
10/29/2017 20:25,36,67.6,53,62.9,89,64.8,2,0,0
10/29/2017 20:30,41,68.7,58,64,99,65.9,2,0,0
10/29/2017 20:35,41,68.9,57,64.2,98,66.1,2,0,0
10/29/2017 20:40,35,68.5,51,63.8,86,65.7,2,0,0
10/29/2017 20:45,33,69.2,50,64.6,83,66.4,2,0,0
10/29/2017 20:50,30,69.3,46,64.7,76,66.5,2,0,0
10/29/2017 20:55,28,69.5,45,64.9,73,66.7,2,0,0
10/29/2017 21:00,30,69.7,46,65.1,76,66.9,2,0,0
10/29/2017 21:05,32,69,47,64.4,79,66.2,2,0,0
10/29/2017 21:10,26,68.7,42,64,68,65.8,2,0,0
10/29/2017 21:15,31,69.2,47,64.5,78,66.4,2,0,0
10/29/2017 21:20,26,68.8,42,64.1,68,65.9,2,0,0
10/29/2017 21:25,34,69.2,50,64.5,84,66.4,2,0,0
10/29/2017 21:30,31,68.5,48,63.8,79,65.6,2,0,0
10/29/2017 21:35,29,67.9,45,63.2,74,65,2,0,0
10/29/2017 21:40,20,68.5,36,63.8,56,65.5,2,0,0
10/29/2017 21:45,30,68.7,46,64,76,65.8,2,0,0
10/29/2017 21:50,27,69.1,43,64.4,70,66.2,2,0,0
10/29/2017 21:55,21,69.3,36,64.6,57,66.3,2,0,0
10/29/2017 22:00,17,69.3,33,64.7,50,66.2,2,0,0
10/29/2017 22:05,19,69.4,35,64.8,54,66.4,2,0,0
10/29/2017 22:10,21,69.3,37,64.7,58,66.4,2,0,0
10/29/2017 22:15,19,69.3,34,64.7,53,66.3,2,0,0
10/29/2017 22:20,19,69.2,35,64.5,54,66.2,2,0,0
10/29/2017 22:25,19,69.2,35,64.6,54,66.2,2,0,0
10/29/2017 22:30,19,69.3,35,64.7,54,66.3,2,0,0
10/29/2017 22:35,19,69.4,35,64.7,54,66.4,2,0,0
10/29/2017 22:40,24,69.4,39,64.7,63,66.5,2,0,0
10/29/2017 22:45,19,69.5,35,64.9,54,66.6,2,0,0
10/29/2017 22:50,21,69.6,36,65,57,66.7,2,0,0
10/29/2017 22:55,17,69.3,32,64.7,49,66.3,2,0,0
10/29/2017 23:00,21,69.5,37,64.9,58,66.6,2,0,0
10/29/2017 23:05,16,69.3,31,64.7,47,66.3,2,0,0
10/29/2017 23:10,16,69.1,32,64.4,48,66,2,0,0
10/29/2017 23:15,17,69.2,32,64.6,49,66.2,2,0,0
10/29/2017 23:20,18,69.2,33,64.5,51,66.2,2,0,0
10/29/2017 23:25,17,69.2,33,64.5,50,66.1,2,0,0
10/29/2017 23:30,19,69.4,35,64.8,54,66.4,2,0,0
10/29/2017 23:35,21,69.3,37,64.7,58,66.3,2,0,0
10/29/2017 23:40,17,69.2,33,64.5,50,66.1,2,0,0
10/29/2017 23:45,10,69.2,25,64.6,35,65.9,2,0,0
10/29/2017 23:50,13,69.3,28,64.7,41,66.1,2,0,0
10/29/2017 23:55,12,69.3,28,64.7,40,66,2,0,0
