5 Minutes,Lane 1 Flow (Veh/5 Minutes),Lane 1 Speed (mph),Lane 2 Flow (Veh/5 Minutes),Lane 2 Speed (mph),Flow (Veh/5 Minutes),Speed (mph),# Lane Points,% Observed,Holiday
10/30/2017 0:00,13,69.3,28,64.7,41,66.2,2,0,0
10/30/2017 0:05,16,69.3,31,64.7,47,66.3,2,0,0
10/30/2017 0:10,11,69.4,27,64.7,38,66.1,2,0,0
10/30/2017 0:15,12,69.2,28,64.6,40,66,2,0,0
10/30/2017 0:20,11,69.3,26,64.7,37,66,2,0,0
10/30/2017 0:25,10,68.6,25,64,35,65.3,2,0,0
10/30/2017 0:30,11,69.1,26,64.5,37,65.8,2,0,0
10/30/2017 0:35,6,69.2,21,64.5,27,65.6,2,0,0
10/30/2017 0:40,13,68.5,28,63.8,41,65.3,2,0,0
10/30/2017 0:45,15,68.8,22,64.2,37,66.1,2,0,0
10/30/2017 0:50,8,69,23,64.4,31,65.6,2,0,0
10/30/2017 0:55,9,69.2,24,64.5,33,65.8,2,0,0
10/30/2017 1:00,6,69,21,64.4,27,65.4,2,0,0
10/30/2017 1:05,7,69.2,22,64.6,29,65.7,2,0,0
10/30/2017 1:10,8,69.3,23,64.7,31,65.8,2,0,0
10/30/2017 1:15,7,69.3,23,64.7,30,65.8,2,0,0
10/30/2017 1:20,9,69.3,25,64.7,34,65.9,2,0,0
10/30/2017 1:25,8,69.2,24,64.5,32,65.7,2,0,0
10/30/2017 1:30,7,69.4,22,64.7,29,65.9,2,0,0
10/30/2017 1:35,5,69.2,21,64.6,26,65.5,2,0,0
10/30/2017 1:40,14,69.3,22,64.7,36,66.5,2,0,0
10/30/2017 1:45,6,69.4,21,64.7,27,65.8,2,0,0
10/30/2017 1:50,10,69.3,20,64.7,30,66.2,2,0,0
10/30/2017 1:55,6,69.3,21,64.7,27,65.8,2,0,0
10/30/2017 2:00,7,69.3,22,64.7,29,65.8,2,0,0
10/30/2017 2:05,7,69.3,22,64.7,29,65.8,2,0,0
10/30/2017 2:10,5,69.3,20,64.7,25,65.7,2,0,0
10/30/2017 2:15,4,69.3,19,64.7,23,65.5,2,0,0
10/30/2017 2:20,6,69.2,21,64.6,27,65.6,2,0,0
10/30/2017 2:25,9,69,24,64.3,33,65.6,2,0,0
10/30/2017 2:30,6,69.1,21,64.5,27,65.5,2,0,0
10/30/2017 2:35,7,69.1,22,64.5,29,65.6,2,0,0
10/30/2017 2:40,6,69.4,21,64.8,27,65.8,2,0,0
10/30/2017 2:45,9,69.3,24,64.7,33,66,2,0,0
10/30/2017 2:50,12,69.1,28,64.5,40,65.8,2,0,0
10/30/2017 2:55,11,69.3,26,64.7,37,66.1,2,0,0
10/30/2017 3:00,7,69,23,64.4,30,65.5,2,0,0
10/30/2017 3:05,9,69.1,25,64.5,34,65.7,2,0,0
10/30/2017 3:10,7,69.2,23,64.6,30,65.7,2,0,0
10/30/2017 3:15,8,69.4,24,64.8,32,65.9,2,0,0
10/30/2017 3:20,8,69.4,23,64.8,31,66,2,0,0
10/30/2017 3:25,8,69.3,24,64.7,32,65.9,2,0,0
10/30/2017 3:30,13,69.2,28,64.6,41,66,2,0,0
10/30/2017 3:35,13,69.3,28,64.7,41,66.1,2,0,0
10/30/2017 3:40,12,69.2,27,64.6,39,66,2,0,0
10/30/2017 3:45,10,69.1,25,64.5,35,65.8,2,0,0
10/30/2017 3:50,12,69.3,27,64.7,39,66.1,2,0,0
10/30/2017 3:55,14,69.4,30,64.8,44,66.3,2,0,0
10/30/2017 4:00,15,68.6,30,64,45,65.6,2,0,0
10/30/2017 4:05,14,68.9,29,64.3,43,65.8,2,0,0
10/30/2017 4:10,23,69.2,39,64.6,62,66.3,2,0,0
10/30/2017 4:15,18,69.4,34,64.7,52,66.3,2,0,0
10/30/2017 4:20,25,69.2,42,64.6,67,66.3,2,0,0
10/30/2017 4:25,21,69.3,37,64.7,58,66.4,2,0,0
10/30/2017 4:30,24,69.3,41,64.6,65,66.3,2,0,0
10/30/2017 4:35,29,69.4,47,64.8,76,66.6,2,0,0
10/30/2017 4:40,36,69.5,54,64.9,90,66.7,2,0,0
10/30/2017 4:45,33,69.8,51,65.2,84,67,2,0,0
10/30/2017 4:50,40,69.7,59,65.1,99,67,2,0,0
10/30/2017 4:55,44,69.3,63,64.7,107,66.6,2,0,0
10/30/2017 5:00,40,69.2,58,64.7,98,66.5,2,0,0
10/30/2017 5:05,48,69.5,67,64.9,115,66.8,2,0,0
10/30/2017 5:10,51,68.2,71,63.5,122,65.4,2,0,0
10/30/2017 5:15,44,68.7,63,64,107,66,2,0,0
10/30/2017 5:20,56,68.4,76,63.8,132,65.7,2,0,0
10/30/2017 5:25,48,69.3,68,64.7,116,66.6,2,0,0
10/30/2017 5:30,58,68.8,78,64.2,136,66.1,2,0,0
10/30/2017 5:35,58,69.1,78,64.4,136,66.4,2,0,0
10/30/2017 5:40,75,69.5,98,64.9,173,66.9,2,0,0
10/30/2017 5:45,66,68.1,88,63.4,154,65.4,2,0,0
10/30/2017 5:50,70,68.8,92,64.1,162,66.1,2,0,0
10/30/2017 5:55,63,68.6,85,63.8,148,65.8,2,0,0
10/30/2017 6:00,61,68.5,81,63.8,142,65.8,2,0,0
10/30/2017 6:05,65,66.3,86,61.3,151,63.5,2,0,0
10/30/2017 6:10,68,66,89,61,157,63.1,2,0,0
10/30/2017 6:15,60,67,81,62.1,141,64.2,2,0,0
10/30/2017 6:20,77,67.2,99,62.3,176,64.5,2,0,0
10/30/2017 6:25,68,67.1,89,62.1,157,64.3,2,0,0
10/30/2017 6:30,67,68.1,89,63.2,156,65.3,2,0,0
10/30/2017 6:35,67,67.9,89,63.1,156,65.2,2,0,0
10/30/2017 6:40,66,67.8,87,62.9,153,65,2,0,0
10/30/2017 6:45,75,67.2,97,62.2,172,64.4,2,0,0
10/30/2017 6:50,84,66.9,107,61.9,191,64.1,2,0,0
10/30/2017 6:55,65,67.6,85,62.7,150,64.8,2,0,0
10/30/2017 7:00,70,66.4,92,61.4,162,63.5,2,0,0
10/30/2017 7:05,72,66.3,94,61.3,166,63.5,2,0,0
10/30/2017 7:10,77,66,99,61,176,63.2,2,0,0
10/30/2017 7:15,81,66.1,103,61,184,63.2,2,0,0
10/30/2017 7:20,92,65.6,115,60.5,207,62.7,2,0,0
10/30/2017 7:25,78,65.6,101,60.5,179,62.8,2,0,0
10/30/2017 7:30,79,65.5,102,60.5,181,62.7,2,0,0
10/30/2017 7:35,77,66.3,99,61.3,176,63.4,2,0,0
10/30/2017 7:40,81,66.9,104,62,185,64.1,2,0,0
10/30/2017 7:45,94,66.3,118,61.3,212,63.5,2,0,0
10/30/2017 7:50,86,67.1,109,62.2,195,64.3,2,0,0
10/30/2017 7:55,87,67.5,111,62.7,198,64.8,2,0,0
10/30/2017 8:00,83,67.8,105,63,188,65.1,2,0,0
10/30/2017 8:05,81,67,103,62.1,184,64.3,2,0,0
10/30/2017 8:10,84,67.1,107,62.2,191,64.4,2,0,0
10/30/2017 8:15,85,65.7,108,60.8,193,63,2,0,0
10/30/2017 8:20,79,66.4,101,61.4,180,63.6,2,0,0
10/30/2017 8:25,81,66.3,104,61.3,185,63.5,2,0,0
10/30/2017 8:30,77,66,98,61,175,63.2,2,0,0
10/30/2017 8:35,81,66.5,104,61.5,185,63.7,2,0,0
10/30/2017 8:40,84,64.4,107,59.3,191,61.5,2,0,0
10/30/2017 8:45,82,64.5,104,59.5,186,61.7,2,0,0
10/30/2017 8:50,77,63.9,99,58.6,176,60.9,2,0,0
10/30/2017 8:55,73,63.7,94,58.5,167,60.8,2,0,0
10/30/2017 9:00,74,64.7,95,59.6,169,61.8,2,0,0
10/30/2017 9:05,77,65.2,100,60.1,177,62.3,2,0,0
10/30/2017 9:10,67,65.2,88,60.1,155,62.3,2,0,0
10/30/2017 9:15,75,66.1,96,61,171,63.2,2,0,0
10/30/2017 9:20,64,64.8,84,59.7,148,61.9,2,0,0
10/30/2017 9:25,65,63.8,85,58.6,150,60.8,2,0,0
10/30/2017 9:30,72,63.6,92,58.4,164,60.7,2,0,0
10/30/2017 9:35,64,63.5,85,58.4,149,60.6,2,0,0
10/30/2017 9:40,68,64.2,88,59,156,61.3,2,0,0
10/30/2017 9:45,74,64,95,58.8,169,61.1,2,0,0
10/30/2017 9:50,65,65.1,85,60,150,62.2,2,0,0
10/30/2017 9:55,62,64.7,82,59.6,144,61.8,2,0,0
10/30/2017 10:00,59,63.7,78,58.5,137,60.8,2,0,0
10/30/2017 10:05,66,63,86,57.8,152,60.1,2,0,0
10/30/2017 10:10,57,64,75,58.9,132,61.1,2,0,0
10/30/2017 10:15,58,65.2,77,60.3,135,62.4,2,0,0
10/30/2017 10:20,62,65.3,82,60.4,144,62.5,2,0,0
10/30/2017 10:25,55,66,73,61.1,128,63.2,2,0,0
10/30/2017 10:30,62,65.5,82,60.6,144,62.7,2,0,0
10/30/2017 10:35,58,65.3,77,60.3,135,62.4,2,0,0
10/30/2017 10:40,54,65.9,73,60.9,127,63,2,0,0
10/30/2017 10:45,59,65.3,78,60.3,137,62.5,2,0,0
10/30/2017 10:50,46,65.5,63,60.6,109,62.7,2,0,0
10/30/2017 10:55,50,65.8,69,60.9,119,62.9,2,0,0
10/30/2017 11:00,53,65.3,71,60.4,124,62.5,2,0,0
10/30/2017 11:05,53,68.3,70,63.6,123,65.6,2,0,0
10/30/2017 11:10,58,68.8,77,64.1,135,66.1,2,0,0
10/30/2017 11:15,53,68.3,71,63.6,124,65.6,2,0,0
10/30/2017 11:20,54,67.8,72,63,126,65,2,0,0
10/30/2017 11:25,59,67.8,78,63,137,65.1,2,0,0
10/30/2017 11:30,53,68.5,71,63.8,124,65.8,2,0,0
10/30/2017 11:35,49,69,66,64.3,115,66.3,2,0,0
10/30/2017 11:40,62,68.9,81,64.1,143,66.1,2,0,0
10/30/2017 11:45,52,69.3,70,64.6,122,66.6,2,0,0
10/30/2017 11:50,60,67,79,62.1,139,64.2,2,0,0
10/30/2017 11:55,37,66.4,54,61.5,91,63.5,2,0,0
10/30/2017 12:00,57,67.1,74,62.2,131,64.3,2,0,0
10/30/2017 12:05,45,65.7,63,60.8,108,62.9,2,0,0
10/30/2017 12:10,56,65.1,74,60.2,130,62.3,2,0,0
10/30/2017 12:15,57,66.1,75,61.2,132,63.3,2,0,0
10/30/2017 12:20,54,66.3,72,61.4,126,63.5,2,0,0
10/30/2017 12:25,54,67.1,72,62.3,126,64.3,2,0,0
10/30/2017 12:30,56,68.2,74,63.4,130,65.5,2,0,0
10/30/2017 12:35,51,67.8,68,63.1,119,65.1,2,0,0
10/30/2017 12:40,44,67.8,61,63.1,105,65,2,0,0
10/30/2017 12:45,53,66,71,61.2,124,63.3,2,0,0
10/30/2017 12:50,40,65.4,58,60.5,98,62.5,2,0,0
10/30/2017 12:55,50,65.2,68,60.2,118,62.4,2,0,0
10/30/2017 13:00,49,66.7,67,61.9,116,63.9,2,0,0
10/30/2017 13:05,39,67.4,55,62.6,94,64.6,2,0,0
10/30/2017 13:10,48,67.9,66,63.2,114,65.2,2,0,0
10/30/2017 13:15,44,66.9,61,62,105,64.1,2,0,0
10/30/2017 13:20,51,68.7,69,64,120,66,2,0,0
10/30/2017 13:25,49,68,67,63.3,116,65.3,2,0,0
10/30/2017 13:30,47,68,66,63.3,113,65.3,2,0,0
10/30/2017 13:35,47,68.2,64,63.4,111,65.4,2,0,0
10/30/2017 13:40,40,68.5,58,63.7,98,65.7,2,0,0
10/30/2017 13:45,45,69.4,62,64.6,107,66.6,2,0,0
10/30/2017 13:50,47,70,66,65.3,113,67.3,2,0,0
10/30/2017 13:55,47,68.8,65,64,112,66,2,0,0
10/30/2017 14:00,47,69.8,64,65.2,111,67.1,2,0,0
10/30/2017 14:05,48,69.1,67,64.4,115,66.4,2,0,0
10/30/2017 14:10,43,68.9,60,64.2,103,66.1,2,0,0
10/30/2017 14:15,52,68.6,70,63.8,122,65.8,2,0,0
10/30/2017 14:20,44,68.4,61,63.7,105,65.7,2,0,0
10/30/2017 14:25,46,67.9,63,63.1,109,65.1,2,0,0
10/30/2017 14:30,46,67.5,64,62.6,110,64.7,2,0,0
10/30/2017 14:35,59,66.3,76,61.3,135,63.5,2,0,0
10/30/2017 14:40,52,66.7,69,61.6,121,63.8,2,0,0
10/30/2017 14:45,53,66.9,71,62,124,64.1,2,0,0
10/30/2017 14:50,54,66.9,73,62.1,127,64.2,2,0,0
10/30/2017 14:55,46,67.3,64,62.5,110,64.5,2,0,0
10/30/2017 15:00,43,68.3,60,63.6,103,65.6,2,0,0
10/30/2017 15:05,45,69.1,63,64.5,108,66.4,2,0,0
10/30/2017 15:10,47,69.7,65,65.1,112,67,2,0,0
10/30/2017 15:15,65,69.9,84,65.3,149,67.3,2,0,0
10/30/2017 15:20,53,69.7,71,65,124,67,2,0,0
10/30/2017 15:25,45,69.7,62,65.1,107,67,2,0,0
10/30/2017 15:30,66,68.5,85,63.7,151,65.8,2,0,0
10/30/2017 15:35,58,66.2,77,61.3,135,63.4,2,0,0
10/30/2017 15:40,69,67.9,88,63.1,157,65.2,2,0,0
10/30/2017 15:45,59,68.8,78,64,137,66.1,2,0,0
10/30/2017 15:50,56,69.7,74,65,130,67,2,0,0
10/30/2017 15:55,54,69.4,72,64.7,126,66.7,2,0,0
10/30/2017 16:00,53,69.8,71,65.1,124,67.1,2,0,0
10/30/2017 16:05,47,68.5,64,63.8,111,65.8,2,0,0
10/30/2017 16:10,57,68.5,76,63.8,133,65.8,2,0,0
10/30/2017 16:15,59,67.4,78,62.7,137,64.7,2,0,0
10/30/2017 16:20,62,66.8,80,62,142,64.1,2,0,0
10/30/2017 16:25,51,66.4,69,61.5,120,63.6,2,0,0
10/30/2017 16:30,48,67.5,65,62.6,113,64.7,2,0,0
10/30/2017 16:35,52,67.8,69,63,121,65.1,2,0,0
10/30/2017 16:40,53,68.6,71,63.8,124,65.9,2,0,0
10/30/2017 16:45,49,68.3,67,63.5,116,65.5,2,0,0
10/30/2017 16:50,56,67.3,74,62.4,130,64.5,2,0,0
10/30/2017 16:55,52,67.5,70,62.6,122,64.7,2,0,0
10/30/2017 17:00,40,67.5,58,62.7,98,64.6,2,0,0
10/30/2017 17:05,59,67.8,78,63,137,65.1,2,0,0
10/30/2017 17:10,46,66.5,64,61.7,110,63.7,2,0,0
10/30/2017 17:15,51,67.7,69,62.9,120,64.9,2,0,0
10/30/2017 17:20,58,67,76,62.2,134,64.3,2,0,0
10/30/2017 17:25,52,66.6,70,61.7,122,63.8,2,0,0
10/30/2017 17:30,49,67,66,62.2,115,64.3,2,0,0
10/30/2017 17:35,50,67.9,68,63.1,118,65.1,2,0,0
10/30/2017 17:40,52,68.4,70,63.6,122,65.7,2,0,0
10/30/2017 17:45,49,69.4,67,64.7,116,66.7,2,0,0
10/30/2017 17:50,49,67.7,67,62.8,116,64.9,2,0,0
10/30/2017 17:55,53,68.7,70,63.9,123,66,2,0,0
10/30/2017 18:00,50,66.8,67,61.9,117,64,2,0,0
10/30/2017 18:05,42,67.6,59,62.8,101,64.8,2,0,0
10/30/2017 18:10,47,67.9,65,63.1,112,65.1,2,0,0
10/30/2017 18:15,49,68.4,67,63.7,116,65.7,2,0,0
10/30/2017 18:20,55,67.8,73,62.9,128,65,2,0,0
10/30/2017 18:25,40,67.9,57,63.1,97,65.1,2,0,0
10/30/2017 18:30,47,67.3,64,62.4,111,64.5,2,0,0
10/30/2017 18:35,40,68.3,57,63.5,97,65.5,2,0,0
10/30/2017 18:40,41,67.7,57,62.9,98,64.9,2,0,0
10/30/2017 18:45,45,67.5,63,62.6,108,64.6,2,0,0
10/30/2017 18:50,41,67.6,59,62.8,100,64.7,2,0,0
10/30/2017 18:55,35,67.2,51,62.3,86,64.3,2,0,0
10/30/2017 19:00,37,66.6,54,61.6,91,63.6,2,0,0
10/30/2017 19:05,44,68.2,60,63.4,104,65.4,2,0,0
10/30/2017 19:10,44,68.6,62,63.9,106,65.8,2,0,0
10/30/2017 19:15,35,68.3,52,63.5,87,65.5,2,0,0
10/30/2017 19:20,37,68.1,54,63.3,91,65.3,2,0,0
10/30/2017 19:25,36,68.2,53,63.5,89,65.4,2,0,0
10/30/2017 19:30,36,67.5,53,62.7,89,64.6,2,0,0
10/30/2017 19:35,34,67.7,51,62.9,85,64.8,2,0,0
10/30/2017 19:40,36,68.9,53,64.2,89,66.1,2,0,0
10/30/2017 19:45,32,68.2,49,63.4,81,65.3,2,0,0
10/30/2017 19:50,27,67.4,43,62.6,70,64.5,2,0,0
10/30/2017 19:55,28,67.8,45,63.1,73,64.9,2,0,0
10/30/2017 20:00,30,68.9,46,64.2,76,66.1,2,0,0
10/30/2017 20:05,25,69.2,42,64.6,67,66.3,2,0,0
10/30/2017 20:10,34,68.9,51,64.2,85,66.1,2,0,0
10/30/2017 20:15,25,69.3,41,64.6,66,66.4,2,0,0
10/30/2017 20:20,24,69,39,64.4,63,66.1,2,0,0
10/30/2017 20:25,33,69.3,49,64.6,82,66.5,2,0,0
10/30/2017 20:30,29,69.8,45,65.2,74,67,2,0,0
10/30/2017 20:35,28,68.5,44,63.8,72,65.6,2,0,0
10/30/2017 20:40,25,68.7,42,64,67,65.7,2,0,0
10/30/2017 20:45,29,69.3,45,64.6,74,66.5,2,0,0
10/30/2017 20:50,27,69.6,43,65,70,66.8,2,0,0
10/30/2017 20:55,24,69.4,40,64.8,64,66.6,2,0,0
10/30/2017 21:00,31,69.3,47,64.7,78,66.5,2,0,0
10/30/2017 21:05,25,69.3,42,64.7,67,66.4,2,0,0
10/30/2017 21:10,25,68.4,40,63.7,65,65.5,2,0,0
10/30/2017 21:15,29,67.7,45,62.9,74,64.8,2,0,0
10/30/2017 21:20,28,68.8,44,64.1,72,65.9,2,0,0
10/30/2017 21:25,28,69.3,43,64.6,71,66.5,2,0,0
10/30/2017 21:30,18,69.3,34,64.7,52,66.3,2,0,0
10/30/2017 21:35,24,69.1,39,64.5,63,66.2,2,0,0
10/30/2017 21:40,24,69.5,39,64.9,63,66.7,2,0,0
10/30/2017 21:45,27,69.4,43,64.7,70,66.5,2,0,0
10/30/2017 21:50,17,69.2,33,64.6,50,66.2,2,0,0
10/30/2017 21:55,24,69.1,39,64.4,63,66.2,2,0,0
10/30/2017 22:00,18,69.1,34,64.5,52,66.1,2,0,0
10/30/2017 22:05,18,69.2,34,64.6,52,66.2,2,0,0
10/30/2017 22:10,20,69.2,35,64.5,55,66.2,2,0,0
10/30/2017 22:15,22,69.5,37,64.9,59,66.6,2,0,0
10/30/2017 22:20,18,69.3,34,64.6,52,66.2,2,0,0
10/30/2017 22:25,19,69.4,34,64.8,53,66.4,2,0,0
10/30/2017 22:30,15,69.1,31,64.5,46,66,2,0,0
10/30/2017 22:35,12,69.2,28,64.5,40,65.9,2,0,0
10/30/2017 22:40,18,69.3,34,64.7,52,66.3,2,0,0
10/30/2017 22:45,18,69.3,34,64.7,52,66.3,2,0,0
10/30/2017 22:50,15,69.5,30,64.9,45,66.5,2,0,0
10/30/2017 22:55,14,69.5,30,64.9,44,66.4,2,0,0
10/30/2017 23:00,13,69.3,29,64.7,42,66.2,2,0,0
10/30/2017 23:05,12,69.4,27,64.8,39,66.2,2,0,0
10/30/2017 23:10,12,69.4,27,64.8,39,66.3,2,0,0
10/30/2017 23:15,13,69.4,29,64.8,42,66.2,2,0,0
10/30/2017 23:20,11,69.4,27,64.8,38,66.1,2,0,0
10/30/2017 23:25,15,69.3,30,64.7,45,66.2,2,0,0
10/30/2017 23:30,14,69.1,29,64.5,43,66,2,0,0
10/30/2017 23:35,10,69.2,26,64.6,36,65.9,2,0,0
10/30/2017 23:40,13,69.3,28,64.7,41,66.1,2,0,0
10/30/2017 23:45,15,69.4,31,64.8,46,66.3,2,0,0
10/30/2017 23:50,8,69.4,23,64.8,31,66,2,0,0
10/30/2017 23:55,11,69.4,27,64.8,38,66.1,2,0,0
10/31/2017 0:00,9,69.3,25,64.7,34,66,2,0,0
10/31/2017 0:05,7,69.4,23,64.8,30,65.9,2,0,0
10/31/2017 0:10,12,69,27,64.4,39,65.8,2,0,0
10/31/2017 0:15,11,69.3,26,64.7,37,66,2,0,0
10/31/2017 0:20,11,68.8,26,64.2,37,65.6,2,0,0
10/31/2017 0:25,9,69.1,24,64.4,33,65.7,2,0,0
10/31/2017 0:30,8,69,23,64.4,31,65.5,2,0,0
10/31/2017 0:35,8,68.9,23,64.3,31,65.5,2,0,0
10/31/2017 0:40,7,69.2,22,64.6,29,65.7,2,0,0
10/31/2017 0:45,6,69.1,21,64.5,27,65.5,2,0,0
10/31/2017 0:50,5,69.2,21,64.6,26,65.5,2,0,0
10/31/2017 0:55,6,69.2,22,64.6,28,65.6,2,0,0
10/31/2017 1:00,7,69.2,22,64.6,29,65.7,2,0,0
10/31/2017 1:05,7,69.2,22,64.6,29,65.7,2,0,0
10/31/2017 1:10,5,69.2,20,64.6,25,65.5,2,0,0
10/31/2017 1:15,6,69.3,21,64.7,27,65.7,2,0,0
10/31/2017 1:20,18,69.1,24,64.5,42,66.5,2,0,0
10/31/2017 1:25,5,69.1,20,64.5,25,65.4,2,0,0
10/31/2017 1:30,8,69.3,23,64.7,31,65.9,2,0,0
10/31/2017 1:35,7,69,22,64.4,29,65.5,2,0,0
10/31/2017 1:40,6,69.2,22,64.5,28,65.5,2,0,0
10/31/2017 1:45,6,69.2,21,64.6,27,65.6,2,0,0
10/31/2017 1:50,7,69.3,22,64.7,29,65.8,2,0,0
10/31/2017 1:55,7,69.3,22,64.7,29,65.8,2,0,0
10/31/2017 2:00,5,69.3,21,64.7,26,65.6,2,0,0
10/31/2017 2:05,12,69.4,21,64.8,33,66.4,2,0,0
10/31/2017 2:10,7,69.2,23,64.6,30,65.7,2,0,0
10/31/2017 2:15,6,69.3,21,64.7,27,65.7,2,0,0
10/31/2017 2:20,8,69.3,23,64.7,31,65.9,2,0,0
10/31/2017 2:25,9,69,24,64.4,33,65.6,2,0,0
10/31/2017 2:30,8,69.1,23,64.5,31,65.7,2,0,0
10/31/2017 2:35,6,69.2,21,64.6,27,65.6,2,0,0
10/31/2017 2:40,10,69.3,26,64.7,36,65.9,2,0,0
10/31/2017 2:45,8,69.2,24,64.6,32,65.8,2,0,0
10/31/2017 2:50,11,69.2,27,64.6,38,65.9,2,0,0
10/31/2017 2:55,7,69.4,22,64.8,29,65.9,2,0,0
10/31/2017 3:00,10,69.3,25,64.7,35,66,2,0,0
10/31/2017 3:05,9,69,25,64.4,34,65.7,2,0,0
10/31/2017 3:10,12,68.3,28,63.6,40,65,2,0,0
10/31/2017 3:15,10,68.7,25,64.1,35,65.4,2,0,0
10/31/2017 3:20,9,69,24,64.3,33,65.6,2,0,0
10/31/2017 3:25,8,69.2,23,64.6,31,65.8,2,0,0
10/31/2017 3:30,10,69.3,26,64.7,36,66,2,0,0
10/31/2017 3:35,12,69.4,28,64.7,40,66.1,2,0,0
10/31/2017 3:40,9,69.4,24,64.7,33,66,2,0,0
10/31/2017 3:45,13,69.3,29,64.7,42,66.1,2,0,0
10/31/2017 3:50,13,69.4,29,64.7,42,66.2,2,0,0
10/31/2017 3:55,11,69.4,26,64.8,37,66.1,2,0,0
10/31/2017 4:00,13,69.3,29,64.7,42,66.1,2,0,0
10/31/2017 4:05,14,69.1,30,64.4,44,65.9,2,0,0
10/31/2017 4:10,17,69.2,33,64.6,50,66.2,2,0,0
10/31/2017 4:15,14,69.2,30,64.6,44,66.1,2,0,0
10/31/2017 4:20,15,69,31,64.4,46,65.9,2,0,0
10/31/2017 4:25,25,69.4,41,64.8,66,66.5,2,0,0
10/31/2017 4:30,23,69.2,40,64.6,63,66.3,2,0,0
10/31/2017 4:35,24,69.1,40,64.5,64,66.2,2,0,0
10/31/2017 4:40,36,69.5,54,64.9,90,66.7,2,0,0
10/31/2017 4:45,35,68.7,53,64,88,65.8,2,0,0
10/31/2017 4:50,35,68.7,54,64,89,65.9,2,0,0
10/31/2017 4:55,36,69.9,53,65.3,89,67.1,2,0,0
10/31/2017 5:00,41,68.4,59,63.7,100,65.7,2,0,0
10/31/2017 5:05,42,69,62,64.3,104,66.2,2,0,0
10/31/2017 5:10,45,68.9,64,64.3,109,66.2,2,0,0
10/31/2017 5:15,47,69.2,66,64.6,113,66.5,2,0,0
10/31/2017 5:20,46,67.3,66,62.6,112,64.5,2,0,0
10/31/2017 5:25,50,66.8,70,62,120,64,2,0,0
10/31/2017 5:30,57,69,78,64.4,135,66.3,2,0,0
10/31/2017 5:35,56,68.2,77,63.5,133,65.4,2,0,0
10/31/2017 5:40,57,68.6,78,63.9,135,65.9,2,0,0
10/31/2017 5:45,56,67.8,77,63,133,65,2,0,0
10/31/2017 5:50,73,68.9,96,64.2,169,66.2,2,0,0
10/31/2017 5:55,64,67.6,86,62.8,150,64.9,2,0,0
10/31/2017 6:00,50,67.4,69,62.6,119,64.6,2,0,0
10/31/2017 6:05,70,67,93,62,163,64.2,2,0,0
10/31/2017 6:10,58,68.4,80,63.6,138,65.6,2,0,0
10/31/2017 6:15,69,67.9,90,63,159,65.1,2,0,0
10/31/2017 6:20,66,67.8,87,62.9,153,65,2,0,0
10/31/2017 6:25,58,68.1,80,63.2,138,65.3,2,0,0
10/31/2017 6:30,59,68.3,80,63.4,139,65.4,2,0,0
10/31/2017 6:35,63,68.6,85,63.8,148,65.8,2,0,0
10/31/2017 6:40,68,67.7,90,62.8,158,64.9,2,0,0
10/31/2017 6:45,81,67.9,104,63,185,65.1,2,0,0
10/31/2017 6:50,64,67.9,84,62.9,148,65,2,0,0
10/31/2017 6:55,71,65.4,93,60.3,164,62.5,2,0,0
10/31/2017 7:00,66,65.6,87,60.6,153,62.8,2,0,0
10/31/2017 7:05,74,66,96,61,170,63.2,2,0,0
10/31/2017 7:10,73,66.1,95,61.1,168,63.3,2,0,0
10/31/2017 7:15,76,65.6,99,60.5,175,62.7,2,0,0
10/31/2017 7:20,67,65.2,88,60.1,155,62.3,2,0,0
10/31/2017 7:25,68,66.9,90,61.9,158,64.1,2,0,0
10/31/2017 7:30,73,66.8,96,61.8,169,63.9,2,0,0
10/31/2017 7:35,81,66.6,104,61.6,185,63.8,2,0,0
10/31/2017 7:40,88,66,113,61,201,63.2,2,0,0
10/31/2017 7:45,93,66.6,117,61.7,210,63.9,2,0,0
10/31/2017 7:50,85,66.8,109,61.8,194,64,2,0,0
10/31/2017 7:55,83,67.7,105,62.7,188,64.9,2,0,0
10/31/2017 8:00,74,67.6,96,62.7,170,64.9,2,0,0
10/31/2017 8:05,76,66.9,99,61.9,175,64.1,2,0,0
10/31/2017 8:10,81,66.6,103,61.6,184,63.8,2,0,0
10/31/2017 8:15,77,67,100,62.1,177,64.2,2,0,0
10/31/2017 8:20,77,66.5,99,61.6,176,63.7,2,0,0
10/31/2017 8:25,83,66.1,105,61.1,188,63.3,2,0,0
10/31/2017 8:30,86,65,108,59.9,194,62.1,2,0,0
10/31/2017 8:35,70,66,92,61,162,63.2,2,0,0
10/31/2017 8:40,72,66.6,91,61.6,163,63.8,2,0,0
10/31/2017 8:45,71,67,93,62,164,64.1,2,0,0
10/31/2017 8:50,77,65.5,98,60.4,175,62.6,2,0,0
10/31/2017 8:55,73,63.1,96,57.8,169,60.1,2,0,0
10/31/2017 9:00,86,60.1,109,54.5,195,57,2,0,0
10/31/2017 9:05,66,62.4,86,57,152,59.3,2,0,0
10/31/2017 9:10,62,65,83,59.9,145,62,2,0,0
10/31/2017 9:15,80,65.7,101,60.6,181,62.8,2,0,0
10/31/2017 9:20,60,66.3,81,61.4,141,63.5,2,0,0
10/31/2017 9:25,61,67.1,81,62.2,142,64.3,2,0,0
10/31/2017 9:30,70,67.1,90,62.2,160,64.4,2,0,0
10/31/2017 9:35,80,65.9,102,60.9,182,63.1,2,0,0
10/31/2017 9:40,69,66.6,90,61.6,159,63.8,2,0,0
10/31/2017 9:45,63,67.3,82,62.4,145,64.5,2,0,0
10/31/2017 9:50,70,67.7,91,62.8,161,64.9,2,0,0
10/31/2017 9:55,65,66.8,84,61.9,149,64,2,0,0
10/31/2017 10:00,66,66.7,86,61.8,152,63.9,2,0,0
10/31/2017 10:05,59,67.3,77,62.5,136,64.5,2,0,0
10/31/2017 10:10,59,65.5,78,60.5,137,62.7,2,0,0
10/31/2017 10:15,59,65.7,78,60.7,137,62.9,2,0,0
10/31/2017 10:20,58,65.6,77,60.7,135,62.8,2,0,0
10/31/2017 10:25,64,65.4,84,60.3,148,62.5,2,0,0
10/31/2017 10:30,49,65.9,67,60.9,116,63,2,0,0
10/31/2017 10:35,53,66.1,72,61.2,125,63.3,2,0,0
10/31/2017 10:40,54,66.6,72,61.7,126,63.8,2,0,0
10/31/2017 10:45,57,66.9,75,62,132,64.1,2,0,0
10/31/2017 10:50,58,65.8,76,60.8,134,63,2,0,0
10/31/2017 10:55,61,66,80,61.1,141,63.2,2,0,0
10/31/2017 11:00,53,64.3,72,59.3,125,61.5,2,0,0
10/31/2017 11:05,53,66.3,70,61.4,123,63.5,2,0,0
10/31/2017 11:10,44,66.3,61,61.4,105,63.5,2,0,0
10/31/2017 11:15,54,66.1,72,61.1,126,63.2,2,0,0
10/31/2017 11:20,58,65.5,77,60.5,135,62.7,2,0,0
10/31/2017 11:25,60,66.3,78,61.5,138,63.6,2,0,0
10/31/2017 11:30,52,66.9,70,62.2,122,64.2,2,0,0
10/31/2017 11:35,41,67.6,58,62.8,99,64.8,2,0,0
10/31/2017 11:40,46,67.1,64,62.3,110,64.3,2,0,0
10/31/2017 11:45,51,68.6,69,64.1,120,66,2,0,0
10/31/2017 11:50,51,69.3,69,64.8,120,66.7,2,0,0
10/31/2017 11:55,41,69.3,58,64.9,99,66.7,2,0,0
10/31/2017 12:00,45,68,63,63.3,108,65.3,2,0,0
10/31/2017 12:05,52,67.2,70,62.4,122,64.5,2,0,0
10/31/2017 12:10,46,68.5,64,63.8,110,65.8,2,0,0
10/31/2017 12:15,48,66.7,66,61.8,114,63.9,2,0,0
10/31/2017 12:20,43,67.2,60,62.4,103,64.4,2,0,0
10/31/2017 12:25,43,68.4,61,63.7,104,65.6,2,0,0
10/31/2017 12:30,53,67.1,71,62.3,124,64.3,2,0,0
10/31/2017 12:35,48,66.6,65,61.8,113,63.8,2,0,0
10/31/2017 12:40,41,67.3,58,62.5,99,64.5,2,0,0
10/31/2017 12:45,43,67.9,61,63.2,104,65.2,2,0,0
10/31/2017 12:50,50,66.8,69,62.1,119,64.1,2,0,0
10/31/2017 12:55,39,66.9,57,62.1,96,64.1,2,0,0
10/31/2017 13:00,36,66.5,53,61.7,89,63.6,2,0,0
10/31/2017 13:05,39,66.6,57,61.8,96,63.8,2,0,0
10/31/2017 13:10,52,66.9,69,62.2,121,64.2,2,0,0
10/31/2017 13:15,42,68.6,59,63.9,101,65.8,2,0,0
10/31/2017 13:20,47,68.2,64,63.5,111,65.5,2,0,0
10/31/2017 13:25,46,68.3,64,63.6,110,65.6,2,0,0
10/31/2017 13:30,45,67.8,63,63.1,108,65,2,0,0
10/31/2017 13:35,38,68.3,54,63.6,92,65.6,2,0,0
10/31/2017 13:40,45,67.2,63,62.4,108,64.4,2,0,0
10/31/2017 13:45,49,66.5,68,61.6,117,63.7,2,0,0
10/31/2017 13:50,44,67.8,61,63.1,105,65.1,2,0,0
10/31/2017 13:55,38,67.2,55,62.4,93,64.3,2,0,0
10/31/2017 14:00,40,68.2,57,63.5,97,65.4,2,0,0
10/31/2017 14:05,47,69,65,64.4,112,66.3,2,0,0
10/31/2017 14:10,42,68.5,59,63.8,101,65.7,2,0,0
10/31/2017 14:15,37,68.3,54,63.7,91,65.6,2,0,0
10/31/2017 14:20,52,68.2,70,63.4,122,65.5,2,0,0
10/31/2017 14:25,51,68.2,69,63.5,120,65.5,2,0,0
10/31/2017 14:30,55,68.9,73,64.3,128,66.3,2,0,0
10/31/2017 14:35,45,67.3,63,62.5,108,64.5,2,0,0
10/31/2017 14:40,50,68.2,67,63.5,117,65.5,2,0,0
10/31/2017 14:45,54,68.6,72,63.9,126,65.9,2,0,0
10/31/2017 14:50,52,68.4,69,63.6,121,65.7,2,0,0
10/31/2017 14:55,47,69.1,64,64.4,111,66.4,2,0,0
10/31/2017 15:00,51,66.9,69,62.1,120,64.2,2,0,0
10/31/2017 15:05,43,68.4,61,63.7,104,65.7,2,0,0
10/31/2017 15:10,50,67.9,67,63.2,117,65.2,2,0,0
10/31/2017 15:15,55,67.6,73,62.9,128,64.9,2,0,0
10/31/2017 15:20,44,67.1,63,62.2,107,64.2,2,0,0
10/31/2017 15:25,41,68.4,58,63.7,99,65.6,2,0,0
10/31/2017 15:30,41,68.3,59,63.6,100,65.5,2,0,0
10/31/2017 15:35,58,68.1,75,63.3,133,65.4,2,0,0
10/31/2017 15:40,61,68.2,79,63.5,140,65.5,2,0,0
10/31/2017 15:45,59,69.5,78,64.9,137,66.9,2,0,0
10/31/2017 15:50,55,67.3,74,62.5,129,64.5,2,0,0
10/31/2017 15:55,56,68.3,73,63.6,129,65.6,2,0,0
10/31/2017 16:00,53,67.7,71,63,124,65,2,0,0
10/31/2017 16:05,53,68.2,70,63.5,123,65.5,2,0,0
10/31/2017 16:10,58,68.2,76,63.4,134,65.5,2,0,0
10/31/2017 16:15,61,67.9,81,63.1,142,65.2,2,0,0
10/31/2017 16:20,50,69.1,69,64.4,119,66.4,2,0,0
10/31/2017 16:25,62,69.9,81,65.3,143,67.3,2,0,0
10/31/2017 16:30,48,68.7,65,64,113,66,2,0,0
10/31/2017 16:35,47,68.6,66,63.9,113,65.9,2,0,0
10/31/2017 16:40,55,67.7,74,62.9,129,65,2,0,0
10/31/2017 16:45,51,68.2,69,63.5,120,65.5,2,0,0
10/31/2017 16:50,42,67.7,59,63,101,64.9,2,0,0
10/31/2017 16:55,48,67.1,65,62.3,113,64.3,2,0,0
10/31/2017 17:00,58,67.8,78,62.9,136,65,2,0,0
10/31/2017 17:05,51,68.4,69,63.6,120,65.6,2,0,0
10/31/2017 17:10,53,68.4,71,63.8,124,65.8,2,0,0
10/31/2017 17:15,53,69.2,71,64.5,124,66.5,2,0,0
10/31/2017 17:20,57,68.9,76,64.2,133,66.2,2,0,0
10/31/2017 17:25,58,69.3,76,64.7,134,66.7,2,0,0
10/31/2017 17:30,57,69.2,75,64.6,132,66.6,2,0,0
10/31/2017 17:35,44,69.4,62,64.8,106,66.8,2,0,0
10/31/2017 17:40,44,69,63,64.4,107,66.3,2,0,0
10/31/2017 17:45,43,69.3,61,64.8,104,66.7,2,0,0
10/31/2017 17:50,42,68.9,60,64.2,102,66.1,2,0,0
10/31/2017 17:55,44,69.2,61,64.5,105,66.5,2,0,0
10/31/2017 18:00,44,68.8,62,64.2,106,66.1,2,0,0
10/31/2017 18:05,46,69.8,64,65.2,110,67.1,2,0,0
10/31/2017 18:10,47,69.8,64,65.3,111,67.2,2,0,0
10/31/2017 18:15,44,69.1,61,64.4,105,66.4,2,0,0
10/31/2017 18:20,47,67.7,65,62.9,112,64.9,2,0,0
10/31/2017 18:25,48,67.4,67,62.6,115,64.6,2,0,0
10/31/2017 18:30,39,67.8,56,63,95,65,2,0,0
10/31/2017 18:35,36,68.5,54,63.8,90,65.7,2,0,0
10/31/2017 18:40,40,67.9,58,63.2,98,65.1,2,0,0
10/31/2017 18:45,40,68.7,57,64.1,97,66,2,0,0
10/31/2017 18:50,37,68.8,54,64.2,91,66,2,0,0
10/31/2017 18:55,36,68.4,52,63.8,88,65.7,2,0,0
10/31/2017 19:00,33,68.3,50,63.6,83,65.5,2,0,0
10/31/2017 19:05,28,68.3,46,63.6,74,65.4,2,0,0
10/31/2017 19:10,36,67.8,53,63,89,64.9,2,0,0
10/31/2017 19:15,31,66.8,48,62,79,63.9,2,0,0
10/31/2017 19:20,31,67.6,47,62.8,78,64.7,2,0,0
10/31/2017 19:25,36,66.2,53,61.2,89,63.2,2,0,0
10/31/2017 19:30,30,67.3,46,62.5,76,64.4,2,0,0
10/31/2017 19:35,36,68.5,53,63.8,89,65.7,2,0,0
10/31/2017 19:40,35,68.6,52,63.9,87,65.8,2,0,0
10/31/2017 19:45,28,69.3,44,64.6,72,66.4,2,0,0
10/31/2017 19:50,33,68.6,49,63.9,82,65.8,2,0,0
10/31/2017 19:55,23,69.3,39,64.7,62,66.4,2,0,0
10/31/2017 20:00,24,69.4,39,64.8,63,66.6,2,0,0
10/31/2017 20:05,34,67.5,51,62.8,85,64.7,2,0,0
10/31/2017 20:10,24,68.4,40,63.7,64,65.5,2,0,0
10/31/2017 20:15,26,69.2,42,64.6,68,66.3,2,0,0
10/31/2017 20:20,25,69.4,41,64.8,66,66.5,2,0,0
10/31/2017 20:25,32,69.3,48,64.7,80,66.5,2,0,0
10/31/2017 20:30,27,69.6,43,65,70,66.7,2,0,0
10/31/2017 20:35,28,69.2,44,64.5,72,66.3,2,0,0
10/31/2017 20:40,31,69.2,47,64.6,78,66.4,2,0,0
10/31/2017 20:45,29,69.7,45,65.1,74,66.9,2,0,0
10/31/2017 20:50,28,68.4,45,63.8,73,65.6,2,0,0
10/31/2017 20:55,28,68.9,44,64.3,72,66.1,2,0,0
10/31/2017 21:00,29,69,45,64.4,74,66.2,2,0,0
10/31/2017 21:05,28,69.4,45,64.8,73,66.6,2,0,0
10/31/2017 21:10,25,69.4,40,64.8,65,66.6,2,0,0
10/31/2017 21:15,23,69.5,38,64.9,61,66.6,2,0,0
10/31/2017 21:20,26,69.7,41,65.1,67,66.9,2,0,0
10/31/2017 21:25,29,69.4,46,64.7,75,66.5,2,0,0
10/31/2017 21:30,26,69.5,42,64.9,68,66.7,2,0,0
10/31/2017 21:35,24,69.5,40,64.9,64,66.7,2,0,0
10/31/2017 21:40,27,69,43,64.3,70,66.1,2,0,0
10/31/2017 21:45,20,69.1,36,64.4,56,66.1,2,0,0
10/31/2017 21:50,26,69.1,43,64.5,69,66.2,2,0,0
10/31/2017 21:55,23,69.2,39,64.6,62,66.3,2,0,0
10/31/2017 22:00,19,69.4,34,64.8,53,66.4,2,0,0
10/31/2017 22:05,17,69.3,32,64.7,49,66.3,2,0,0
10/31/2017 22:10,19,69.4,35,64.8,54,66.4,2,0,0
10/31/2017 22:15,24,69.5,40,64.9,64,66.6,2,0,0
10/31/2017 22:20,23,69.5,39,64.9,62,66.6,2,0,0
10/31/2017 22:25,19,69.1,35,64.4,54,66.1,2,0,0
10/31/2017 22:30,18,69.2,34,64.6,52,66.2,2,0,0
10/31/2017 22:35,18,69.3,34,64.7,52,66.3,2,0,0
10/31/2017 22:40,22,68.6,37,63.9,59,65.7,2,0,0
10/31/2017 22:45,12,69,28,64.4,40,65.7,2,0,0
10/31/2017 22:50,18,69.2,33,64.5,51,66.2,2,0,0
10/31/2017 22:55,14,69.2,29,64.6,43,66.1,2,0,0
10/31/2017 23:00,17,69.2,32,64.6,49,66.2,2,0,0
10/31/2017 23:05,14,69.4,30,64.8,44,66.2,2,0,0
10/31/2017 23:10,15,69.5,30,64.9,45,66.4,2,0,0
10/31/2017 23:15,17,69.5,33,64.9,50,66.4,2,0,0
10/31/2017 23:20,14,69.3,30,64.7,44,66.2,2,0,0
10/31/2017 23:25,16,68.8,31,64.2,47,65.8,2,0,0
10/31/2017 23:30,14,69.1,30,64.5,44,66,2,0,0
10/31/2017 23:35,11,69.2,27,64.6,38,66,2,0,0
10/31/2017 23:40,14,69.2,29,64.6,43,66.1,2,0,0
10/31/2017 23:45,19,69.4,35,64.8,54,66.4,2,0,0
10/31/2017 23:50,16,69.3,31,64.7,47,66.2,2,0,0
10/31/2017 23:55,9,69.3,25,64.7,34,65.9,2,0,0
11/01/2017 0:00,12,69.3,27,64.7,39,66.2,2,0,0
11/01/2017 0:05,11,69.3,26,64.7,37,66.1,2,0,0
11/01/2017 0:10,13,69.4,28,64.8,41,66.2,2,0,0
11/01/2017 0:15,12,69.4,27,64.8,39,66.2,2,0,0
11/01/2017 0:20,7,69.4,22,64.8,29,65.9,2,0,0
11/01/2017 0:25,12,69.2,27,64.6,39,66,2,0,0
11/01/2017 0:30,13,68.9,28,64.3,41,65.8,2,0,0
11/01/2017 0:35,6,69.2,22,64.5,28,65.5,2,0,0
11/01/2017 0:40,10,69.3,26,64.7,36,66,2,0,0
11/01/2017 0:45,9,68.9,24,64.3,33,65.5,2,0,0
11/01/2017 0:50,11,69.3,26,64.7,37,66,2,0,0
11/01/2017 0:55,12,69.3,27,64.7,39,66.1,2,0,0
11/01/2017 1:00,9,69.5,24,64.9,33,66.2,2,0,0
11/01/2017 1:05,7,69.4,22,64.8,29,65.9,2,0,0
11/01/2017 1:10,6,69.3,22,64.7,28,65.7,2,0,0
11/01/2017 1:15,8,69.2,23,64.5,31,65.7,2,0,0
11/01/2017 1:20,6,69.3,21,64.7,27,65.7,2,0,0
11/01/2017 1:25,10,69.3,20,64.7,30,66.2,2,0,0
11/01/2017 1:30,10,69.1,25,64.5,35,65.8,2,0,0
11/01/2017 1:35,9,68.9,24,64.3,33,65.6,2,0,0
11/01/2017 1:40,5,69.1,20,64.5,25,65.4,2,0,0
11/01/2017 1:45,5,69.2,20,64.6,25,65.5,2,0,0
11/01/2017 1:50,6,69.3,21,64.7,27,65.7,2,0,0
11/01/2017 1:55,7,69.4,23,64.8,30,65.9,2,0,0
11/01/2017 2:00,8,69.4,23,64.8,31,66,2,0,0
11/01/2017 2:05,18,69.4,23,64.8,41,66.8,2,0,0
11/01/2017 2:10,7,69.4,22,64.8,29,65.9,2,0,0
11/01/2017 2:15,10,69.2,25,64.6,35,65.9,2,0,0
11/01/2017 2:20,7,69.1,22,64.4,29,65.6,2,0,0
11/01/2017 2:25,6,69.3,21,64.7,27,65.8,2,0,0
11/01/2017 2:30,6,69.3,21,64.7,27,65.7,2,0,0
11/01/2017 2:35,9,69.3,24,64.7,33,66,2,0,0
11/01/2017 2:40,9,69.1,24,64.4,33,65.7,2,0,0
11/01/2017 2:45,11,69.3,27,64.7,38,66,2,0,0
11/01/2017 2:50,9,69.1,24,64.5,33,65.7,2,0,0
11/01/2017 2:55,10,69.4,25,64.8,35,66.1,2,0,0
11/01/2017 3:00,9,69.3,24,64.7,33,65.9,2,0,0
11/01/2017 3:05,12,69,28,64.4,40,65.8,2,0,0
11/01/2017 3:10,11,69.3,26,64.7,37,66,2,0,0
11/01/2017 3:15,11,69.3,26,64.7,37,66.1,2,0,0
11/01/2017 3:20,9,69.4,24,64.8,33,66,2,0,0
11/01/2017 3:25,11,69.3,27,64.7,38,66,2,0,0
11/01/2017 3:30,10,69.3,25,64.7,35,66,2,0,0
11/01/2017 3:35,12,69.4,28,64.8,40,66.2,2,0,0
11/01/2017 3:40,16,69.1,32,64.5,48,66.1,2,0,0
11/01/2017 3:45,13,69.1,29,64.5,42,65.9,2,0,0
11/01/2017 3:50,16,69.2,32,64.6,48,66.2,2,0,0
11/01/2017 3:55,16,69.3,32,64.6,48,66.2,2,0,0
11/01/2017 4:00,18,69.2,33,64.5,51,66.2,2,0,0
11/01/2017 4:05,18,69.2,34,64.5,52,66.1,2,0,0
11/01/2017 4:10,18,69.3,33,64.7,51,66.3,2,0,0
11/01/2017 4:15,23,69,39,64.4,62,66.1,2,0,0
11/01/2017 4:20,24,69.5,41,65,65,66.7,2,0,0
11/01/2017 4:25,25,69.3,42,64.7,67,66.4,2,0,0
11/01/2017 4:30,27,70.1,44,65.5,71,67.3,2,0,0
11/01/2017 4:35,35,69.9,53,65.3,88,67.1,2,0,0
11/01/2017 4:40,37,69.6,55,65,92,66.8,2,0,0
11/01/2017 4:45,42,70.3,60,65.8,102,67.7,2,0,0
11/01/2017 4:50,43,70.6,62,66.1,105,67.9,2,0,0
11/01/2017 4:55,37,71.2,55,66.7,92,68.5,2,0,0
11/01/2017 5:00,49,70.3,67,65.8,116,67.7,2,0,0
11/01/2017 5:05,45,69.8,64,65.2,109,67.1,2,0,0
11/01/2017 5:10,54,68,75,63.4,129,65.3,2,0,0
11/01/2017 5:15,55,69.2,74,64.6,129,66.6,2,0,0
11/01/2017 5:20,57,68,78,63.3,135,65.3,2,0,0
11/01/2017 5:25,62,69,83,64.4,145,66.4,2,0,0
11/01/2017 5:30,64,68.5,84,63.8,148,65.9,2,0,0
11/01/2017 5:35,68,69.1,90,64.5,158,66.5,2,0,0
11/01/2017 5:40,67,69.5,89,64.9,156,66.9,2,0,0
11/01/2017 5:45,66,68.7,87,64,153,66,2,0,0
11/01/2017 5:50,68,69.1,90,64.4,158,66.4,2,0,0
11/01/2017 5:55,69,68.2,91,63.5,160,65.5,2,0,0
11/01/2017 6:00,63,67.9,83,63,146,65.1,2,0,0
11/01/2017 6:05,55,67.7,76,62.9,131,64.9,2,0,0
11/01/2017 6:10,65,67.2,87,62.3,152,64.4,2,0,0
11/01/2017 6:15,66,67.6,88,62.8,154,64.9,2,0,0
11/01/2017 6:20,60,67.4,81,62.6,141,64.6,2,0,0
11/01/2017 6:25,62,68.6,82,63.9,144,65.9,2,0,0
11/01/2017 6:30,58,68.8,79,64.1,137,66.1,2,0,0
11/01/2017 6:35,72,69.1,95,64.4,167,66.4,2,0,0
11/01/2017 6:40,71,67.1,93,62.3,164,64.4,2,0,0
11/01/2017 6:45,74,67.2,96,62.3,170,64.4,2,0,0
11/01/2017 6:50,72,67.8,94,62.9,166,65,2,0,0
11/01/2017 6:55,74,67.9,96,63,170,65.1,2,0,0
11/01/2017 7:00,73,67.3,95,62.4,168,64.5,2,0,0
11/01/2017 7:05,77,66.5,99,61.5,176,63.7,2,0,0
11/01/2017 7:10,80,66.5,102,61.6,182,63.7,2,0,0
11/01/2017 7:15,75,66.2,97,61.2,172,63.4,2,0,0
11/01/2017 7:20,83,66,106,61.1,189,63.2,2,0,0
11/01/2017 7:25,79,66.5,102,61.6,181,63.7,2,0,0
11/01/2017 7:30,83,66.6,106,61.7,189,63.9,2,0,0
11/01/2017 7:35,89,67.2,112,62.3,201,64.5,2,0,0
11/01/2017 7:40,105,67,130,62,235,64.2,2,0,0
11/01/2017 7:45,98,67.4,123,62.5,221,64.7,2,0,0
11/01/2017 7:50,99,66.5,123,61.5,222,63.8,2,0,0
11/01/2017 7:55,94,66.6,119,61.7,213,63.9,2,0,0
11/01/2017 8:00,86,66.1,109,61.2,195,63.3,2,0,0
11/01/2017 8:05,79,66.7,101,61.8,180,63.9,2,0,0
11/01/2017 8:10,74,67.1,96,62.2,170,64.4,2,0,0
11/01/2017 8:15,86,66.3,110,61.4,196,63.5,2,0,0
11/01/2017 8:20,81,65.9,103,61,184,63.2,2,0,0
11/01/2017 8:25,76,65.7,98,60.8,174,63,2,0,0
11/01/2017 8:30,85,65.7,107,60.8,192,63,2,0,0
11/01/2017 8:35,80,66.1,102,61.2,182,63.3,2,0,0
11/01/2017 8:40,85,66.2,109,61.3,194,63.5,2,0,0
11/01/2017 8:45,79,66.8,101,61.9,180,64,2,0,0
11/01/2017 8:50,78,67,100,62.1,178,64.2,2,0,0
11/01/2017 8:55,81,66.7,103,61.8,184,63.9,2,0,0
11/01/2017 9:00,66,66.1,87,61.2,153,63.3,2,0,0
11/01/2017 9:05,82,66,105,61.1,187,63.3,2,0,0
11/01/2017 9:10,81,65.7,104,60.8,185,62.9,2,0,0
11/01/2017 9:15,77,65.1,100,60.1,177,62.3,2,0,0
11/01/2017 9:20,69,65.9,89,61,158,63.1,2,0,0
11/01/2017 9:25,71,65.5,91,60.6,162,62.8,2,0,0
11/01/2017 9:30,64,67.1,85,62.2,149,64.3,2,0,0
11/01/2017 9:35,65,65.6,86,60.7,151,62.8,2,0,0
11/01/2017 9:40,74,64.4,96,59.3,170,61.5,2,0,0
11/01/2017 9:45,67,65.2,87,60.2,154,62.4,2,0,0
11/01/2017 9:50,68,64.9,89,60,157,62.1,2,0,0
11/01/2017 9:55,68,64.7,88,59.7,156,61.9,2,0,0
11/01/2017 10:00,65,66.1,85,61.2,150,63.3,2,0,0
11/01/2017 10:05,66,64.9,86,59.9,152,62.1,2,0,0
11/01/2017 10:10,62,64.2,82,59,144,61.3,2,0,0
11/01/2017 10:15,62,65.7,82,60.6,144,62.8,2,0,0
11/01/2017 10:20,76,65.7,97,60.7,173,62.9,2,0,0
11/01/2017 10:25,63,65.8,83,60.9,146,63,2,0,0
11/01/2017 10:30,65,66.9,84,62,149,64.1,2,0,0
11/01/2017 10:35,61,66.8,80,62,141,64.1,2,0,0
11/01/2017 10:40,55,65.6,75,60.7,130,62.8,2,0,0
11/01/2017 10:45,62,65.8,82,60.8,144,63,2,0,0
11/01/2017 10:50,59,66.6,77,61.7,136,63.8,2,0,0
11/01/2017 10:55,59,67.3,79,62.5,138,64.6,2,0,0
11/01/2017 11:00,54,67.1,72,62.3,126,64.3,2,0,0
11/01/2017 11:05,75,67.8,94,63.1,169,65.2,2,0,0
11/01/2017 11:10,62,66.8,80,62,142,64.1,2,0,0
11/01/2017 11:15,72,66.8,92,62,164,64.1,2,0,0
11/01/2017 11:20,68,67,87,62.2,155,64.3,2,0,0
11/01/2017 11:25,64,67.1,83,62.3,147,64.4,2,0,0
11/01/2017 11:30,56,67.2,74,62.4,130,64.5,2,0,0
11/01/2017 11:35,61,66.4,80,61.6,141,63.7,2,0,0
11/01/2017 11:40,64,66.4,83,61.6,147,63.7,2,0,0
11/01/2017 11:45,52,66.7,70,61.9,122,64,2,0,0
11/01/2017 11:50,56,67.7,75,62.9,131,65,2,0,0
11/01/2017 11:55,53,68.1,71,63.4,124,65.4,2,0,0
11/01/2017 12:00,50,67.9,68,63.2,118,65.2,2,0,0
11/01/2017 12:05,55,67.5,74,62.8,129,64.8,2,0,0
11/01/2017 12:10,54,68.8,72,64.1,126,66.1,2,0,0
11/01/2017 12:15,64,69.5,82,64.9,146,67,2,0,0
11/01/2017 12:20,53,69.8,70,65.2,123,67.2,2,0,0
11/01/2017 12:25,52,68.6,71,63.9,123,65.9,2,0,0
11/01/2017 12:30,56,68.2,74,63.5,130,65.5,2,0,0
11/01/2017 12:35,59,66.6,78,61.8,137,63.9,2,0,0
11/01/2017 12:40,52,66.5,70,61.5,122,63.7,2,0,0
11/01/2017 12:45,44,68,61,63.2,105,65.2,2,0,0
11/01/2017 12:50,56,68.8,74,64.1,130,66.1,2,0,0
11/01/2017 12:55,45,70.4,62,65.9,107,67.8,2,0,0
11/01/2017 13:00,50,68.7,68,64,118,66,2,0,0
11/01/2017 13:05,51,68.7,69,64,120,66,2,0,0
11/01/2017 13:10,42,68.6,59,64,101,65.9,2,0,0
11/01/2017 13:15,49,69.5,67,65,116,66.9,2,0,0
11/01/2017 13:20,54,68.7,73,64.1,127,66.1,2,0,0
11/01/2017 13:25,51,69.3,68,64.7,119,66.7,2,0,0
11/01/2017 13:30,56,68.6,75,63.9,131,66,2,0,0
11/01/2017 13:35,47,68.8,65,64.1,112,66.1,2,0,0
11/01/2017 13:40,50,67.9,69,63.2,119,65.1,2,0,0
11/01/2017 13:45,52,69.4,69,64.8,121,66.7,2,0,0
11/01/2017 13:50,49,67,67,62.2,116,64.2,2,0,0
11/01/2017 13:55,46,66.1,64,61.3,110,63.3,2,0,0
11/01/2017 14:00,48,67.3,65,62.6,113,64.6,2,0,0
11/01/2017 14:05,55,68.5,73,63.9,128,65.9,2,0,0
11/01/2017 14:10,42,69.2,59,64.6,101,66.5,2,0,0
11/01/2017 14:15,43,69.5,61,64.9,104,66.8,2,0,0
11/01/2017 14:20,52,68,70,63.4,122,65.4,2,0,0
11/01/2017 14:25,54,67.5,73,62.8,127,64.8,2,0,0
11/01/2017 14:30,51,67,70,62.1,121,64.1,2,0,0
11/01/2017 14:35,47,68.1,64,63.3,111,65.3,2,0,0
11/01/2017 14:40,48,67.7,66,63,114,65,2,0,0
11/01/2017 14:45,45,67.3,63,62.6,108,64.5,2,0,0
11/01/2017 14:50,52,66.5,70,61.7,122,63.8,2,0,0
11/01/2017 14:55,50,67,68,62.2,118,64.2,2,0,0
11/01/2017 15:00,41,67.4,58,62.6,99,64.6,2,0,0
11/01/2017 15:05,54,68.1,72,63.5,126,65.5,2,0,0
11/01/2017 15:10,43,69.1,59,64.5,102,66.5,2,0,0
11/01/2017 15:15,51,69.4,69,64.8,120,66.7,2,0,0
11/01/2017 15:20,59,69.1,76,64.4,135,66.5,2,0,0
11/01/2017 15:25,60,68.5,79,63.9,139,65.9,2,0,0
11/01/2017 15:30,54,68.6,73,64,127,66,2,0,0
11/01/2017 15:35,60,69,78,64.4,138,66.4,2,0,0
11/01/2017 15:40,56,69.9,73,65.4,129,67.4,2,0,0
11/01/2017 15:45,71,69.9,92,65.4,163,67.3,2,0,0
11/01/2017 15:50,54,70.7,72,66.3,126,68.2,2,0,0
11/01/2017 15:55,50,69.6,68,65.1,118,67,2,0,0
11/01/2017 16:00,69,69.6,88,65.1,157,67.1,2,0,0
11/01/2017 16:05,64,69.3,83,64.7,147,66.7,2,0,0
11/01/2017 16:10,61,69.6,79,65,140,67,2,0,0
11/01/2017 16:15,68,69.7,87,65,155,67.1,2,0,0
11/01/2017 16:20,56,70,75,65.5,131,67.4,2,0,0
11/01/2017 16:25,56,68.9,74,64.2,130,66.2,2,0,0
11/01/2017 16:30,63,68.1,82,63.3,145,65.4,2,0,0
11/01/2017 16:35,62,68.7,82,64.1,144,66.1,2,0,0
11/01/2017 16:40,57,68,75,63.3,132,65.3,2,0,0
11/01/2017 16:45,62,67.5,81,62.7,143,64.8,2,0,0
11/01/2017 16:50,59,67.1,77,62.2,136,64.3,2,0,0
11/01/2017 16:55,57,67.4,75,62.5,132,64.6,2,0,0
11/01/2017 17:00,59,68.5,77,63.8,136,65.8,2,0,0
11/01/2017 17:05,55,68.8,73,64,128,66.1,2,0,0
11/01/2017 17:10,56,68.5,75,63.8,131,65.8,2,0,0
11/01/2017 17:15,52,68.5,70,63.8,122,65.8,2,0,0
11/01/2017 17:20,55,68.5,74,63.8,129,65.8,2,0,0
11/01/2017 17:25,59,68.8,78,64,137,66,2,0,0
11/01/2017 17:30,47,69.4,65,64.7,112,66.7,2,0,0
11/01/2017 17:35,56,68.6,74,63.9,130,65.9,2,0,0
11/01/2017 17:40,45,69.5,63,64.9,108,66.8,2,0,0
11/01/2017 17:45,50,69.7,69,65.1,119,67,2,0,0
11/01/2017 17:50,60,67.8,80,63,140,65.1,2,0,0
11/01/2017 17:55,60,68.2,78,63.5,138,65.5,2,0,0
11/01/2017 18:00,45,69.1,62,64.5,107,66.4,2,0,0
11/01/2017 18:05,44,69.4,61,64.8,105,66.8,2,0,0
11/01/2017 18:10,58,69.7,76,65.1,134,67.1,2,0,0
11/01/2017 18:15,53,69.4,72,64.8,125,66.7,2,0,0
11/01/2017 18:20,52,68.4,70,63.6,122,65.7,2,0,0
11/01/2017 18:25,46,68.9,64,64.2,110,66.2,2,0,0
11/01/2017 18:30,50,68,68,63.2,118,65.2,2,0,0
11/01/2017 18:35,46,68,63,63.3,109,65.3,2,0,0
11/01/2017 18:40,46,68.2,63,63.4,109,65.4,2,0,0
11/01/2017 18:45,46,67.6,64,62.8,110,64.8,2,0,0
11/01/2017 18:50,45,67.9,62,63.1,107,65.1,2,0,0
11/01/2017 18:55,38,68.1,55,63.3,93,65.2,2,0,0
11/01/2017 19:00,42,68.2,59,63.5,101,65.4,2,0,0
11/01/2017 19:05,55,68.6,72,64,127,66,2,0,0
11/01/2017 19:10,47,68.6,65,64,112,66,2,0,0
11/01/2017 19:15,45,67,63,62.2,108,64.2,2,0,0
11/01/2017 19:20,41,67.9,58,63.1,99,65.1,2,0,0
11/01/2017 19:25,42,67.1,59,62.3,101,64.3,2,0,0
11/01/2017 19:30,47,67.9,65,63.2,112,65.2,2,0,0
11/01/2017 19:35,36,68.2,53,63.5,89,65.4,2,0,0
11/01/2017 19:40,36,68.8,53,64.1,89,66,2,0,0
11/01/2017 19:45,39,68.8,56,64.1,95,66,2,0,0
11/01/2017 19:50,32,68.6,49,63.9,81,65.8,2,0,0
11/01/2017 19:55,28,68.9,45,64.2,73,66,2,0,0
11/01/2017 20:00,28,69.1,44,64.4,72,66.2,2,0,0
11/01/2017 20:05,27,69.3,44,64.7,71,66.4,2,0,0
11/01/2017 20:10,33,69.2,50,64.6,83,66.4,2,0,0
11/01/2017 20:15,31,69.9,47,65.3,78,67.2,2,0,0
11/01/2017 20:20,26,69.8,41,65.2,67,66.9,2,0,0
11/01/2017 20:25,34,68.9,51,64.2,85,66.1,2,0,0
11/01/2017 20:30,29,68,45,63.3,74,65.2,2,0,0
11/01/2017 20:35,37,69,54,64.4,91,66.3,2,0,0
11/01/2017 20:40,31,68.6,47,64,78,65.9,2,0,0
11/01/2017 20:45,27,69.1,42,64.5,69,66.3,2,0,0
11/01/2017 20:50,32,68.2,49,63.6,81,65.4,2,0,0
11/01/2017 20:55,27,68.7,43,64,70,65.8,2,0,0
11/01/2017 21:00,28,68.6,44,63.9,72,65.7,2,0,0
11/01/2017 21:05,27,69.1,43,64.5,70,66.3,2,0,0
11/01/2017 21:10,22,69.2,38,64.6,60,66.3,2,0,0
11/01/2017 21:15,28,69.5,43,65,71,66.8,2,0,0
11/01/2017 21:20,26,69.4,42,64.8,68,66.6,2,0,0
11/01/2017 21:25,28,68.5,44,63.8,72,65.7,2,0,0
11/01/2017 21:30,24,68.4,39,63.8,63,65.5,2,0,0
11/01/2017 21:35,27,69.2,43,64.5,70,66.3,2,0,0
11/01/2017 21:40,25,68.8,41,64.1,66,65.9,2,0,0
11/01/2017 21:45,23,69.3,38,64.7,61,66.5,2,0,0
11/01/2017 21:50,25,69.8,41,65.2,66,66.9,2,0,0
11/01/2017 21:55,22,69.6,37,65,59,66.7,2,0,0
11/01/2017 22:00,22,69.1,37,64.5,59,66.2,2,0,0
11/01/2017 22:05,21,69.7,36,65.1,57,66.8,2,0,0
11/01/2017 22:10,16,69.6,31,65,47,66.6,2,0,0
11/01/2017 22:15,20,69.6,35,65,55,66.7,2,0,0
11/01/2017 22:20,18,69.7,33,65.2,51,66.8,2,0,0
11/01/2017 22:25,20,69.1,36,64.5,56,66.2,2,0,0
11/01/2017 22:30,20,68.8,35,64.1,55,65.8,2,0,0
11/01/2017 22:35,16,69.1,31,64.5,47,66.1,2,0,0
11/01/2017 22:40,18,69.4,33,64.8,51,66.4,2,0,0
11/01/2017 22:45,15,69.5,30,64.9,45,66.4,2,0,0
11/01/2017 22:50,18,69.7,34,65.2,52,66.7,2,0,0
11/01/2017 22:55,12,69.6,27,65,39,66.5,2,0,0
11/01/2017 23:00,16,69.2,32,64.6,48,66.1,2,0,0
11/01/2017 23:05,9,69.2,24,64.6,33,65.8,2,0,0
11/01/2017 23:10,11,69.3,26,64.7,37,66.1,2,0,0
11/01/2017 23:15,12,69.3,27,64.7,39,66.1,2,0,0
11/01/2017 23:20,12,69.3,27,64.7,39,66.2,2,0,0
11/01/2017 23:25,11,69.4,27,64.8,38,66.1,2,0,0
11/01/2017 23:30,10,69.3,25,64.7,35,66.1,2,0,0
11/01/2017 23:35,10,69.4,25,64.7,35,66.1,2,0,0
11/01/2017 23:40,13,69.3,28,64.7,41,66.2,2,0,0
11/01/2017 23:45,13,69.4,28,64.8,41,66.3,2,0,0
11/01/2017 23:50,11,69.4,26,64.8,37,66.2,2,0,0
11/01/2017 23:55,13,69.4,29,64.8,42,66.2,2,0,0
11/02/2017 0:00,10,69.3,25,64.7,35,66.1,2,0,0
11/02/2017 0:05,7,69.3,23,64.7,30,65.7,2,0,0
11/02/2017 0:10,9,69.3,24,64.7,33,66,2,0,0
11/02/2017 0:15,10,69,26,64.4,36,65.6,2,0,0
11/02/2017 0:20,10,69.2,25,64.6,35,65.9,2,0,0
11/02/2017 0:25,7,69.3,22,64.7,29,65.8,2,0,0
11/02/2017 0:30,7,69.4,22,64.7,29,65.9,2,0,0
11/02/2017 0:35,5,69.3,21,64.7,26,65.6,2,0,0
11/02/2017 0:40,6,69.4,21,64.8,27,65.8,2,0,0
11/02/2017 0:45,7,69.4,22,64.8,29,65.9,2,0,0
11/02/2017 0:50,14,69.4,22,64.8,36,66.6,2,0,0
11/02/2017 0:55,6,69.2,21,64.5,27,65.6,2,0,0
11/02/2017 1:00,6,69.3,21,64.7,27,65.7,2,0,0
11/02/2017 1:05,7,69.4,22,64.8,29,65.9,2,0,0
11/02/2017 1:10,7,69.2,22,64.5,29,65.7,2,0,0
11/02/2017 1:15,5,69.2,21,64.6,26,65.5,2,0,0
11/02/2017 1:20,10,69.3,20,64.7,30,66.2,2,0,0
11/02/2017 1:25,8,69.4,23,64.8,31,66,2,0,0
11/02/2017 1:30,7,69.4,22,64.8,29,65.9,2,0,0
11/02/2017 1:35,8,69.3,23,64.7,31,65.9,2,0,0
11/02/2017 1:40,7,69.3,22,64.7,29,65.8,2,0,0
11/02/2017 1:45,5,69.2,20,64.5,25,65.4,2,0,0
11/02/2017 1:50,5,69,20,64.4,25,65.3,2,0,0
11/02/2017 1:55,8,69,23,64.3,31,65.5,2,0,0
11/02/2017 2:00,5,69.1,21,64.5,26,65.4,2,0,0
11/02/2017 2:05,8,69.2,19,64.5,27,65.9,2,0,0
11/02/2017 2:10,6,69.3,21,64.7,27,65.7,2,0,0
11/02/2017 2:15,7,69.3,22,64.7,29,65.8,2,0,0
11/02/2017 2:20,7,69.3,22,64.7,29,65.8,2,0,0
11/02/2017 2:25,6,69.3,22,64.7,28,65.7,2,0,0
11/02/2017 2:30,8,69.4,23,64.8,31,66,2,0,0
11/02/2017 2:35,6,69.3,22,64.7,28,65.7,2,0,0
11/02/2017 2:40,8,69.4,24,64.8,32,65.9,2,0,0
11/02/2017 2:45,8,69.3,24,64.7,32,65.8,2,0,0
11/02/2017 2:50,10,69.4,25,64.8,35,66.2,2,0,0
11/02/2017 2:55,8,69.4,24,64.8,32,65.9,2,0,0
11/02/2017 3:00,8,69.4,23,64.8,31,66,2,0,0
11/02/2017 3:05,7,69.4,22,64.7,29,65.9,2,0,0
11/02/2017 3:10,9,69.4,25,64.7,34,66,2,0,0
11/02/2017 3:15,11,69.1,26,64.5,37,65.8,2,0,0
11/02/2017 3:20,10,69.3,26,64.7,36,66,2,0,0
11/02/2017 3:25,10,69.1,26,64.5,36,65.8,2,0,0
11/02/2017 3:30,6,69.1,21,64.5,27,65.5,2,0,0
11/02/2017 3:35,12,69.3,28,64.7,40,66.1,2,0,0
11/02/2017 3:40,13,69.3,29,64.7,42,66.2,2,0,0
11/02/2017 3:45,11,69.4,27,64.8,38,66.1,2,0,0
11/02/2017 3:50,11,69.2,27,64.5,38,65.9,2,0,0
11/02/2017 3:55,13,69.2,29,64.5,42,66,2,0,0
11/02/2017 4:00,15,69.1,30,64.5,45,66,2,0,0
11/02/2017 4:05,15,69.3,31,64.7,46,66.2,2,0,0
11/02/2017 4:10,17,69.2,33,64.6,50,66.2,2,0,0
11/02/2017 4:15,22,69.5,39,64.9,61,66.6,2,0,0
11/02/2017 4:20,19,69.3,35,64.7,54,66.3,2,0,0
11/02/2017 4:25,21,69.5,37,64.9,58,66.6,2,0,0
11/02/2017 4:30,30,69.5,48,64.9,78,66.7,2,0,0
11/02/2017 4:35,27,69.8,45,65.3,72,67,2,0,0
11/02/2017 4:40,27,69.2,44,64.6,71,66.4,2,0,0
11/02/2017 4:45,39,69.5,57,64.9,96,66.8,2,0,0
11/02/2017 4:50,39,69.8,57,65.2,96,67,2,0,0
11/02/2017 4:55,42,70,60,65.4,102,67.3,2,0,0
11/02/2017 5:00,35,69.7,53,65.1,88,67,2,0,0
11/02/2017 5:05,39,67.8,58,63.1,97,65,2,0,0
11/02/2017 5:10,47,68.2,66,63.5,113,65.4,2,0,0
11/02/2017 5:15,47,68.4,66,63.7,113,65.6,2,0,0
11/02/2017 5:20,49,68.3,68,63.6,117,65.6,2,0,0
11/02/2017 5:25,63,66.9,85,62.1,148,64.1,2,0,0
11/02/2017 5:30,61,67.6,82,62.8,143,64.8,2,0,0
11/02/2017 5:35,59,66.3,80,61.4,139,63.5,2,0,0
11/02/2017 5:40,57,67,78,62.1,135,64.1,2,0,0
11/02/2017 5:45,66,66,88,61.1,154,63.2,2,0,0
11/02/2017 5:50,68,66.6,90,61.8,158,63.9,2,0,0
11/02/2017 5:55,63,67,84,62.2,147,64.3,2,0,0
11/02/2017 6:00,72,67.5,94,62.6,166,64.8,2,0,0
11/02/2017 6:05,57,68,79,63.2,136,65.2,2,0,0
11/02/2017 6:10,60,67.6,81,62.8,141,64.8,2,0,0
11/02/2017 6:15,66,66.5,88,61.5,154,63.6,2,0,0
11/02/2017 6:20,58,67.1,79,62.1,137,64.2,2,0,0
11/02/2017 6:25,67,67.4,89,62.5,156,64.6,2,0,0
11/02/2017 6:30,66,67.5,87,62.7,153,64.8,2,0,0
11/02/2017 6:35,74,66.4,96,61.4,170,63.6,2,0,0
11/02/2017 6:40,73,68.3,95,63.4,168,65.5,2,0,0
11/02/2017 6:45,76,67.5,98,62.6,174,64.7,2,0,0
11/02/2017 6:50,73,67,96,62.1,169,64.2,2,0,0
11/02/2017 6:55,62,66.9,83,62,145,64.1,2,0,0
11/02/2017 7:00,73,67.3,95,62.4,168,64.5,2,0,0
11/02/2017 7:05,69,67.1,91,62.2,160,64.3,2,0,0
11/02/2017 7:10,73,66,96,61,169,63.2,2,0,0
11/02/2017 7:15,67,66.5,88,61.5,155,63.6,2,0,0
11/02/2017 7:20,87,65.4,110,60.3,197,62.6,2,0,0
11/02/2017 7:25,78,65.6,101,60.6,179,62.8,2,0,0
11/02/2017 7:30,97,66.8,121,61.8,218,64,2,0,0
11/02/2017 7:35,87,66.2,111,61.3,198,63.5,2,0,0
11/02/2017 7:40,85,66.8,110,61.9,195,64,2,0,0
11/02/2017 7:45,93,67.5,117,62.7,210,64.8,2,0,0
11/02/2017 7:50,94,66.7,119,61.9,213,64,2,0,0
11/02/2017 7:55,84,67.7,107,62.9,191,65.1,2,0,0
11/02/2017 8:00,79,67.1,102,62.2,181,64.3,2,0,0
11/02/2017 8:05,64,67.9,85,63.1,149,65.2,2,0,0
11/02/2017 8:10,84,66.6,108,61.7,192,63.8,2,0,0
11/02/2017 8:15,82,67.4,104,62.6,186,64.7,2,0,0
11/02/2017 8:20,83,67.4,106,62.5,189,64.7,2,0,0
11/02/2017 8:25,79,67.2,100,62.2,179,64.4,2,0,0
11/02/2017 8:30,70,67.3,92,62.4,162,64.6,2,0,0
11/02/2017 8:35,76,66.9,99,62,175,64.1,2,0,0
11/02/2017 8:40,89,66,111,61.1,200,63.3,2,0,0
11/02/2017 8:45,86,66.9,108,61.9,194,64.1,2,0,0
11/02/2017 8:50,79,66.9,101,62,180,64.1,2,0,0
11/02/2017 8:55,83,65,105,60,188,62.2,2,0,0
11/02/2017 9:00,77,63.8,99,58.7,176,60.9,2,0,0
11/02/2017 9:05,76,64.7,98,59.6,174,61.8,2,0,0
11/02/2017 9:10,65,64.9,85,59.9,150,62.1,2,0,0
11/02/2017 9:15,65,66.2,85,61.3,150,63.4,2,0,0
11/02/2017 9:20,66,65.5,86,60.5,152,62.7,2,0,0
11/02/2017 9:25,68,66.8,89,62,157,64.1,2,0,0
11/02/2017 9:30,65,68.3,86,63.5,151,65.6,2,0,0
11/02/2017 9:35,63,67.7,83,63,146,65,2,0,0
11/02/2017 9:40,68,67.1,89,62.2,157,64.3,2,0,0
11/02/2017 9:45,73,66.9,94,62,167,64.1,2,0,0
11/02/2017 9:50,69,66.6,88,61.6,157,63.8,2,0,0
11/02/2017 9:55,74,66,94,61,168,63.2,2,0,0
11/02/2017 10:00,69,66.4,88,61.5,157,63.6,2,0,0
11/02/2017 10:05,64,68.8,83,64.1,147,66.1,2,0,0
11/02/2017 10:10,66,68.4,86,63.7,152,65.8,2,0,0
11/02/2017 10:15,65,67.6,84,62.8,149,64.9,2,0,0
11/02/2017 10:20,80,67.5,101,62.7,181,64.8,2,0,0
11/02/2017 10:25,70,66.9,89,62.1,159,64.2,2,0,0
11/02/2017 10:30,66,68,86,63.3,152,65.3,2,0,0
11/02/2017 10:35,66,67.5,85,62.8,151,64.9,2,0,0
11/02/2017 10:40,66,67.5,85,62.8,151,64.9,2,0,0
11/02/2017 10:45,66,67.9,85,63.2,151,65.3,2,0,0
11/02/2017 10:50,58,68.3,77,63.6,135,65.6,2,0,0
11/02/2017 10:55,59,67.3,78,62.5,137,64.6,2,0,0
11/02/2017 11:00,68,67.2,87,62.5,155,64.6,2,0,0
11/02/2017 11:05,60,67.4,79,62.6,139,64.7,2,0,0
11/02/2017 11:10,55,68.2,73,63.5,128,65.5,2,0,0
11/02/2017 11:15,58,67,77,62.2,135,64.3,2,0,0
11/02/2017 11:20,54,67.5,72,62.7,126,64.8,2,0,0
11/02/2017 11:25,63,68.2,82,63.5,145,65.5,2,0,0
11/02/2017 11:30,70,67.5,89,62.7,159,64.8,2,0,0
11/02/2017 11:35,69,68,89,63.3,158,65.3,2,0,0
11/02/2017 11:40,63,68.2,81,63.6,144,65.6,2,0,0
11/02/2017 11:45,53,66.8,72,62.1,125,64.1,2,0,0
11/02/2017 11:50,55,65.5,73,60.7,128,62.8,2,0,0
11/02/2017 11:55,50,67.3,68,62.7,118,64.6,2,0,0
11/02/2017 12:00,48,67.5,66,62.8,114,64.8,2,0,0
11/02/2017 12:05,57,67.4,76,62.7,133,64.7,2,0,0
11/02/2017 12:10,52,66.3,71,61.6,123,63.6,2,0,0
11/02/2017 12:15,55,66.5,73,61.8,128,63.9,2,0,0
11/02/2017 12:20,62,67.1,81,62.2,143,64.3,2,0,0
11/02/2017 12:25,51,66.3,69,61.4,120,63.5,2,0,0
11/02/2017 12:30,65,66.3,85,61.4,150,63.6,2,0,0
11/02/2017 12:35,47,67.6,64,62.8,111,64.8,2,0,0
11/02/2017 12:40,42,66.7,60,61.9,102,63.9,2,0,0
11/02/2017 12:45,53,67.7,71,62.9,124,65,2,0,0
11/02/2017 12:50,56,67.1,74,62.4,130,64.4,2,0,0
11/02/2017 12:55,54,66.7,71,61.9,125,64,2,0,0
11/02/2017 13:00,50,66.9,67,62.2,117,64.2,2,0,0
11/02/2017 13:05,50,67.3,68,62.5,118,64.5,2,0,0
11/02/2017 13:10,54,66.6,72,61.7,126,63.8,2,0,0
11/02/2017 13:15,54,66.4,72,61.5,126,63.6,2,0,0
11/02/2017 13:20,50,65.9,68,61.1,118,63.1,2,0,0
11/02/2017 13:25,54,65.2,72,60.3,126,62.4,2,0,0
11/02/2017 13:30,58,65.5,77,60.5,135,62.7,2,0,0
11/02/2017 13:35,46,67.6,64,62.8,110,64.8,2,0,0
11/02/2017 13:40,56,67.8,74,63.1,130,65.2,2,0,0
11/02/2017 13:45,50,66.8,68,62,118,64,2,0,0
11/02/2017 13:50,53,67.5,71,62.8,124,64.8,2,0,0
11/02/2017 13:55,55,67.5,73,62.7,128,64.8,2,0,0
11/02/2017 14:00,50,68.2,67,63.5,117,65.5,2,0,0
11/02/2017 14:05,48,68.4,65,63.7,113,65.7,2,0,0
11/02/2017 14:10,48,68.8,66,64.2,114,66.1,2,0,0
11/02/2017 14:15,71,68.4,89,63.8,160,65.8,2,0,0
11/02/2017 14:20,54,67.7,73,63,127,65,2,0,0
11/02/2017 14:25,51,68.5,69,63.8,120,65.8,2,0,0
11/02/2017 14:30,55,68.1,74,63.4,129,65.4,2,0,0
11/02/2017 14:35,53,68.8,71,64.2,124,66.1,2,0,0
11/02/2017 14:40,51,68.6,69,64,120,66,2,0,0
11/02/2017 14:45,58,67.5,76,62.8,134,64.9,2,0,0
11/02/2017 14:50,52,67.8,71,63.1,123,65.1,2,0,0
11/02/2017 14:55,48,68.5,65,63.9,113,65.8,2,0,0
11/02/2017 15:00,44,68.6,61,63.9,105,65.8,2,0,0
11/02/2017 15:05,55,68.4,73,63.7,128,65.7,2,0,0
11/02/2017 15:10,59,66.3,78,61.5,137,63.6,2,0,0
11/02/2017 15:15,55,67.4,73,62.7,128,64.7,2,0,0
11/02/2017 15:20,54,67.2,72,62.5,126,64.5,2,0,0
11/02/2017 15:25,46,69.2,63,64.6,109,66.5,2,0,0
11/02/2017 15:30,60,69.1,79,64.5,139,66.5,2,0,0
11/02/2017 15:35,52,68,71,63.2,123,65.2,2,0,0
11/02/2017 15:40,70,68.5,90,63.9,160,65.9,2,0,0
11/02/2017 15:45,57,69,76,64.4,133,66.4,2,0,0
11/02/2017 15:50,58,69.7,77,65.1,135,67.1,2,0,0
11/02/2017 15:55,64,69.1,83,64.5,147,66.5,2,0,0
11/02/2017 16:00,59,69.4,78,64.8,137,66.8,2,0,0
11/02/2017 16:05,62,70,82,65.5,144,67.5,2,0,0
11/02/2017 16:10,51,70,69,65.5,120,67.4,2,0,0
11/02/2017 16:15,58,68.5,77,63.9,135,65.9,2,0,0
11/02/2017 16:20,53,68.1,71,63.4,124,65.4,2,0,0
11/02/2017 16:25,50,69.4,68,64.8,118,66.7,2,0,0
11/02/2017 16:30,53,69,71,64.4,124,66.4,2,0,0
11/02/2017 16:35,57,68.8,76,64.2,133,66.2,2,0,0
11/02/2017 16:40,52,69.4,70,64.8,122,66.7,2,0,0
11/02/2017 16:45,57,68.1,74,63.3,131,65.4,2,0,0
11/02/2017 16:50,55,68,73,63.2,128,65.3,2,0,0
11/02/2017 16:55,62,67.6,81,62.7,143,64.8,2,0,0
11/02/2017 17:00,46,68.5,63,63.8,109,65.8,2,0,0
11/02/2017 17:05,62,68.9,81,64.2,143,66.2,2,0,0
11/02/2017 17:10,60,68.5,78,63.7,138,65.8,2,0,0
11/02/2017 17:15,49,69.7,67,65.1,116,67,2,0,0
11/02/2017 17:20,57,70,76,65.4,133,67.3,2,0,0
11/02/2017 17:25,59,69.6,79,65,138,66.9,2,0,0
11/02/2017 17:30,56,68.6,74,63.9,130,65.9,2,0,0
11/02/2017 17:35,52,68.7,70,64,122,66,2,0,0
11/02/2017 17:40,55,68,73,63.3,128,65.3,2,0,0
11/02/2017 17:45,59,69,78,64.4,137,66.4,2,0,0
11/02/2017 17:50,59,69.6,78,65,137,67,2,0,0
11/02/2017 17:55,58,68.8,77,64.2,135,66.2,2,0,0
11/02/2017 18:00,52,68.7,70,64,122,66,2,0,0
11/02/2017 18:05,46,69,64,64.4,110,66.3,2,0,0
11/02/2017 18:10,57,69.7,76,65.1,133,67,2,0,0
11/02/2017 18:15,49,69.3,67,64.7,116,66.6,2,0,0
11/02/2017 18:20,51,69.2,69,64.6,120,66.6,2,0,0
11/02/2017 18:25,53,68.3,72,63.6,125,65.6,2,0,0
11/02/2017 18:30,45,67.6,63,62.9,108,64.9,2,0,0
11/02/2017 18:35,45,69.1,63,64.5,108,66.4,2,0,0
11/02/2017 18:40,61,67.9,79,63.1,140,65.2,2,0,0
11/02/2017 18:45,49,66.9,68,62,117,64,2,0,0
11/02/2017 18:50,48,67.7,65,63,113,65,2,0,0
11/02/2017 18:55,49,68.3,66,63.5,115,65.6,2,0,0
11/02/2017 19:00,38,68.3,55,63.5,93,65.5,2,0,0
11/02/2017 19:05,38,68.2,55,63.4,93,65.4,2,0,0
11/02/2017 19:10,47,67.1,66,62.2,113,64.2,2,0,0
11/02/2017 19:15,52,68.4,71,63.7,123,65.7,2,0,0
11/02/2017 19:20,42,68.6,60,63.9,102,65.8,2,0,0
11/02/2017 19:25,51,65.3,69,60.3,120,62.4,2,0,0
11/02/2017 19:30,44,67.5,61,62.7,105,64.7,2,0,0
11/02/2017 19:35,41,68.1,58,63.4,99,65.3,2,0,0
11/02/2017 19:40,40,69,57,64.4,97,66.3,2,0,0
11/02/2017 19:45,47,69.4,65,64.8,112,66.7,2,0,0
11/02/2017 19:50,39,67.2,56,62.5,95,64.4,2,0,0
11/02/2017 19:55,34,68.2,51,63.5,85,65.4,2,0,0
11/02/2017 20:00,37,68.5,55,63.9,92,65.8,2,0,0
11/02/2017 20:05,40,69.5,57,64.9,97,66.8,2,0,0
11/02/2017 20:10,37,70.6,54,66.1,91,67.9,2,0,0
11/02/2017 20:15,34,70.5,51,66,85,67.8,2,0,0
11/02/2017 20:20,33,69.8,49,65.3,82,67.1,2,0,0
11/02/2017 20:25,32,69.5,49,64.9,81,66.7,2,0,0
11/02/2017 20:30,29,69.5,45,65,74,66.8,2,0,0
11/02/2017 20:35,41,69,58,64.4,99,66.3,2,0,0
11/02/2017 20:40,37,70,53,65.5,90,67.3,2,0,0
11/02/2017 20:45,39,70.2,56,65.7,95,67.6,2,0,0
11/02/2017 20:50,35,70.6,51,66.1,86,67.9,2,0,0
11/02/2017 20:55,25,69,41,64.4,66,66.1,2,0,0
11/02/2017 21:00,33,68.9,49,64.3,82,66.1,2,0,0
11/02/2017 21:05,33,69,49,64.4,82,66.3,2,0,0
11/02/2017 21:10,30,69.3,47,64.8,77,66.5,2,0,0
11/02/2017 21:15,34,69.2,52,64.5,86,66.4,2,0,0
11/02/2017 21:20,26,69.2,43,64.6,69,66.4,2,0,0
11/02/2017 21:25,30,69.7,46,65.1,76,66.9,2,0,0
11/02/2017 21:30,26,69.8,43,65.2,69,66.9,2,0,0
11/02/2017 21:35,29,69.5,45,64.9,74,66.7,2,0,0
11/02/2017 21:40,22,69.6,38,65,60,66.7,2,0,0
11/02/2017 21:45,27,69.9,43,65.3,70,67.1,2,0,0
11/02/2017 21:50,22,69.1,39,64.4,61,66.1,2,0,0
11/02/2017 21:55,27,68.9,42,64.2,69,66,2,0,0
11/02/2017 22:00,23,69.1,39,64.5,62,66.2,2,0,0
11/02/2017 22:05,18,69.4,33,64.7,51,66.4,2,0,0
11/02/2017 22:10,18,69.3,34,64.7,52,66.3,2,0,0
11/02/2017 22:15,21,69.5,36,64.9,57,66.5,2,0,0
11/02/2017 22:20,20,69.5,35,64.9,55,66.6,2,0,0
11/02/2017 22:25,18,69,33,64.4,51,66,2,0,0
11/02/2017 22:30,17,69.2,32,64.5,49,66.1,2,0,0
11/02/2017 22:35,21,69.3,36,64.7,57,66.4,2,0,0
11/02/2017 22:40,21,69.3,38,64.7,59,66.4,2,0,0
11/02/2017 22:45,20,69.4,36,64.8,56,66.4,2,0,0
11/02/2017 22:50,16,69.1,31,64.5,47,66,2,0,0
11/02/2017 22:55,18,69.1,33,64.5,51,66.1,2,0,0
11/02/2017 23:00,20,68.8,35,64.2,55,65.9,2,0,0
11/02/2017 23:05,16,69.1,31,64.4,47,66,2,0,0
11/02/2017 23:10,14,69.3,29,64.7,43,66.2,2,0,0
11/02/2017 23:15,17,69.3,33,64.7,50,66.2,2,0,0
11/02/2017 23:20,15,69.3,30,64.7,45,66.2,2,0,0
11/02/2017 23:25,16,69.4,32,64.8,48,66.3,2,0,0
11/02/2017 23:30,14,69.4,30,64.8,44,66.3,2,0,0
11/02/2017 23:35,15,69.5,31,64.9,46,66.4,2,0,0
11/02/2017 23:40,15,69.3,31,64.7,46,66.2,2,0,0
11/02/2017 23:45,14,69.3,29,64.7,43,66.2,2,0,0
11/02/2017 23:50,16,69,32,64.4,48,66,2,0,0
11/02/2017 23:55,12,69.3,27,64.7,39,66.1,2,0,0
11/03/2017 0:00,9,69.3,24,64.7,33,66,2,0,0
11/03/2017 0:05,12,69.3,27,64.7,39,66.2,2,0,0
11/03/2017 0:10,14,69.4,29,64.7,43,66.2,2,0,0
11/03/2017 0:15,13,69.5,28,64.9,41,66.4,2,0,0
11/03/2017 0:20,15,69.3,30,64.7,45,66.2,2,0,0
11/03/2017 0:25,6,69.1,22,64.5,28,65.5,2,0,0
11/03/2017 0:30,9,69.2,24,64.6,33,65.9,2,0,0
11/03/2017 0:35,7,69.3,23,64.7,30,65.8,2,0,0
11/03/2017 0:40,10,69.3,26,64.7,36,66,2,0,0
11/03/2017 0:45,10,69.4,25,64.8,35,66.1,2,0,0
11/03/2017 0:50,7,69.2,22,64.6,29,65.7,2,0,0
11/03/2017 0:55,9,69.2,24,64.6,33,65.9,2,0,0
11/03/2017 1:00,9,69.4,24,64.8,33,66,2,0,0
11/03/2017 1:05,7,69.4,22,64.8,29,65.9,2,0,0
11/03/2017 1:10,10,69.4,20,64.8,30,66.3,2,0,0
11/03/2017 1:15,11,69.4,26,64.8,37,66.1,2,0,0
11/03/2017 1:20,10,69.5,25,64.9,35,66.2,2,0,0
11/03/2017 1:25,8,69.5,23,64.9,31,66.1,2,0,0
11/03/2017 1:30,6,69.4,21,64.8,27,65.9,2,0,0
11/03/2017 1:35,7,69.4,22,64.7,29,65.9,2,0,0
11/03/2017 1:40,5,69.4,21,64.8,26,65.7,2,0,0
11/03/2017 1:45,6,69.4,21,64.8,27,65.9,2,0,0
11/03/2017 1:50,6,69.2,22,64.5,28,65.5,2,0,0
11/03/2017 1:55,9,69.4,24,64.8,33,66.1,2,0,0
11/03/2017 2:00,8,69.5,23,64.9,31,66.1,2,0,0
11/03/2017 2:05,8,69.6,23,65,31,66.2,2,0,0
11/03/2017 2:10,7,69.5,23,64.9,30,66,2,0,0
11/03/2017 2:15,6,69.2,21,64.6,27,65.6,2,0,0
11/03/2017 2:20,6,69.3,21,64.7,27,65.8,2,0,0
11/03/2017 2:25,7,69.3,22,64.7,29,65.8,2,0,0
11/03/2017 2:30,8,69.2,24,64.5,32,65.7,2,0,0
11/03/2017 2:35,8,69,24,64.4,32,65.5,2,0,0
11/03/2017 2:40,11,69.2,26,64.5,37,65.9,2,0,0
11/03/2017 2:45,8,69.1,24,64.5,32,65.6,2,0,0
11/03/2017 2:50,10,69.2,26,64.5,36,65.8,2,0,0
11/03/2017 2:55,11,69,27,64.4,38,65.7,2,0,0
11/03/2017 3:00,10,69.2,25,64.6,35,65.9,2,0,0
11/03/2017 3:05,11,69.4,27,64.8,38,66.1,2,0,0
11/03/2017 3:10,13,69.3,29,64.7,42,66.2,2,0,0
11/03/2017 3:15,10,69.3,25,64.6,35,65.9,2,0,0
11/03/2017 3:20,11,69.2,27,64.5,38,65.9,2,0,0
11/03/2017 3:25,7,69.3,23,64.7,30,65.7,2,0,0
11/03/2017 3:30,13,69.1,28,64.5,41,65.9,2,0,0
11/03/2017 3:35,13,69.1,29,64.5,42,65.9,2,0,0
11/03/2017 3:40,14,69.2,30,64.5,44,66,2,0,0
11/03/2017 3:45,13,69.3,29,64.7,42,66.1,2,0,0
11/03/2017 3:50,13,68.7,28,64,41,65.5,2,0,0
11/03/2017 3:55,15,68.9,30,64.2,45,65.8,2,0,0
11/03/2017 4:00,14,68.9,30,64.3,44,65.7,2,0,0
11/03/2017 4:05,14,69.1,29,64.4,43,65.9,2,0,0
11/03/2017 4:10,21,69.2,36,64.6,57,66.3,2,0,0
11/03/2017 4:15,20,68.7,36,64.1,56,65.7,2,0,0
11/03/2017 4:20,25,68.6,42,63.9,67,65.7,2,0,0
11/03/2017 4:25,19,69,35,64.3,54,66,2,0,0
11/03/2017 4:30,32,68.5,49,63.8,81,65.7,2,0,0
11/03/2017 4:35,30,68.1,47,63.4,77,65.3,2,0,0
11/03/2017 4:40,33,68.3,51,63.6,84,65.4,2,0,0
11/03/2017 4:45,37,67.5,55,62.7,92,64.6,2,0,0
11/03/2017 4:50,36,67.4,55,62.5,91,64.4,2,0,0
11/03/2017 4:55,42,68.3,60,63.5,102,65.5,2,0,0
11/03/2017 5:00,45,69.2,65,64.6,110,66.5,2,0,0
11/03/2017 5:05,40,68.5,57,63.8,97,65.8,2,0,0
11/03/2017 5:10,41,67.8,60,63.1,101,65,2,0,0
11/03/2017 5:15,42,67.8,62,63,104,64.9,2,0,0
11/03/2017 5:20,46,67.3,64,62.5,110,64.5,2,0,0
11/03/2017 5:25,48,68.2,67,63.4,115,65.4,2,0,0
11/03/2017 5:30,57,67.2,77,62.4,134,64.4,2,0,0
11/03/2017 5:35,53,67.7,73,62.9,126,64.9,2,0,0
11/03/2017 5:40,59,67.1,80,62.2,139,64.3,2,0,0
11/03/2017 5:45,57,66.7,79,61.9,136,63.9,2,0,0
11/03/2017 5:50,60,66.5,81,61.7,141,63.8,2,0,0
11/03/2017 5:55,64,67.5,85,62.8,149,64.8,2,0,0
11/03/2017 6:00,59,66.3,80,61.3,139,63.4,2,0,0
11/03/2017 6:05,61,66.6,81,61.6,142,63.8,2,0,0
11/03/2017 6:10,61,66.8,83,61.8,144,63.9,2,0,0
11/03/2017 6:15,66,65.9,87,60.8,153,63,2,0,0
11/03/2017 6:20,58,66,79,60.9,137,63.1,2,0,0
11/03/2017 6:25,61,67.3,83,62.3,144,64.4,2,0,0
11/03/2017 6:30,60,65.3,82,60.2,142,62.4,2,0,0
11/03/2017 6:35,71,65.9,94,60.8,165,63,2,0,0
11/03/2017 6:40,63,66.1,84,61,147,63.2,2,0,0
11/03/2017 6:45,66,65.4,87,60.3,153,62.5,2,0,0
11/03/2017 6:50,66,65.1,87,60,153,62.2,2,0,0
11/03/2017 6:55,71,64.9,92,59.8,163,62,2,0,0
11/03/2017 7:00,60,64.4,81,59.1,141,61.4,2,0,0
11/03/2017 7:05,69,63.8,91,58.6,160,60.8,2,0,0
11/03/2017 7:10,72,64.2,94,59,166,61.3,2,0,0
11/03/2017 7:15,73,63.7,96,58.5,169,60.8,2,0,0
11/03/2017 7:20,87,63.1,110,57.7,197,60.1,2,0,0
11/03/2017 7:25,81,64.6,103,59.3,184,61.6,2,0,0
11/03/2017 7:30,81,65.8,104,60.7,185,62.9,2,0,0
11/03/2017 7:35,85,65.6,109,60.5,194,62.7,2,0,0
11/03/2017 7:40,89,66,112,61,201,63.2,2,0,0
11/03/2017 7:45,82,66.7,103,61.7,185,63.9,2,0,0
11/03/2017 7:50,96,66.7,120,61.7,216,63.9,2,0,0
11/03/2017 7:55,87,66.5,111,61.5,198,63.7,2,0,0
11/03/2017 8:00,82,66.4,105,61.4,187,63.6,2,0,0
11/03/2017 8:05,83,66.5,107,61.5,190,63.7,2,0,0
11/03/2017 8:10,91,66.7,115,61.7,206,63.9,2,0,0
11/03/2017 8:15,80,66.5,102,61.5,182,63.7,2,0,0
11/03/2017 8:20,89,65.8,112,60.8,201,63,2,0,0
11/03/2017 8:25,74,66.9,96,61.9,170,64.1,2,0,0
11/03/2017 8:30,87,67,110,62.1,197,64.2,2,0,0
11/03/2017 8:35,78,66.1,100,61.1,178,63.3,2,0,0
11/03/2017 8:40,78,66.6,100,61.7,178,63.9,2,0,0
11/03/2017 8:45,70,65.2,92,60.2,162,62.4,2,0,0
11/03/2017 8:50,77,65.8,99,60.7,176,62.9,2,0,0
11/03/2017 8:55,80,66.3,102,61.3,182,63.5,2,0,0
11/03/2017 9:00,74,66,95,61,169,63.2,2,0,0
11/03/2017 9:05,74,65.3,97,60.3,171,62.4,2,0,0
11/03/2017 9:10,71,65.5,92,60.5,163,62.7,2,0,0
11/03/2017 9:15,60,65.4,81,60.3,141,62.5,2,0,0
11/03/2017 9:20,66,62.7,87,57.4,153,59.7,2,0,0
11/03/2017 9:25,58,64.9,77,59.8,135,62,2,0,0
11/03/2017 9:30,53,66.5,71,61.5,124,63.6,2,0,0
11/03/2017 9:35,62,67.7,81,62.9,143,65,2,0,0
11/03/2017 9:40,64,67.2,84,62.3,148,64.4,2,0,0
11/03/2017 9:45,67,66.7,86,61.8,153,64,2,0,0
11/03/2017 9:50,64,67.6,83,62.8,147,64.9,2,0,0
11/03/2017 9:55,62,66.6,82,61.7,144,63.8,2,0,0
11/03/2017 10:00,56,66.9,75,62.1,131,64.1,2,0,0
11/03/2017 10:05,53,66.3,71,61.5,124,63.6,2,0,0
11/03/2017 10:10,54,68.4,72,63.8,126,65.8,2,0,0
11/03/2017 10:15,56,67.8,75,63.1,131,65.1,2,0,0
11/03/2017 10:20,60,67.9,79,63.3,139,65.3,2,0,0
11/03/2017 10:25,66,68.7,84,64.1,150,66.2,2,0,0
11/03/2017 10:30,61,68.7,80,64.1,141,66.1,2,0,0
11/03/2017 10:35,59,66.6,80,61.8,139,63.8,2,0,0
11/03/2017 10:40,60,67.7,79,63,139,65,2,0,0
11/03/2017 10:45,65,68,84,63.2,149,65.3,2,0,0
11/03/2017 10:50,60,66.8,79,62,139,64.1,2,0,0
11/03/2017 10:55,59,68.1,77,63.3,136,65.4,2,0,0
11/03/2017 11:00,56,67.4,75,62.6,131,64.7,2,0,0
11/03/2017 11:05,59,66.4,77,61.5,136,63.6,2,0,0
11/03/2017 11:10,57,65.7,75,60.8,132,62.9,2,0,0
11/03/2017 11:15,58,66.8,76,62,134,64,2,0,0
11/03/2017 11:20,56,67.5,74,62.8,130,64.8,2,0,0
11/03/2017 11:25,64,67.9,82,63.3,146,65.3,2,0,0
11/03/2017 11:30,60,67.6,78,62.8,138,64.9,2,0,0
11/03/2017 11:35,61,68.6,80,64,141,66,2,0,0
11/03/2017 11:40,54,68.3,71,63.5,125,65.6,2,0,0
11/03/2017 11:45,57,70.3,75,65.8,132,67.8,2,0,0
11/03/2017 11:50,61,69,78,64.4,139,66.4,2,0,0
11/03/2017 11:55,64,68.2,83,63.5,147,65.6,2,0,0
11/03/2017 12:00,60,68.5,79,63.7,139,65.8,2,0,0
11/03/2017 12:05,58,68.1,77,63.3,135,65.3,2,0,0
11/03/2017 12:10,50,67.4,68,62.7,118,64.7,2,0,0
11/03/2017 12:15,46,66.2,64,61.3,110,63.3,2,0,0
11/03/2017 12:20,53,67,70,62.2,123,64.2,2,0,0
11/03/2017 12:25,57,66.9,75,62,132,64.1,2,0,0
11/03/2017 12:30,50,66.8,68,62,118,64,2,0,0
11/03/2017 12:35,54,67.9,73,63.1,127,65.1,2,0,0
11/03/2017 12:40,55,67.9,73,63.2,128,65.2,2,0,0
11/03/2017 12:45,53,67,72,62.2,125,64.3,2,0,0
11/03/2017 12:50,43,67.7,61,63.1,104,65,2,0,0
11/03/2017 12:55,49,68,67,63.3,116,65.3,2,0,0
11/03/2017 13:00,51,67.6,69,62.9,120,64.9,2,0,0
11/03/2017 13:05,49,68.2,67,63.5,116,65.5,2,0,0
11/03/2017 13:10,41,68.7,58,64,99,65.9,2,0,0
11/03/2017 13:15,46,68.2,64,63.4,110,65.4,2,0,0
11/03/2017 13:20,68,68,87,63.3,155,65.4,2,0,0
11/03/2017 13:25,37,68.9,53,64.2,90,66.1,2,0,0
11/03/2017 13:30,50,67.9,68,63.1,118,65.1,2,0,0
11/03/2017 13:35,53,66.8,71,62,124,64,2,0,0
11/03/2017 13:40,55,66.5,73,61.6,128,63.7,2,0,0
11/03/2017 13:45,47,67.9,65,63.2,112,65.2,2,0,0
11/03/2017 13:50,45,69.2,63,64.6,108,66.5,2,0,0
11/03/2017 13:55,51,68.4,68,63.8,119,65.8,2,0,0
11/03/2017 14:00,47,68.2,64,63.5,111,65.5,2,0,0
11/03/2017 14:05,50,67.6,68,62.9,118,64.9,2,0,0
11/03/2017 14:10,61,68,80,63.3,141,65.4,2,0,0
11/03/2017 14:15,58,66.9,76,62.1,134,64.2,2,0,0
11/03/2017 14:20,66,66.4,85,61.6,151,63.7,2,0,0
11/03/2017 14:25,63,66.4,83,61.6,146,63.7,2,0,0
11/03/2017 14:30,46,68.1,64,63.4,110,65.3,2,0,0
11/03/2017 14:35,44,67.8,60,63.1,104,65.1,2,0,0
11/03/2017 14:40,52,68,70,63.3,122,65.3,2,0,0
11/03/2017 14:45,55,67.6,73,62.8,128,64.8,2,0,0
11/03/2017 14:50,54,66.4,72,61.5,126,63.6,2,0,0
11/03/2017 14:55,45,67.2,62,62.4,107,64.4,2,0,0
11/03/2017 15:00,57,66.2,75,61.3,132,63.4,2,0,0
11/03/2017 15:05,55,67.4,73,62.7,128,64.7,2,0,0
11/03/2017 15:10,69,68.1,88,63.3,157,65.4,2,0,0
11/03/2017 15:15,66,67,86,62.1,152,64.2,2,0,0
11/03/2017 15:20,54,67.9,72,63.1,126,65.2,2,0,0
11/03/2017 15:25,62,67,81,62.2,143,64.3,2,0,0
11/03/2017 15:30,60,67.2,79,62.4,139,64.4,2,0,0
11/03/2017 15:35,63,68.1,82,63.3,145,65.4,2,0,0
11/03/2017 15:40,60,68.5,78,63.8,138,65.8,2,0,0
11/03/2017 15:45,69,68.1,89,63.3,158,65.4,2,0,0
11/03/2017 15:50,68,67,88,62.1,156,64.2,2,0,0
11/03/2017 15:55,70,66.8,89,61.8,159,64,2,0,0
11/03/2017 16:00,65,68.2,83,63.5,148,65.5,2,0,0
11/03/2017 16:05,59,69,78,64.4,137,66.3,2,0,0
11/03/2017 16:10,67,69.2,85,64.6,152,66.7,2,0,0
11/03/2017 16:15,63,67.3,82,62.5,145,64.6,2,0,0
11/03/2017 16:20,58,68,76,63.2,134,65.3,2,0,0
11/03/2017 16:25,60,66,79,61,139,63.2,2,0,0
11/03/2017 16:30,50,65.4,69,60.3,119,62.4,2,0,0
11/03/2017 16:35,57,64.8,75,59.6,132,61.8,2,0,0
11/03/2017 16:40,54,65.9,73,60.8,127,63,2,0,0
11/03/2017 16:45,57,65.4,76,60.3,133,62.5,2,0,0
11/03/2017 16:50,56,65.7,75,60.7,131,62.9,2,0,0
11/03/2017 16:55,53,66.6,71,61.7,124,63.8,2,0,0
11/03/2017 17:00,53,67.9,71,63.2,124,65.2,2,0,0
11/03/2017 17:05,56,68.2,75,63.5,131,65.5,2,0,0
11/03/2017 17:10,50,69.5,68,65,118,66.9,2,0,0
11/03/2017 17:15,61,69.4,80,64.8,141,66.8,2,0,0
11/03/2017 17:20,52,68.2,70,63.5,122,65.5,2,0,0
11/03/2017 17:25,55,66.7,74,61.8,129,63.9,2,0,0
11/03/2017 17:30,55,67,74,62.2,129,64.2,2,0,0
11/03/2017 17:35,56,66.8,74,61.9,130,64,2,0,0
11/03/2017 17:40,60,67.2,77,62.5,137,64.6,2,0,0
11/03/2017 17:45,57,68,76,63.2,133,65.3,2,0,0
11/03/2017 17:50,52,68.1,70,63.3,122,65.4,2,0,0
11/03/2017 17:55,52,68.3,70,63.5,122,65.6,2,0,0
11/03/2017 18:00,53,67.8,71,63.1,124,65.1,2,0,0
11/03/2017 18:05,54,67.9,72,63.2,126,65.2,2,0,0
11/03/2017 18:10,58,68.1,77,63.3,135,65.4,2,0,0
11/03/2017 18:15,58,66.5,77,61.6,135,63.7,2,0,0
11/03/2017 18:20,54,64.9,72,59.8,126,62,2,0,0
11/03/2017 18:25,54,64.4,72,59.3,126,61.5,2,0,0
11/03/2017 18:30,59,64.9,79,59.8,138,62,2,0,0
11/03/2017 18:35,56,64.4,75,59.2,131,61.4,2,0,0
11/03/2017 18:40,62,65.6,80,60.6,142,62.8,2,0,0
11/03/2017 18:45,57,66.5,75,61.5,132,63.6,2,0,0
11/03/2017 18:50,59,65.8,77,60.9,136,63,2,0,0
11/03/2017 18:55,55,66.7,74,61.9,129,64,2,0,0
11/03/2017 19:00,65,67.1,83,62.3,148,64.4,2,0,0
11/03/2017 19:05,59,67,77,62.2,136,64.3,2,0,0
11/03/2017 19:10,63,67,82,62.1,145,64.3,2,0,0
11/03/2017 19:15,58,66.9,77,62,135,64.1,2,0,0
11/03/2017 19:20,51,67,68,62.1,119,64.2,2,0,0
11/03/2017 19:25,51,64.5,68,59.4,119,61.6,2,0,0
11/03/2017 19:30,48,65.4,65,60.4,113,62.5,2,0,0
11/03/2017 19:35,51,66.5,68,61.6,119,63.7,2,0,0
11/03/2017 19:40,37,68,54,63.2,91,65.2,2,0,0
11/03/2017 19:45,39,68.3,56,63.6,95,65.6,2,0,0
11/03/2017 19:50,43,68.9,61,64.2,104,66.1,2,0,0
11/03/2017 19:55,34,67.7,51,63,85,64.9,2,0,0
11/03/2017 20:00,37,67.9,52,63.2,89,65.1,2,0,0
11/03/2017 20:05,36,68.7,53,64.1,89,65.9,2,0,0
11/03/2017 20:10,40,69.1,57,64.4,97,66.3,2,0,0
11/03/2017 20:15,35,69.1,51,64.4,86,66.3,2,0,0
11/03/2017 20:20,30,69.4,47,64.8,77,66.6,2,0,0
11/03/2017 20:25,34,69.2,51,64.6,85,66.4,2,0,0
11/03/2017 20:30,32,69.3,48,64.7,80,66.5,2,0,0
11/03/2017 20:35,33,69.2,49,64.5,82,66.4,2,0,0
11/03/2017 20:40,35,69.6,52,65,87,66.8,2,0,0
11/03/2017 20:45,34,68.9,51,64.3,85,66.1,2,0,0
11/03/2017 20:50,36,68.8,52,64.1,88,66,2,0,0
11/03/2017 20:55,31,67.9,48,63.1,79,65,2,0,0
11/03/2017 21:00,28,68.2,44,63.5,72,65.3,2,0,0
11/03/2017 21:05,38,67.7,55,62.9,93,64.9,2,0,0
11/03/2017 21:10,29,69,45,64.3,74,66.1,2,0,0
11/03/2017 21:15,33,68.9,49,64.2,82,66.1,2,0,0
11/03/2017 21:20,30,68.9,47,64.2,77,66,2,0,0
11/03/2017 21:25,33,69.4,49,64.8,82,66.6,2,0,0
11/03/2017 21:30,34,69.4,50,64.8,84,66.7,2,0,0
11/03/2017 21:35,29,69.3,45,64.7,74,66.5,2,0,0
11/03/2017 21:40,40,68.6,57,63.9,97,65.8,2,0,0
11/03/2017 21:45,34,69.1,50,64.5,84,66.3,2,0,0
11/03/2017 21:50,33,69.6,49,65,82,66.9,2,0,0
11/03/2017 21:55,32,70.2,49,65.7,81,67.5,2,0,0
11/03/2017 22:00,31,69.6,48,65,79,66.8,2,0,0
11/03/2017 22:05,31,69.7,48,65.1,79,66.9,2,0,0
11/03/2017 22:10,29,69.6,44,65,73,66.8,2,0,0
11/03/2017 22:15,30,69.4,46,64.8,76,66.6,2,0,0
11/03/2017 22:20,32,69.6,48,65,80,66.8,2,0,0
11/03/2017 22:25,27,69.3,43,64.7,70,66.5,2,0,0
11/03/2017 22:30,25,69.1,42,64.5,67,66.2,2,0,0
11/03/2017 22:35,25,68.9,41,64.3,66,66,2,0,0
11/03/2017 22:40,28,69,44,64.4,72,66.2,2,0,0
11/03/2017 22:45,29,69.2,45,64.6,74,66.4,2,0,0
11/03/2017 22:50,25,69,41,64.4,66,66.1,2,0,0
11/03/2017 22:55,18,69.2,34,64.5,52,66.1,2,0,0
11/03/2017 23:00,23,68.9,38,64.3,61,66.1,2,0,0
11/03/2017 23:05,21,69.2,37,64.6,58,66.2,2,0,0
11/03/2017 23:10,21,69.4,37,64.8,58,66.4,2,0,0
11/03/2017 23:15,22,69.3,38,64.7,60,66.4,2,0,0
11/03/2017 23:20,26,69.2,41,64.5,67,66.3,2,0,0
11/03/2017 23:25,18,69.2,33,64.6,51,66.3,2,0,0
11/03/2017 23:30,25,69.4,41,64.8,66,66.6,2,0,0
11/03/2017 23:35,24,69.1,40,64.5,64,66.2,2,0,0
11/03/2017 23:40,19,69.3,35,64.7,54,66.4,2,0,0
11/03/2017 23:45,17,69.3,32,64.7,49,66.3,2,0,0
11/03/2017 23:50,20,69.1,36,64.4,56,66.1,2,0,0
11/03/2017 23:55,14,69.2,30,64.6,44,66.1,2,0,0
11/04/2017 0:00,19,69.3,34,64.7,53,66.4,2,0,0
11/04/2017 0:05,16,69.5,31,64.9,47,66.5,2,0,0
11/04/2017 0:10,16,69.5,32,65,48,66.5,2,0,0
11/04/2017 0:15,18,68.9,33,64.3,51,65.9,2,0,0
11/04/2017 0:20,16,69.2,32,64.5,48,66.1,2,0,0
11/04/2017 0:25,16,69.3,32,64.7,48,66.2,2,0,0
11/04/2017 0:30,15,69.3,30,64.7,45,66.3,2,0,0
11/04/2017 0:35,10,69.3,25,64.7,35,66.1,2,0,0
11/04/2017 0:40,13,68.8,28,64.2,41,65.6,2,0,0
11/04/2017 0:45,12,69.1,27,64.5,39,65.9,2,0,0
11/04/2017 0:50,9,68.9,24,64.3,33,65.5,2,0,0
11/04/2017 0:55,14,69.1,29,64.5,43,66,2,0,0
11/04/2017 1:00,11,69.1,26,64.5,37,65.9,2,0,0
11/04/2017 1:05,9,69.3,24,64.7,33,66,2,0,0
11/04/2017 1:10,14,69.5,29,64.9,43,66.4,2,0,0
11/04/2017 1:15,9,69.4,24,64.8,33,66.1,2,0,0
11/04/2017 1:20,10,69.4,25,64.8,35,66.1,2,0,0
11/04/2017 1:25,10,69.5,25,64.9,35,66.2,2,0,0
11/04/2017 1:30,8,69.5,23,64.9,31,66.1,2,0,0
11/04/2017 1:35,10,69.5,25,64.9,35,66.2,2,0,0
11/04/2017 1:40,9,69.5,24,64.9,33,66.1,2,0,0
11/04/2017 1:45,8,69.2,24,64.6,32,65.8,2,0,0
11/04/2017 1:50,10,69.3,25,64.7,35,66,2,0,0
11/04/2017 1:55,8,69.6,23,65.1,31,66.2,2,0,0
11/04/2017 2:00,6,69.5,21,65,27,66,2,0,0
11/04/2017 2:05,7,69.4,23,64.8,30,65.8,2,0,0
11/04/2017 2:10,8,69.4,23,64.8,31,66,2,0,0
11/04/2017 2:15,11,69.4,27,64.8,38,66.1,2,0,0
11/04/2017 2:20,12,69.3,27,64.7,39,66.1,2,0,0
11/04/2017 2:25,6,69.3,21,64.7,27,65.7,2,0,0
11/04/2017 2:30,9,69.1,24,64.4,33,65.7,2,0,0
11/04/2017 2:35,10,69.2,25,64.5,35,65.9,2,0,0
11/04/2017 2:40,7,69.2,23,64.6,30,65.7,2,0,0
11/04/2017 2:45,12,69.2,28,64.6,40,66,2,0,0
11/04/2017 2:50,12,69.3,26,64.7,38,66.2,2,0,0
11/04/2017 2:55,8,69.2,23,64.5,31,65.7,2,0,0
11/04/2017 3:00,14,68.9,29,64.3,43,65.8,2,0,0
11/04/2017 3:05,9,69,25,64.4,34,65.6,2,0,0
11/04/2017 3:10,7,69.1,22,64.5,29,65.6,2,0,0
11/04/2017 3:15,10,69.1,25,64.5,35,65.8,2,0,0
11/04/2017 3:20,8,69.2,24,64.6,32,65.7,2,0,0
11/04/2017 3:25,7,69.3,22,64.7,29,65.8,2,0,0
11/04/2017 3:30,5,69.3,21,64.7,26,65.6,2,0,0
11/04/2017 3:35,9,69.4,24,64.7,33,66,2,0,0
11/04/2017 3:40,10,69.4,25,64.8,35,66.1,2,0,0
11/04/2017 3:45,7,69.3,23,64.7,30,65.8,2,0,0
11/04/2017 3:50,9,69.3,24,64.7,33,66,2,0,0
11/04/2017 3:55,10,69.1,25,64.5,35,65.8,2,0,0
11/04/2017 4:00,9,69.2,25,64.6,34,65.8,2,0,0
11/04/2017 4:05,10,69.3,26,64.7,36,66,2,0,0
11/04/2017 4:10,9,69.3,24,64.7,33,65.9,2,0,0
11/04/2017 4:15,9,69.1,24,64.5,33,65.8,2,0,0
11/04/2017 4:20,11,69.2,26,64.5,37,65.9,2,0,0
11/04/2017 4:25,10,69.3,25,64.7,35,66,2,0,0
11/04/2017 4:30,17,68.6,32,63.9,49,65.5,2,0,0
11/04/2017 4:35,16,68.7,32,64.1,48,65.6,2,0,0
11/04/2017 4:40,17,68.9,32,64.3,49,65.9,2,0,0
11/04/2017 4:45,15,68.6,31,64,46,65.5,2,0,0
11/04/2017 4:50,15,67.8,30,63.1,45,64.6,2,0,0
11/04/2017 4:55,15,67.8,30,63.1,45,64.7,2,0,0
11/04/2017 5:00,20,67.3,36,62.5,56,64.2,2,0,0
11/04/2017 5:05,12,67.9,28,63.1,40,64.6,2,0,0
11/04/2017 5:10,14,68.4,30,63.7,44,65.2,2,0,0
11/04/2017 5:15,17,68.5,33,63.8,50,65.4,2,0,0
11/04/2017 5:20,17,67.6,33,62.9,50,64.5,2,0,0
11/04/2017 5:25,20,68.1,36,63.4,56,65.1,2,0,0
11/04/2017 5:30,28,67.7,44,62.9,72,64.8,2,0,0
11/04/2017 5:35,19,67.6,35,62.8,54,64.5,2,0,0
11/04/2017 5:40,22,67.9,39,63.2,61,64.9,2,0,0
11/04/2017 5:45,24,68.7,40,64.1,64,65.8,2,0,0
11/04/2017 5:50,20,68.6,36,64,56,65.6,2,0,0
11/04/2017 5:55,21,68.7,37,64,58,65.7,2,0,0
11/04/2017 6:00,18,68.6,33,63.9,51,65.5,2,0,0
11/04/2017 6:05,19,68.5,35,63.8,54,65.4,2,0,0
11/04/2017 6:10,21,69.1,37,64.5,58,66.2,2,0,0
11/04/2017 6:15,22,69.1,38,64.4,60,66.1,2,0,0
11/04/2017 6:20,25,68.2,42,63.6,67,65.3,2,0,0
11/04/2017 6:25,24,67.7,41,62.8,65,64.6,2,0,0
11/04/2017 6:30,29,67.2,45,62.3,74,64.2,2,0,0
11/04/2017 6:35,23,67.6,40,62.8,63,64.5,2,0,0
11/04/2017 6:40,28,68,44,63.3,72,65.1,2,0,0
11/04/2017 6:45,30,68.3,47,63.6,77,65.4,2,0,0
11/04/2017 6:50,29,68.4,46,63.7,75,65.5,2,0,0
11/04/2017 6:55,25,68.7,41,64.1,66,65.8,2,0,0
11/04/2017 7:00,25,68.9,41,64.2,66,66,2,0,0
11/04/2017 7:05,24,68.9,40,64.2,64,66,2,0,0
11/04/2017 7:10,28,66.9,45,62.2,73,64,2,0,0
11/04/2017 7:15,29,67.5,45,62.8,74,64.7,2,0,0
11/04/2017 7:20,26,67.7,42,62.9,68,64.7,2,0,0
11/04/2017 7:25,30,68.2,47,63.5,77,65.3,2,0,0
11/04/2017 7:30,41,67.6,58,62.8,99,64.8,2,0,0
11/04/2017 7:35,40,67.7,58,63,98,64.9,2,0,0
11/04/2017 7:40,48,67.6,66,62.8,114,64.8,2,0,0
11/04/2017 7:45,39,68,57,63.3,96,65.2,2,0,0
11/04/2017 7:50,49,67.7,68,63,117,65,2,0,0
11/04/2017 7:55,38,67.5,55,62.7,93,64.6,2,0,0
11/04/2017 8:00,39,67.8,57,63,96,65,2,0,0
11/04/2017 8:05,44,68.1,61,63.4,105,65.4,2,0,0
11/04/2017 8:10,27,67.4,44,62.6,71,64.4,2,0,0
11/04/2017 8:15,56,67.9,76,63.2,132,65.2,2,0,0
11/04/2017 8:20,54,68.2,72,63.4,126,65.5,2,0,0
11/04/2017 8:25,53,68.6,72,63.8,125,65.8,2,0,0
11/04/2017 8:30,45,68,63,63.3,108,65.3,2,0,0
11/04/2017 8:35,53,68.1,72,63.4,125,65.4,2,0,0
11/04/2017 8:40,54,68.7,73,64.1,127,66.1,2,0,0
11/04/2017 8:45,57,68.8,75,64.1,132,66.2,2,0,0
11/04/2017 8:50,63,68.6,82,63.9,145,65.9,2,0,0
11/04/2017 8:55,42,69.3,60,64.6,102,66.5,2,0,0
11/04/2017 9:00,46,69,64,64.4,110,66.3,2,0,0
11/04/2017 9:05,49,68.5,67,63.7,116,65.7,2,0,0
11/04/2017 9:10,44,68.8,62,64,106,66,2,0,0
11/04/2017 9:15,41,68.6,58,63.9,99,65.8,2,0,0
11/04/2017 9:20,48,69.2,66,64.5,114,66.5,2,0,0
11/04/2017 9:25,51,68.4,69,63.7,120,65.7,2,0,0
11/04/2017 9:30,52,68.9,70,64.2,122,66.2,2,0,0
11/04/2017 9:35,59,67.9,78,63.1,137,65.2,2,0,0
11/04/2017 9:40,53,68.2,72,63.5,125,65.5,2,0,0
11/04/2017 9:45,57,68.8,75,64.1,132,66.1,2,0,0
11/04/2017 9:50,55,69.3,74,64.7,129,66.7,2,0,0
11/04/2017 9:55,62,68.6,82,64,144,66,2,0,0
11/04/2017 10:00,49,68.5,67,63.8,116,65.8,2,0,0
11/04/2017 10:05,37,68.6,53,63.9,90,65.9,2,0,0
11/04/2017 10:10,50,67.3,68,62.5,118,64.5,2,0,0
11/04/2017 10:15,61,67.6,80,62.8,141,64.8,2,0,0
11/04/2017 10:20,51,68,69,63.3,120,65.3,2,0,0
11/04/2017 10:25,49,68.9,66,64.2,115,66.2,2,0,0
11/04/2017 10:30,58,68.5,77,63.8,135,65.8,2,0,0
11/04/2017 10:35,63,68,84,63.3,147,65.3,2,0,0
11/04/2017 10:40,64,68.3,83,63.7,147,65.7,2,0,0
11/04/2017 10:45,62,67.7,82,62.9,144,65,2,0,0
11/04/2017 10:50,57,68.1,76,63.4,133,65.4,2,0,0
11/04/2017 10:55,63,68.3,82,63.6,145,65.6,2,0,0
11/04/2017 11:00,60,68.5,79,63.8,139,65.9,2,0,0
11/04/2017 11:05,51,69,68,64.4,119,66.4,2,0,0
11/04/2017 11:10,69,68.4,88,63.6,157,65.7,2,0,0
11/04/2017 11:15,61,68.7,80,64,141,66,2,0,0
11/04/2017 11:20,57,67.8,75,63,132,65.1,2,0,0
11/04/2017 11:25,66,66.8,85,61.9,151,64,2,0,0
11/04/2017 11:30,55,67.9,72,63.1,127,65.2,2,0,0
11/04/2017 11:35,53,69.4,70,64.8,123,66.7,2,0,0
11/04/2017 11:40,60,68.6,79,64,139,65.9,2,0,0
11/04/2017 11:45,55,68.8,73,64.2,128,66.1,2,0,0
11/04/2017 11:50,53,68.9,71,64.3,124,66.2,2,0,0
11/04/2017 11:55,60,69.2,78,64.6,138,66.6,2,0,0
11/04/2017 12:00,70,69.4,88,64.8,158,66.9,2,0,0
11/04/2017 12:05,54,69.2,71,64.6,125,66.6,2,0,0
11/04/2017 12:10,61,68.6,79,63.9,140,65.9,2,0,0
11/04/2017 12:15,71,68.7,90,64,161,66.1,2,0,0
11/04/2017 12:20,64,68.2,82,63.4,146,65.5,2,0,0
11/04/2017 12:25,64,67.4,83,62.6,147,64.7,2,0,0
11/04/2017 12:30,66,67.8,85,62.9,151,65.1,2,0,0
11/04/2017 12:35,71,68,90,63.2,161,65.3,2,0,0
11/04/2017 12:40,61,67.8,80,63,141,65.1,2,0,0
11/04/2017 12:45,66,67.3,85,62.5,151,64.6,2,0,0
11/04/2017 12:50,53,68,71,63.2,124,65.2,2,0,0
11/04/2017 12:55,57,68.3,76,63.6,133,65.6,2,0,0
11/04/2017 13:00,60,68.7,78,64,138,66,2,0,0
11/04/2017 13:05,56,68.6,74,63.9,130,65.9,2,0,0
11/04/2017 13:10,50,69,66,64.3,116,66.3,2,0,0
11/04/2017 13:15,66,69.1,86,64.4,152,66.5,2,0,0
11/04/2017 13:20,57,69.2,75,64.5,132,66.5,2,0,0
11/04/2017 13:25,66,68.7,86,64.1,152,66.1,2,0,0
11/04/2017 13:30,62,68.6,81,63.9,143,65.9,2,0,0
11/04/2017 13:35,56,68.7,73,64,129,66,2,0,0
11/04/2017 13:40,66,68.8,85,64.1,151,66.1,2,0,0
11/04/2017 13:45,63,68.7,79,64,142,66.1,2,0,0
11/04/2017 13:50,76,67.9,95,63.1,171,65.2,2,0,0
11/04/2017 13:55,62,68,80,63.2,142,65.3,2,0,0
11/04/2017 14:00,60,68.4,80,63.7,140,65.7,2,0,0
11/04/2017 14:05,66,68.3,85,63.6,151,65.7,2,0,0
11/04/2017 14:10,67,67.9,86,63.1,153,65.2,2,0,0
11/04/2017 14:15,72,67.2,92,62.3,164,64.4,2,0,0
11/04/2017 14:20,61,67.3,79,62.5,140,64.6,2,0,0
11/04/2017 14:25,59,67.1,77,62.2,136,64.3,2,0,0
11/04/2017 14:30,62,67,81,62.1,143,64.2,2,0,0
11/04/2017 14:35,64,67.1,82,62.2,146,64.3,2,0,0
11/04/2017 14:40,64,66.3,84,61.3,148,63.4,2,0,0
11/04/2017 14:45,58,66.5,75,61.6,133,63.8,2,0,0
11/04/2017 14:50,60,66.8,78,61.9,138,64,2,0,0
11/04/2017 14:55,63,67.8,81,63,144,65.1,2,0,0
11/04/2017 15:00,58,68.1,76,63.4,134,65.4,2,0,0
11/04/2017 15:05,64,68.3,82,63.6,146,65.7,2,0,0
11/04/2017 15:10,55,69.1,74,64.4,129,66.4,2,0,0
11/04/2017 15:15,43,69,61,64.3,104,66.3,2,0,0
11/04/2017 15:20,45,69.1,62,64.5,107,66.4,2,0,0
11/04/2017 15:25,46,69.4,64,64.7,110,66.7,2,0,0
11/04/2017 15:30,46,68.8,63,64.1,109,66.1,2,0,0
11/04/2017 15:35,42,67.7,60,62.9,102,64.9,2,0,0
11/04/2017 15:40,39,67.9,55,63.2,94,65.2,2,0,0
11/04/2017 15:45,48,68.6,66,64,114,65.9,2,0,0
11/04/2017 15:50,44,68.1,61,63.3,105,65.3,2,0,0
11/04/2017 15:55,43,68.5,59,63.8,102,65.8,2,0,0
11/04/2017 16:00,40,68.6,56,63.9,96,65.8,2,0,0
11/04/2017 16:05,41,69.3,58,64.6,99,66.5,2,0,0
11/04/2017 16:10,42,69.2,59,64.5,101,66.4,2,0,0
11/04/2017 16:15,35,68.5,51,63.8,86,65.7,2,0,0
11/04/2017 16:20,40,68.5,57,63.8,97,65.7,2,0,0
11/04/2017 16:25,45,67.8,62,63,107,65,2,0,0
11/04/2017 16:30,52,68.1,70,63.3,122,65.4,2,0,0
11/04/2017 16:35,45,69.3,62,64.6,107,66.6,2,0,0
11/04/2017 16:40,54,69.1,73,64.5,127,66.4,2,0,0
11/04/2017 16:45,56,69.8,74,65.2,130,67.2,2,0,0
11/04/2017 16:50,64,68.9,82,64.2,146,66.3,2,0,0
11/04/2017 16:55,58,68.4,77,63.7,135,65.7,2,0,0
11/04/2017 17:00,47,68,65,63.2,112,65.2,2,0,0
11/04/2017 17:05,51,68.4,69,63.7,120,65.7,2,0,0
11/04/2017 17:10,49,67.3,67,62.5,116,64.5,2,0,0
11/04/2017 17:15,52,67.4,70,62.7,122,64.7,2,0,0
11/04/2017 17:20,52,68.1,70,63.4,122,65.4,2,0,0
11/04/2017 17:25,50,68.3,68,63.6,118,65.6,2,0,0
11/04/2017 17:30,63,68.5,81,63.8,144,65.9,2,0,0
11/04/2017 17:35,63,68.5,82,63.8,145,65.8,2,0,0
11/04/2017 17:40,64,67.5,83,62.7,147,64.8,2,0,0
11/04/2017 17:45,66,66.3,85,61.3,151,63.5,2,0,0
11/04/2017 17:50,55,66.7,73,61.7,128,63.9,2,0,0
11/04/2017 17:55,64,66.5,82,61.6,146,63.7,2,0,0
11/04/2017 18:00,74,68.5,94,63.8,168,65.8,2,0,0
11/04/2017 18:05,61,69.2,80,64.6,141,66.6,2,0,0
11/04/2017 18:10,72,69,91,64.3,163,66.4,2,0,0
11/04/2017 18:15,74,68.5,94,63.7,168,65.8,2,0,0
11/04/2017 18:20,71,68.4,90,63.6,161,65.7,2,0,0
11/04/2017 18:25,59,67.3,76,62.4,135,64.5,2,0,0
11/04/2017 18:30,66,67.2,85,62.3,151,64.4,2,0,0
11/04/2017 18:35,68,65.3,88,60.1,156,62.4,2,0,0
11/04/2017 18:40,61,65.9,79,60.9,140,63.1,2,0,0
11/04/2017 18:45,57,66.5,75,61.5,132,63.6,2,0,0
11/04/2017 18:50,53,67.3,71,62.5,124,64.5,2,0,0
11/04/2017 18:55,63,66,81,61.1,144,63.2,2,0,0
11/04/2017 19:00,56,67.2,74,62.3,130,64.4,2,0,0
11/04/2017 19:05,46,68.7,64,64,110,66,2,0,0
11/04/2017 19:10,52,68.8,70,64.1,122,66.1,2,0,0
11/04/2017 19:15,49,68.1,67,63.4,116,65.4,2,0,0
11/04/2017 19:20,58,67.8,76,63,134,65.1,2,0,0
11/04/2017 19:25,59,67.9,78,63.1,137,65.2,2,0,0
11/04/2017 19:30,57,67.6,76,62.7,133,64.8,2,0,0
11/04/2017 19:35,53,68,71,63.2,124,65.2,2,0,0
11/04/2017 19:40,43,68,61,63.3,104,65.2,2,0,0
11/04/2017 19:45,36,68.5,53,63.8,89,65.7,2,0,0
11/04/2017 19:50,43,69.1,59,64.4,102,66.4,2,0,0
11/04/2017 19:55,35,68.6,52,63.8,87,65.8,2,0,0
11/04/2017 20:00,38,68.8,54,64.1,92,66,2,0,0
11/04/2017 20:05,43,68.8,60,64.2,103,66.1,2,0,0
11/04/2017 20:10,31,69.1,47,64.5,78,66.3,2,0,0
11/04/2017 20:15,40,69.2,57,64.6,97,66.5,2,0,0
11/04/2017 20:20,40,68.9,57,64.3,97,66.2,2,0,0
11/04/2017 20:25,34,69.7,51,65.2,85,67,2,0,0
11/04/2017 20:30,27,70,44,65.4,71,67.2,2,0,0
11/04/2017 20:35,34,69.2,51,64.6,85,66.4,2,0,0
11/04/2017 20:40,35,69.7,52,65.2,87,67,2,0,0
11/04/2017 20:45,29,69.6,45,65.1,74,66.9,2,0,0
11/04/2017 20:50,28,69.5,44,65,72,66.7,2,0,0
11/04/2017 20:55,25,69.7,41,65.1,66,66.8,2,0,0
11/04/2017 21:00,36,69.7,53,65.1,89,66.9,2,0,0
11/04/2017 21:05,29,69.5,45,65,74,66.8,2,0,0
11/04/2017 21:10,38,69.3,55,64.7,93,66.6,2,0,0
11/04/2017 21:15,30,69.9,46,65.3,76,67.1,2,0,0
11/04/2017 21:20,37,69.9,53,65.3,90,67.2,2,0,0
11/04/2017 21:25,31,69.7,47,65.2,78,67,2,0,0
11/04/2017 21:30,30,69.3,46,64.6,76,66.5,2,0,0
11/04/2017 21:35,28,69.5,44,64.9,72,66.7,2,0,0
11/04/2017 21:40,29,69,45,64.3,74,66.1,2,0,0
11/04/2017 21:45,30,69.7,47,65.1,77,66.9,2,0,0
11/04/2017 21:50,32,69.7,48,65,80,66.9,2,0,0
11/04/2017 21:55,28,69.8,44,65.2,72,67,2,0,0
11/04/2017 22:00,26,69.3,41,64.7,67,66.5,2,0,0
11/04/2017 22:05,38,68.9,54,64.2,92,66.2,2,0,0
11/04/2017 22:10,30,68.7,46,64.1,76,65.9,2,0,0
11/04/2017 22:15,26,69.3,42,64.7,68,66.5,2,0,0
11/04/2017 22:20,35,69.4,51,64.8,86,66.6,2,0,0
11/04/2017 22:25,25,69.2,41,64.5,66,66.3,2,0,0
11/04/2017 22:30,29,69.3,45,64.7,74,66.5,2,0,0
11/04/2017 22:35,28,69.2,44,64.6,72,66.4,2,0,0
11/04/2017 22:40,33,69.4,49,64.8,82,66.6,2,0,0
11/04/2017 22:45,23,69.4,38,64.8,61,66.5,2,0,0
11/04/2017 22:50,25,69.4,41,64.8,66,66.6,2,0,0
11/04/2017 22:55,21,69.4,36,64.8,57,66.5,2,0,0
11/04/2017 23:00,24,69.8,40,65.2,64,66.9,2,0,0
11/04/2017 23:05,23,69.8,38,65.3,61,67,2,0,0
11/04/2017 23:10,30,69.7,45,65.1,75,66.9,2,0,0
11/04/2017 23:15,25,69.6,41,65,66,66.8,2,0,0
11/04/2017 23:20,23,69.6,39,65,62,66.7,2,0,0
11/04/2017 23:25,25,69.4,40,64.8,65,66.5,2,0,0
11/04/2017 23:30,25,69.4,42,64.8,67,66.5,2,0,0
11/04/2017 23:35,22,69.3,38,64.7,60,66.4,2,0,0
11/04/2017 23:40,20,69.4,36,64.8,56,66.5,2,0,0
11/04/2017 23:45,16,69.4,32,64.8,48,66.4,2,0,0
11/04/2017 23:50,23,69.1,39,64.4,62,66.2,2,0,0
11/04/2017 23:55,21,69.1,37,64.5,58,66.1,2,0,0
11/05/2017 0:00,21,69.3,36,64.7,57,66.4,2,0,0
11/05/2017 0:05,16,69.1,31,64.5,47,66.1,2,0,0
11/05/2017 0:10,14,69.3,30,64.7,44,66.1,2,0,0
11/05/2017 0:15,13,69.3,29,64.7,42,66.1,2,0,0
11/05/2017 0:20,16,69.3,31,64.7,47,66.3,2,0,0
11/05/2017 0:25,15,69.3,30,64.7,45,66.2,2,0,0
11/05/2017 0:30,10,69.3,25,64.7,35,66.1,2,0,0
11/05/2017 0:35,14,69.4,29,64.8,43,66.3,2,0,0
11/05/2017 0:40,12,69.4,27,64.8,39,66.2,2,0,0
11/05/2017 0:45,12,69.5,27,64.9,39,66.3,2,0,0
11/05/2017 0:50,12,69.4,27,64.8,39,66.3,2,0,0
11/05/2017 0:55,12,69.4,27,64.8,39,66.2,2,0,0
11/05/2017 1:00,10,69.4,25,64.8,35,66.2,2,0,0
11/05/2017 1:05,9,69.3,24,64.7,33,66,2,0,0
11/05/2017 1:10,11,69.3,26,64.7,37,66.1,2,0,0
11/05/2017 1:15,10,69.3,26,64.7,36,66,2,0,0
11/05/2017 1:20,9,69.2,24,64.6,33,65.8,2,0,0
11/05/2017 1:25,12,69.3,27,64.7,39,66.2,2,0,0
11/05/2017 1:30,9,69.4,24,64.8,33,66,2,0,0
11/05/2017 1:35,11,69.2,26,64.5,37,65.9,2,0,0
11/05/2017 1:40,10,69.2,25,64.6,35,65.9,2,0,0
11/05/2017 1:45,11,69.3,26,64.7,37,66,2,0,0
11/05/2017 1:50,11,69.4,26,64.8,37,66.2,2,0,0
11/05/2017 1:55,11,69.5,26,64.9,37,66.2,2,0,0
11/05/2017 2:00,9,70.3,8,64.3,17,67.5,2,0,0
11/05/2017 2:05,8,70.3,8,64.3,16,67.3,2,0,0
11/05/2017 2:10,9,70.3,8,64.3,17,67.5,2,0,0
11/05/2017 2:15,8,70.3,8,64.3,16,67.3,2,0,0
11/05/2017 2:20,8,70.4,8,64.4,16,67.4,2,0,0
11/05/2017 2:25,7,70.4,7,64.4,14,67.4,2,0,0
11/05/2017 2:30,7,70.3,6,64.3,13,67.5,2,0,0
11/05/2017 2:35,6,70.3,6,64.3,12,67.3,2,0,0
11/05/2017 2:40,6,70.3,6,64.3,12,67.3,2,0,0
11/05/2017 2:45,7,70.4,6,64.4,13,67.6,2,0,0
11/05/2017 2:50,6,70.3,6,64.3,12,67.3,2,0,0
11/05/2017 2:55,6,70.4,5,64.4,11,67.7,2,0,0
11/05/2017 3:00,5,70.3,5,64.3,10,67.3,2,0,0
11/05/2017 3:05,5,70.4,5,64.4,10,67.4,2,0,0
11/05/2017 3:10,5,70.3,5,64.3,10,67.3,2,0,0
11/05/2017 3:15,5,70.2,5,64.2,10,67.2,2,0,0
11/05/2017 3:20,5,70.5,4,64.5,9,67.8,2,0,0
11/05/2017 3:25,5,70.4,4,64.4,9,67.7,2,0,0
11/05/2017 3:30,5,70.4,4,64.4,9,67.7,2,0,0
11/05/2017 3:35,5,70.2,4,64.2,9,67.5,2,0,0
11/05/2017 3:40,5,70.3,4,64.3,9,67.6,2,0,0
11/05/2017 3:45,5,70.3,4,64.3,9,67.6,2,0,0
11/05/2017 3:50,5,70.3,4,64.3,9,67.6,2,0,0
11/05/2017 3:55,4,70.2,4,64.2,8,67.2,2,0,0
11/05/2017 4:00,4,70,4,64,8,67,2,0,0
11/05/2017 4:05,4,70.2,4,64.2,8,67.2,2,0,0
11/05/2017 4:10,4,70.2,4,64.2,8,67.2,2,0,0
11/05/2017 4:15,4,70.3,4,64.3,8,67.3,2,0,0
11/05/2017 4:20,4,70.2,4,64.2,8,67.2,2,0,0
11/05/2017 4:25,4,70.3,4,64.3,8,67.3,2,0,0
11/05/2017 4:30,5,70.3,4,64.3,9,67.6,2,0,0
11/05/2017 4:35,5,70.4,4,64.4,9,67.7,2,0,0
11/05/2017 4:40,5,70.4,4,64.4,9,67.7,2,0,0
11/05/2017 4:45,5,70.4,5,64.4,10,67.4,2,0,0
11/05/2017 4:50,5,70.3,5,64.3,10,67.3,2,0,0
11/05/2017 4:55,5,70.4,5,64.4,10,67.4,2,0,0
11/05/2017 5:00,5,70.4,5,64.4,10,67.4,2,0,0
11/05/2017 5:05,6,70.4,5,64.4,11,67.7,2,0,0
11/05/2017 5:10,6,70.4,5,64.4,11,67.7,2,0,0
11/05/2017 5:15,6,70.5,6,64.5,12,67.5,2,0,0
11/05/2017 5:20,7,70.4,6,64.4,13,67.6,2,0,0
11/05/2017 5:25,7,70.5,7,64.5,14,67.5,2,0,0
11/05/2017 5:30,7,70.4,7,64.4,14,67.4,2,0,0
11/05/2017 5:35,7,70.7,7,64.7,14,67.7,2,0,0
11/05/2017 5:40,8,70.4,7,64.4,15,67.6,2,0,0
11/05/2017 5:45,9,70.7,8,64.7,17,67.9,2,0,0
11/05/2017 5:50,9,70.5,8,64.5,17,67.7,2,0,0
11/05/2017 5:55,8,70.5,8,64.5,16,67.5,2,0,0
11/05/2017 6:00,8,70.4,8,64.4,16,67.4,2,0,0
11/05/2017 6:05,9,70.4,8,64.4,17,67.6,2,0,0
11/05/2017 6:10,9,70.4,9,64.4,18,67.4,2,0,0
11/05/2017 6:15,11,70.5,9,64.5,20,67.8,2,0,0
11/05/2017 6:20,11,70.6,9,64.6,20,67.9,2,0,0
11/05/2017 6:25,11,70.5,10,64.5,21,67.6,2,0,0
11/05/2017 6:30,12,70.5,11,64.5,23,67.6,2,0,0
11/05/2017 6:35,13,70.5,11,64.5,24,67.8,2,0,0
11/05/2017 6:40,14,70.4,13,64.4,27,67.5,2,0,0
11/05/2017 6:45,15,70.6,14,64.6,29,67.7,2,0,0
11/05/2017 6:50,16,70.6,14,64.6,30,67.8,2,0,0
11/05/2017 6:55,14,70.5,13,64.5,27,67.6,2,0,0
11/05/2017 7:00,14,70.5,12,64.5,26,67.7,2,0,0
11/05/2017 7:05,14,70.4,12,64.4,26,67.6,2,0,0
11/05/2017 7:10,15,70.4,14,64.4,29,67.5,2,0,0
11/05/2017 7:15,16,70.4,15,64.4,31,67.5,2,0,0
11/05/2017 7:20,17,70.5,15,64.5,32,67.7,2,0,0
11/05/2017 7:25,17,70.5,16,64.5,33,67.6,2,0,0
11/05/2017 7:30,18,70.4,17,64.4,35,67.5,2,0,0
11/05/2017 7:35,19,70.5,18,64.5,37,67.6,2,0,0
11/05/2017 7:40,21,70.5,19,64.5,40,67.7,2,0,0
11/05/2017 7:45,22,70.6,19,64.6,41,67.8,2,0,0
11/05/2017 7:50,23,70.7,20,64.7,43,67.9,2,0,0
11/05/2017 7:55,23,70.7,20,64.7,43,67.9,2,0,0
11/05/2017 8:00,22,70.5,19,64.5,41,67.7,2,0,0
11/05/2017 8:05,21,70.4,19,64.4,40,67.6,2,0,0
11/05/2017 8:10,22,70.4,20,64.4,42,67.5,2,0,0
11/05/2017 8:15,23,70.4,21,64.4,44,67.5,2,0,0
11/05/2017 8:20,26,70.5,23,64.5,49,67.7,2,0,0
11/05/2017 8:25,26,70.5,24,64.5,50,67.6,2,0,0
11/05/2017 8:30,27,70.6,24,64.6,51,67.8,2,0,0
11/05/2017 8:35,28,70.6,25,64.6,53,67.8,2,0,0
11/05/2017 8:40,31,70.6,27,64.6,58,67.8,2,0,0
11/05/2017 8:45,33,70.6,30,64.6,63,67.7,2,0,0
11/05/2017 8:50,33,70.7,30,64.7,63,67.8,2,0,0
11/05/2017 8:55,33,70.7,30,64.7,63,67.8,2,0,0
11/05/2017 9:00,32,70.7,28,64.7,60,67.9,2,0,0
11/05/2017 9:05,32,70.5,29,64.5,61,67.6,2,0,0
11/05/2017 9:10,34,70.5,30,64.5,64,67.7,2,0,0
11/05/2017 9:15,35,70.6,32,64.6,67,67.7,2,0,0
11/05/2017 9:20,37,70.6,34,64.6,71,67.7,2,0,0
11/05/2017 9:25,40,70.7,35,64.7,75,67.9,2,0,0
11/05/2017 9:30,41,70.6,36,64.6,77,67.8,2,0,0
11/05/2017 9:35,42,70.7,37,64.7,79,67.9,2,0,0
11/05/2017 9:40,46,70.7,41,64.7,87,67.9,2,0,0
11/05/2017 9:45,47,70.6,43,64.6,90,67.7,2,0,0
11/05/2017 9:50,48,70.7,43,64.7,91,67.9,2,0,0
11/05/2017 9:55,47,70.7,43,64.7,90,67.8,2,0,0
11/05/2017 10:00,47,70.6,42,64.6,89,67.8,2,0,0
11/05/2017 10:05,46,70.6,42,64.6,88,67.7,2,0,0
11/05/2017 10:10,48,70.5,44,64.5,92,67.6,2,0,0
11/05/2017 10:15,51,70.5,45,64.5,96,67.7,2,0,0
11/05/2017 10:20,52,70.5,46,64.5,98,67.7,2,0,0
11/05/2017 10:25,53,70.5,47,64.5,100,67.7,2,0,0
11/05/2017 10:30,54,70.5,49,64.5,103,67.6,2,0,0
11/05/2017 10:35,56,70.4,50,64.4,106,67.6,2,0,0
11/05/2017 10:40,57,70.4,51,64.4,108,67.6,2,0,0
11/05/2017 10:45,60,70.5,53,64.5,113,67.7,2,0,0
11/05/2017 10:50,59,70.4,53,64.4,112,67.6,2,0,0
11/05/2017 10:55,57,70.4,52,64.4,109,67.5,2,0,0
11/05/2017 11:00,57,70.5,51,64.5,108,67.7,2,0,0
11/05/2017 11:05,55,70.4,50,64.4,105,67.5,2,0,0
11/05/2017 11:10,57,70.4,51,64.4,108,67.6,2,0,0
11/05/2017 11:15,58,70.4,53,64.4,111,67.5,2,0,0
11/05/2017 11:20,60,70.5,53,64.5,113,67.7,2,0,0
11/05/2017 11:25,60,70.4,53,64.4,113,67.6,2,0,0
11/05/2017 11:30,60,70.4,53,64.4,113,67.6,2,0,0
11/05/2017 11:35,61,70.3,55,64.3,116,67.5,2,0,0
11/05/2017 11:40,62,70.2,56,64.2,118,67.4,2,0,0
11/05/2017 11:45,64,70.3,58,64.3,122,67.4,2,0,0
11/05/2017 11:50,65,70.3,59,64.3,124,67.4,2,0,0
11/05/2017 11:55,64,70.3,58,64.3,122,67.4,2,0,0
11/05/2017 12:00,62,70.3,56,64.3,118,67.5,2,0,0
11/05/2017 12:05,64,70.4,57,64.4,121,67.6,2,0,0
11/05/2017 12:10,64,70.2,58,64.2,122,67.3,2,0,0
11/05/2017 12:15,65,70.3,59,64.3,124,67.4,2,0,0
11/05/2017 12:20,65,70.3,59,64.3,124,67.4,2,0,0
11/05/2017 12:25,66,70.2,60,64.2,126,67.3,2,0,0
11/05/2017 12:30,67,70.4,61,64.4,128,67.5,2,0,0
11/05/2017 12:35,67,70.2,60,64.2,127,67.4,2,0,0
11/05/2017 12:40,69,70.2,62,64.2,131,67.4,2,0,0
11/05/2017 12:45,71,70.2,63,64.2,134,67.4,2,0,0
11/05/2017 12:50,70,70.3,62,64.3,132,67.5,2,0,0
11/05/2017 12:55,70,70.2,62,64.2,132,67.4,2,0,0
11/05/2017 13:00,68,70.1,62,64.1,130,67.2,2,0,0
11/05/2017 13:05,68,70.1,61,64.1,129,67.3,2,0,0
11/05/2017 13:10,69,70.1,62,64.1,131,67.3,2,0,0
11/05/2017 13:15,70,70.1,62,64.1,132,67.3,2,0,0
11/05/2017 13:20,71,70.1,63,64.1,134,67.3,2,0,0
11/05/2017 13:25,71,70.1,63,64.1,134,67.3,2,0,0
11/05/2017 13:30,70,70.1,63,64.1,133,67.3,2,0,0
11/05/2017 13:35,71,70.1,64,64.1,135,67.3,2,0,0
11/05/2017 13:40,71,70,64,64,135,67.2,2,0,0
11/05/2017 13:45,71,70,63,64,134,67.2,2,0,0
11/05/2017 13:50,72,70,65,64,137,67.2,2,0,0
11/05/2017 13:55,70,70,62,64,132,67.2,2,0,0
11/05/2017 14:00,70,70,62,64,132,67.2,2,0,0
11/05/2017 14:05,69,70.1,62,64.1,131,67.3,2,0,0
11/05/2017 14:10,68,70,61,64,129,67.2,2,0,0
11/05/2017 14:15,70,70,63,64,133,67.2,2,0,0
11/05/2017 14:20,71,70.1,63,64.1,134,67.3,2,0,0
11/05/2017 14:25,70,70.1,62,64.1,132,67.3,2,0,0
11/05/2017 14:30,69,70.1,62,64.1,131,67.3,2,0,0
11/05/2017 14:35,70,70.1,63,64.1,133,67.3,2,0,0
11/05/2017 14:40,72,70,64,64,136,67.2,2,0,0
11/05/2017 14:45,70,70.1,63,64.1,133,67.3,2,0,0
11/05/2017 14:50,71,70.1,64,64.1,135,67.3,2,0,0
11/05/2017 14:55,68,70.1,62,64.1,130,67.2,2,0,0
11/05/2017 15:00,67,70.2,61,64.2,128,67.3,2,0,0
11/05/2017 15:05,67,70.1,61,64.1,128,67.2,2,0,0
11/05/2017 15:10,69,70.2,62,64.2,131,67.4,2,0,0
11/05/2017 15:15,70,70.1,62,64.1,132,67.3,2,0,0
11/05/2017 15:20,70,70.1,63,64.1,133,67.3,2,0,0
11/05/2017 15:25,70,70.1,62,64.1,132,67.3,2,0,0
11/05/2017 15:30,70,70.1,63,64.1,133,67.3,2,0,0
11/05/2017 15:35,71,70.2,64,64.2,135,67.4,2,0,0
11/05/2017 15:40,72,70,65,64,137,67.2,2,0,0
11/05/2017 15:45,73,70.1,65,64.1,138,67.3,2,0,0
11/05/2017 15:50,72,70.1,65,64.1,137,67.3,2,0,0
11/05/2017 15:55,70,70.2,63,64.2,133,67.4,2,0,0
11/05/2017 16:00,69,70.2,62,64.2,131,67.4,2,0,0
11/05/2017 16:05,70,70.2,63,64.2,133,67.4,2,0,0
11/05/2017 16:10,70,70.3,63,64.3,133,67.5,2,0,0
11/05/2017 16:15,71,70.2,64,64.2,135,67.4,2,0,0
11/05/2017 16:20,71,70.3,64,64.3,135,67.5,2,0,0
11/05/2017 16:25,71,70.3,64,64.3,135,67.5,2,0,0
11/05/2017 16:30,69,70.2,62,64.2,131,67.4,2,0,0
11/05/2017 16:35,70,70.1,63,64.1,133,67.3,2,0,0
11/05/2017 16:40,71,70.2,64,64.2,135,67.4,2,0,0
11/05/2017 16:45,70,70.1,62,64.1,132,67.3,2,0,0
11/05/2017 16:50,71,70,63,64,134,67.2,2,0,0
11/05/2017 16:55,71,70,64,64,135,67.2,2,0,0
11/05/2017 17:00,71,70.3,63,64.3,134,67.5,2,0,0
11/05/2017 17:05,71,70.4,63,64.4,134,67.6,2,0,0
11/05/2017 17:10,71,70.6,63,64.6,134,67.8,2,0,0
11/05/2017 17:15,71,70.5,64,64.5,135,67.7,2,0,0
11/05/2017 17:20,69,70.4,62,64.4,131,67.6,2,0,0
11/05/2017 17:25,71,70.3,63,64.3,134,67.5,2,0,0
11/05/2017 17:30,68,70.3,62,64.3,130,67.4,2,0,0
11/05/2017 17:35,70,70.2,63,64.2,133,67.4,2,0,0
11/05/2017 17:40,67,69.9,60,63.9,127,67.1,2,0,0
11/05/2017 17:45,69,69.8,62,63.8,131,67,2,0,0
11/05/2017 17:50,66,69.5,60,63.5,126,66.6,2,0,0
11/05/2017 17:55,64,69.5,58,63.5,122,66.6,2,0,0
11/05/2017 18:00,62,69.7,56,63.7,118,66.9,2,0,0
11/05/2017 18:05,62,69.9,55,63.9,117,67.1,2,0,0
11/05/2017 18:10,61,69.9,55,63.9,116,67.1,2,0,0
11/05/2017 18:15,62,69.8,55,63.8,117,67,2,0,0
11/05/2017 18:20,60,70,53,64,113,67.2,2,0,0
11/05/2017 18:25,59,70,53,64,112,67.2,2,0,0
11/05/2017 18:30,57,70.1,52,64.1,109,67.2,2,0,0
11/05/2017 18:35,57,70.2,52,64.2,109,67.3,2,0,0
11/05/2017 18:40,55,70.1,49,64.1,104,67.3,2,0,0
11/05/2017 18:45,55,70.3,50,64.3,105,67.4,2,0,0
11/05/2017 18:50,54,70.3,49,64.3,103,67.4,2,0,0
11/05/2017 18:55,50,70.3,45,64.3,95,67.5,2,0,0
11/05/2017 19:00,48,70.4,43,64.4,91,67.6,2,0,0
11/05/2017 19:05,48,70.4,44,64.4,92,67.5,2,0,0
11/05/2017 19:10,48,70.4,43,64.4,91,67.6,2,0,0
11/05/2017 19:15,47,70.4,43,64.4,90,67.5,2,0,0
11/05/2017 19:20,49,70.5,44,64.5,93,67.7,2,0,0
11/05/2017 19:25,48,70.5,43,64.5,91,67.7,2,0,0
11/05/2017 19:30,47,70.6,43,64.6,90,67.7,2,0,0
11/05/2017 19:35,46,70.7,42,64.7,88,67.8,2,0,0
11/05/2017 19:40,45,70.6,40,64.6,85,67.8,2,0,0
11/05/2017 19:45,44,70.6,40,64.6,84,67.7,2,0,0
11/05/2017 19:50,44,70.6,39,64.6,83,67.8,2,0,0
11/05/2017 19:55,43,70.7,38,64.7,81,67.9,2,0,0
11/05/2017 20:00,42,70.7,37,64.7,79,67.9,2,0,0
11/05/2017 20:05,42,70.6,38,64.6,80,67.8,2,0,0
11/05/2017 20:10,42,70.6,37,64.6,79,67.8,2,0,0
11/05/2017 20:15,42,70.7,37,64.7,79,67.9,2,0,0
11/05/2017 20:20,40,70.6,36,64.6,76,67.8,2,0,0
11/05/2017 20:25,40,70.7,36,64.7,76,67.9,2,0,0
11/05/2017 20:30,39,70.6,35,64.6,74,67.8,2,0,0
11/05/2017 20:35,39,70.7,35,64.7,74,67.9,2,0,0
11/05/2017 20:40,37,70.6,34,64.6,71,67.7,2,0,0
11/05/2017 20:45,37,70.6,33,64.6,70,67.8,2,0,0
11/05/2017 20:50,37,70.5,33,64.5,70,67.7,2,0,0
11/05/2017 20:55,36,70.7,32,64.7,68,67.9,2,0,0
11/05/2017 21:00,35,70.6,31,64.6,66,67.8,2,0,0
11/05/2017 21:05,35,70.6,31,64.6,66,67.8,2,0,0
11/05/2017 21:10,36,70.7,32,64.7,68,67.9,2,0,0
11/05/2017 21:15,35,70.6,32,64.6,67,67.7,2,0,0
11/05/2017 21:20,34,70.6,31,64.6,65,67.7,2,0,0
11/05/2017 21:25,34,70.6,31,64.6,65,67.7,2,0,0
11/05/2017 21:30,33,70.6,29,64.6,62,67.8,2,0,0
11/05/2017 21:35,33,70.7,29,64.7,62,67.9,2,0,0
11/05/2017 21:40,32,70.7,28,64.7,60,67.9,2,0,0
11/05/2017 21:45,30,70.7,27,64.7,57,67.9,2,0,0
11/05/2017 21:50,29,70.7,26,64.7,55,67.9,2,0,0
11/05/2017 21:55,27,70.6,24,64.6,51,67.8,2,0,0
11/05/2017 22:00,27,70.6,24,64.6,51,67.8,2,0,0
11/05/2017 22:05,27,70.7,24,64.7,51,67.9,2,0,0
11/05/2017 22:10,27,70.7,25,64.7,52,67.8,2,0,0
11/05/2017 22:15,26,70.6,24,64.6,50,67.7,2,0,0
11/05/2017 22:20,25,70.7,23,64.7,48,67.8,2,0,0
11/05/2017 22:25,24,70.6,22,64.6,46,67.7,2,0,0
11/05/2017 22:30,23,70.6,21,64.6,44,67.7,2,0,0
11/05/2017 22:35,22,70.5,19,64.5,41,67.7,2,0,0
11/05/2017 22:40,22,70.6,20,64.6,42,67.7,2,0,0
11/05/2017 22:45,21,70.5,19,64.5,40,67.7,2,0,0
11/05/2017 22:50,19,70.6,18,64.6,37,67.7,2,0,0
11/05/2017 22:55,17,70.6,15,64.6,32,67.8,2,0,0
11/05/2017 23:00,16,70.7,15,64.7,31,67.8,2,0,0
11/05/2017 23:05,16,70.6,15,64.6,31,67.7,2,0,0
11/05/2017 23:10,16,70.6,15,64.6,31,67.7,2,0,0
11/05/2017 23:15,17,70.5,15,64.5,32,67.7,2,0,0
11/05/2017 23:20,15,70.6,14,64.6,29,67.7,2,0,0
11/05/2017 23:25,15,70.5,13,64.5,28,67.7,2,0,0
11/05/2017 23:30,14,70.5,12,64.5,26,67.7,2,0,0
11/05/2017 23:35,14,70.5,13,64.5,27,67.6,2,0,0
11/05/2017 23:40,14,70.4,12,64.4,26,67.6,2,0,0
11/05/2017 23:45,12,70.4,11,64.4,23,67.5,2,0,0
11/05/2017 23:50,12,70.5,10,64.5,22,67.8,2,0,0
11/05/2017 23:55,12,70.4,10,64.4,22,67.7,2,0,0
