5 Minutes,Lane 1 Flow (Veh/5 Minutes),Lane 1 Speed (mph),Lane 2 Flow (Veh/5 Minutes),Lane 2 Speed (mph),Flow (Veh/5 Minutes),Speed (mph),# Lane Points,% Observed,Holiday
11/06/2017 0:00,10,70.5,9,64.5,19,67.7,2,0,0
11/06/2017 0:05,9,70.5,9,64.5,18,67.5,2,0,0
11/06/2017 0:10,9,70.5,9,64.5,18,67.5,2,0,0
11/06/2017 0:15,9,70.5,8,64.5,17,67.7,2,0,0
11/06/2017 0:20,9,70.3,8,64.3,17,67.5,2,0,0
11/06/2017 0:25,8,70.4,8,64.4,16,67.4,2,0,0
11/06/2017 0:30,7,70.3,7,64.3,14,67.3,2,0,0
11/06/2017 0:35,7,70.3,7,64.3,14,67.3,2,0,0
11/06/2017 0:40,7,70.3,6,64.3,13,67.5,2,0,0
11/06/2017 0:45,6,70.2,6,64.2,12,67.2,2,0,0
11/06/2017 0:50,6,70.2,6,64.2,12,67.2,2,0,0
11/06/2017 0:55,6,70.1,5,64.1,11,67.4,2,0,0
11/06/2017 1:00,5,70.2,5,64.2,10,67.2,2,0,0
11/06/2017 1:05,5,70.3,5,64.3,10,67.3,2,0,0
11/06/2017 1:10,4,70.7,3,64.7,7,68.1,2,0,0
11/06/2017 1:15,5,70.1,4,64.1,9,67.4,2,0,0
11/06/2017 1:20,5,70.3,4,64.3,9,67.6,2,0,0
11/06/2017 1:25,4,70.3,4,64.3,8,67.3,2,0,0
11/06/2017 1:30,4,70.3,4,64.3,8,67.3,2,0,0
11/06/2017 1:35,4,70.1,3,64.1,7,67.5,2,0,0
11/06/2017 1:40,4,69.8,4,63.8,8,66.8,2,0,0
11/06/2017 1:45,4,69.9,4,63.9,8,66.9,2,0,0
11/06/2017 1:50,4,70.1,3,64.1,7,67.5,2,0,0
11/06/2017 1:55,4,70,3,64,7,67.4,2,0,0
11/06/2017 2:00,4,70,3,64,7,67.4,2,0,0
11/06/2017 2:05,4,70,3,64,7,67.4,2,0,0
11/06/2017 2:10,4,70.1,3,64.1,7,67.5,2,0,0
11/06/2017 2:15,4,70,3,64,7,67.4,2,0,0
11/06/2017 2:20,3,70.3,3,64.3,6,67.3,2,0,0
11/06/2017 2:25,3,70.2,3,64.2,6,67.2,2,0,0
11/06/2017 2:30,3,70.1,3,64.1,6,67.1,2,0,0
11/06/2017 2:35,3,70.1,3,64.1,6,67.1,2,0,0
11/06/2017 2:40,4,70.2,3,64.2,7,67.6,2,0,0
11/06/2017 2:45,3,70.1,3,64.1,6,67.1,2,0,0
11/06/2017 2:50,3,70.2,3,64.2,6,67.2,2,0,0
11/06/2017 2:55,3,70.1,3,64.1,6,67.1,2,0,0
11/06/2017 3:00,3,70,3,64,6,67,2,0,0
11/06/2017 3:05,3,70.1,3,64.1,6,67.1,2,0,0
11/06/2017 3:10,4,70,3,64,7,67.4,2,0,0
11/06/2017 3:15,4,70.1,3,64.1,7,67.5,2,0,0
11/06/2017 3:20,4,70.2,3,64.2,7,67.6,2,0,0
11/06/2017 3:25,4,70.1,3,64.1,7,67.5,2,0,0
11/06/2017 3:30,4,70,4,64,8,67,2,0,0
11/06/2017 3:35,5,70.2,4,64.2,9,67.5,2,0,0
11/06/2017 3:40,5,70.3,5,64.3,10,67.3,2,0,0
11/06/2017 3:45,5,69.9,5,63.9,10,66.9,2,0,0
11/06/2017 3:50,5,70.1,5,64.1,10,67.1,2,0,0
11/06/2017 3:55,5,69.9,5,63.9,10,66.9,2,0,0
11/06/2017 4:00,5,70,5,64,10,67,2,0,0
11/06/2017 4:05,6,69.8,5,63.8,11,67.1,2,0,0
11/06/2017 4:10,6,70,5,64,11,67.3,2,0,0
11/06/2017 4:15,6,69.8,6,63.8,12,66.8,2,0,0
11/06/2017 4:20,7,70,7,64,14,67,2,0,0
11/06/2017 4:25,8,70,7,64,15,67.2,2,0,0
11/06/2017 4:30,8,70.1,8,64.1,16,67.1,2,0,0
11/06/2017 4:35,10,70.1,9,64.1,19,67.3,2,0,0
11/06/2017 4:40,12,70.4,11,64.4,23,67.5,2,0,0
11/06/2017 4:45,13,70.3,12,64.3,25,67.4,2,0,0
11/06/2017 4:50,14,70.4,12,64.4,26,67.6,2,0,0
11/06/2017 4:55,14,70.4,12,64.4,26,67.6,2,0,0
11/06/2017 5:00,14,70.2,13,64.2,27,67.3,2,0,0
11/06/2017 5:05,16,70.2,14,64.2,30,67.4,2,0,0
11/06/2017 5:10,18,70.2,17,64.2,35,67.3,2,0,0
11/06/2017 5:15,20,70.2,18,64.2,38,67.4,2,0,0
11/06/2017 5:20,22,70.3,20,64.3,42,67.4,2,0,0
11/06/2017 5:25,25,70.3,22,64.3,47,67.5,2,0,0
11/06/2017 5:30,27,70.4,25,64.4,52,67.5,2,0,0
11/06/2017 5:35,30,70.4,27,64.4,57,67.6,2,0,0
11/06/2017 5:40,32,70.6,28,64.6,60,67.8,2,0,0
11/06/2017 5:45,34,70.6,30,64.6,64,67.8,2,0,0
11/06/2017 5:50,36,70.7,32,64.7,68,67.9,2,0,0
11/06/2017 5:55,35,70.5,31,64.5,66,67.7,2,0,0
11/06/2017 6:00,35,70.1,32,64.1,67,67.2,2,0,0
11/06/2017 6:05,37,70,34,64,71,67.1,2,0,0
11/06/2017 6:10,40,69.9,35,63.9,75,67.1,2,0,0
11/06/2017 6:15,43,69.9,38,63.9,81,67.1,2,0,0
11/06/2017 6:20,45,69.7,41,63.7,86,66.8,2,0,0
11/06/2017 6:25,48,69.6,43,63.6,91,66.8,2,0,0
11/06/2017 6:30,49,69.5,44,63.5,93,66.7,2,0,0
11/06/2017 6:35,52,69.5,47,63.5,99,66.7,2,0,0
11/06/2017 6:40,56,69.4,51,63.4,107,66.5,2,0,0
11/06/2017 6:45,60,69.4,53,63.4,113,66.6,2,0,0
11/06/2017 6:50,58,69.5,53,63.5,111,66.6,2,0,0
11/06/2017 6:55,57,69.5,52,63.5,109,66.6,2,0,0
11/06/2017 7:00,58,69.2,52,63.2,110,66.4,2,0,0
11/06/2017 7:05,61,69.2,55,63.2,116,66.4,2,0,0
11/06/2017 7:10,64,69.1,58,63.1,122,66.2,2,0,0
11/06/2017 7:15,68,69.2,62,63.2,130,66.3,2,0,0
11/06/2017 7:20,72,69.3,64,63.3,136,66.5,2,0,0
11/06/2017 7:25,71,69.4,64,63.4,135,66.6,2,0,0
11/06/2017 7:30,73,69.4,66,63.4,139,66.5,2,0,0
11/06/2017 7:35,77,69.4,69,63.4,146,66.6,2,0,0
11/06/2017 7:40,80,69.5,72,63.5,152,66.7,2,0,0
11/06/2017 7:45,81,69.2,73,63.2,154,66.4,2,0,0
11/06/2017 7:50,81,69.2,72,63.2,153,66.4,2,0,0
11/06/2017 7:55,77,69.4,70,63.4,147,66.5,2,0,0
11/06/2017 8:00,74,69.3,67,63.3,141,66.4,2,0,0
11/06/2017 8:05,73,69.2,65,63.2,138,66.4,2,0,0
11/06/2017 8:10,74,69.1,67,63.1,141,66.2,2,0,0
11/06/2017 8:15,74,68.7,66,62.9,140,66,2,0,0
11/06/2017 8:20,74,68.9,66,62.9,140,66.1,2,0,0
11/06/2017 8:25,72,68.7,64,62.9,136,66,2,0,0
11/06/2017 8:30,71,68.9,64,62.9,135,66.1,2,0,0
11/06/2017 8:35,71,68.7,64,62.9,135,66,2,0,0
11/06/2017 8:40,73,68.7,65,62.9,138,66,2,0,0
11/06/2017 8:45,73,68.5,66,62.7,139,65.7,2,0,0
11/06/2017 8:50,73,68.5,65,62.7,138,65.8,2,0,0
11/06/2017 8:55,70,68.3,63,62.5,133,65.6,2,0,0
11/06/2017 9:00,66,68.7,59,62.9,125,66,2,0,0
11/06/2017 9:05,65,69,58,63,123,66.2,2,0,0
11/06/2017 9:10,66,69.1,60,63.1,126,66.2,2,0,0
11/06/2017 9:15,67,69,61,63,128,66.1,2,0,0
11/06/2017 9:20,70,69.2,62,63.2,132,66.4,2,0,0
11/06/2017 9:25,68,69,61,63,129,66.2,2,0,0
11/06/2017 9:30,66,69.1,59,63.1,125,66.3,2,0,0
11/06/2017 9:35,66,69.2,60,63.2,126,66.3,2,0,0
11/06/2017 9:40,66,69.1,60,63.1,126,66.2,2,0,0
11/06/2017 9:45,67,68.9,60,62.9,127,66.1,2,0,0
11/06/2017 9:50,66,69,60,63,126,66.1,2,0,0
11/06/2017 9:55,65,69.1,58,63.1,123,66.3,2,0,0
11/06/2017 10:00,61,69,55,63,116,66.2,2,0,0
11/06/2017 10:05,62,69.3,55,63.3,117,66.5,2,0,0
11/06/2017 10:10,62,69.2,55,63.2,117,66.4,2,0,0
11/06/2017 10:15,61,69,55,63,116,66.2,2,0,0
11/06/2017 10:20,62,69.1,55,63.1,117,66.3,2,0,0
11/06/2017 10:25,61,69,54,63,115,66.2,2,0,0
11/06/2017 10:30,61,69.1,54,63.1,115,66.3,2,0,0
11/06/2017 10:35,62,69.1,56,63.1,118,66.3,2,0,0
11/06/2017 10:40,62,69,55,63,117,66.2,2,0,0
11/06/2017 10:45,62,69,55,63,117,66.2,2,0,0
11/06/2017 10:50,62,68.9,55,62.9,117,66.1,2,0,0
11/06/2017 10:55,61,69,54,63,115,66.2,2,0,0
11/06/2017 11:00,59,69,53,63,112,66.2,2,0,0
11/06/2017 11:05,58,68.9,52,62.9,110,66.1,2,0,0
11/06/2017 11:10,59,68.6,53,62.8,112,65.9,2,0,0
11/06/2017 11:15,60,68.9,54,62.9,114,66.1,2,0,0
11/06/2017 11:20,61,68.9,54,62.9,115,66.1,2,0,0
11/06/2017 11:25,60,69,53,63,113,66.2,2,0,0
11/06/2017 11:30,60,69,53,63,113,66.2,2,0,0
11/06/2017 11:35,61,69,55,63,116,66.2,2,0,0
11/06/2017 11:40,62,68.9,56,62.9,118,66.1,2,0,0
11/06/2017 11:45,62,69.3,56,63.3,118,66.5,2,0,0
11/06/2017 11:50,63,69.3,56,63.3,119,66.5,2,0,0
11/06/2017 11:55,61,69.3,55,63.3,116,66.5,2,0,0
11/06/2017 12:00,60,69.2,53,63.2,113,66.4,2,0,0
11/06/2017 12:05,62,69.2,56,63.2,118,66.4,2,0,0
11/06/2017 12:10,63,69.1,57,63.1,120,66.2,2,0,0
11/06/2017 12:15,63,69.2,56,63.2,119,66.4,2,0,0
11/06/2017 12:20,64,69,57,63,121,66.2,2,0,0
11/06/2017 12:25,63,69.1,57,63.1,120,66.2,2,0,0
11/06/2017 12:30,63,69.1,57,63.1,120,66.2,2,0,0
11/06/2017 12:35,64,69.1,57,63.1,121,66.3,2,0,0
11/06/2017 12:40,63,69.2,57,63.2,120,66.3,2,0,0
11/06/2017 12:45,65,69.3,59,63.3,124,66.4,2,0,0
11/06/2017 12:50,63,69.4,57,63.4,120,66.5,2,0,0
11/06/2017 12:55,64,69.3,57,63.3,121,66.5,2,0,0
11/06/2017 13:00,62,69,56,63,118,66.2,2,0,0
11/06/2017 13:05,63,69.2,56,63.2,119,66.4,2,0,0
11/06/2017 13:10,63,69.4,57,63.4,120,66.5,2,0,0
11/06/2017 13:15,64,69.3,58,63.3,122,66.4,2,0,0
11/06/2017 13:20,66,69.2,59,63.2,125,66.4,2,0,0
11/06/2017 13:25,65,69.2,58,63.2,123,66.4,2,0,0
11/06/2017 13:30,65,69.2,58,63.2,123,66.4,2,0,0
11/06/2017 13:35,64,69.2,58,63.2,122,66.3,2,0,0
11/06/2017 13:40,66,69.3,59,63.3,125,66.5,2,0,0
11/06/2017 13:45,68,69.4,61,63.4,129,66.6,2,0,0
11/06/2017 13:50,67,69.5,61,63.5,128,66.6,2,0,0
11/06/2017 13:55,65,69.4,59,63.4,124,66.5,2,0,0
11/06/2017 14:00,65,69.3,59,63.3,124,66.4,2,0,0
11/06/2017 14:05,66,69.1,59,63.1,125,66.3,2,0,0
11/06/2017 14:10,68,69,62,63,130,66.1,2,0,0
11/06/2017 14:15,71,69,64,63,135,66.2,2,0,0
11/06/2017 14:20,72,69.3,65,63.3,137,66.5,2,0,0
11/06/2017 14:25,72,69.3,65,63.3,137,66.5,2,0,0
11/06/2017 14:30,71,69.2,64,63.2,135,66.4,2,0,0
11/06/2017 14:35,74,69.4,67,63.4,141,66.5,2,0,0
11/06/2017 14:40,77,69.4,69,63.4,146,66.6,2,0,0
11/06/2017 14:45,79,69.7,71,63.7,150,66.9,2,0,0
11/06/2017 14:50,81,69.5,72,63.5,153,66.7,2,0,0
11/06/2017 14:55,76,69.5,68,63.5,144,66.7,2,0,0
11/06/2017 15:00,74,69.2,67,63.2,141,66.3,2,0,0
11/06/2017 15:05,77,69,69,63,146,66.2,2,0,0
11/06/2017 15:10,77,68.9,70,62.9,147,66,2,0,0
11/06/2017 15:15,82,68.9,73,62.9,155,66.1,2,0,0
11/06/2017 15:20,82,68.7,73,62.9,155,66,2,0,0
11/06/2017 15:25,80,68.7,71,62.9,151,66,2,0,0
11/06/2017 15:30,78,68.7,70,62.9,148,66,2,0,0
11/06/2017 15:35,81,68.5,72,62.7,153,65.8,2,0,0
11/06/2017 15:40,85,68.5,76,62.7,161,65.8,2,0,0
11/06/2017 15:45,84,68.6,76,62.8,160,65.8,2,0,0
11/06/2017 15:50,83,68.6,74,62.8,157,65.9,2,0,0
11/06/2017 15:55,81,68.7,73,62.9,154,66,2,0,0
11/06/2017 16:00,78,68.5,70,62.7,148,65.8,2,0,0
11/06/2017 16:05,80,68.6,72,62.8,152,65.9,2,0,0
11/06/2017 16:10,84,68.6,75,62.8,159,65.9,2,0,0
11/06/2017 16:15,83,68.6,75,62.8,158,65.8,2,0,0
11/06/2017 16:20,84,68.6,76,62.8,160,65.8,2,0,0
11/06/2017 16:25,81,68.5,72,62.7,153,65.8,2,0,0
11/06/2017 16:30,81,68.6,72,62.8,153,65.9,2,0,0
11/06/2017 16:35,84,68.4,75,62.6,159,65.7,2,0,0
11/06/2017 16:40,85,68.4,77,62.6,162,65.6,2,0,0
11/06/2017 16:45,87,68.3,78,62.5,165,65.6,2,0,0
11/06/2017 16:50,85,68.3,76,62.5,161,65.6,2,0,0
11/06/2017 16:55,83,68.4,74,62.6,157,65.7,2,0,0
11/06/2017 17:00,82,68.3,74,62.5,156,65.6,2,0,0
11/06/2017 17:05,85,68.2,76,62.4,161,65.5,2,0,0
11/06/2017 17:10,91,68.1,82,62.3,173,65.4,2,0,0
11/06/2017 17:15,94,68,84,62.2,178,65.3,2,0,0
11/06/2017 17:20,93,67.8,83,62,176,65.1,2,0,0
11/06/2017 17:25,89,67.7,80,61.9,169,65,2,0,0
11/06/2017 17:30,89,67.8,79,62,168,65.1,2,0,0
11/06/2017 17:35,90,67.6,80,61.8,170,64.9,2,0,0
11/06/2017 17:40,89,67.3,79,61.5,168,64.6,2,0,0
11/06/2017 17:45,87,67.2,78,61.4,165,64.5,2,0,0
11/06/2017 17:50,85,67.2,76,61.4,161,64.5,2,0,0
11/06/2017 17:55,83,67.5,75,61.7,158,64.7,2,0,0
11/06/2017 18:00,80,67.7,72,61.9,152,65,2,0,0
11/06/2017 18:05,80,67.9,72,62.1,152,65.2,2,0,0
11/06/2017 18:10,79,67.9,70,62.1,149,65.2,2,0,0
11/06/2017 18:15,79,67.8,70,62,149,65.1,2,0,0
11/06/2017 18:20,76,68.2,68,62.4,144,65.5,2,0,0
11/06/2017 18:25,74,68.4,67,62.6,141,65.6,2,0,0
11/06/2017 18:30,72,68.5,64,62.7,136,65.8,2,0,0
11/06/2017 18:35,72,68.7,65,62.9,137,66,2,0,0
11/06/2017 18:40,71,68.7,63,62.9,134,66,2,0,0
11/06/2017 18:45,68,69,61,63,129,66.2,2,0,0
11/06/2017 18:50,66,69.2,59,63.2,125,66.4,2,0,0
11/06/2017 18:55,62,69.4,56,63.4,118,66.6,2,0,0
11/06/2017 19:00,60,69.8,54,63.8,114,67,2,0,0
11/06/2017 19:05,60,69.8,53,63.8,113,67,2,0,0
11/06/2017 19:10,61,70,54,64,115,67.2,2,0,0
11/06/2017 19:15,58,70.1,52,64.1,110,67.3,2,0,0
11/06/2017 19:20,56,70.2,51,64.2,107,67.3,2,0,0
11/06/2017 19:25,53,70.3,47,64.3,100,67.5,2,0,0
11/06/2017 19:30,51,70.4,45,64.4,96,67.6,2,0,0
11/06/2017 19:35,51,70.5,45,64.5,96,67.7,2,0,0
11/06/2017 19:40,47,70.5,43,64.5,90,67.6,2,0,0
11/06/2017 19:45,46,70.5,41,64.5,87,67.7,2,0,0
11/06/2017 19:50,45,70.5,40,64.5,85,67.7,2,0,0
11/06/2017 19:55,43,70.5,38,64.5,81,67.7,2,0,0
11/06/2017 20:00,42,70.6,38,64.6,80,67.8,2,0,0
11/06/2017 20:05,42,70.5,37,64.5,79,67.7,2,0,0
11/06/2017 20:10,41,70.5,36,64.5,77,67.7,2,0,0
11/06/2017 20:15,39,70.5,35,64.5,74,67.7,2,0,0
11/06/2017 20:20,40,70.6,35,64.6,75,67.8,2,0,0
11/06/2017 20:25,38,70.7,34,64.7,72,67.9,2,0,0
11/06/2017 20:30,36,70.6,33,64.6,69,67.7,2,0,0
11/06/2017 20:35,36,70.5,33,64.5,69,67.6,2,0,0
11/06/2017 20:40,36,70.5,32,64.5,68,67.7,2,0,0
11/06/2017 20:45,35,70.6,31,64.6,66,67.8,2,0,0
11/06/2017 20:50,33,70.5,30,64.5,63,67.6,2,0,0
11/06/2017 20:55,34,70.4,30,64.4,64,67.6,2,0,0
11/06/2017 21:00,32,70.5,29,64.5,61,67.6,2,0,0
11/06/2017 21:05,32,70.5,29,64.5,61,67.6,2,0,0
11/06/2017 21:10,34,70.5,30,64.5,64,67.7,2,0,0
11/06/2017 21:15,33,70.5,30,64.5,63,67.6,2,0,0
11/06/2017 21:20,33,70.5,30,64.5,63,67.6,2,0,0
11/06/2017 21:25,32,70.5,28,64.5,60,67.7,2,0,0
11/06/2017 21:30,30,70.5,27,64.5,57,67.7,2,0,0
11/06/2017 21:35,31,70.5,28,64.5,59,67.7,2,0,0
11/06/2017 21:40,30,70.5,27,64.5,57,67.7,2,0,0
11/06/2017 21:45,30,70.6,26,64.6,56,67.8,2,0,0
11/06/2017 21:50,28,70.5,25,64.5,53,67.7,2,0,0
11/06/2017 21:55,26,70.5,23,64.5,49,67.7,2,0,0
11/06/2017 22:00,26,70.4,23,64.4,49,67.6,2,0,0
11/06/2017 22:05,25,70.5,23,64.5,48,67.6,2,0,0
11/06/2017 22:10,26,70.5,24,64.5,50,67.6,2,0,0
11/06/2017 22:15,25,70.5,22,64.5,47,67.7,2,0,0
11/06/2017 22:20,24,70.4,22,64.4,46,67.5,2,0,0
11/06/2017 22:25,22,70.4,20,64.4,42,67.5,2,0,0
11/06/2017 22:30,21,70.4,18,64.4,39,67.6,2,0,0
11/06/2017 22:35,21,70.5,18,64.5,39,67.7,2,0,0
11/06/2017 22:40,20,70.6,18,64.6,38,67.8,2,0,0
11/06/2017 22:45,19,70.4,17,64.4,36,67.6,2,0,0
11/06/2017 22:50,18,70.5,16,64.5,34,67.7,2,0,0
11/06/2017 22:55,16,70.4,15,64.4,31,67.5,2,0,0
11/06/2017 23:00,15,70.4,14,64.4,29,67.5,2,0,0
11/06/2017 23:05,15,70.4,14,64.4,29,67.5,2,0,0
11/06/2017 23:10,15,70.5,14,64.5,29,67.6,2,0,0
11/06/2017 23:15,15,70.3,13,64.3,28,67.5,2,0,0
11/06/2017 23:20,14,70.4,12,64.4,26,67.6,2,0,0
11/06/2017 23:25,13,70.4,12,64.4,25,67.5,2,0,0
11/06/2017 23:30,13,70.4,12,64.4,25,67.5,2,0,0
11/06/2017 23:35,13,70.4,11,64.4,24,67.7,2,0,0
11/06/2017 23:40,13,70.3,11,64.3,24,67.6,2,0,0
11/06/2017 23:45,12,70.1,11,64.1,23,67.2,2,0,0
11/06/2017 23:50,11,70.2,10,64.2,21,67.3,2,0,0
11/06/2017 23:55,9,70.1,9,64.1,18,67.1,2,0,0
11/07/2017 0:00,9,70.5,9,64.5,18,67.5,2,0,0
11/07/2017 0:05,9,70.4,8,64.4,17,67.6,2,0,0
11/07/2017 0:10,9,70.4,9,64.4,18,67.4,2,0,0
11/07/2017 0:15,8,70.4,8,64.4,16,67.4,2,0,0
11/07/2017 0:20,8,70.4,8,64.4,16,67.4,2,0,0
11/07/2017 0:25,7,70.1,7,64.1,14,67.1,2,0,0
11/07/2017 0:30,7,70.3,6,64.3,13,67.5,2,0,0
11/07/2017 0:35,7,70.1,6,64.1,13,67.3,2,0,0
11/07/2017 0:40,6,70.3,6,64.3,12,67.3,2,0,0
11/07/2017 0:45,6,70.2,6,64.2,12,67.2,2,0,0
11/07/2017 0:50,5,70.2,5,64.2,10,67.2,2,0,0
11/07/2017 0:55,5,70.1,5,64.1,10,67.1,2,0,0
11/07/2017 1:00,5,70.3,4,64.3,9,67.6,2,0,0
11/07/2017 1:05,5,70.1,4,64.1,9,67.4,2,0,0
11/07/2017 1:10,5,70.2,4,64.2,9,67.5,2,0,0
11/07/2017 1:15,5,70.2,4,64.2,9,67.5,2,0,0
11/07/2017 1:20,4,70.3,4,64.3,8,67.3,2,0,0
11/07/2017 1:25,4,70,4,64,8,67,2,0,0
11/07/2017 1:30,4,70.3,3,64.3,7,67.7,2,0,0
11/07/2017 1:35,4,70,4,64,8,67,2,0,0
11/07/2017 1:40,4,70.1,4,64.1,8,67.1,2,0,0
11/07/2017 1:45,4,69.9,3,63.9,7,67.3,2,0,0
11/07/2017 1:50,4,69.8,3,63.8,7,67.2,2,0,0
11/07/2017 1:55,4,70,3,64,7,67.4,2,0,0
11/07/2017 2:00,4,69.9,3,63.9,7,67.3,2,0,0
11/07/2017 2:05,4,70,3,64,7,67.4,2,0,0
11/07/2017 2:10,4,70,3,64,7,67.4,2,0,0
11/07/2017 2:15,4,70.2,3,64.2,7,67.6,2,0,0
11/07/2017 2:20,3,70.1,3,64.1,6,67.1,2,0,0
11/07/2017 2:25,3,70.1,3,64.1,6,67.1,2,0,0
11/07/2017 2:30,4,70,3,64,7,67.4,2,0,0
11/07/2017 2:35,3,70,3,64,6,67,2,0,0
11/07/2017 2:40,4,70.2,3,64.2,7,67.6,2,0,0
11/07/2017 2:45,4,70,3,64,7,67.4,2,0,0
11/07/2017 2:50,4,70.1,3,64.1,7,67.5,2,0,0
11/07/2017 2:55,3,69.9,3,63.9,6,66.9,2,0,0
11/07/2017 3:00,4,70,3,64,7,67.4,2,0,0
11/07/2017 3:05,4,70.1,3,64.1,7,67.5,2,0,0
11/07/2017 3:10,4,70,3,64,7,67.4,2,0,0
11/07/2017 3:15,4,70.1,3,64.1,7,67.5,2,0,0
11/07/2017 3:20,4,70.2,3,64.2,7,67.6,2,0,0
11/07/2017 3:25,4,69.9,4,63.9,8,66.9,2,0,0
11/07/2017 3:30,4,69.7,4,63.7,8,66.7,2,0,0
11/07/2017 3:35,5,69.9,4,63.9,9,67.2,2,0,0
11/07/2017 3:40,5,70.2,5,64.2,10,67.2,2,0,0
11/07/2017 3:45,5,70,5,64,10,67,2,0,0
11/07/2017 3:50,6,69.8,5,63.8,11,67.1,2,0,0
11/07/2017 3:55,5,70,5,64,10,67,2,0,0
11/07/2017 4:00,5,69.8,5,63.8,10,66.8,2,0,0
11/07/2017 4:05,6,69.8,5,63.8,11,67.1,2,0,0
11/07/2017 4:10,6,70,6,64,12,67,2,0,0
11/07/2017 4:15,6,69.8,6,63.8,12,66.8,2,0,0
11/07/2017 4:20,8,70.1,8,64.1,16,67.1,2,0,0
11/07/2017 4:25,8,70,8,64,16,67,2,0,0
11/07/2017 4:30,9,70.1,9,64.1,18,67.1,2,0,0
11/07/2017 4:35,11,70.2,10,64.2,21,67.3,2,0,0
11/07/2017 4:40,13,70.2,11,64.2,24,67.5,2,0,0
11/07/2017 4:45,14,70.3,12,64.3,26,67.5,2,0,0
11/07/2017 4:50,15,70.4,13,64.4,28,67.6,2,0,0
11/07/2017 4:55,15,70.2,13,64.2,28,67.4,2,0,0
11/07/2017 5:00,16,70.2,15,64.2,31,67.3,2,0,0
11/07/2017 5:05,18,70.3,16,64.3,34,67.5,2,0,0
11/07/2017 5:10,21,70.3,19,64.3,40,67.5,2,0,0
11/07/2017 5:15,24,70.4,21,64.4,45,67.6,2,0,0
11/07/2017 5:20,26,70.5,23,64.5,49,67.7,2,0,0
11/07/2017 5:25,27,70.4,25,64.4,52,67.5,2,0,0
11/07/2017 5:30,31,70.6,27,64.6,58,67.8,2,0,0
11/07/2017 5:35,33,70.8,30,64.8,63,67.9,2,0,0
11/07/2017 5:40,36,70.8,32,64.8,68,68,2,0,0
11/07/2017 5:45,40,70.9,36,64.9,76,68.1,2,0,0
11/07/2017 5:50,42,70.8,37,64.8,79,68,2,0,0
11/07/2017 5:55,41,70.7,36,64.7,77,67.9,2,0,0
11/07/2017 6:00,40,70.3,35,64.3,75,67.5,2,0,0
11/07/2017 6:05,42,70,37,64,79,67.2,2,0,0
11/07/2017 6:10,45,69.8,40,63.8,85,67,2,0,0
11/07/2017 6:15,47,69.7,43,63.7,90,66.8,2,0,0
11/07/2017 6:20,48,69.5,44,63.5,92,66.6,2,0,0
11/07/2017 6:25,53,69.4,47,63.4,100,66.6,2,0,0
11/07/2017 6:30,54,69.4,48,63.4,102,66.6,2,0,0
11/07/2017 6:35,58,69.3,52,63.3,110,66.5,2,0,0
11/07/2017 6:40,63,69.2,56,63.2,119,66.4,2,0,0
11/07/2017 6:45,65,69.1,58,63.1,123,66.3,2,0,0
11/07/2017 6:50,65,69.2,59,63.2,124,66.3,2,0,0
11/07/2017 6:55,64,69.3,58,63.3,122,66.4,2,0,0
11/07/2017 7:00,65,69,58,63,123,66.2,2,0,0
11/07/2017 7:05,67,68.9,61,62.9,128,66,2,0,0
11/07/2017 7:10,72,68.9,64,62.9,136,66.1,2,0,0
11/07/2017 7:15,79,69.1,70,63.1,149,66.3,2,0,0
11/07/2017 7:20,81,69.1,72,63.1,153,66.3,2,0,0
11/07/2017 7:25,87,68.9,78,62.9,165,66.1,2,0,0
11/07/2017 7:30,87,68.9,78,62.9,165,66.1,2,0,0
11/07/2017 7:35,90,69,80,63,170,66.2,2,0,0
11/07/2017 7:40,94,69,84,63,178,66.2,2,0,0
11/07/2017 7:45,92,68.9,83,62.9,175,66.1,2,0,0
11/07/2017 7:50,90,69,81,63,171,66.2,2,0,0
11/07/2017 7:55,91,68.9,81,62.9,172,66.1,2,0,0
11/07/2017 8:00,89,69,79,63,168,66.2,2,0,0
11/07/2017 8:05,89,68.6,79,62.8,168,65.9,2,0,0
11/07/2017 8:10,90,68.5,80,62.7,170,65.8,2,0,0
11/07/2017 8:15,87,68.3,78,62.5,165,65.6,2,0,0
11/07/2017 8:20,79,68.3,71,62.5,150,65.6,2,0,0
11/07/2017 8:25,71,68.4,63,62.6,134,65.7,2,0,0
11/07/2017 8:30,84,68.2,76,62.4,160,65.4,2,0,0
11/07/2017 8:35,81,68.1,72,62.3,153,65.4,2,0,0
11/07/2017 8:40,81,68.3,73,62.5,154,65.6,2,0,0
11/07/2017 8:45,76,68.3,69,62.5,145,65.5,2,0,0
11/07/2017 8:50,83,68.3,75,62.5,158,65.5,2,0,0
11/07/2017 8:55,81,68,72,62.2,153,65.3,2,0,0
11/07/2017 9:00,79,68.5,70,62.7,149,65.8,2,0,0
11/07/2017 9:05,75,68.5,68,62.7,143,65.7,2,0,0
11/07/2017 9:10,75,68.5,68,62.7,143,65.7,2,0,0
11/07/2017 9:15,75,68.5,67,62.7,142,65.8,2,0,0
11/07/2017 9:20,75,68.7,67,62.9,142,66,2,0,0
11/07/2017 9:25,73,68.5,66,62.7,139,65.7,2,0,0
11/07/2017 9:30,72,68.6,65,62.8,137,65.9,1,0,0
11/07/2017 9:35,70,68.9,63,62.9,133,66.1,1,0,0
11/07/2017 9:40,72,68.7,64,62.9,136,66,1,0,0
11/07/2017 9:45,71,68.9,63,62.9,134,66.1,1,0,0
11/07/2017 9:50,70,69.2,62,63.2,132,66.4,1,0,0
11/07/2017 9:55,66,69,60,63,126,66.1,1,0,0
11/07/2017 10:00,64,69.3,57,63.3,121,66.5,1,0,0
11/07/2017 10:05,64,69.2,58,63.2,122,66.3,1,0,0
11/07/2017 10:10,63,69.3,56,63.3,119,66.5,1,0,0
11/07/2017 10:15,65,69.1,58,63.1,123,66.3,1,0,0
11/07/2017 10:20,64,69,58,63,122,66.1,1,0,0
11/07/2017 10:25,62,69,56,63,118,66.2,1,0,0
11/07/2017 10:30,62,69.1,56,63.1,118,66.3,1,0,0
11/07/2017 10:35,63,69.2,56,63.2,119,66.4,1,0,0
11/07/2017 10:40,64,69.1,57,63.1,121,66.3,1,0,0
11/07/2017 10:45,63,69.1,56,63.1,119,66.3,1,0,0
11/07/2017 10:50,62,69.2,56,63.2,118,66.4,1,0,0
11/07/2017 10:55,60,69.2,54,63.2,114,66.4,1,0,0
11/07/2017 11:00,58,69.1,53,63.1,111,66.2,1,0,0
11/07/2017 11:05,58,69,53,63,111,66.1,1,0,0
11/07/2017 11:10,60,68.9,54,62.9,114,66.1,1,0,0
11/07/2017 11:15,59,69,53,63,112,66.2,1,0,0
11/07/2017 11:20,60,69,54,63,114,66.2,1,0,0
11/07/2017 11:25,60,68.9,53,62.9,113,66.1,1,0,0
11/07/2017 11:30,60,69,54,63,114,66.2,1,0,0
11/07/2017 11:35,61,69.1,54,63.1,115,66.3,1,0,0
11/07/2017 11:40,62,69.1,55,63.1,117,66.3,1,0,0
11/07/2017 11:45,62,69.1,56,63.1,118,66.3,1,0,0
11/07/2017 11:50,62,69.3,55,63.3,117,66.5,1,0,0
11/07/2017 11:55,60,69.4,54,63.4,114,66.6,1,0,0
11/07/2017 12:00,61,69.1,54,63.1,115,66.3,1,0,0
11/07/2017 12:05,61,68.9,54,62.9,115,66.1,1,0,0
11/07/2017 12:10,61,68.7,54,62.9,115,66,1,0,0
11/07/2017 12:15,62,69.1,56,63.1,118,66.3,1,0,0
11/07/2017 12:20,62,69.3,56,63.3,118,66.5,1,0,0
11/07/2017 12:25,61,69,55,63,116,66.2,1,0,0
11/07/2017 12:30,62,69.1,55,63.1,117,66.3,1,0,0
11/07/2017 12:35,62,69,55,63,117,66.2,1,0,0
11/07/2017 12:40,64,69.2,57,63.2,121,66.4,1,0,0
11/07/2017 12:45,64,69.2,57,63.2,121,66.4,2,0,0
11/07/2017 12:50,64,69.3,58,63.3,122,66.4,2,0,0
11/07/2017 12:55,62,69.2,56,63.2,118,66.4,2,0,0
11/07/2017 13:00,62,69.3,55,63.3,117,66.5,2,0,0
11/07/2017 13:05,61,69.1,55,63.1,116,66.3,2,0,0
11/07/2017 13:10,62,69.1,56,63.1,118,66.3,2,0,0
11/07/2017 13:15,63,69.2,57,63.2,120,66.3,2,0,0
11/07/2017 13:20,63,69.1,57,63.1,120,66.2,2,0,0
11/07/2017 13:25,65,69.1,58,63.1,123,66.3,2,0,0
11/07/2017 13:30,64,69,57,63,121,66.2,2,0,0
11/07/2017 13:35,64,69.2,58,63.2,122,66.3,2,0,0
11/07/2017 13:40,65,69.3,59,63.3,124,66.4,2,0,0
11/07/2017 13:45,67,69.2,61,63.2,128,66.3,2,0,0
11/07/2017 13:50,66,69,60,63,126,66.1,2,0,0
11/07/2017 13:55,66,69.3,59,63.3,125,66.5,2,0,0
11/07/2017 14:00,66,69,59,63,125,66.2,2,0,0
11/07/2017 14:05,66,68.9,60,62.9,126,66,2,0,0
11/07/2017 14:10,68,68.9,61,62.9,129,66.1,2,0,0
11/07/2017 14:15,71,68.9,64,62.9,135,66.1,2,0,0
11/07/2017 14:20,74,68.9,66,62.9,140,66.1,2,0,0
11/07/2017 14:25,73,68.9,65,62.9,138,66.1,2,0,0
11/07/2017 14:30,74,69.1,66,63.1,140,66.3,2,0,0
11/07/2017 14:35,76,69,68,63,144,66.2,2,0,0
11/07/2017 14:40,79,69,70,63,149,66.2,2,0,0
11/07/2017 14:45,80,69.1,71,63.1,151,66.3,2,0,0
11/07/2017 14:50,80,69.1,71,63.1,151,66.3,2,0,0
11/07/2017 14:55,78,69.1,70,63.1,148,66.3,2,0,0
11/07/2017 15:00,76,68.6,68,62.8,144,65.9,2,0,0
11/07/2017 15:05,77,68.5,69,62.7,146,65.8,2,0,0
11/07/2017 15:10,80,68.3,71,62.5,151,65.6,2,0,0
11/07/2017 15:15,82,68.5,74,62.7,156,65.8,2,0,0
11/07/2017 15:20,81,68.6,73,62.8,154,65.9,2,0,0
11/07/2017 15:25,80,68.5,71,62.7,151,65.8,2,0,0
11/07/2017 15:30,81,68.5,72,62.7,153,65.8,2,0,0
11/07/2017 15:35,82,68.5,74,62.7,156,65.8,2,0,0
11/07/2017 15:40,84,68.5,75,62.7,159,65.8,2,0,0
11/07/2017 15:45,85,68.5,77,62.7,162,65.7,2,0,0
11/07/2017 15:50,83,68.5,75,62.7,158,65.7,2,0,0
11/07/2017 15:55,81,68.4,73,62.6,154,65.7,2,0,0
11/07/2017 16:00,79,68.3,71,62.5,150,65.6,2,0,0
11/07/2017 16:05,80,68.5,72,62.7,152,65.8,2,0,0
11/07/2017 16:10,85,68.4,76,62.6,161,65.7,2,0,0
11/07/2017 16:15,85,68.4,76,62.6,161,65.7,2,0,0
11/07/2017 16:20,84,68.3,75,62.5,159,65.6,2,0,0
11/07/2017 16:25,82,68.5,73,62.7,155,65.8,2,0,0
11/07/2017 16:30,83,68.3,74,62.5,157,65.6,2,0,0
11/07/2017 16:35,83,68.3,75,62.5,158,65.5,2,0,0
11/07/2017 16:40,86,68.3,78,62.5,164,65.5,2,0,0
11/07/2017 16:45,89,68.2,79,62.4,168,65.5,2,0,0
11/07/2017 16:50,86,68.4,77,62.6,163,65.7,2,0,0
11/07/2017 16:55,86,68.2,77,62.4,163,65.5,2,0,0
11/07/2017 17:00,84,68.2,76,62.4,160,65.4,2,0,0
11/07/2017 17:05,89,68.2,79,62.4,168,65.5,2,0,0
11/07/2017 17:10,92,67.9,82,62.1,174,65.2,2,0,0
11/07/2017 17:15,95,68,85,62.2,180,65.3,2,0,0
11/07/2017 17:20,95,67.7,86,61.9,181,64.9,2,0,0
11/07/2017 17:25,94,67.8,85,62,179,65,2,0,0
11/07/2017 17:30,92,67.5,83,61.7,175,64.7,2,0,0
11/07/2017 17:35,91,67,81,61.2,172,64.3,2,0,0
11/07/2017 17:40,89,67.1,80,61.3,169,64.4,2,0,0
11/07/2017 17:45,89,67,80,61.2,169,64.3,2,0,0
11/07/2017 17:50,89,66.7,80,60.9,169,64,2,0,0
11/07/2017 17:55,84,66.7,76,60.9,160,63.9,2,0,0
11/07/2017 18:00,83,66.8,75,61,158,64,2,0,0
11/07/2017 18:05,82,67.1,73,61.3,155,64.4,2,0,0
11/07/2017 18:10,82,67.2,74,61.4,156,64.4,2,0,0
11/07/2017 18:15,82,67.5,73,61.7,155,64.8,2,0,0
11/07/2017 18:20,81,67.5,72,61.7,153,64.8,2,0,0
11/07/2017 18:25,77,67.8,69,62,146,65.1,2,0,0
11/07/2017 18:30,40,67.7,58,63,98,64.9,2,0,0
11/07/2017 18:35,42,68.6,59,63.9,101,65.9,2,0,0
11/07/2017 18:40,48,68.2,66,63.4,114,65.4,2,0,0
11/07/2017 18:45,51,66.9,69,62.1,120,64.2,2,0,0
11/07/2017 18:50,55,68.7,73,64.1,128,66.1,2,0,0
11/07/2017 18:55,47,68.4,64,63.7,111,65.7,2,0,0
11/07/2017 19:00,51,68.6,68,63.8,119,65.8,2,0,0
11/07/2017 19:05,50,68.9,68,64.2,118,66.2,2,0,0
11/07/2017 19:10,38,69.8,54,65.1,92,67.1,2,0,0
11/07/2017 19:15,46,70.5,63,66,109,67.9,2,0,0
11/07/2017 19:20,44,70,60,65.3,104,67.3,2,0,0
11/07/2017 19:25,29,70,46,65.4,75,67.2,2,0,0
11/07/2017 19:30,45,69.5,63,64.9,108,66.8,2,0,0
11/07/2017 19:35,39,69.7,55,65.1,94,67,2,0,0
11/07/2017 19:40,41,69.5,58,64.8,99,66.8,2,0,0
11/07/2017 19:45,38,69.7,55,65,93,66.9,2,0,0
11/07/2017 19:50,33,68.2,49,63.4,82,65.3,2,0,0
11/07/2017 19:55,37,68.5,54,63.7,91,65.6,2,0,0
11/07/2017 20:00,32,68.9,48,64.2,80,66.1,2,0,0
11/07/2017 20:05,31,68.8,47,64.1,78,66,2,0,0
11/07/2017 20:10,28,68.8,45,64.1,73,65.9,2,0,0
11/07/2017 20:15,33,68.6,49,63.9,82,65.8,2,0,0
11/07/2017 20:20,39,69.2,56,64.7,95,66.5,2,0,0
11/07/2017 20:25,36,68.4,52,63.7,88,65.6,2,0,0
11/07/2017 20:30,29,69,45,64.3,74,66.1,2,0,0
11/07/2017 20:35,30,68.9,47,64.2,77,66,2,0,0
11/07/2017 20:40,27,68.6,43,64,70,65.8,2,0,0
11/07/2017 20:45,33,68.1,50,63.4,83,65.3,2,0,0
11/07/2017 20:50,29,68.7,45,64,74,65.9,2,0,0
11/07/2017 20:55,24,68.9,41,64.3,65,66,2,0,0
11/07/2017 21:00,27,69.2,42,64.6,69,66.4,2,0,0
11/07/2017 21:05,30,68.5,46,63.9,76,65.7,2,0,0
11/07/2017 21:10,31,69,48,64.3,79,66.2,2,0,0
11/07/2017 21:15,31,68.3,48,63.7,79,65.5,2,0,0
11/07/2017 21:20,27,68.9,43,64.3,70,66.1,2,0,0
11/07/2017 21:25,29,69.3,45,64.7,74,66.5,2,0,0
11/07/2017 21:30,23,68.6,39,64,62,65.7,2,0,0
11/07/2017 21:35,23,68.7,39,64,62,65.8,2,0,0
11/07/2017 21:40,23,68.8,39,64.2,62,65.9,2,0,0
11/07/2017 21:45,23,69.1,39,64.5,62,66.2,2,0,0
11/07/2017 21:50,19,69.4,35,64.8,54,66.4,2,0,0
11/07/2017 21:55,20,69.5,36,64.9,56,66.6,2,0,0
11/07/2017 22:00,20,69.3,36,64.7,56,66.3,2,0,0
11/07/2017 22:05,20,69.2,35,64.5,55,66.2,2,0,0
11/07/2017 22:10,21,69.2,36,64.5,57,66.3,2,0,0
11/07/2017 22:15,23,69.4,38,64.8,61,66.5,2,0,0
11/07/2017 22:20,22,69.2,38,64.6,60,66.3,2,0,0
11/07/2017 22:25,21,69.4,37,64.7,58,66.4,2,0,0
11/07/2017 22:30,29,69.5,45,64.9,74,66.7,2,0,0
11/07/2017 22:35,17,69.5,33,64.9,50,66.5,2,0,0
11/07/2017 22:40,16,69.4,32,64.8,48,66.3,2,0,0
11/07/2017 22:45,20,69.4,36,64.8,56,66.5,2,0,0
11/07/2017 22:50,15,69.3,31,64.7,46,66.2,2,0,0
11/07/2017 22:55,16,69.2,31,64.5,47,66.1,2,0,0
11/07/2017 23:00,14,69.2,29,64.6,43,66.1,2,0,0
11/07/2017 23:05,12,69,27,64.4,39,65.8,2,0,0
11/07/2017 23:10,14,69.2,29,64.6,43,66.1,2,0,0
11/07/2017 23:15,16,69.3,32,64.7,48,66.3,2,0,0
11/07/2017 23:20,13,69.1,29,64.5,42,65.9,2,0,0
11/07/2017 23:25,13,69.3,29,64.7,42,66.1,2,0,0
11/07/2017 23:30,15,69.3,30,64.7,45,66.2,2,0,0
11/07/2017 23:35,13,69.4,29,64.8,42,66.2,2,0,0
11/07/2017 23:40,8,69.4,24,64.8,32,66,2,0,0
11/07/2017 23:45,10,69.5,25,64.9,35,66.2,2,0,0
11/07/2017 23:50,12,69.6,27,65,39,66.4,2,0,0
11/07/2017 23:55,12,69.5,28,64.9,40,66.3,2,0,0
11/08/2017 0:00,8,69.3,23,64.7,31,65.9,2,0,0
11/08/2017 0:05,11,69.4,26,64.8,37,66.2,2,0,0
11/08/2017 0:10,8,69.4,23,64.8,31,66,2,0,0
11/08/2017 0:15,9,69.4,24,64.8,33,66.1,2,0,0
11/08/2017 0:20,9,69.3,24,64.7,33,66,2,0,0
11/08/2017 0:25,8,69.3,23,64.7,31,65.9,2,0,0
11/08/2017 0:30,7,69.1,23,64.4,30,65.5,2,0,0
11/08/2017 0:35,12,69.3,21,64.7,33,66.3,2,0,0
11/08/2017 0:40,8,69.3,24,64.7,32,65.8,2,0,0
11/08/2017 0:45,7,69.3,22,64.7,29,65.8,2,0,0
11/08/2017 0:50,7,69.3,22,64.7,29,65.8,2,0,0
11/08/2017 0:55,9,69.4,24,64.8,33,66,2,0,0
11/08/2017 1:00,7,69.4,22,64.8,29,66,2,0,0
11/08/2017 1:05,8,69.3,23,64.7,31,65.9,2,0,0
11/08/2017 1:10,7,69.3,22,64.7,29,65.8,2,0,0
11/08/2017 1:15,5,69.3,21,64.7,26,65.6,2,0,0
11/08/2017 1:20,6,69.4,21,64.8,27,65.9,2,0,0
11/08/2017 1:25,7,69.3,22,64.7,29,65.8,2,0,0
11/08/2017 1:30,7,69.3,22,64.7,29,65.8,2,0,0
11/08/2017 1:35,9,69.3,24,64.7,33,66,2,0,0
11/08/2017 1:40,6,69.4,21,64.8,27,65.8,2,0,0
11/08/2017 1:45,6,69.4,21,64.8,27,65.8,2,0,0
11/08/2017 1:50,6,69.3,21,64.7,27,65.8,2,0,0
11/08/2017 1:55,7,69.2,22,64.6,29,65.7,2,0,0
11/08/2017 2:00,10,69.3,20,64.7,30,66.3,2,0,0
11/08/2017 2:05,8,69.3,23,64.7,31,65.9,2,0,0
11/08/2017 2:10,6,69.4,21,64.8,27,65.8,2,0,0
11/08/2017 2:15,7,69.1,22,64.5,29,65.6,2,0,0
11/08/2017 2:20,7,69.2,22,64.6,29,65.7,2,0,0
11/08/2017 2:25,8,69.3,23,64.7,31,65.9,2,0,0
11/08/2017 2:30,7,68.9,23,64.2,30,65.3,2,0,0
11/08/2017 2:35,7,69.1,22,64.5,29,65.7,2,0,0
11/08/2017 2:40,9,69.2,24,64.6,33,65.8,2,0,0
11/08/2017 2:45,7,69.3,22,64.7,29,65.8,2,0,0
11/08/2017 2:50,8,69.5,23,64.9,31,66.1,2,0,0
11/08/2017 2:55,10,69.4,26,64.8,36,66.1,2,0,0
11/08/2017 3:00,10,69.4,26,64.8,36,66.1,2,0,0
11/08/2017 3:05,11,69.3,26,64.7,37,66.1,2,0,0
11/08/2017 3:10,10,69.3,25,64.7,35,66,2,0,0
11/08/2017 3:15,12,69.2,27,64.6,39,66,2,0,0
11/08/2017 3:20,11,69.1,26,64.5,37,65.9,2,0,0
11/08/2017 3:25,13,69.3,29,64.7,42,66.1,2,0,0
11/08/2017 3:30,11,69.2,27,64.6,38,65.9,2,0,0
11/08/2017 3:35,11,69.2,27,64.6,38,66,2,0,0
11/08/2017 3:40,14,69.4,30,64.7,44,66.2,2,0,0
11/08/2017 3:45,17,69.4,33,64.8,50,66.4,2,0,0
11/08/2017 3:50,19,69.2,35,64.5,54,66.2,2,0,0
11/08/2017 3:55,17,69.4,33,64.8,50,66.3,2,0,0
11/08/2017 4:00,13,69.1,29,64.5,42,65.9,2,0,0
11/08/2017 4:05,19,69.1,34,64.4,53,66.1,2,0,0
11/08/2017 4:10,14,69.4,30,64.8,44,66.3,2,0,0
11/08/2017 4:15,23,69.8,40,65.2,63,66.9,2,0,0
11/08/2017 4:20,19,69.6,35,65,54,66.6,2,0,0
11/08/2017 4:25,21,69.7,37,65.2,58,66.8,2,0,0
11/08/2017 4:30,23,69.5,40,64.9,63,66.6,2,0,0
11/08/2017 4:35,34,68.3,51,63.5,85,65.4,2,0,0
11/08/2017 4:40,31,68.4,48,63.7,79,65.5,2,0,0
11/08/2017 4:45,34,69.6,52,64.9,86,66.7,2,0,0
11/08/2017 4:50,44,69.9,62,65.3,106,67.2,2,0,0
11/08/2017 4:55,36,69.9,54,65.3,90,67.1,2,0,0
11/08/2017 5:00,46,70.3,64,65.8,110,67.7,2,0,0
11/08/2017 5:05,46,70.2,64,65.6,110,67.5,2,0,0
11/08/2017 5:10,53,69.8,73,65.2,126,67.1,2,0,0
11/08/2017 5:15,47,70.5,66,66,113,67.9,2,0,0
11/08/2017 5:20,58,69.7,78,65.1,136,67.1,2,0,0
11/08/2017 5:25,61,69.1,82,64.5,143,66.5,2,0,0
11/08/2017 5:30,63,68.6,85,64,148,66,2,0,0
11/08/2017 5:35,59,68.7,80,64.1,139,66.1,2,0,0
11/08/2017 5:40,66,70,87,65.5,153,67.4,2,0,0
11/08/2017 5:45,74,68.8,96,64.2,170,66.2,2,0,0
11/08/2017 5:50,73,69.2,96,64.6,169,66.6,2,0,0
11/08/2017 5:55,62,69.8,84,65.2,146,67.1,2,0,0
11/08/2017 6:00,53,67.8,74,63.1,127,65.1,2,0,0
11/08/2017 6:05,63,68.8,85,64.1,148,66.1,2,0,0
11/08/2017 6:10,73,67.7,95,62.9,168,65,2,0,0
11/08/2017 6:15,62,68.2,83,63.5,145,65.5,2,0,0
11/08/2017 6:20,60,67.9,81,63.2,141,65.2,2,0,0
11/08/2017 6:25,62,69.4,84,64.7,146,66.7,2,0,0
11/08/2017 6:30,72,69.9,94,65.3,166,67.3,2,0,0
11/08/2017 6:35,71,69.8,95,65.2,166,67.1,2,0,0
11/08/2017 6:40,66,68.7,88,64,154,66,2,0,0
11/08/2017 6:45,78,69.5,102,64.8,180,66.9,2,0,0
11/08/2017 6:50,83,70.1,107,65.4,190,67.5,2,0,0
11/08/2017 6:55,66,70.8,87,66.3,153,68.2,2,0,0
11/08/2017 7:00,73,69.5,95,64.8,168,66.9,2,0,0
11/08/2017 7:05,72,68.4,95,63.6,167,65.7,2,0,0
11/08/2017 7:10,91,67.7,113,62.8,204,65,2,0,0
11/08/2017 7:15,89,67.2,113,62.3,202,64.4,2,0,0
11/08/2017 7:20,85,68,108,63.2,193,65.3,2,0,0
11/08/2017 7:25,86,67.9,109,63,195,65.2,2,0,0
11/08/2017 7:30,99,68.1,123,63.2,222,65.4,2,0,0
11/08/2017 7:35,92,67.9,115,63,207,65.2,2,0,0
11/08/2017 7:40,89,67.8,113,63,202,65.1,2,0,0
11/08/2017 7:45,99,67.3,125,62.3,224,64.5,2,0,0
11/08/2017 7:50,87,66.5,110,61.5,197,63.7,2,0,0
11/08/2017 7:55,89,66.9,113,62,202,64.2,2,0,0
11/08/2017 8:00,90,66.3,114,61.4,204,63.6,2,0,0
11/08/2017 8:05,80,67.7,102,62.9,182,65,2,0,0
11/08/2017 8:10,81,67,104,62.1,185,64.2,2,0,0
11/08/2017 8:15,71,66.9,93,62.1,164,64.2,2,0,0
11/08/2017 8:20,72,67.5,95,62.7,167,64.8,2,0,0
11/08/2017 8:25,78,67.3,100,62.4,178,64.5,2,0,0
11/08/2017 8:30,81,67.3,103,62.4,184,64.6,2,0,0
11/08/2017 8:35,73,66.5,95,61.5,168,63.7,2,0,0
11/08/2017 8:40,72,59.5,93,53.8,165,56.3,2,0,0
11/08/2017 8:45,71,51.4,92,44.8,163,47.7,2,0,0
11/08/2017 8:50,72,42.6,91,35,163,38.4,2,0,0
11/08/2017 8:55,61,36.1,80,27.8,141,31.4,2,0,0
11/08/2017 9:00,57,32.9,76,24.3,133,28,2,0,0
11/08/2017 9:05,65,31.5,84,22.8,149,26.6,2,0,0
11/08/2017 9:10,65,31,85,22.3,150,26.1,2,0,0
11/08/2017 9:15,54,31.4,78,22.7,132,26.3,2,0,0
11/08/2017 9:20,47,31.6,73,23,120,26.4,2,0,0
11/08/2017 9:25,57,42.4,84,34.4,141,37.6,2,0,0
11/08/2017 9:30,81,44.6,102,37.1,183,40.4,2,0,0
11/08/2017 9:35,72,52.7,91,46.3,163,49.1,2,0,0
11/08/2017 9:40,77,56.7,99,50.7,176,53.3,2,0,0
11/08/2017 9:45,82,57.7,103,51.9,185,54.5,2,0,0
11/08/2017 9:50,72,59.2,91,53.6,163,56.1,2,0,0
11/08/2017 9:55,77,58.3,98,52.6,175,55.1,2,0,0
11/08/2017 10:00,78,60,98,54.5,176,56.9,2,0,0
11/08/2017 10:05,76,60.8,95,55.3,171,57.7,2,0,0
11/08/2017 10:10,68,60.6,88,55.1,156,57.5,2,0,0
11/08/2017 10:15,65,62.7,84,57.4,149,59.7,2,0,0
11/08/2017 10:20,68,64.5,86,59.5,154,61.7,2,0,0
11/08/2017 10:25,68,65.3,88,60.2,156,62.4,2,0,0
11/08/2017 10:30,73,64.7,94,59.6,167,61.8,2,0,0
11/08/2017 10:35,70,64.9,90,59.9,160,62.1,2,0,0
11/08/2017 10:40,60,64,80,58.9,140,61.1,2,0,0
11/08/2017 10:45,64,63.3,83,58.1,147,60.4,2,0,0
11/08/2017 10:50,64,64.8,83,59.8,147,62,2,0,0
11/08/2017 10:55,71,63.2,90,58.1,161,60.3,2,0,0
11/08/2017 11:00,67,62.2,86,56.9,153,59.2,2,0,0
11/08/2017 11:05,57,63.2,75,58.1,132,60.3,2,0,0
11/08/2017 11:10,56,63.7,75,58.7,131,60.9,2,0,0
11/08/2017 11:15,69,64,89,59,158,61.2,2,0,0
11/08/2017 11:20,59,65.3,78,60.4,137,62.5,2,0,0
11/08/2017 11:25,57,64.8,75,59.9,132,62,2,0,0
11/08/2017 11:30,55,64.9,74,60.1,129,62.2,2,0,0
11/08/2017 11:35,61,65.6,79,60.9,140,62.9,2,0,0
11/08/2017 11:40,63,65.2,82,60.4,145,62.5,2,0,0
11/08/2017 11:45,69,65.2,90,60.4,159,62.5,2,0,0
11/08/2017 11:50,60,65.6,79,60.9,139,62.9,2,0,0
11/08/2017 11:55,55,66.1,74,61.3,129,63.3,2,0,0
11/08/2017 12:00,57,68.1,75,63.3,132,65.4,2,0,0
11/08/2017 12:05,48,68.6,66,63.9,114,65.9,2,0,0
11/08/2017 12:10,48,68.4,65,63.7,113,65.7,2,0,0
11/08/2017 12:15,50,68.3,67,63.5,117,65.5,2,0,0
11/08/2017 12:20,58,69,76,64.3,134,66.3,2,0,0
11/08/2017 12:25,51,70.4,69,65.9,120,67.8,2,0,0
11/08/2017 12:30,51,68.1,70,63.3,121,65.3,2,0,0
11/08/2017 12:35,57,67.6,75,62.8,132,64.8,2,0,0
11/08/2017 12:40,50,68.4,68,63.6,118,65.6,2,0,0
11/08/2017 12:45,57,68.1,76,63.2,133,65.3,2,0,0
11/08/2017 12:50,45,68,62,63.1,107,65.2,2,0,0
11/08/2017 12:55,41,67.2,59,62.3,100,64.3,2,0,0
11/08/2017 13:00,55,68.4,72,63.7,127,65.7,2,0,0
11/08/2017 13:05,47,69.4,65,64.8,112,66.8,2,0,0
11/08/2017 13:10,48,68.9,66,64.3,114,66.2,2,0,0
11/08/2017 13:15,46,69.8,64,65.2,110,67.1,2,0,0
11/08/2017 13:20,46,69.6,64,65,110,66.9,2,0,0
11/08/2017 13:25,53,69.5,71,64.9,124,66.9,2,0,0
11/08/2017 13:30,54,69.3,72,64.7,126,66.7,2,0,0
11/08/2017 13:35,60,70,79,65.5,139,67.5,2,0,0
11/08/2017 13:40,46,70.6,63,66,109,67.9,2,0,0
11/08/2017 13:45,54,69.2,73,64.5,127,66.5,2,0,0
11/08/2017 13:50,50,69,68,64.3,118,66.3,2,0,0
11/08/2017 13:55,48,69.9,65,65.3,113,67.3,2,0,0
11/08/2017 14:00,52,69.6,69,65.1,121,67,2,0,0
11/08/2017 14:05,46,70,63,65.4,109,67.3,2,0,0
11/08/2017 14:10,58,69.1,77,64.5,135,66.4,2,0,0
11/08/2017 14:15,49,69.8,66,65.2,115,67.1,2,0,0
11/08/2017 14:20,57,68,75,63.2,132,65.3,2,0,0
11/08/2017 14:25,47,66.8,65,61.9,112,64,2,0,0
11/08/2017 14:30,47,66.7,66,61.8,113,63.8,2,0,0
11/08/2017 14:35,48,67,66,62.1,114,64.2,2,0,0
11/08/2017 14:40,51,68.3,69,63.6,120,65.6,2,0,0
11/08/2017 14:45,50,68.8,69,64,119,66,2,0,0
11/08/2017 14:50,49,69.2,67,64.5,116,66.5,2,0,0
11/08/2017 14:55,52,68.9,70,64.2,122,66.2,2,0,0
11/08/2017 15:00,45,66.8,62,62,107,64,2,0,0
11/08/2017 15:05,58,67.3,77,62.5,135,64.6,2,0,0
11/08/2017 15:10,54,67,73,62.2,127,64.2,2,0,0
11/08/2017 15:15,42,67.1,60,62.3,102,64.3,2,0,0
11/08/2017 15:20,55,67.4,74,62.7,129,64.7,2,0,0
11/08/2017 15:25,54,67.8,72,63,126,65.1,2,0,0
11/08/2017 15:30,64,68,84,63.2,148,65.3,2,0,0
11/08/2017 15:35,52,68.1,70,63.4,122,65.4,2,0,0
11/08/2017 15:40,65,68.4,85,63.6,150,65.6,2,0,0
11/08/2017 15:45,48,67.5,66,62.7,114,64.7,2,0,0
11/08/2017 15:50,53,67.6,71,62.9,124,64.9,2,0,0
11/08/2017 15:55,44,67.8,61,63,105,65,2,0,0
11/08/2017 16:00,49,67.7,67,63,116,65,2,0,0
11/08/2017 16:05,38,68.1,55,63.4,93,65.3,2,0,0
11/08/2017 16:10,44,68,62,63.3,106,65.2,2,0,0
11/08/2017 16:15,38,67.1,54,62.3,92,64.3,2,0,0
11/08/2017 16:20,38,63.8,55,58.6,93,60.8,2,0,0
11/08/2017 16:25,36,55.5,54,49.4,90,51.8,2,0,0
11/08/2017 16:30,36,43.8,53,36.3,89,39.4,2,0,0
11/08/2017 16:35,31,35.3,48,26.9,79,30.2,2,0,0
11/08/2017 16:40,26,30.7,42,21.8,68,25.2,2,0,0
11/08/2017 16:45,42,28.9,60,19.9,102,23.6,2,0,0
11/08/2017 16:50,63,29.6,82,20.7,145,24.6,2,0,0
11/08/2017 16:55,51,31.3,69,22.5,120,26.3,2,0,0
11/08/2017 17:00,47,32,66,23.3,113,27,2,0,0
11/08/2017 17:05,44,37.4,62,29.3,106,32.7,2,0,0
11/08/2017 17:10,38,40.7,57,33,95,36.1,2,0,0
11/08/2017 17:15,46,42.5,65,35,111,38.1,2,0,0
11/08/2017 17:20,43,41.1,61,33.2,104,36.5,2,0,0
11/08/2017 17:25,42,45.6,61,38.1,103,41.2,2,0,0
11/08/2017 17:30,40,53.6,57,47.1,97,49.8,2,0,0
11/08/2017 17:35,48,54.7,66,48.4,114,51.1,2,0,0
11/08/2017 17:40,46,46.4,65,39.2,111,42.2,2,0,0
11/08/2017 17:45,39,37.3,57,29.1,96,32.4,2,0,0
11/08/2017 17:50,59,33.9,78,25.4,137,29.1,2,0,0
11/08/2017 17:55,55,35.3,73,26.8,128,30.4,2,0,0
11/08/2017 18:00,59,32.8,77,24.1,136,27.8,2,0,0
11/08/2017 18:05,55,31.2,73,22.3,128,26.1,2,0,0
11/08/2017 18:10,51,30.6,69,21.7,120,25.5,2,0,0
11/08/2017 18:15,46,29.3,64,20.3,110,24,2,0,0
11/08/2017 18:20,46,28.8,64,19.8,110,23.6,2,0,0
11/08/2017 18:25,52,32.2,71,23.5,123,27.2,2,0,0
11/08/2017 18:30,41,39.9,59,31.9,100,35.2,2,0,0
11/08/2017 18:35,45,52.8,63,46.2,108,48.9,2,0,0
11/08/2017 18:40,59,59.8,78,54.2,137,56.6,2,0,0
11/08/2017 18:45,49,63.6,69,58.4,118,60.5,2,0,0
11/08/2017 18:50,53,65.3,73,60.3,126,62.4,2,0,0
11/08/2017 18:55,42,66.3,59,61.4,101,63.5,2,0,0
11/08/2017 19:00,44,66.8,61,61.9,105,63.9,2,0,0
11/08/2017 19:05,43,67.4,60,62.6,103,64.6,2,0,0
11/08/2017 19:10,41,67.7,59,63,100,64.9,2,0,0
11/08/2017 19:15,39,69,57,64.4,96,66.2,2,0,0
11/08/2017 19:20,40,68,56,63.3,96,65.2,2,0,0
11/08/2017 19:25,39,67.8,56,63.1,95,65,2,0,0
11/08/2017 19:30,41,69.2,57,64.6,98,66.5,2,0,0
11/08/2017 19:35,43,69.2,61,64.6,104,66.5,2,0,0
11/08/2017 19:40,36,68,52,63.3,88,65.3,2,0,0
11/08/2017 19:45,39,67.8,56,63.1,95,65.1,2,0,0
11/08/2017 19:50,31,68.3,48,63.6,79,65.4,2,0,0
11/08/2017 19:55,35,68.3,52,63.6,87,65.5,2,0,0
11/08/2017 20:00,37,67.8,54,63.1,91,65,2,0,0
11/08/2017 20:05,35,68,51,63.2,86,65.2,2,0,0
11/08/2017 20:10,36,67.8,52,63,88,64.9,2,0,0
11/08/2017 20:15,33,67.3,50,62.4,83,64.3,2,0,0
11/08/2017 20:20,27,67.7,43,62.9,70,64.7,2,0,0
11/08/2017 20:25,32,67.6,48,62.8,80,64.7,2,0,0
11/08/2017 20:30,24,68.5,40,63.8,64,65.6,2,0,0
11/08/2017 20:35,37,67,54,62.2,91,64.2,2,0,0
11/08/2017 20:40,38,67.2,55,62.4,93,64.4,2,0,0
11/08/2017 20:45,31,68.1,47,63.4,78,65.3,2,0,0
11/08/2017 20:50,26,68.2,42,63.4,68,65.2,2,0,0
11/08/2017 20:55,30,67.1,46,62.3,76,64.2,2,0,0
11/08/2017 21:00,33,67.6,49,62.8,82,64.7,2,0,0
11/08/2017 21:05,26,68.2,42,63.4,68,65.2,2,0,0
11/08/2017 21:10,33,67.5,49,62.6,82,64.6,2,0,0
11/08/2017 21:15,21,67.6,37,62.9,58,64.6,2,0,0
11/08/2017 21:20,25,68,41,63.3,66,65,2,0,0
11/08/2017 21:25,37,67.9,54,63.2,91,65.1,2,0,0
11/08/2017 21:30,29,67.6,44,62.8,73,64.7,2,0,0
11/08/2017 21:35,30,67.9,47,63.1,77,65,2,0,0
11/08/2017 21:40,27,68.2,43,63.5,70,65.3,2,0,0
11/08/2017 21:45,26,68.4,42,63.8,68,65.5,2,0,0
11/08/2017 21:50,25,68.5,42,63.8,67,65.5,2,0,0
11/08/2017 21:55,23,67.9,39,63.2,62,65,2,0,0
11/08/2017 22:00,18,68.5,33,63.8,51,65.5,2,0,0
11/08/2017 22:05,20,68.6,36,63.9,56,65.6,2,0,0
11/08/2017 22:10,27,67.7,43,63,70,64.8,2,0,0
11/08/2017 22:15,22,67.9,37,63.2,59,65,2,0,0
11/08/2017 22:20,24,67,39,62.2,63,64.1,2,0,0
11/08/2017 22:25,26,67.9,42,63.1,68,64.9,2,0,0
11/08/2017 22:30,21,68.1,37,63.4,58,65.1,2,0,0
11/08/2017 22:35,18,68.4,34,63.7,52,65.3,2,0,0
11/08/2017 22:40,21,68.3,37,63.6,58,65.3,2,0,0
11/08/2017 22:45,23,68.3,39,63.6,62,65.4,2,0,0
11/08/2017 22:50,21,68.6,36,64,57,65.7,2,0,0
11/08/2017 22:55,13,69,28,64.4,41,65.8,2,0,0
11/08/2017 23:00,13,68.8,29,64.2,42,65.6,2,0,0
11/08/2017 23:05,20,68.8,36,64.1,56,65.8,2,0,0
11/08/2017 23:10,13,69.1,28,64.4,41,65.9,2,0,0
11/08/2017 23:15,15,68.3,30,63.6,45,65.1,2,0,0
11/08/2017 23:20,15,68.7,30,64,45,65.6,2,0,0
11/08/2017 23:25,13,68.8,29,64.1,42,65.6,2,0,0
11/08/2017 23:30,17,68.2,32,63.6,49,65.2,2,0,0
11/08/2017 23:35,12,68.7,28,64,40,65.4,2,0,0
11/08/2017 23:40,16,69.1,31,64.5,47,66,2,0,0
11/08/2017 23:45,11,69.1,27,64.5,38,65.8,2,0,0
11/08/2017 23:50,14,69,30,64.4,44,65.9,2,0,0
11/08/2017 23:55,13,69,28,64.3,41,65.8,2,0,0
11/09/2017 0:00,12,69.3,27,64.7,39,66.2,2,0,0
11/09/2017 0:05,11,69.1,26,64.5,37,65.9,2,0,0
11/09/2017 0:10,9,69.2,24,64.5,33,65.8,2,0,0
11/09/2017 0:15,10,69,26,64.4,36,65.7,2,0,0
11/09/2017 0:20,10,69.1,26,64.5,36,65.8,2,0,0
11/09/2017 0:25,9,68.9,24,64.3,33,65.6,2,0,0
11/09/2017 0:30,8,68.9,24,64.2,32,65.4,2,0,0
11/09/2017 0:35,7,69.1,22,64.4,29,65.6,2,0,0
11/09/2017 0:40,9,69.2,24,64.5,33,65.8,2,0,0
11/09/2017 0:45,6,69,21,64.3,27,65.3,2,0,0
11/09/2017 0:50,7,69.1,22,64.5,29,65.6,2,0,0
11/09/2017 0:55,9,69,24,64.4,33,65.7,2,0,0
11/09/2017 1:00,9,68.9,24,64.2,33,65.5,2,0,0
11/09/2017 1:05,8,69,23,64.4,31,65.6,2,0,0
11/09/2017 1:10,8,68.7,23,64,31,65.2,2,0,0
11/09/2017 1:15,12,69,21,64.4,33,66.1,2,0,0
11/09/2017 1:20,6,69.2,21,64.6,27,65.6,2,0,0
11/09/2017 1:25,9,69.2,24,64.5,33,65.8,2,0,0
11/09/2017 1:30,7,69.3,22,64.7,29,65.8,2,0,0
11/09/2017 1:35,11,69.3,26,64.7,37,66,2,0,0
11/09/2017 1:40,7,69.2,22,64.6,29,65.7,2,0,0
11/09/2017 1:45,7,69.3,22,64.7,29,65.8,2,0,0
11/09/2017 1:50,9,69.3,19,64.7,28,66.1,2,0,0
11/09/2017 1:55,7,69.3,22,64.7,29,65.8,2,0,0
11/09/2017 2:00,6,69.3,21,64.7,27,65.7,2,0,0
11/09/2017 2:05,7,69.4,22,64.8,29,65.9,2,0,0
11/09/2017 2:10,7,69.3,23,64.7,30,65.8,2,0,0
11/09/2017 2:15,7,69.3,22,64.7,29,65.8,2,0,0
11/09/2017 2:20,5,69,20,64.4,25,65.3,2,0,0
11/09/2017 2:25,7,69,22,64.3,29,65.4,2,0,0
11/09/2017 2:30,7,69.1,22,64.5,29,65.6,2,0,0
11/09/2017 2:35,11,69.3,26,64.7,37,66,2,0,0
11/09/2017 2:40,9,69.3,24,64.7,33,65.9,2,0,0
11/09/2017 2:45,9,69.4,24,64.8,33,66,2,0,0
11/09/2017 2:50,16,69.4,23,64.8,39,66.7,2,0,0
11/09/2017 2:55,12,68.8,28,64.2,40,65.6,2,0,0
11/09/2017 3:00,11,69.1,26,64.4,37,65.8,2,0,0
11/09/2017 3:05,8,69.3,24,64.7,32,65.8,2,0,0
11/09/2017 3:10,11,69.3,27,64.7,38,66,2,0,0
11/09/2017 3:15,13,69.4,28,64.8,41,66.3,2,0,0
11/09/2017 3:20,10,68.9,26,64.2,36,65.5,2,0,0
11/09/2017 3:25,7,69,23,64.4,30,65.4,2,0,0
11/09/2017 3:30,12,69.2,28,64.6,40,66,2,0,0
11/09/2017 3:35,19,69.2,35,64.6,54,66.2,2,0,0
11/09/2017 3:40,13,69.1,29,64.5,42,65.9,2,0,0
11/09/2017 3:45,14,68.9,30,64.3,44,65.8,2,0,0
11/09/2017 3:50,19,69.2,35,64.6,54,66.2,2,0,0
11/09/2017 3:55,16,69.3,31,64.7,47,66.2,2,0,0
11/09/2017 4:00,13,69.3,29,64.7,42,66.2,2,0,0
11/09/2017 4:05,21,69.4,37,64.8,58,66.5,2,0,0
11/09/2017 4:10,17,69.4,33,64.8,50,66.3,2,0,0
11/09/2017 4:15,23,69.5,40,64.9,63,66.6,2,0,0
11/09/2017 4:20,18,69.3,34,64.7,52,66.3,2,0,0
11/09/2017 4:25,26,69.9,42,65.3,68,67,2,0,0
11/09/2017 4:30,24,69.7,41,65.1,65,66.8,2,0,0
11/09/2017 4:35,32,69.3,49,64.7,81,66.5,2,0,0
11/09/2017 4:40,32,69.5,50,64.9,82,66.7,2,0,0
11/09/2017 4:45,41,68.3,60,63.7,101,65.6,2,0,0
11/09/2017 4:50,37,69.3,54,64.7,91,66.6,2,0,0
11/09/2017 4:55,35,69.6,53,65,88,66.8,2,0,0
11/09/2017 5:00,35,68.8,53,64.1,88,66,2,0,0
11/09/2017 5:05,40,68.6,58,64,98,65.9,2,0,0
11/09/2017 5:10,43,68.5,62,63.8,105,65.7,2,0,0
11/09/2017 5:15,47,67.8,65,63,112,65,2,0,0
11/09/2017 5:20,62,67.1,83,62.3,145,64.4,2,0,0
11/09/2017 5:25,54,67.2,74,62.4,128,64.4,2,0,0
11/09/2017 5:30,56,66.9,76,62.1,132,64.1,2,0,0
11/09/2017 5:35,50,65,70,60,120,62.1,2,0,0
11/09/2017 5:40,60,65.7,81,60.7,141,62.8,2,0,0
11/09/2017 5:45,59,66.6,79,61.8,138,63.8,2,0,0
11/09/2017 5:50,64,66.8,85,61.9,149,64,2,0,0
11/09/2017 5:55,53,67.6,73,62.8,126,64.8,2,0,0
11/09/2017 6:00,52,67.5,74,62.7,126,64.7,2,0,0
11/09/2017 6:05,51,68.1,71,63.2,122,65.2,2,0,0
11/09/2017 6:10,52,68.2,72,63.4,124,65.4,2,0,0
11/09/2017 6:15,62,67.4,83,62.5,145,64.6,2,0,0
11/09/2017 6:20,53,68.4,73,63.7,126,65.7,2,0,0
11/09/2017 6:25,63,68.3,84,63.5,147,65.6,2,0,0
11/09/2017 6:30,71,67.2,94,62.3,165,64.4,2,0,0
11/09/2017 6:35,71,68.1,94,63.3,165,65.4,2,0,0
11/09/2017 6:40,79,68.1,101,63.2,180,65.4,2,0,0
11/09/2017 6:45,79,68.7,102,63.9,181,66,2,0,0
11/09/2017 6:50,82,68.5,106,63.8,188,65.9,2,0,0
11/09/2017 6:55,70,68.9,92,64.1,162,66.2,2,0,0
11/09/2017 7:00,75,68.1,98,63.3,173,65.4,2,0,0
11/09/2017 7:05,75,68.6,97,63.9,172,65.9,2,0,0
11/09/2017 7:10,86,68.7,108,63.9,194,66,2,0,0
11/09/2017 7:15,91,67.9,116,63.1,207,65.2,2,0,0
11/09/2017 7:20,86,67.9,110,63.1,196,65.2,2,0,0
11/09/2017 7:25,95,67,119,62.1,214,64.3,2,0,0
11/09/2017 7:30,96,67.2,121,62.3,217,64.5,2,0,0
11/09/2017 7:35,100,66.4,125,61.5,225,63.7,2,0,0
11/09/2017 7:40,98,65.6,123,60.6,221,62.9,2,0,0
11/09/2017 7:45,101,66.6,125,61.6,226,63.8,2,0,0
11/09/2017 7:50,95,67.7,120,62.9,215,65,2,0,0
11/09/2017 7:55,88,66.7,113,61.8,201,63.9,2,0,0
11/09/2017 8:00,87,66.5,111,61.5,198,63.7,2,0,0
11/09/2017 8:05,96,65.1,120,59.9,216,62.2,2,0,0
11/09/2017 8:10,90,66,115,60.9,205,63.1,2,0,0
11/09/2017 8:15,85,66.1,108,61.1,193,63.3,2,0,0
11/09/2017 8:20,76,66.7,97,61.7,173,63.9,2,0,0
11/09/2017 8:25,82,66.1,106,61.1,188,63.3,2,0,0
11/09/2017 8:30,76,66.6,98,61.7,174,63.8,2,0,0
11/09/2017 8:35,80,66.9,103,62,183,64.2,2,0,0
11/09/2017 8:40,81,66.9,103,62,184,64.1,2,0,0
11/09/2017 8:45,86,66.5,108,61.5,194,63.7,2,0,0
11/09/2017 8:50,83,66.3,105,61.3,188,63.5,2,0,0
11/09/2017 8:55,77,65.2,98,60.1,175,62.3,2,0,0
11/09/2017 9:00,71,65.9,92,60.8,163,63,2,0,0
11/09/2017 9:05,79,64.6,101,59.5,180,61.8,2,0,0
11/09/2017 9:10,79,64.6,102,59.5,181,61.7,2,0,0
11/09/2017 9:15,73,65.1,94,60,167,62.3,2,0,0
11/09/2017 9:20,69,65.6,91,60.5,160,62.7,2,0,0
11/09/2017 9:25,70,67.2,90,62.3,160,64.4,2,0,0
11/09/2017 9:30,67,67.5,88,62.7,155,64.8,2,0,0
11/09/2017 9:35,63,66.5,84,61.7,147,63.7,2,0,0
11/09/2017 9:40,68,65.4,88,60.5,156,62.6,2,0,0
11/09/2017 9:45,81,65.5,104,60.5,185,62.7,2,0,0
11/09/2017 9:50,90,66.2,111,61.2,201,63.5,2,0,0
11/09/2017 9:55,71,65.8,92,60.9,163,63,2,0,0
11/09/2017 10:00,71,66.5,91,61.5,162,63.7,2,0,0
11/09/2017 10:05,56,64.4,76,59.4,132,61.5,2,0,0
11/09/2017 10:10,80,65,100,60,180,62.2,2,0,0
11/09/2017 10:15,75,65.5,97,60.6,172,62.7,2,0,0
11/09/2017 10:20,75,66.6,96,61.7,171,63.8,2,0,0
11/09/2017 10:25,77,66.9,98,62,175,64.2,2,0,0
11/09/2017 10:30,71,66.9,91,62.1,162,64.2,2,0,0
11/09/2017 10:35,64,67,82,62.2,146,64.3,2,0,0
11/09/2017 10:40,57,68.3,75,63.6,132,65.6,2,0,0
11/09/2017 10:45,64,68.2,84,63.5,148,65.5,2,0,0
11/09/2017 10:50,56,67,75,62.3,131,64.3,2,0,0
11/09/2017 10:55,60,66.5,79,61.7,139,63.8,2,0,0
11/09/2017 11:00,53,67,71,62.2,124,64.3,2,0,0
11/09/2017 11:05,63,66.9,83,62.1,146,64.2,2,0,0
11/09/2017 11:10,50,65.9,68,61,118,63.1,2,0,0
11/09/2017 11:15,59,66.1,77,61.2,136,63.4,2,0,0
11/09/2017 11:20,48,66.1,66,61.3,114,63.3,2,0,0
11/09/2017 11:25,54,66.3,73,61.6,127,63.6,2,0,0
11/09/2017 11:30,59,66.8,78,62,137,64,2,0,0
11/09/2017 11:35,51,68.5,68,63.9,119,65.9,2,0,0
11/09/2017 11:40,56,67.1,74,62.3,130,64.4,2,0,0
11/09/2017 11:45,58,68.6,77,64,135,66,2,0,0
11/09/2017 11:50,60,68.3,78,63.6,138,65.6,2,0,0
11/09/2017 11:55,52,67.7,70,63,122,65,2,0,0
11/09/2017 12:00,55,66.7,74,62,129,64,2,0,0
11/09/2017 12:05,50,67,68,62.3,118,64.3,2,0,0
11/09/2017 12:10,45,67.9,62,63.2,107,65.2,2,0,0
11/09/2017 12:15,58,67.5,76,62.7,134,64.8,2,0,0
11/09/2017 12:20,58,67.4,76,62.6,134,64.7,2,0,0
11/09/2017 12:25,61,67.3,80,62.5,141,64.6,2,0,0
11/09/2017 12:30,57,67.6,75,62.8,132,64.9,2,0,0
11/09/2017 12:35,59,66.5,77,61.6,136,63.7,2,0,0
11/09/2017 12:40,50,66.6,68,61.7,118,63.8,2,0,0
11/09/2017 12:45,51,65.8,68,60.9,119,63,2,0,0
11/09/2017 12:50,45,66.8,63,62,108,64,2,0,0
11/09/2017 12:55,56,68.3,75,63.6,131,65.6,2,0,0
11/09/2017 13:00,57,68,76,63.3,133,65.3,2,0,0
11/09/2017 13:05,44,67.1,60,62.3,104,64.3,2,0,0
11/09/2017 13:10,52,66.5,69,61.6,121,63.7,2,0,0
11/09/2017 13:15,51,64.7,69,59.7,120,61.8,2,0,0
11/09/2017 13:20,55,63.6,74,58.5,129,60.7,2,0,0
11/09/2017 13:25,56,66.1,74,61.1,130,63.3,2,0,0
11/09/2017 13:30,54,65.6,72,60.6,126,62.8,2,0,0
11/09/2017 13:35,53,66.8,70,62,123,64.1,2,0,0
11/09/2017 13:40,54,65.7,73,60.8,127,62.9,2,0,0
11/09/2017 13:45,45,66.6,62,61.7,107,63.8,2,0,0
11/09/2017 13:50,49,65.5,67,60.5,116,62.6,2,0,0
11/09/2017 13:55,54,66.8,72,62,126,64.1,2,0,0
11/09/2017 14:00,53,66.6,71,61.7,124,63.8,2,0,0
11/09/2017 14:05,47,66.4,64,61.5,111,63.5,2,0,0
11/09/2017 14:10,50,65.5,68,60.6,118,62.6,2,0,0
11/09/2017 14:15,59,66.7,78,61.8,137,63.9,2,0,0
11/09/2017 14:20,57,66.3,76,61.6,133,63.6,2,0,0
11/09/2017 14:25,52,68.2,71,63.5,123,65.5,2,0,0
11/09/2017 14:30,51,68.4,69,63.7,120,65.7,2,0,0
11/09/2017 14:35,54,68.5,73,63.8,127,65.8,2,0,0
11/09/2017 14:40,48,68,66,63.3,114,65.3,2,0,0
11/09/2017 14:45,53,69.4,72,64.8,125,66.8,2,0,0
11/09/2017 14:50,49,68.9,68,64.3,117,66.3,2,0,0
11/09/2017 14:55,48,68.5,65,63.9,113,65.9,2,0,0
11/09/2017 15:00,48,68.7,65,64.1,113,66.1,2,0,0
11/09/2017 15:05,62,66.9,81,62.1,143,64.2,2,0,0
11/09/2017 15:10,60,67.1,78,62.3,138,64.4,2,0,0
11/09/2017 15:15,62,67.8,80,63.2,142,65.2,2,0,0
11/09/2017 15:20,64,67.7,83,63.1,147,65.1,2,0,0
11/09/2017 15:25,60,68,78,63.3,138,65.3,2,0,0
11/09/2017 15:30,69,67.8,89,63.1,158,65.2,2,0,0
11/09/2017 15:35,67,67.1,87,62.3,154,64.4,2,0,0
11/09/2017 15:40,66,66.5,86,61.5,152,63.7,2,0,0
11/09/2017 15:45,65,64.8,85,59.6,150,61.9,2,0,0
11/09/2017 15:50,64,65.5,83,60.5,147,62.7,2,0,0
11/09/2017 15:55,60,64.9,78,59.7,138,62,2,0,0
11/09/2017 16:00,52,64.9,70,59.9,122,62,2,0,0
11/09/2017 16:05,63,66.1,82,61.2,145,63.3,2,0,0
11/09/2017 16:10,64,66,82,61,146,63.2,2,0,0
11/09/2017 16:15,64,66.7,84,61.7,148,63.9,2,0,0
11/09/2017 16:20,55,68.1,73,63.3,128,65.3,2,0,0
11/09/2017 16:25,64,67.9,82,63,146,65.1,2,0,0
11/09/2017 16:30,60,67.2,80,62.4,140,64.5,2,0,0
11/09/2017 16:35,48,66.8,66,62,114,64,2,0,0
11/09/2017 16:40,57,67.4,75,62.5,132,64.6,2,0,0
11/09/2017 16:45,53,67.7,71,62.9,124,65,2,0,0
11/09/2017 16:50,54,67.9,72,63.2,126,65.2,2,0,0
11/09/2017 16:55,59,68.4,78,63.7,137,65.7,2,0,0
11/09/2017 17:00,49,67.8,68,63.1,117,65,2,0,0
11/09/2017 17:05,43,68.3,60,63.5,103,65.5,2,0,0
11/09/2017 17:10,48,68.7,66,64,114,66,2,0,0
11/09/2017 17:15,51,68.8,69,64.1,120,66.1,2,0,0
11/09/2017 17:20,56,68.8,75,64.2,131,66.1,2,0,0
11/09/2017 17:25,44,68.1,62,63.4,106,65.3,2,0,0
11/09/2017 17:30,42,69.1,60,64.4,102,66.3,2,0,0
11/09/2017 17:35,55,64.1,74,58.9,129,61.1,2,0,0
11/09/2017 17:40,53,53.3,71,46.9,124,49.6,2,0,0
11/09/2017 17:45,47,46.1,65,39,112,42,2,0,0
11/09/2017 17:50,42,40.7,60,32.9,102,36.1,2,0,0
11/09/2017 17:55,38,34.8,55,26.4,93,29.8,2,0,0
11/09/2017 18:00,37,32.3,55,23.6,92,27.1,2,0,0
11/09/2017 18:05,39,47.6,57,40.5,96,43.4,2,0,0
11/09/2017 18:10,41,56.7,59,50.7,100,53.1,2,0,0
11/09/2017 18:15,48,62,66,56.6,114,58.9,2,0,0
11/09/2017 18:20,44,64.3,61,59.1,105,61.3,2,0,0
11/09/2017 18:25,50,66.3,68,61.3,118,63.4,2,0,0
11/09/2017 18:30,45,68.7,63,64,108,65.9,2,0,0
11/09/2017 18:35,45,68.5,61,63.8,106,65.8,2,0,0
11/09/2017 18:40,44,68.3,62,63.5,106,65.5,2,0,0
11/09/2017 18:45,45,68.1,63,63.4,108,65.3,2,0,0
11/09/2017 18:50,51,67.8,69,63,120,65.1,2,0,0
11/09/2017 18:55,55,68.4,73,63.6,128,65.7,2,0,0
11/09/2017 19:00,46,69.4,63,64.7,109,66.7,2,0,0
11/09/2017 19:05,48,68.7,66,64,114,66,2,0,0
11/09/2017 19:10,56,68.6,75,64,131,66,2,0,0
11/09/2017 19:15,47,69.2,64,64.6,111,66.6,2,0,0
11/09/2017 19:20,48,69.5,66,64.9,114,66.8,2,0,0
11/09/2017 19:25,37,69.3,54,64.6,91,66.5,2,0,0
11/09/2017 19:30,47,68.6,64,63.9,111,65.9,2,0,0
11/09/2017 19:35,37,69.4,54,64.7,91,66.6,2,0,0
11/09/2017 19:40,39,70,56,65.4,95,67.3,2,0,0
11/09/2017 19:45,37,70.4,54,65.8,91,67.7,2,0,0
11/09/2017 19:50,38,70.4,55,65.8,93,67.6,2,0,0
11/09/2017 19:55,40,70.4,57,65.9,97,67.7,2,0,0
11/09/2017 20:00,40,69.7,57,65.1,97,67,2,0,0
11/09/2017 20:05,36,69.2,53,64.6,89,66.5,2,0,0
11/09/2017 20:10,42,67.8,59,63,101,65,2,0,0
11/09/2017 20:15,34,68.6,51,63.9,85,65.8,2,0,0
11/09/2017 20:20,38,68.9,54,64.2,92,66.1,2,0,0
11/09/2017 20:25,37,68,55,63.3,92,65.2,2,0,0
11/09/2017 20:30,37,69,54,64.4,91,66.3,2,0,0
11/09/2017 20:35,32,69.2,49,64.6,81,66.4,2,0,0
11/09/2017 20:40,35,69.7,52,65.1,87,66.9,2,0,0
11/09/2017 20:45,38,69.4,55,64.7,93,66.6,2,0,0
11/09/2017 20:50,40,69.6,57,65,97,66.9,2,0,0
11/09/2017 20:55,40,68.4,57,63.7,97,65.6,2,0,0
11/09/2017 21:00,32,68.2,49,63.5,81,65.4,2,0,0
11/09/2017 21:05,32,69.1,48,64.5,80,66.3,2,0,0
11/09/2017 21:10,32,69.2,49,64.5,81,66.4,2,0,0
11/09/2017 21:15,42,68.4,60,63.7,102,65.7,2,0,0
11/09/2017 21:20,27,68.5,43,63.9,70,65.7,2,0,0
11/09/2017 21:25,30,68.7,46,64,76,65.8,2,0,0
11/09/2017 21:30,27,68.9,43,64.3,70,66.1,2,0,0
11/09/2017 21:35,26,69.1,42,64.5,68,66.3,2,0,0
11/09/2017 21:40,32,69.4,48,64.7,80,66.6,2,0,0
11/09/2017 21:45,28,69.6,44,65,72,66.8,2,0,0
11/09/2017 21:50,25,69.7,41,65.1,66,66.9,2,0,0
11/09/2017 21:55,21,69.1,37,64.4,58,66.1,2,0,0
11/09/2017 22:00,23,68.7,38,64.1,61,65.8,2,0,0
11/09/2017 22:05,22,69.3,38,64.7,60,66.3,2,0,0
11/09/2017 22:10,22,69,37,64.4,59,66.1,2,0,0
11/09/2017 22:15,23,69.4,39,64.8,62,66.5,2,0,0
11/09/2017 22:20,29,69.1,44,64.5,73,66.3,2,0,0
11/09/2017 22:25,32,69.5,49,65,81,66.8,2,0,0
11/09/2017 22:30,24,69.4,40,64.8,64,66.5,2,0,0
11/09/2017 22:35,24,69.3,40,64.7,64,66.4,2,0,0
11/09/2017 22:40,27,69.4,43,64.8,70,66.6,2,0,0
11/09/2017 22:45,19,69.7,35,65.1,54,66.7,2,0,0
11/09/2017 22:50,21,69.7,37,65.1,58,66.7,2,0,0
11/09/2017 22:55,18,69.3,33,64.7,51,66.4,2,0,0
11/09/2017 23:00,22,67.7,38,63,60,64.7,2,0,0
11/09/2017 23:05,18,67.9,33,63.2,51,64.9,2,0,0
11/09/2017 23:10,15,68.6,31,64,46,65.5,2,0,0
11/09/2017 23:15,12,69,27,64.4,39,65.8,2,0,0
11/09/2017 23:20,14,69.2,30,64.6,44,66,2,0,0
11/09/2017 23:25,16,69.2,31,64.6,47,66.2,2,0,0
11/09/2017 23:30,24,69.4,40,64.8,64,66.5,2,0,0
11/09/2017 23:35,21,69.3,37,64.7,58,66.3,2,0,0
11/09/2017 23:40,17,69.2,32,64.5,49,66.1,2,0,0
11/09/2017 23:45,13,69.1,28,64.5,41,66,2,0,0
11/09/2017 23:50,12,69.3,27,64.7,39,66.2,2,0,0
11/09/2017 23:55,13,69.3,28,64.7,41,66.2,2,0,0
11/10/2017 0:00,10,69.3,26,64.7,36,66,2,0,1
11/10/2017 0:05,16,68.9,31,64.3,47,65.9,2,0,1
11/10/2017 0:10,12,68.9,27,64.3,39,65.7,2,0,1
11/10/2017 0:15,11,69.3,26,64.7,37,66,2,0,1
11/10/2017 0:20,11,69.1,26,64.5,37,65.9,2,0,1
11/10/2017 0:25,11,69.3,26,64.7,37,66.1,2,0,1
11/10/2017 0:30,11,69.4,26,64.8,37,66.2,2,0,1
11/10/2017 0:35,10,69.1,25,64.4,35,65.8,2,0,1
11/10/2017 0:40,11,69.3,27,64.6,38,66,2,0,1
11/10/2017 0:45,10,69.3,25,64.7,35,66,2,0,1
11/10/2017 0:50,11,69.3,27,64.7,38,66,2,0,1
11/10/2017 0:55,8,69.3,24,64.7,32,65.9,2,0,1
11/10/2017 1:00,9,69,24,64.4,33,65.6,2,0,1
11/10/2017 1:05,10,69.3,25,64.7,35,66,2,0,1
11/10/2017 1:10,7,69.3,23,64.7,30,65.8,2,0,1
11/10/2017 1:15,6,69.2,21,64.5,27,65.6,2,0,1
11/10/2017 1:20,5,69.3,21,64.7,26,65.5,2,0,1
11/10/2017 1:25,8,69.2,23,64.6,31,65.8,2,0,1
11/10/2017 1:30,7,69.3,22,64.7,29,65.8,2,0,1
11/10/2017 1:35,12,69,27,64.4,39,65.8,2,0,1
11/10/2017 1:40,14,69.2,22,64.5,36,66.3,2,0,1
11/10/2017 1:45,6,69.2,21,64.6,27,65.6,2,0,1
11/10/2017 1:50,8,69.3,24,64.7,32,65.8,2,0,1
11/10/2017 1:55,15,69.3,22,64.7,37,66.5,2,0,1
11/10/2017 2:00,7,69.3,22,64.7,29,65.8,2,0,1
11/10/2017 2:05,11,69.4,27,64.8,38,66.1,2,0,1
11/10/2017 2:10,9,69.4,25,64.8,34,66,2,0,1
11/10/2017 2:15,6,69.1,21,64.5,27,65.5,2,0,1
11/10/2017 2:20,7,69,22,64.4,29,65.5,2,0,1
11/10/2017 2:25,7,69.2,22,64.5,29,65.7,2,0,1
11/10/2017 2:30,8,69.3,24,64.7,32,65.9,2,0,1
11/10/2017 2:35,9,69.3,25,64.7,34,65.9,2,0,1
11/10/2017 2:40,11,69.1,27,64.5,38,65.8,2,0,1
11/10/2017 2:45,11,69,26,64.4,37,65.7,2,0,1
11/10/2017 2:50,11,69,27,64.3,38,65.7,2,0,1
11/10/2017 2:55,8,69.2,24,64.6,32,65.8,2,0,1
11/10/2017 3:00,10,69.3,25,64.7,35,66.1,2,0,1
11/10/2017 3:05,10,69,25,64.4,35,65.7,2,0,1
11/10/2017 3:10,14,69,29,64.4,43,65.9,2,0,1
11/10/2017 3:15,10,69.3,26,64.7,36,66,2,0,1
11/10/2017 3:20,11,69.4,27,64.8,38,66.1,2,0,1
11/10/2017 3:25,10,69.5,26,64.9,36,66.2,2,0,1
11/10/2017 3:30,13,69.5,29,64.9,42,66.3,2,0,1
11/10/2017 3:35,15,69.6,31,65,46,66.5,2,0,1
11/10/2017 3:40,13,69.6,29,65,42,66.4,2,0,1
11/10/2017 3:45,12,69.6,28,65,40,66.4,2,0,1
11/10/2017 3:50,17,68.7,33,64.1,50,65.7,2,0,1
11/10/2017 3:55,18,69.3,34,64.7,52,66.3,2,0,1
11/10/2017 4:00,18,69,34,64.4,52,66,2,0,1
11/10/2017 4:05,13,69.3,28,64.7,41,66.2,2,0,1
11/10/2017 4:10,19,69.3,36,64.7,55,66.3,2,0,1
11/10/2017 4:15,18,69.2,33,64.6,51,66.2,2,0,1
11/10/2017 4:20,23,69.8,39,65.2,62,66.9,2,0,1
11/10/2017 4:25,19,69.4,35,64.8,54,66.4,2,0,1
11/10/2017 4:30,28,69.8,45,65.2,73,66.9,2,0,1
11/10/2017 4:35,29,69.8,47,65.2,76,67,2,0,1
11/10/2017 4:40,30,69.4,46,64.8,76,66.6,2,0,1
11/10/2017 4:45,39,69.4,58,64.8,97,66.7,2,0,1
11/10/2017 4:50,31,70.2,49,65.7,80,67.4,2,0,1
11/10/2017 4:55,39,69.9,56,65.4,95,67.2,2,0,1
11/10/2017 5:00,42,70.3,60,65.8,102,67.6,2,0,1
11/10/2017 5:05,43,71.8,61,67.5,104,69.3,2,0,1
11/10/2017 5:10,41,70.5,59,66.1,100,67.9,2,0,1
11/10/2017 5:15,46,69.9,65,65.5,111,67.3,2,0,1
11/10/2017 5:20,42,70,61,65.5,103,67.4,2,0,1
11/10/2017 5:25,51,70.3,71,65.8,122,67.7,2,0,1
11/10/2017 5:30,45,70.1,64,65.5,109,67.4,2,0,1
11/10/2017 5:35,50,68.9,70,64.2,120,66.2,2,0,1
11/10/2017 5:40,59,70.6,80,66.2,139,68.1,2,0,1
11/10/2017 5:45,59,70,79,65.4,138,67.4,2,0,1
11/10/2017 5:50,50,69.3,69,64.7,119,66.6,2,0,1
11/10/2017 5:55,47,68.9,66,64.3,113,66.2,2,0,1
11/10/2017 6:00,51,68.1,71,63.3,122,65.3,2,0,1
11/10/2017 6:05,45,67.2,65,62.3,110,64.3,2,0,1
11/10/2017 6:10,47,67.2,67,62.2,114,64.3,2,0,1
11/10/2017 6:15,53,67.6,73,62.7,126,64.7,2,0,1
11/10/2017 6:20,54,67.2,74,62.3,128,64.4,2,0,1
11/10/2017 6:25,53,66.6,72,61.7,125,63.8,2,0,1
11/10/2017 6:30,58,66.7,79,61.7,137,63.8,2,0,1
11/10/2017 6:35,60,66.6,81,61.6,141,63.7,2,0,1
11/10/2017 6:40,56,67.6,76,62.8,132,64.9,2,0,1
11/10/2017 6:45,60,67.3,81,62.4,141,64.5,2,0,1
11/10/2017 6:50,59,68,80,63.2,139,65.2,2,0,1
11/10/2017 6:55,57,68.2,77,63.3,134,65.4,2,0,1
11/10/2017 7:00,74,66.3,96,61.3,170,63.5,2,0,1
11/10/2017 7:05,59,68,80,63.1,139,65.2,2,0,1
11/10/2017 7:10,70,66.4,90,61.4,160,63.6,2,0,1
11/10/2017 7:15,66,66.7,88,61.7,154,63.8,2,0,1
11/10/2017 7:20,84,65.1,108,60,192,62.3,2,0,1
11/10/2017 7:25,71,66.1,94,61.1,165,63.3,2,0,1
11/10/2017 7:30,67,66.8,87,61.8,154,64,2,0,1
11/10/2017 7:35,62,68,82,63.1,144,65.2,2,0,1
11/10/2017 7:40,67,67.1,90,62.1,157,64.2,2,0,1
11/10/2017 7:45,61,66.9,81,61.9,142,64.1,2,0,1
11/10/2017 7:50,68,65.8,89,60.8,157,63,2,0,1
11/10/2017 7:55,61,65.8,83,60.8,144,62.9,2,0,1
11/10/2017 8:00,64,64.3,84,59.1,148,61.3,2,0,1
11/10/2017 8:05,72,65.1,94,60,166,62.2,2,0,1
11/10/2017 8:10,64,66.5,84,61.5,148,63.7,2,0,1
11/10/2017 8:15,62,66.6,83,61.6,145,63.7,2,0,1
11/10/2017 8:20,56,66.7,75,61.9,131,64,2,0,1
11/10/2017 8:25,63,66.7,83,61.7,146,63.9,2,0,1
11/10/2017 8:30,63,67.5,82,62.5,145,64.7,2,0,1
11/10/2017 8:35,62,67.3,81,62.4,143,64.6,2,0,1
11/10/2017 8:40,60,68.1,80,63.2,140,65.3,2,0,1
11/10/2017 8:45,62,67.4,82,62.5,144,64.6,2,0,1
11/10/2017 8:50,64,68.2,85,63.3,149,65.4,2,0,1
11/10/2017 8:55,60,68.5,81,63.6,141,65.7,2,0,1
11/10/2017 9:00,63,68.1,83,63.3,146,65.4,2,0,1
11/10/2017 9:05,48,66.7,66,61.7,114,63.8,2,0,1
11/10/2017 9:10,71,66.7,91,61.7,162,63.9,2,0,1
11/10/2017 9:15,65,66.9,84,61.9,149,64.1,2,0,1
11/10/2017 9:20,61,66.7,81,61.8,142,63.9,2,0,1
11/10/2017 9:25,74,66.7,96,61.7,170,63.9,2,0,1
11/10/2017 9:30,56,66.6,76,61.7,132,63.8,2,0,1
11/10/2017 9:35,62,65.2,81,60.2,143,62.4,2,0,1
11/10/2017 9:40,68,65.4,89,60.4,157,62.5,2,0,1
11/10/2017 9:45,72,66.5,92,61.6,164,63.7,2,0,1
11/10/2017 9:50,78,65,99,59.9,177,62.2,2,0,1
11/10/2017 9:55,61,66.9,80,61.9,141,64.1,2,0,1
11/10/2017 10:00,64,69.2,83,64.6,147,66.6,2,0,1
11/10/2017 10:05,60,67.7,79,62.9,139,65,2,0,1
11/10/2017 10:10,56,67.6,74,62.8,130,64.9,2,0,1
11/10/2017 10:15,68,68,87,63.3,155,65.3,2,0,1
11/10/2017 10:20,66,68.3,84,63.7,150,65.7,2,0,1
11/10/2017 10:25,71,69.5,92,64.9,163,66.9,2,0,1
11/10/2017 10:30,69,69,90,64.4,159,66.4,2,0,1
11/10/2017 10:35,62,68.2,80,63.4,142,65.5,2,0,1
11/10/2017 10:40,60,67.9,79,63.2,139,65.3,2,0,1
11/10/2017 10:45,62,68,81,63.3,143,65.3,2,0,1
11/10/2017 10:50,62,67.5,82,62.7,144,64.8,2,0,1
11/10/2017 10:55,71,65.5,92,60.5,163,62.6,2,0,1
11/10/2017 11:00,66,64,86,58.9,152,61.2,2,0,1
11/10/2017 11:05,59,64.2,78,59.1,137,61.3,2,0,1
11/10/2017 11:10,64,63.5,83,58.4,147,60.6,2,0,1
11/10/2017 11:15,61,62.7,80,57.5,141,59.7,2,0,1
11/10/2017 11:20,54,61.9,72,56.5,126,58.8,2,0,1
11/10/2017 11:25,59,61.4,77,55.9,136,58.3,2,0,1
11/10/2017 11:30,55,61,74,55.6,129,57.9,2,0,1
11/10/2017 11:35,61,61.6,82,56.2,143,58.5,2,0,1
11/10/2017 11:40,62,62.8,82,57.6,144,59.8,2,0,1
11/10/2017 11:45,57,64.6,75,59.5,132,61.7,2,0,1
11/10/2017 11:50,63,63.9,82,58.8,145,61,2,0,1
11/10/2017 11:55,66,64.8,86,59.8,152,62,2,0,1
11/10/2017 12:00,66,65.8,85,60.8,151,63,2,0,1
11/10/2017 12:05,56,66.4,75,61.5,131,63.6,2,0,1
11/10/2017 12:10,66,66.6,86,61.7,152,63.9,2,0,1
11/10/2017 12:15,62,67,81,62.1,143,64.3,2,0,1
11/10/2017 12:20,51,67.1,69,62.2,120,64.3,2,0,1
11/10/2017 12:25,55,67.9,74,63.1,129,65.1,2,0,1
11/10/2017 12:30,54,66.5,74,61.5,128,63.6,2,0,1
11/10/2017 12:35,52,67.3,69,62.4,121,64.5,2,0,1
11/10/2017 12:40,52,67,70,62.1,122,64.2,2,0,1
11/10/2017 12:45,54,66.3,73,61.4,127,63.5,2,0,1
11/10/2017 12:50,46,67.1,63,62.3,109,64.3,2,0,1
11/10/2017 12:55,55,66.3,74,61.5,129,63.5,2,0,1
11/10/2017 13:00,48,65.5,66,60.6,114,62.7,2,0,1
11/10/2017 13:05,52,66.5,69,61.5,121,63.7,2,0,1
11/10/2017 13:10,47,66.5,64,61.6,111,63.7,2,0,1
11/10/2017 13:15,52,67.8,71,63,123,65,2,0,1
11/10/2017 13:20,53,67.9,70,63.2,123,65.2,2,0,1
11/10/2017 13:25,41,66.7,59,61.9,100,63.9,2,0,1
11/10/2017 13:30,48,66.2,67,61.3,115,63.4,2,0,1
11/10/2017 13:35,50,65.6,68,60.7,118,62.8,2,0,1
11/10/2017 13:40,46,67,63,62.1,109,64.2,2,0,1
11/10/2017 13:45,41,67,59,62.1,100,64.1,2,0,1
11/10/2017 13:50,45,67.1,63,62.3,108,64.3,2,0,1
11/10/2017 13:55,48,67.8,66,63.1,114,65.1,2,0,1
11/10/2017 14:00,44,68.5,61,63.7,105,65.7,2,0,1
11/10/2017 14:05,44,66.8,61,61.8,105,63.9,2,0,1
11/10/2017 14:10,42,66.7,59,61.7,101,63.8,2,0,1
11/10/2017 14:15,52,67.3,70,62.4,122,64.5,2,0,1
11/10/2017 14:20,45,68.5,63,63.7,108,65.7,2,0,1
11/10/2017 14:25,47,68.8,66,64.1,113,66,2,0,1
11/10/2017 14:30,49,67.3,66,62.5,115,64.6,2,0,1
11/10/2017 14:35,51,68.4,68,63.6,119,65.7,2,0,1
11/10/2017 14:40,52,68,70,63.1,122,65.2,2,0,1
11/10/2017 14:45,51,68.2,68,63.4,119,65.5,2,0,1
11/10/2017 14:50,43,69.1,61,64.4,104,66.4,2,0,1
11/10/2017 14:55,47,68,64,63.2,111,65.2,2,0,1
11/10/2017 15:00,48,67.6,65,62.7,113,64.8,2,0,1
11/10/2017 15:05,47,66.8,65,61.8,112,63.9,2,0,1
11/10/2017 15:10,46,67.7,63,62.9,109,64.9,2,0,1
11/10/2017 15:15,38,68.2,56,63.4,94,65.3,2,0,1
11/10/2017 15:20,46,67.7,64,62.9,110,64.9,2,0,1
11/10/2017 15:25,55,65.8,73,60.8,128,63,2,0,1
11/10/2017 15:30,47,67.8,65,62.9,112,65,2,0,1
11/10/2017 15:35,58,68,76,63.2,134,65.3,2,0,1
11/10/2017 15:40,56,67.1,76,62.2,132,64.2,2,0,1
11/10/2017 15:45,64,66.9,83,62,147,64.1,2,0,1
11/10/2017 15:50,52,67.3,71,62.4,123,64.4,2,0,1
11/10/2017 15:55,48,68.6,66,63.9,114,65.9,2,0,1
11/10/2017 16:00,55,69.1,72,64.5,127,66.5,2,0,1
11/10/2017 16:05,53,69.7,72,65.2,125,67.1,2,0,1
11/10/2017 16:10,48,68.5,65,63.8,113,65.8,2,0,1
11/10/2017 16:15,51,68.7,68,64.1,119,66.1,2,0,1
11/10/2017 16:20,53,67.7,71,63,124,65,2,0,1
11/10/2017 16:25,51,68.3,69,63.6,120,65.6,2,0,1
11/10/2017 16:30,54,69.8,73,65.2,127,67.2,2,0,1
11/10/2017 16:35,54,68.6,73,64,127,66,2,0,1
11/10/2017 16:40,50,70.1,68,65.5,118,67.5,2,0,1
11/10/2017 16:45,37,70.3,53,65.7,90,67.6,2,0,1
11/10/2017 16:50,69,68.9,90,64.2,159,66.2,2,0,1
11/10/2017 16:55,59,68.6,77,64,136,66,2,0,1
11/10/2017 17:00,62,68,81,63.2,143,65.3,2,0,1
11/10/2017 17:05,47,68,65,63.2,112,65.3,2,0,1
11/10/2017 17:10,49,67.8,67,63,116,65.1,2,0,1
11/10/2017 17:15,50,67.5,68,62.8,118,64.8,2,0,1
11/10/2017 17:20,53,68.5,70,63.8,123,65.8,2,0,1
11/10/2017 17:25,52,67.9,71,63.2,123,65.2,2,0,1
11/10/2017 17:30,51,68.9,69,64.3,120,66.3,2,0,1
11/10/2017 17:35,50,68.5,68,63.8,118,65.8,2,0,1
11/10/2017 17:40,48,67.2,66,62.4,114,64.4,2,0,1
11/10/2017 17:45,44,65.8,61,60.9,105,62.9,2,0,1
11/10/2017 17:50,47,67.1,64,62.3,111,64.3,2,0,1
11/10/2017 17:55,46,68.6,63,63.9,109,65.9,2,0,1
11/10/2017 18:00,46,69.4,63,64.8,109,66.7,2,0,1
11/10/2017 18:05,51,68.7,69,64.1,120,66.1,2,0,1
11/10/2017 18:10,47,68.7,63,64,110,66,2,0,1
11/10/2017 18:15,55,68.2,74,63.5,129,65.5,2,0,1
11/10/2017 18:20,51,68.1,69,63.3,120,65.3,2,0,1
11/10/2017 18:25,57,67.4,75,62.6,132,64.7,2,0,1
11/10/2017 18:30,53,67.3,71,62.5,124,64.5,2,0,1
11/10/2017 18:35,56,67.4,76,62.5,132,64.6,2,0,1
11/10/2017 18:40,50,67.9,68,63.1,118,65.2,2,0,1
11/10/2017 18:45,57,67.4,75,62.6,132,64.7,2,0,1
11/10/2017 18:50,58,68.9,75,64.2,133,66.3,2,0,1
11/10/2017 18:55,48,68.3,65,63.6,113,65.6,2,0,1
11/10/2017 19:00,47,68.5,64,63.9,111,65.8,2,0,1
11/10/2017 19:05,58,69.2,76,64.6,134,66.6,2,0,1
11/10/2017 19:10,56,69.3,74,64.7,130,66.7,2,0,1
11/10/2017 19:15,54,68.9,73,64.3,127,66.3,2,0,1
11/10/2017 19:20,46,68.7,64,64.1,110,66.1,2,0,1
11/10/2017 19:25,45,69.1,63,64.5,108,66.4,2,0,1
11/10/2017 19:30,45,67.7,63,62.9,108,64.9,2,0,1
11/10/2017 19:35,41,68.1,58,63.4,99,65.3,2,0,1
11/10/2017 19:40,41,68.9,59,64.3,100,66.1,2,0,1
11/10/2017 19:45,40,69.5,57,65,97,66.9,2,0,1
11/10/2017 19:50,35,68.3,52,63.7,87,65.5,2,0,1
11/10/2017 19:55,41,69.5,58,64.9,99,66.8,2,0,1
11/10/2017 20:00,45,69.4,62,64.8,107,66.7,2,0,1
11/10/2017 20:05,36,69.8,52,65.2,88,67.1,2,0,1
11/10/2017 20:10,28,69.6,45,65,73,66.8,2,0,1
11/10/2017 20:15,31,68.6,48,63.9,79,65.7,2,0,1
11/10/2017 20:20,29,69,45,64.3,74,66.1,2,0,1
11/10/2017 20:25,37,68.6,54,63.8,91,65.8,2,0,1
11/10/2017 20:30,32,69.5,49,64.9,81,66.7,2,0,1
11/10/2017 20:35,30,67.8,46,63.1,76,64.9,2,0,1
11/10/2017 20:40,32,68.8,49,64.1,81,65.9,2,0,1
11/10/2017 20:45,26,69.5,42,64.9,68,66.7,2,0,1
11/10/2017 20:50,26,69.7,41,65.1,67,66.9,2,0,1
11/10/2017 20:55,26,70.2,42,65.6,68,67.3,2,0,1
11/10/2017 21:00,24,69.4,40,64.8,64,66.5,2,0,1
11/10/2017 21:05,25,69.5,41,64.9,66,66.6,2,0,1
11/10/2017 21:10,28,69.3,44,64.7,72,66.5,2,0,1
11/10/2017 21:15,31,69,47,64.4,78,66.3,2,0,1
11/10/2017 21:20,25,68.7,41,64,66,65.8,2,0,1
11/10/2017 21:25,30,69.4,46,64.8,76,66.6,2,0,1
11/10/2017 21:30,29,69.3,45,64.7,74,66.5,2,0,1
11/10/2017 21:35,31,69.7,47,65.1,78,66.9,2,0,1
11/10/2017 21:40,23,69.2,39,64.5,62,66.2,2,0,1
11/10/2017 21:45,25,69.1,42,64.5,67,66.2,2,0,1
11/10/2017 21:50,31,69.2,47,64.6,78,66.4,2,0,1
11/10/2017 21:55,24,69.4,39,64.8,63,66.6,2,0,1
11/10/2017 22:00,27,69.3,43,64.7,70,66.4,2,0,1
11/10/2017 22:05,24,69.2,39,64.6,63,66.4,2,0,1
11/10/2017 22:10,24,69.3,40,64.7,64,66.4,2,0,1
11/10/2017 22:15,32,69.2,48,64.5,80,66.4,2,0,1
11/10/2017 22:20,29,69.4,44,64.7,73,66.6,2,0,1
11/10/2017 22:25,28,69.3,44,64.6,72,66.4,2,0,1
11/10/2017 22:30,25,68.9,41,64.3,66,66,2,0,1
11/10/2017 22:35,26,68.8,43,64.1,69,65.9,2,0,1
11/10/2017 22:40,27,69.1,42,64.5,69,66.3,2,0,1
11/10/2017 22:45,26,69.1,42,64.5,68,66.3,2,0,1
11/10/2017 22:50,23,68.8,38,64.2,61,65.9,2,0,1
11/10/2017 22:55,18,69.1,33,64.5,51,66.1,2,0,1
11/10/2017 23:00,22,69.2,37,64.5,59,66.3,2,0,1
11/10/2017 23:05,21,69.1,36,64.5,57,66.2,2,0,1
11/10/2017 23:10,23,69.3,39,64.7,62,66.4,2,0,1
11/10/2017 23:15,22,69.2,38,64.6,60,66.3,2,0,1
11/10/2017 23:20,19,69.4,34,64.8,53,66.5,2,0,1
11/10/2017 23:25,20,69.2,35,64.6,55,66.3,2,0,1
11/10/2017 23:30,18,68.7,33,64.1,51,65.7,2,0,1
11/10/2017 23:35,19,69.1,35,64.4,54,66.1,2,0,1
11/10/2017 23:40,21,69.3,37,64.7,58,66.4,2,0,1
11/10/2017 23:45,22,69,37,64.4,59,66.1,2,0,1
11/10/2017 23:50,20,69.1,36,64.5,56,66.2,2,0,1
11/10/2017 23:55,18,69.2,33,64.6,51,66.2,2,0,1
11/11/2017 0:00,17,69.3,32,64.7,49,66.3,2,0,0
11/11/2017 0:05,20,69.6,36,65,56,66.6,2,0,0
11/11/2017 0:10,16,69.4,31,64.8,47,66.4,2,0,0
11/11/2017 0:15,13,69.4,28,64.8,41,66.3,2,0,0
11/11/2017 0:20,14,69.3,30,64.7,44,66.2,2,0,0
11/11/2017 0:25,12,69.4,28,64.8,40,66.2,2,0,0
11/11/2017 0:30,16,69.2,32,64.5,48,66.1,2,0,0
11/11/2017 0:35,13,69.3,29,64.7,42,66.1,2,0,0
11/11/2017 0:40,12,69.3,27,64.7,39,66.1,2,0,0
11/11/2017 0:45,12,69,27,64.4,39,65.8,2,0,0
11/11/2017 0:50,9,69.3,24,64.7,33,65.9,2,0,0
11/11/2017 0:55,9,69.3,24,64.7,33,65.9,2,0,0
11/11/2017 1:00,12,69.3,27,64.7,39,66.1,2,0,0
11/11/2017 1:05,11,69.1,27,64.5,38,65.8,2,0,0
11/11/2017 1:10,10,69.2,25,64.5,35,65.9,2,0,0
11/11/2017 1:15,8,69.1,23,64.5,31,65.7,2,0,0
11/11/2017 1:20,7,69.1,22,64.5,29,65.6,2,0,0
11/11/2017 1:25,9,69.3,25,64.7,34,65.9,2,0,0
11/11/2017 1:30,11,69.3,27,64.7,38,66.1,2,0,0
11/11/2017 1:35,8,69.4,23,64.8,31,66,2,0,0
11/11/2017 1:40,8,69.4,23,64.8,31,66,2,0,0
11/11/2017 1:45,8,69.3,23,64.7,31,65.9,2,0,0
11/11/2017 1:50,10,69.4,26,64.8,36,66.1,2,0,0
11/11/2017 1:55,9,69.3,24,64.7,33,65.9,2,0,0
11/11/2017 2:00,8,69.3,23,64.7,31,65.9,2,0,0
11/11/2017 2:05,5,69.4,21,64.7,26,65.6,2,0,0
11/11/2017 2:10,8,69.4,23,64.7,31,65.9,2,0,0
11/11/2017 2:15,6,69.3,21,64.7,27,65.7,2,0,0
11/11/2017 2:20,7,69.1,22,64.5,29,65.6,2,0,0
11/11/2017 2:25,10,69.3,25,64.7,35,66,2,0,0
11/11/2017 2:30,9,69.3,24,64.7,33,66,2,0,0
11/11/2017 2:35,10,69.3,25,64.7,35,66.1,2,0,0
11/11/2017 2:40,10,69.1,26,64.4,36,65.7,2,0,0
11/11/2017 2:45,11,69.2,27,64.5,38,65.9,2,0,0
11/11/2017 2:50,11,69.3,26,64.7,37,66,2,0,0
11/11/2017 2:55,9,69,24,64.4,33,65.7,2,0,0
11/11/2017 3:00,10,69.1,26,64.5,36,65.8,2,0,0
11/11/2017 3:05,9,69.2,24,64.6,33,65.9,2,0,0
11/11/2017 3:10,7,69.2,22,64.6,29,65.7,2,0,0
11/11/2017 3:15,7,69.1,23,64.5,30,65.6,2,0,0
11/11/2017 3:20,7,69.3,23,64.7,30,65.8,2,0,0
11/11/2017 3:25,10,69.4,26,64.8,36,66.1,2,0,0
11/11/2017 3:30,7,69.3,22,64.7,29,65.8,2,0,0
11/11/2017 3:35,6,69.2,21,64.6,27,65.6,2,0,0
11/11/2017 3:40,7,69.3,22,64.7,29,65.8,2,0,0
11/11/2017 3:45,7,69.4,22,64.8,29,65.9,2,0,0
11/11/2017 3:50,7,69.2,22,64.6,29,65.7,2,0,0
11/11/2017 3:55,9,69.3,25,64.7,34,65.9,2,0,0
11/11/2017 4:00,9,69.4,24,64.8,33,66,2,0,0
11/11/2017 4:05,10,69.4,25,64.8,35,66.1,2,0,0
11/11/2017 4:10,10,69,25,64.4,35,65.7,2,0,0
11/11/2017 4:15,13,69.1,28,64.5,41,66,2,0,0
11/11/2017 4:20,11,69.2,27,64.6,38,65.9,2,0,0
11/11/2017 4:25,13,69.3,28,64.7,41,66.2,2,0,0
11/11/2017 4:30,11,69.3,27,64.7,38,66,2,0,0
11/11/2017 4:35,12,69.4,27,64.8,39,66.2,2,0,0
11/11/2017 4:40,10,69.3,26,64.7,36,65.9,2,0,0
11/11/2017 4:45,16,69.1,32,64.5,48,66,2,0,0
11/11/2017 4:50,15,69.2,30,64.6,45,66.2,2,0,0
11/11/2017 4:55,16,69.1,32,64.5,48,66,2,0,0
11/11/2017 5:00,15,69.2,31,64.5,46,66.1,2,0,0
11/11/2017 5:05,11,69.3,27,64.7,38,66,2,0,0
11/11/2017 5:10,15,69.3,30,64.7,45,66.2,2,0,0
11/11/2017 5:15,15,69.3,31,64.7,46,66.2,2,0,0
11/11/2017 5:20,20,69.5,36,64.9,56,66.5,2,0,0
11/11/2017 5:25,18,69.6,34,65,52,66.6,2,0,0
11/11/2017 5:30,17,69.3,33,64.7,50,66.3,2,0,0
11/11/2017 5:35,20,69.4,36,64.8,56,66.5,2,0,0
11/11/2017 5:40,20,69.6,36,65,56,66.6,2,0,0
11/11/2017 5:45,21,68.7,37,64,58,65.7,2,0,0
11/11/2017 5:50,18,69,34,64.4,52,66,2,0,0
11/11/2017 5:55,17,68.9,33,64.2,50,65.8,2,0,0
11/11/2017 6:00,19,69.1,35,64.5,54,66.1,2,0,0
11/11/2017 6:05,21,69.2,38,64.6,59,66.3,2,0,0
11/11/2017 6:10,26,68.1,42,63.5,68,65.3,2,0,0
11/11/2017 6:15,29,68.1,46,63.4,75,65.2,2,0,0
11/11/2017 6:20,26,68.6,43,63.9,69,65.7,2,0,0
11/11/2017 6:25,24,68.8,40,64.1,64,65.8,2,0,0
11/11/2017 6:30,24,69.2,41,64.6,65,66.3,2,0,0
11/11/2017 6:35,31,70,48,65.4,79,67.2,2,0,0
11/11/2017 6:40,35,69.2,53,64.6,88,66.4,2,0,0
11/11/2017 6:45,33,69.9,50,65.3,83,67.2,2,0,0
11/11/2017 6:50,31,69.7,47,65.1,78,66.9,2,0,0
11/11/2017 6:55,30,69.9,47,65.4,77,67.1,2,0,0
11/11/2017 7:00,23,69.9,39,65.4,62,67.1,2,0,0
11/11/2017 7:05,28,69.5,45,65,73,66.7,2,0,0
11/11/2017 7:10,28,69.9,45,65.3,73,67.1,2,0,0
11/11/2017 7:15,38,68.8,55,64.2,93,66.1,2,0,0
11/11/2017 7:20,36,69.2,53,64.6,89,66.5,2,0,0
11/11/2017 7:25,37,69.3,55,64.7,92,66.5,2,0,0
11/11/2017 7:30,32,69.3,48,64.7,80,66.5,2,0,0
11/11/2017 7:35,33,69.5,49,64.9,82,66.7,2,0,0
11/11/2017 7:40,43,68.8,61,64.2,104,66.1,2,0,0
11/11/2017 7:45,44,68.9,62,64.3,106,66.2,2,0,0
11/11/2017 7:50,48,69.1,65,64.5,113,66.5,2,0,0
11/11/2017 7:55,43,69.4,60,64.8,103,66.7,2,0,0
11/11/2017 8:00,39,70,56,65.4,95,67.2,2,0,0
11/11/2017 8:05,39,69.6,56,65,95,66.9,2,0,0
11/11/2017 8:10,37,69.6,54,65,91,66.9,2,0,0
11/11/2017 8:15,42,69.1,59,64.5,101,66.4,2,0,0
11/11/2017 8:20,46,69.6,63,65,109,66.9,2,0,0
11/11/2017 8:25,39,69.6,55,65,94,66.9,2,0,0
11/11/2017 8:30,44,69.8,61,65.3,105,67.2,2,0,0
11/11/2017 8:35,47,69.4,64,64.8,111,66.7,2,0,0
11/11/2017 8:40,48,69.5,66,64.9,114,66.8,2,0,0
11/11/2017 8:45,51,69,70,64.3,121,66.3,2,0,0
11/11/2017 8:50,49,69.4,67,64.8,116,66.8,2,0,0
11/11/2017 8:55,55,69,74,64.4,129,66.4,2,0,0
11/11/2017 9:00,52,69.5,69,64.9,121,66.9,2,0,0
11/11/2017 9:05,43,69.5,61,65,104,66.9,2,0,0
11/11/2017 9:10,51,69.7,69,65.1,120,67,2,0,0
11/11/2017 9:15,61,69.6,79,65.1,140,67,2,0,0
11/11/2017 9:20,56,68.8,75,64.2,131,66.2,2,0,0
11/11/2017 9:25,53,68.8,71,64.2,124,66.1,2,0,0
11/11/2017 9:30,59,69.4,78,64.8,137,66.8,2,0,0
11/11/2017 9:35,59,68.6,78,63.9,137,65.9,2,0,0
11/11/2017 9:40,58,69.3,76,64.6,134,66.6,2,0,0
11/11/2017 9:45,64,69.4,83,64.7,147,66.8,2,0,0
11/11/2017 9:50,63,69.3,82,64.7,145,66.7,2,0,0
11/11/2017 9:55,58,70,76,65.5,134,67.5,2,0,0
11/11/2017 10:00,62,69.9,82,65.4,144,67.3,2,0,0
11/11/2017 10:05,59,69.8,78,65.3,137,67.2,2,0,0
11/11/2017 10:10,56,69.4,75,64.8,131,66.8,2,0,0
11/11/2017 10:15,57,67.9,76,63.2,133,65.2,2,0,0
11/11/2017 10:20,53,68.4,72,63.7,125,65.7,2,0,0
11/11/2017 10:25,54,68.1,71,63.3,125,65.4,2,0,0
11/11/2017 10:30,57,69.1,75,64.5,132,66.5,2,0,0
11/11/2017 10:35,61,67.7,80,62.9,141,65,2,0,0
11/11/2017 10:40,62,68.3,80,63.5,142,65.6,2,0,0
11/11/2017 10:45,58,68,78,63.2,136,65.3,2,0,0
11/11/2017 10:50,68,68.6,88,63.9,156,65.9,2,0,0
11/11/2017 10:55,68,68.1,87,63.4,155,65.5,2,0,0
11/11/2017 11:00,59,68.5,78,63.8,137,65.9,2,0,0
11/11/2017 11:05,70,68,90,63.2,160,65.3,2,0,0
11/11/2017 11:10,60,67.6,79,62.8,139,64.9,2,0,0
11/11/2017 11:15,58,67.8,77,63,135,65.1,2,0,0
11/11/2017 11:20,60,68.5,79,63.7,139,65.8,2,0,0
11/11/2017 11:25,66,68.5,85,63.7,151,65.8,2,0,0
11/11/2017 11:30,59,68.7,78,64.1,137,66.1,2,0,0
11/11/2017 11:35,62,68.5,82,63.9,144,65.9,2,0,0
11/11/2017 11:40,65,68.4,83,63.8,148,65.8,2,0,0
11/11/2017 11:45,75,68.5,96,63.8,171,65.9,2,0,0
11/11/2017 11:50,71,68,91,63.3,162,65.3,2,0,0
11/11/2017 11:55,65,68,84,63.3,149,65.4,2,0,0
11/11/2017 12:00,59,68,77,63.3,136,65.4,2,0,0
11/11/2017 12:05,66,68.7,85,64,151,66.1,2,0,0
11/11/2017 12:10,68,68.6,89,63.9,157,65.9,2,0,0
11/11/2017 12:15,75,68.3,95,63.7,170,65.7,2,0,0
11/11/2017 12:20,59,68.2,78,63.5,137,65.5,2,0,0
11/11/2017 12:25,67,68.7,86,64.1,153,66.1,2,0,0
11/11/2017 12:30,66,68.3,84,63.6,150,65.7,2,0,0
11/11/2017 12:35,60,69.1,78,64.5,138,66.5,2,0,0
11/11/2017 12:40,70,69.3,89,64.7,159,66.7,2,0,0
11/11/2017 12:45,70,68.9,90,64.3,160,66.3,2,0,0
11/11/2017 12:50,59,68.2,78,63.5,137,65.6,2,0,0
11/11/2017 12:55,66,69,85,64.4,151,66.4,2,0,0
11/11/2017 13:00,70,69,89,64.3,159,66.4,2,0,0
11/11/2017 13:05,62,69,81,64.4,143,66.4,2,0,0
11/11/2017 13:10,64,69.4,83,64.8,147,66.8,2,0,0
11/11/2017 13:15,60,68,79,63.3,139,65.3,2,0,0
11/11/2017 13:20,61,68.5,80,63.9,141,65.9,2,0,0
11/11/2017 13:25,62,69.4,81,64.8,143,66.8,2,0,0
11/11/2017 13:30,64,69.4,84,64.8,148,66.8,2,0,0
11/11/2017 13:35,72,69,92,64.4,164,66.4,2,0,0
11/11/2017 13:40,78,68.5,97,63.8,175,65.9,2,0,0
11/11/2017 13:45,63,68.7,82,64.1,145,66.1,2,0,0
11/11/2017 13:50,67,68.1,87,63.3,154,65.4,2,0,0
11/11/2017 13:55,67,66.9,88,62,155,64.1,2,0,0
11/11/2017 14:00,65,68,84,63.2,149,65.3,2,0,0
11/11/2017 14:05,71,68,91,63.2,162,65.3,2,0,0
11/11/2017 14:10,64,68.1,83,63.3,147,65.4,2,0,0
11/11/2017 14:15,64,68.5,84,63.7,148,65.7,2,0,0
11/11/2017 14:20,63,68.9,82,64.2,145,66.2,2,0,0
11/11/2017 14:25,64,69.1,83,64.4,147,66.4,2,0,0
11/11/2017 14:30,69,68.9,88,64.3,157,66.3,2,0,0
11/11/2017 14:35,69,67.9,88,63.2,157,65.2,2,0,0
11/11/2017 14:40,66,67,85,62.2,151,64.3,2,0,0
11/11/2017 14:45,59,68.1,77,63.4,136,65.4,2,0,0
11/11/2017 14:50,65,68.8,84,64.1,149,66.2,2,0,0
11/11/2017 14:55,57,68.8,75,64.2,132,66.2,2,0,0
11/11/2017 15:00,60,69.2,79,64.7,139,66.6,2,0,0
11/11/2017 15:05,60,69.2,78,64.6,138,66.6,2,0,0
11/11/2017 15:10,60,70,78,65.4,138,67.4,2,0,0
11/11/2017 15:15,55,69.1,73,64.4,128,66.4,2,0,0
11/11/2017 15:20,58,68.8,78,64.1,136,66.1,2,0,0
11/11/2017 15:25,62,68.2,82,63.5,144,65.5,2,0,0
11/11/2017 15:30,61,67.7,80,62.9,141,65,2,0,0
11/11/2017 15:35,64,67.4,83,62.7,147,64.8,2,0,0
11/11/2017 15:40,64,67.9,84,63.2,148,65.3,2,0,0
11/11/2017 15:45,70,68.5,89,63.9,159,65.9,2,0,0
11/11/2017 15:50,67,68.8,85,64.1,152,66.2,2,0,0
11/11/2017 15:55,61,68.7,80,64,141,66,2,0,0
11/11/2017 16:00,62,68.9,81,64.3,143,66.3,2,0,0
11/11/2017 16:05,64,67.4,83,62.6,147,64.7,2,0,0
11/11/2017 16:10,77,68.1,98,63.4,175,65.5,2,0,0
11/11/2017 16:15,72,67.5,91,62.7,163,64.8,2,0,0
11/11/2017 16:20,70,67.5,89,62.7,159,64.8,2,0,0
11/11/2017 16:25,61,68.1,78,63.4,139,65.4,2,0,0
11/11/2017 16:30,76,67.8,97,63.1,173,65.2,2,0,0
11/11/2017 16:35,67,68.4,87,63.7,154,65.7,2,0,0
11/11/2017 16:40,70,69.2,89,64.5,159,66.6,2,0,0
11/11/2017 16:45,75,68.3,95,63.6,170,65.7,2,0,0
11/11/2017 16:50,57,67.3,76,62.5,133,64.5,2,0,0
11/11/2017 16:55,68,67.5,88,62.7,156,64.8,2,0,0
11/11/2017 17:00,72,66.7,92,61.8,164,64,2,0,0
11/11/2017 17:05,58,66.5,76,61.6,134,63.7,2,0,0
11/11/2017 17:10,52,66.3,70,61.4,122,63.5,2,0,0
11/11/2017 17:15,49,67.4,67,62.6,116,64.6,2,0,0
11/11/2017 17:20,66,67.5,85,62.7,151,64.8,2,0,0
11/11/2017 17:25,53,67.6,71,62.8,124,64.9,2,0,0
11/11/2017 17:30,56,67.1,74,62.2,130,64.3,2,0,0
11/11/2017 17:35,50,67.4,68,62.6,118,64.7,2,0,0
11/11/2017 17:40,56,67,75,62.1,131,64.2,2,0,0
11/11/2017 17:45,65,66.7,83,61.8,148,63.9,2,0,0
11/11/2017 17:50,58,66.5,76,61.6,134,63.7,2,0,0
11/11/2017 17:55,57,66.2,76,61.3,133,63.4,2,0,0
11/11/2017 18:00,65,66.5,85,61.6,150,63.7,2,0,0
11/11/2017 18:05,63,66.3,82,61.4,145,63.5,2,0,0
11/11/2017 18:10,66,65.4,85,60.4,151,62.6,2,0,0
11/11/2017 18:15,60,66.6,79,61.8,139,63.9,2,0,0
11/11/2017 18:20,56,66.9,74,62.1,130,64.2,2,0,0
11/11/2017 18:25,62,66.9,82,62,144,64.1,2,0,0
11/11/2017 18:30,45,67.5,62,62.7,107,64.7,2,0,0
11/11/2017 18:35,66,66.9,85,62,151,64.1,2,0,0
11/11/2017 18:40,49,67.6,66,62.8,115,64.9,2,0,0
11/11/2017 18:45,53,68,69,63.3,122,65.3,2,0,0
11/11/2017 18:50,56,68.8,73,64.2,129,66.2,2,0,0
11/11/2017 18:55,46,69.3,64,64.7,110,66.6,2,0,0
11/11/2017 19:00,50,69.1,68,64.5,118,66.4,2,0,0
11/11/2017 19:05,50,68.9,68,64.2,118,66.2,2,0,0
11/11/2017 19:10,54,69,72,64.3,126,66.3,2,0,0
11/11/2017 19:15,49,68.6,66,63.9,115,65.9,2,0,0
11/11/2017 19:20,45,68.6,62,63.8,107,65.8,2,0,0
11/11/2017 19:25,56,68,74,63.3,130,65.3,2,0,0
11/11/2017 19:30,43,68.7,59,64.1,102,66,2,0,0
11/11/2017 19:35,49,70,66,65.4,115,67.4,2,0,0
11/11/2017 19:40,46,69.4,63,64.8,109,66.7,2,0,0
11/11/2017 19:45,45,69.2,63,64.6,108,66.5,2,0,0
11/11/2017 19:50,38,69.3,54,64.6,92,66.5,2,0,0
11/11/2017 19:55,38,69.1,55,64.4,93,66.4,2,0,0
11/11/2017 20:00,37,69.1,54,64.5,91,66.4,2,0,0
11/11/2017 20:05,47,69.7,64,65.1,111,67.1,2,0,0
11/11/2017 20:10,37,68.8,54,64.2,91,66.1,2,0,0
11/11/2017 20:15,38,69.2,54,64.5,92,66.5,2,0,0
11/11/2017 20:20,37,69.2,53,64.6,90,66.5,2,0,0
11/11/2017 20:25,37,69.4,54,64.8,91,66.6,2,0,0
11/11/2017 20:30,33,69.5,49,64.9,82,66.7,2,0,0
11/11/2017 20:35,42,69.7,59,65.2,101,67.1,2,0,0
11/11/2017 20:40,27,68.8,44,64.2,71,66,2,0,0
11/11/2017 20:45,32,69,47,64.4,79,66.3,2,0,0
11/11/2017 20:50,37,69.7,54,65.1,91,67,2,0,0
11/11/2017 20:55,34,69.3,50,64.7,84,66.6,2,0,0
11/11/2017 21:00,28,69,44,64.4,72,66.2,2,0,0
11/11/2017 21:05,30,69.3,46,64.7,76,66.6,2,0,0
11/11/2017 21:10,37,69.2,53,64.5,90,66.4,2,0,0
11/11/2017 21:15,28,68.9,44,64.3,72,66.1,2,0,0
11/11/2017 21:20,35,68.6,51,63.9,86,65.8,2,0,0
11/11/2017 21:25,34,68.7,50,64.1,84,65.9,2,0,0
11/11/2017 21:30,34,68.9,51,64.2,85,66.1,2,0,0
11/11/2017 21:35,29,68.9,46,64.2,75,66,2,0,0
11/11/2017 21:40,32,68.9,49,64.2,81,66.1,2,0,0
11/11/2017 21:45,32,69.2,48,64.5,80,66.4,2,0,0
11/11/2017 21:50,30,69.2,46,64.6,76,66.4,2,0,0
11/11/2017 21:55,37,68.8,55,64.1,92,66,2,0,0
11/11/2017 22:00,32,69.1,48,64.5,80,66.3,2,0,0
11/11/2017 22:05,34,68.8,52,64.1,86,66,2,0,0
11/11/2017 22:10,25,68.8,41,64.1,66,65.9,2,0,0
11/11/2017 22:15,31,69.2,47,64.6,78,66.4,2,0,0
11/11/2017 22:20,31,69.2,47,64.6,78,66.4,2,0,0
11/11/2017 22:25,32,68.8,48,64.2,80,66,2,0,0
11/11/2017 22:30,30,68.8,45,64.2,75,66.1,2,0,0
11/11/2017 22:35,29,69.1,46,64.5,75,66.2,2,0,0
11/11/2017 22:40,31,69,47,64.4,78,66.2,2,0,0
11/11/2017 22:45,31,69.1,47,64.5,78,66.4,2,0,0
11/11/2017 22:50,27,69.6,43,65,70,66.8,2,0,0
11/11/2017 22:55,24,69,39,64.4,63,66.1,2,0,0
11/11/2017 23:00,25,69.1,41,64.5,66,66.3,2,0,0
11/11/2017 23:05,22,69.1,38,64.5,60,66.2,2,0,0
11/11/2017 23:10,28,69.2,44,64.6,72,66.4,2,0,0
11/11/2017 23:15,25,69.4,42,64.8,67,66.5,2,0,0
11/11/2017 23:20,22,69.5,38,64.9,60,66.6,2,0,0
11/11/2017 23:25,23,69.7,38,65.1,61,66.8,2,0,0
11/11/2017 23:30,22,69.8,37,65.2,59,66.9,2,0,0
11/11/2017 23:35,18,69.9,33,65.3,51,66.9,2,0,0
11/11/2017 23:40,23,69.5,38,64.9,61,66.7,2,0,0
11/11/2017 23:45,29,69.7,44,65.1,73,66.9,2,0,0
11/11/2017 23:50,25,69.5,41,64.9,66,66.6,2,0,0
11/11/2017 23:55,17,69.4,32,64.8,49,66.4,2,0,0
11/12/2017 0:00,17,69.3,33,64.7,50,66.3,2,0,0
11/12/2017 0:05,20,69.3,35,64.7,55,66.3,2,0,0
11/12/2017 0:10,16,69.2,32,64.5,48,66.1,2,0,0
11/12/2017 0:15,15,69.2,30,64.6,45,66.2,2,0,0
11/12/2017 0:20,20,69.4,36,64.8,56,66.5,2,0,0
11/12/2017 0:25,17,69.4,32,64.8,49,66.4,2,0,0
11/12/2017 0:30,13,69.4,28,64.8,41,66.2,2,0,0
11/12/2017 0:35,13,69.4,29,64.8,42,66.2,2,0,0
11/12/2017 0:40,14,69.4,30,64.8,44,66.2,2,0,0
11/12/2017 0:45,15,69.4,30,64.8,45,66.3,2,0,0
11/12/2017 0:50,16,69.3,32,64.7,48,66.3,2,0,0
11/12/2017 0:55,13,69.3,28,64.7,41,66.2,2,0,0
11/12/2017 1:00,10,69.2,25,64.6,35,65.9,2,0,0
11/12/2017 1:05,11,69.3,27,64.7,38,66,2,0,0
11/12/2017 1:10,10,69.1,25,64.5,35,65.8,2,0,0
11/12/2017 1:15,11,69.2,26,64.6,37,66,2,0,0
11/12/2017 1:20,8,69.3,23,64.7,31,65.8,2,0,0
11/12/2017 1:25,10,69.3,25,64.7,35,66,2,0,0
11/12/2017 1:30,7,69.2,22,64.6,29,65.7,2,0,0
11/12/2017 1:35,7,69.3,22,64.7,29,65.8,2,0,0
11/12/2017 1:40,9,69.3,25,64.7,34,66,2,0,0
11/12/2017 1:45,14,69.4,29,64.8,43,66.3,2,0,0
11/12/2017 1:50,10,69.4,25,64.8,35,66.1,2,0,0
11/12/2017 1:55,9,69.4,25,64.8,34,66.1,2,0,0
11/12/2017 2:00,9,69.5,25,64.9,34,66.1,2,0,0
11/12/2017 2:05,8,69.4,24,64.8,32,66,2,0,0
11/12/2017 2:10,9,69.4,24,64.8,33,66.1,2,0,0
11/12/2017 2:15,8,69.6,24,65,32,66.1,2,0,0
11/12/2017 2:20,10,69.5,25,65,35,66.3,2,0,0
11/12/2017 2:25,14,69.5,22,64.9,36,66.7,2,0,0
11/12/2017 2:30,8,69.4,24,64.8,32,66,2,0,0
11/12/2017 2:35,10,69.3,25,64.7,35,66,2,0,0
11/12/2017 2:40,8,69.4,23,64.7,31,65.9,2,0,0
11/12/2017 2:45,8,69.4,23,64.8,31,66,2,0,0
11/12/2017 2:50,7,69.4,22,64.8,29,66,2,0,0
11/12/2017 2:55,9,69.3,24,64.7,33,66,2,0,0
11/12/2017 3:00,9,69.4,25,64.8,34,66.1,2,0,0
11/12/2017 3:05,10,69.3,25,64.7,35,66,2,0,0
11/12/2017 3:10,7,69.3,22,64.7,29,65.8,2,0,0
11/12/2017 3:15,8,69.3,23,64.7,31,65.9,2,0,0
11/12/2017 3:20,5,69.4,21,64.8,26,65.7,2,0,0
11/12/2017 3:25,8,69.4,23,64.8,31,66,2,0,0
11/12/2017 3:30,10,69.3,26,64.7,36,66,2,0,0
11/12/2017 3:35,8,69.3,23,64.7,31,65.8,2,0,0
11/12/2017 3:40,8,69.2,23,64.6,31,65.8,2,0,0
11/12/2017 3:45,10,69.2,25,64.6,35,65.9,2,0,0
11/12/2017 3:50,15,69.2,22,64.6,37,66.5,2,0,0
11/12/2017 3:55,8,69.3,23,64.7,31,65.9,2,0,0
11/12/2017 4:00,11,69.3,26,64.7,37,66.1,2,0,0
11/12/2017 4:05,8,69.3,23,64.7,31,65.8,2,0,0
11/12/2017 4:10,9,69.4,24,64.8,33,66.1,2,0,0
11/12/2017 4:15,10,69.4,26,64.8,36,66.1,2,0,0
11/12/2017 4:20,7,69.3,22,64.7,29,65.8,2,0,0
11/12/2017 4:25,10,69.3,25,64.7,35,66,2,0,0
11/12/2017 4:30,10,69.3,25,64.7,35,66,2,0,0
11/12/2017 4:35,12,69.3,28,64.7,40,66,2,0,0
11/12/2017 4:40,12,69.3,28,64.7,40,66,2,0,0
11/12/2017 4:45,15,69.4,30,64.8,45,66.3,2,0,0
11/12/2017 4:50,12,69.3,27,64.7,39,66.1,2,0,0
11/12/2017 4:55,14,69.3,30,64.7,44,66.1,2,0,0
11/12/2017 5:00,11,69.2,27,64.5,38,65.9,2,0,0
11/12/2017 5:05,13,69.2,29,64.5,42,66,2,0,0
11/12/2017 5:10,19,69.3,35,64.7,54,66.3,2,0,0
11/12/2017 5:15,16,69.3,31,64.7,47,66.3,2,0,0
11/12/2017 5:20,13,69.2,29,64.6,42,66.1,2,0,0
11/12/2017 5:25,16,69,32,64.4,48,65.9,2,0,0
11/12/2017 5:30,24,69.2,40,64.5,64,66.3,2,0,0
11/12/2017 5:35,17,69.2,34,64.6,51,66.1,2,0,0
11/12/2017 5:40,19,69.5,35,64.9,54,66.5,2,0,0
11/12/2017 5:45,15,69.4,30,64.8,45,66.4,2,0,0
11/12/2017 5:50,18,69.6,34,65,52,66.6,2,0,0
11/12/2017 5:55,14,69.4,30,64.8,44,66.3,2,0,0
11/12/2017 6:00,14,69.3,29,64.7,43,66.2,2,0,0
11/12/2017 6:05,11,69.2,27,64.6,38,66,2,0,0
11/12/2017 6:10,17,68.8,33,64.2,50,65.7,2,0,0
11/12/2017 6:15,18,69.2,34,64.6,52,66.2,2,0,0
11/12/2017 6:20,17,69.2,33,64.5,50,66.1,2,0,0
11/12/2017 6:25,15,69.3,30,64.7,45,66.2,2,0,0
11/12/2017 6:30,14,69.3,29,64.7,43,66.2,2,0,0
11/12/2017 6:35,21,69.4,36,64.8,57,66.5,2,0,0
11/12/2017 6:40,19,68.6,35,63.9,54,65.6,2,0,0
11/12/2017 6:45,23,69,39,64.4,62,66.1,2,0,0
11/12/2017 6:50,19,69.3,34,64.7,53,66.3,2,0,0
11/12/2017 6:55,18,69.4,34,64.8,52,66.4,2,0,0
11/12/2017 7:00,15,69.4,31,64.8,46,66.3,2,0,0
11/12/2017 7:05,21,69.3,36,64.7,57,66.4,2,0,0
11/12/2017 7:10,21,69.4,36,64.8,57,66.5,2,0,0
11/12/2017 7:15,23,69.7,39,65.1,62,66.8,2,0,0
11/12/2017 7:20,17,69,32,64.4,49,66,2,0,0
11/12/2017 7:25,24,69,41,64.4,65,66.1,2,0,0
11/12/2017 7:30,26,69.5,42,64.9,68,66.7,2,0,0
11/12/2017 7:35,22,69.4,38,64.8,60,66.5,2,0,0
11/12/2017 7:40,30,69.5,46,64.9,76,66.7,2,0,0
11/12/2017 7:45,29,69.7,45,65.1,74,66.9,2,0,0
11/12/2017 7:50,30,69.4,46,64.8,76,66.7,2,0,0
11/12/2017 7:55,27,69.8,43,65.2,70,67,2,0,0
11/12/2017 8:00,26,69.6,42,65,68,66.8,2,0,0
11/12/2017 8:05,28,69.6,44,65,72,66.8,2,0,0
11/12/2017 8:10,33,69,50,64.4,83,66.2,2,0,0
11/12/2017 8:15,27,69.2,43,64.6,70,66.4,2,0,0
11/12/2017 8:20,33,69,50,64.3,83,66.2,2,0,0
11/12/2017 8:25,30,68.3,46,63.7,76,65.5,2,0,0
11/12/2017 8:30,38,68.9,55,64.3,93,66.2,2,0,0
11/12/2017 8:35,40,69.5,57,64.9,97,66.8,2,0,0
11/12/2017 8:40,36,69.5,52,64.9,88,66.8,2,0,0
11/12/2017 8:45,37,69.8,53,65.2,90,67.1,2,0,0
11/12/2017 8:50,34,69.5,51,64.9,85,66.7,2,0,0
11/12/2017 8:55,43,69.6,59,65,102,66.9,2,0,0
11/12/2017 9:00,37,69.3,53,64.7,90,66.6,2,0,0
11/12/2017 9:05,38,69.3,56,64.6,94,66.5,2,0,0
11/12/2017 9:10,34,69.3,50,64.7,84,66.5,2,0,0
11/12/2017 9:15,28,69.3,44,64.7,72,66.5,2,0,0
11/12/2017 9:20,39,68.4,56,63.7,95,65.7,2,0,0
11/12/2017 9:25,53,67.7,71,62.9,124,64.9,2,0,0
11/12/2017 9:30,50,68.6,68,63.9,118,65.9,2,0,0
11/12/2017 9:35,47,68.7,66,64,113,66,2,0,0
11/12/2017 9:40,46,68.5,64,63.8,110,65.8,2,0,0
11/12/2017 9:45,46,68.8,64,64.1,110,66.1,2,0,0
11/12/2017 9:50,56,68.6,74,63.9,130,66,2,0,0
11/12/2017 9:55,62,68.4,80,63.6,142,65.7,2,0,0
11/12/2017 10:00,56,69,75,64.3,131,66.3,2,0,0
11/12/2017 10:05,50,69.5,66,64.9,116,66.9,2,0,0
11/12/2017 10:10,57,68.5,75,63.8,132,65.9,2,0,0
11/12/2017 10:15,50,68.8,68,64.1,118,66.1,2,0,0
11/12/2017 10:20,62,69,79,64.3,141,66.4,2,0,0
11/12/2017 10:25,48,69.3,65,64.7,113,66.6,2,0,0
11/12/2017 10:30,56,69.7,73,65.2,129,67.1,2,0,0
11/12/2017 10:35,64,69.6,83,65,147,67,2,0,0
11/12/2017 10:40,64,69.2,82,64.6,146,66.6,2,0,0
11/12/2017 10:45,76,69.3,97,64.7,173,66.8,2,0,0
11/12/2017 10:50,54,69.1,72,64.4,126,66.4,2,0,0
11/12/2017 10:55,58,69.1,76,64.4,134,66.4,2,0,0
11/12/2017 11:00,52,69.3,70,64.7,122,66.7,2,0,0
11/12/2017 11:05,52,69.6,69,65,121,67,2,0,0
11/12/2017 11:10,58,69.2,76,64.5,134,66.5,2,0,0
11/12/2017 11:15,54,69.2,72,64.5,126,66.5,2,0,0
11/12/2017 11:20,70,68.5,91,63.8,161,65.8,2,0,0
11/12/2017 11:25,69,68.7,88,64,157,66.1,2,0,0
11/12/2017 11:30,61,68.6,79,63.9,140,65.9,2,0,0
11/12/2017 11:35,58,68.3,76,63.5,134,65.6,2,0,0
11/12/2017 11:40,70,68.8,88,64.1,158,66.2,2,0,0
11/12/2017 11:45,64,69.1,84,64.4,148,66.4,2,0,0
11/12/2017 11:50,66,69.3,85,64.7,151,66.7,2,0,0
11/12/2017 11:55,55,69,73,64.4,128,66.4,2,0,0
11/12/2017 12:00,64,69.6,82,65.1,146,67.1,2,0,0
11/12/2017 12:05,54,69.4,72,64.7,126,66.7,2,0,0
11/12/2017 12:10,65,69.7,84,65.2,149,67.1,2,0,0
11/12/2017 12:15,71,69.3,89,64.7,160,66.7,2,0,0
11/12/2017 12:20,66,68.7,84,64,150,66.1,2,0,0
11/12/2017 12:25,58,67.9,78,63.1,136,65.2,2,0,0
11/12/2017 12:30,69,68,89,63.3,158,65.4,2,0,0
11/12/2017 12:35,64,68.4,83,63.7,147,65.7,2,0,0
11/12/2017 12:40,60,67.6,78,62.8,138,64.9,2,0,0
11/12/2017 12:45,62,67.8,81,63.1,143,65.1,2,0,0
11/12/2017 12:50,62,67.7,80,63,142,65,2,0,0
11/12/2017 12:55,62,68.4,80,63.7,142,65.7,2,0,0
11/12/2017 13:00,55,69.1,74,64.6,129,66.5,2,0,0
11/12/2017 13:05,60,69.3,79,64.8,139,66.8,2,0,0
11/12/2017 13:10,53,68.6,71,63.9,124,65.9,2,0,0
11/12/2017 13:15,59,69.2,76,64.6,135,66.6,2,0,0
11/12/2017 13:20,57,69,76,64.4,133,66.4,2,0,0
11/12/2017 13:25,61,68.8,79,64.2,140,66.2,2,0,0
11/12/2017 13:30,48,68,66,63.3,114,65.3,2,0,0
11/12/2017 13:35,58,68.4,78,63.7,136,65.7,2,0,0
11/12/2017 13:40,62,68.9,82,64.3,144,66.3,2,0,0
11/12/2017 13:45,58,68.3,77,63.6,135,65.6,2,0,0
11/12/2017 13:50,54,68.6,72,63.9,126,65.9,2,0,0
11/12/2017 13:55,61,68.6,80,64,141,66,2,0,0
11/12/2017 14:00,60,68,79,63.2,139,65.3,2,0,0
11/12/2017 14:05,58,67.8,76,63,134,65.1,2,0,0
11/12/2017 14:10,53,68.3,72,63.5,125,65.6,2,0,0
11/12/2017 14:15,65,68,84,63.2,149,65.3,2,0,0
11/12/2017 14:20,55,68.4,73,63.7,128,65.7,2,0,0
11/12/2017 14:25,62,67.9,81,63.2,143,65.2,2,0,0
11/12/2017 14:30,64,68.1,83,63.3,147,65.4,2,0,0
11/12/2017 14:35,62,68.6,80,63.9,142,65.9,2,0,0
11/12/2017 14:40,52,69.3,70,64.6,122,66.6,2,0,0
11/12/2017 14:45,66,68.8,85,64.1,151,66.1,2,0,0
11/12/2017 14:50,68,68.9,86,64.2,154,66.3,2,0,0
11/12/2017 14:55,69,68.7,89,64,158,66.1,2,0,0
11/12/2017 15:00,55,68.9,74,64.2,129,66.2,2,0,0
11/12/2017 15:05,51,68.8,68,64.1,119,66.1,2,0,0
11/12/2017 15:10,56,68.4,74,63.7,130,65.7,2,0,0
11/12/2017 15:15,56,67.9,75,63.2,131,65.2,2,0,0
11/12/2017 15:20,58,68.1,76,63.3,134,65.3,2,0,0
11/12/2017 15:25,57,68.8,75,64.1,132,66.2,2,0,0
11/12/2017 15:30,58,68.6,77,63.9,135,65.9,2,0,0
11/12/2017 15:35,50,67.9,68,63.1,118,65.2,2,0,0
11/12/2017 15:40,65,68.2,84,63.5,149,65.5,2,0,0
11/12/2017 15:45,59,68.1,77,63.4,136,65.4,2,0,0
11/12/2017 15:50,57,68.4,75,63.7,132,65.7,2,0,0
11/12/2017 15:55,50,69,68,64.4,118,66.3,2,0,0
11/12/2017 16:00,62,68.5,80,63.8,142,65.9,2,0,0
11/12/2017 16:05,58,68.5,76,63.8,134,65.8,2,0,0
11/12/2017 16:10,62,68.2,80,63.4,142,65.5,2,0,0
11/12/2017 16:15,55,67.8,73,63,128,65.1,2,0,0
11/12/2017 16:20,55,67.3,72,62.5,127,64.6,2,0,0
11/12/2017 16:25,47,68,64,63.3,111,65.3,2,0,0
11/12/2017 16:30,55,67.5,73,62.7,128,64.7,2,0,0
11/12/2017 16:35,58,67.8,76,63,134,65.1,2,0,0
11/12/2017 16:40,46,68,64,63.2,110,65.2,2,0,0
11/12/2017 16:45,52,68,70,63.3,122,65.3,2,0,0
11/12/2017 16:50,49,68.7,66,64.1,115,66,2,0,0
11/12/2017 16:55,52,69.2,70,64.5,122,66.5,2,0,0
11/12/2017 17:00,57,69.7,75,65.1,132,67.1,2,0,0
11/12/2017 17:05,50,69.4,68,64.8,118,66.7,2,0,0
11/12/2017 17:10,64,68.9,84,64.2,148,66.2,2,0,0
11/12/2017 17:15,59,69.1,77,64.5,136,66.5,2,0,0
11/12/2017 17:20,50,69,67,64.3,117,66.4,2,0,0
11/12/2017 17:25,61,68.4,80,63.7,141,65.7,2,0,0
11/12/2017 17:30,58,67.5,77,62.7,135,64.8,2,0,0
11/12/2017 17:35,68,67.5,86,62.6,154,64.8,2,0,0
11/12/2017 17:40,55,67.7,74,62.9,129,64.9,2,0,0
11/12/2017 17:45,57,67.6,74,62.7,131,64.8,2,0,0
11/12/2017 17:50,52,67.4,68,62.6,120,64.7,2,0,0
11/12/2017 17:55,60,66.5,79,61.5,139,63.7,2,0,0
11/12/2017 18:00,57,67.5,74,62.7,131,64.8,2,0,0
11/12/2017 18:05,64,67.9,83,63.2,147,65.2,2,0,0
11/12/2017 18:10,56,68.2,75,63.4,131,65.4,2,0,0
11/12/2017 18:15,67,67.8,87,63,154,65.1,2,0,0
11/12/2017 18:20,66,67.1,84,62.2,150,64.4,2,0,0
11/12/2017 18:25,62,67.4,81,62.5,143,64.6,2,0,0
11/12/2017 18:30,66,67.4,84,62.5,150,64.7,2,0,0
11/12/2017 18:35,62,68,80,63.2,142,65.3,2,0,0
11/12/2017 18:40,52,67.9,69,63.1,121,65.2,2,0,0
11/12/2017 18:45,47,67.9,63,63.2,110,65.2,2,0,0
11/12/2017 18:50,51,69.1,69,64.4,120,66.4,2,0,0
11/12/2017 18:55,50,68.7,68,64,118,66,2,0,0
11/12/2017 19:00,48,69.3,64,64.7,112,66.6,2,0,0
11/12/2017 19:05,46,69.5,64,64.8,110,66.8,2,0,0
11/12/2017 19:10,39,69.5,56,64.9,95,66.8,2,0,0
11/12/2017 19:15,46,69.2,63,64.5,109,66.5,2,0,0
11/12/2017 19:20,40,69.1,57,64.5,97,66.4,2,0,0
11/12/2017 19:25,46,68.9,64,64.2,110,66.1,2,0,0
11/12/2017 19:30,41,68.9,57,64.2,98,66.2,2,0,0
11/12/2017 19:35,41,68.6,57,63.9,98,65.9,2,0,0
11/12/2017 19:40,45,69,62,64.3,107,66.3,2,0,0
11/12/2017 19:45,43,69.1,60,64.5,103,66.4,2,0,0
11/12/2017 19:50,35,68.7,51,64.1,86,65.9,2,0,0
11/12/2017 19:55,34,69,50,64.3,84,66.2,2,0,0
11/12/2017 20:00,38,69.1,54,64.5,92,66.4,2,0,0
11/12/2017 20:05,34,68.9,50,64.3,84,66.2,2,0,0
11/12/2017 20:10,26,68.2,42,63.6,68,65.3,2,0,0
11/12/2017 20:15,28,68.7,44,64.1,72,65.9,2,0,0
11/12/2017 20:20,27,69.1,44,64.5,71,66.3,2,0,0
11/12/2017 20:25,29,69.1,46,64.5,75,66.3,2,0,0
11/12/2017 20:30,30,68.9,47,64.3,77,66.1,2,0,0
11/12/2017 20:35,23,69.1,40,64.5,63,66.2,2,0,0
11/12/2017 20:40,30,68.9,47,64.2,77,66,2,0,0
11/12/2017 20:45,24,69,40,64.3,64,66.1,2,0,0
11/12/2017 20:50,27,69,43,64.3,70,66.1,2,0,0
11/12/2017 20:55,27,68.8,44,64.2,71,65.9,2,0,0
11/12/2017 21:00,25,69.3,41,64.7,66,66.5,2,0,0
11/12/2017 21:05,27,68.6,43,63.9,70,65.7,2,0,0
11/12/2017 21:10,23,68.6,38,63.9,61,65.7,2,0,0
11/12/2017 21:15,33,69.4,49,64.8,82,66.6,2,0,0
11/12/2017 21:20,25,69.6,41,65,66,66.7,2,0,0
11/12/2017 21:25,20,69.5,36,64.9,56,66.5,2,0,0
11/12/2017 21:30,21,69.5,37,64.9,58,66.6,2,0,0
11/12/2017 21:35,23,69.6,40,65,63,66.7,2,0,0
11/12/2017 21:40,26,69.4,41,64.8,67,66.6,2,0,0
11/12/2017 21:45,20,69.1,36,64.5,56,66.2,2,0,0
11/12/2017 21:50,20,69.4,36,64.8,56,66.4,2,0,0
11/12/2017 21:55,22,69,39,64.4,61,66.1,2,0,0
11/12/2017 22:00,20,69.1,36,64.4,56,66.1,2,0,0
11/12/2017 22:05,17,69.2,33,64.6,50,66.2,2,0,0
11/12/2017 22:10,18,69.5,33,64.9,51,66.5,2,0,0
11/12/2017 22:15,20,69.5,35,64.9,55,66.6,2,0,0
11/12/2017 22:20,17,69.4,33,64.8,50,66.4,2,0,0
11/12/2017 22:25,17,69.3,32,64.7,49,66.3,2,0,0
11/12/2017 22:30,16,69.4,31,64.8,47,66.3,2,0,0
11/12/2017 22:35,20,69.2,36,64.5,56,66.2,2,0,0
11/12/2017 22:40,19,69.4,35,64.8,54,66.4,2,0,0
11/12/2017 22:45,20,69.5,36,64.9,56,66.6,2,0,0
11/12/2017 22:50,17,69.4,33,64.8,50,66.4,2,0,0
11/12/2017 22:55,15,69.5,30,64.9,45,66.4,2,0,0
11/12/2017 23:00,21,69.4,36,64.8,57,66.5,2,0,0
11/12/2017 23:05,12,69.3,27,64.7,39,66.1,2,0,0
11/12/2017 23:10,19,69.3,35,64.7,54,66.3,2,0,0
11/12/2017 23:15,17,69.5,32,64.9,49,66.5,2,0,0
11/12/2017 23:20,14,69.4,30,64.8,44,66.3,2,0,0
11/12/2017 23:25,12,69.3,27,64.7,39,66.2,2,0,0
11/12/2017 23:30,20,69.4,36,64.8,56,66.5,2,0,0
11/12/2017 23:35,17,69.5,32,64.9,49,66.5,2,0,0
11/12/2017 23:40,14,69.5,29,64.9,43,66.4,2,0,0
11/12/2017 23:45,14,69.5,30,64.9,44,66.3,2,0,0
11/12/2017 23:50,13,69.5,28,64.9,41,66.3,2,0,0
11/12/2017 23:55,12,69.5,27,64.9,39,66.3,2,0,0
