5 Minutes,Lane 1 Flow (Veh/5 Minutes),Lane 1 Speed (mph),Lane 2 Flow (Veh/5 Minutes),Lane 2 Speed (mph),Flow (Veh/5 Minutes),Speed (mph),# Lane Points,% Observed,Holiday
11/13/2017 0:00,12,69.3,27,64.7,39,66.2,2,0,0
11/13/2017 0:05,14,69.2,29,64.6,43,66.1,2,0,0
11/13/2017 0:10,12,69.3,28,64.7,40,66.1,2,0,0
11/13/2017 0:15,10,69.3,26,64.7,36,66,2,0,0
11/13/2017 0:20,10,69.2,25,64.6,35,65.9,2,0,0
11/13/2017 0:25,10,69.2,25,64.5,35,65.9,2,0,0
11/13/2017 0:30,9,69.2,24,64.5,33,65.8,2,0,0
11/13/2017 0:35,11,69.3,26,64.7,37,66.1,2,0,0
11/13/2017 0:40,10,69.3,25,64.7,35,66,2,0,0
11/13/2017 0:45,10,69.4,25,64.8,35,66.1,2,0,0
11/13/2017 0:50,7,69.4,22,64.8,29,65.9,2,0,0
11/13/2017 0:55,10,69.3,25,64.7,35,66,2,0,0
11/13/2017 1:00,6,69.4,21,64.8,27,65.8,2,0,0
11/13/2017 1:05,7,69.4,23,64.8,30,65.9,2,0,0
11/13/2017 1:10,9,69,24,64.4,33,65.6,2,0,0
11/13/2017 1:15,6,69.1,21,64.4,27,65.5,2,0,0
11/13/2017 1:20,6,69.2,21,64.6,27,65.6,2,0,0
11/13/2017 1:25,8,69.1,23,64.4,31,65.6,2,0,0
11/13/2017 1:30,7,69.2,22,64.5,29,65.7,2,0,0
11/13/2017 1:35,6,69.3,21,64.7,27,65.7,2,0,0
11/13/2017 1:40,14,69.3,22,64.7,36,66.5,2,0,0
11/13/2017 1:45,13,69.2,21,64.6,34,66.4,2,0,0
11/13/2017 1:50,7,69.3,22,64.7,29,65.8,2,0,0
11/13/2017 1:55,10,69.3,20,64.7,30,66.2,2,0,0
11/13/2017 2:00,10,69.1,20,64.5,30,66,2,0,0
11/13/2017 2:05,10,69.3,20,64.7,30,66.2,2,0,0
11/13/2017 2:10,5,69.3,20,64.7,25,65.7,2,0,0
11/13/2017 2:15,7,69.1,22,64.4,29,65.5,2,0,0
11/13/2017 2:20,7,69.2,22,64.6,29,65.7,2,0,0
11/13/2017 2:25,9,69.1,24,64.5,33,65.7,2,0,0
11/13/2017 2:30,8,69.2,23,64.6,31,65.8,2,0,0
11/13/2017 2:35,7,69.3,22,64.7,29,65.8,2,0,0
11/13/2017 2:40,6,69.3,22,64.7,28,65.7,2,0,0
11/13/2017 2:45,10,69.4,25,64.8,35,66.1,2,0,0
11/13/2017 2:50,7,69.4,22,64.8,29,65.9,2,0,0
11/13/2017 2:55,11,69.4,27,64.8,38,66.1,2,0,0
11/13/2017 3:00,8,69.3,24,64.7,32,65.9,2,0,0
11/13/2017 3:05,8,69.4,24,64.8,32,66,2,0,0
11/13/2017 3:10,7,69.2,23,64.6,30,65.7,2,0,0
11/13/2017 3:15,8,69.2,24,64.5,32,65.7,2,0,0
11/13/2017 3:20,10,69,26,64.4,36,65.6,2,0,0
11/13/2017 3:25,9,69.2,25,64.5,34,65.8,2,0,0
11/13/2017 3:30,10,69.1,26,64.5,36,65.8,2,0,0
11/13/2017 3:35,12,69.2,27,64.6,39,66,2,0,0
11/13/2017 3:40,9,69.4,24,64.8,33,66,2,0,0
11/13/2017 3:45,13,69.3,29,64.7,42,66.1,2,0,0
11/13/2017 3:50,14,69.1,30,64.5,44,65.9,2,0,0
11/13/2017 3:55,18,68.6,34,64,52,65.6,2,0,0
11/13/2017 4:00,17,69,33,64.4,50,66,2,0,0
11/13/2017 4:05,22,67.8,37,63.2,59,64.9,2,0,0
11/13/2017 4:10,21,68.6,38,63.9,59,65.6,2,0,0
11/13/2017 4:15,20,69.2,37,64.6,57,66.2,2,0,0
11/13/2017 4:20,22,69.1,38,64.5,60,66.2,2,0,0
11/13/2017 4:25,26,69.2,43,64.6,69,66.3,2,0,0
11/13/2017 4:30,36,68.9,53,64.1,89,66.1,2,0,0
11/13/2017 4:35,33,68.7,51,64,84,65.8,2,0,0
11/13/2017 4:40,33,68.6,50,63.9,83,65.7,2,0,0
11/13/2017 4:45,39,67.8,57,63.1,96,65,2,0,0
11/13/2017 4:50,33,68,51,63.3,84,65.2,2,0,0
11/13/2017 4:55,42,69,61,64.4,103,66.3,2,0,0
11/13/2017 5:00,43,68.5,62,63.8,105,65.8,2,0,0
11/13/2017 5:05,50,69.1,70,64.4,120,66.4,2,0,0
11/13/2017 5:10,51,68.5,70,63.8,121,65.8,2,0,0
11/13/2017 5:15,50,69.4,69,64.8,119,66.7,2,0,0
11/13/2017 5:20,63,69.3,84,64.7,147,66.7,2,0,0
11/13/2017 5:25,64,69.7,85,65.1,149,67.1,2,0,0
11/13/2017 5:30,66,69.5,88,64.9,154,66.8,2,0,0
11/13/2017 5:35,62,68.9,83,64.2,145,66.2,2,0,0
11/13/2017 5:40,76,69.4,99,64.7,175,66.7,2,0,0
11/13/2017 5:45,75,69.1,97,64.4,172,66.5,2,0,0
11/13/2017 5:50,74,69.1,96,64.4,170,66.4,2,0,0
11/13/2017 5:55,60,69.5,81,64.9,141,66.8,2,0,0
11/13/2017 6:00,71,68.5,92,63.7,163,65.8,2,0,0
11/13/2017 6:05,67,67.4,88,62.4,155,64.6,2,0,0
11/13/2017 6:10,67,67.9,88,62.9,155,65.1,2,0,0
11/13/2017 6:15,62,67.4,83,62.4,145,64.5,2,0,0
11/13/2017 6:20,78,66.8,101,61.8,179,64,2,0,0
11/13/2017 6:25,71,66.3,93,61.3,164,63.4,2,0,0
11/13/2017 6:30,62,66.4,83,61.3,145,63.5,2,0,0
11/13/2017 6:35,72,66.4,94,61.3,166,63.5,2,0,0
11/13/2017 6:40,77,66.5,101,61.5,178,63.7,2,0,0
11/13/2017 6:45,68,65.8,90,60.8,158,63,2,0,0
11/13/2017 6:50,75,67.2,97,62.3,172,64.4,2,0,0
11/13/2017 6:55,73,68.2,95,63.4,168,65.5,2,0,0
11/13/2017 7:00,76,68.4,99,63.7,175,65.7,2,0,0
11/13/2017 7:05,83,68.4,107,63.6,190,65.7,2,0,0
11/13/2017 7:10,82,67.1,106,62.2,188,64.4,2,0,0
11/13/2017 7:15,77,68.1,99,63.3,176,65.4,2,0,0
11/13/2017 7:20,86,68.3,109,63.5,195,65.6,2,0,0
11/13/2017 7:25,89,68.6,112,63.8,201,66,2,0,0
11/13/2017 7:30,82,68.5,104,63.7,186,65.8,2,0,0
11/13/2017 7:35,90,68.2,114,63.4,204,65.5,2,0,0
11/13/2017 7:40,91,68.2,113,63.4,204,65.5,2,0,0
11/13/2017 7:45,85,67.1,109,62.2,194,64.4,2,0,0
11/13/2017 7:50,82,67.4,103,62.5,185,64.7,2,0,0
11/13/2017 7:55,92,66.7,116,61.7,208,63.9,2,0,0
11/13/2017 8:00,87,67.3,111,62.4,198,64.5,2,0,0
11/13/2017 8:05,83,65.2,106,60.1,189,62.3,2,0,0
11/13/2017 8:10,86,66.5,107,61.5,193,63.8,2,0,0
11/13/2017 8:15,82,65.9,105,60.8,187,63.1,2,0,0
11/13/2017 8:20,69,65.6,92,60.5,161,62.7,2,0,0
11/13/2017 8:25,81,65.4,103,60.3,184,62.6,2,0,0
11/13/2017 8:30,80,65.1,102,60,182,62.2,2,0,0
11/13/2017 8:35,74,64.8,96,59.7,170,61.9,2,0,0
11/13/2017 8:40,72,66.1,93,61.2,165,63.4,2,0,0
11/13/2017 8:45,74,65,96,60,170,62.2,2,0,0
11/13/2017 8:50,84,65.1,107,60,191,62.2,2,0,0
11/13/2017 8:55,78,64.8,101,59.8,179,62,2,0,0
11/13/2017 9:00,71,65.1,92,60,163,62.2,2,0,0
11/13/2017 9:05,69,66.6,89,61.7,158,63.8,2,0,0
11/13/2017 9:10,68,66.5,89,61.6,157,63.8,2,0,0
11/13/2017 9:15,72,65.6,93,60.6,165,62.8,2,0,0
11/13/2017 9:20,61,66,80,61.1,141,63.2,2,0,0
11/13/2017 9:25,68,65.9,89,60.9,157,63.1,2,0,0
11/13/2017 9:30,69,64.7,89,59.6,158,61.8,2,0,0
11/13/2017 9:35,73,66,94,61,167,63.2,2,0,0
11/13/2017 9:40,66,66.6,87,61.7,153,63.8,2,0,0
11/13/2017 9:45,68,65.3,88,60.2,156,62.4,2,0,0
11/13/2017 9:50,69,66.7,88,61.8,157,63.9,2,0,0
11/13/2017 9:55,63,66.1,81,61.2,144,63.4,2,0,0
11/13/2017 10:00,67,67.1,88,62.4,155,64.5,2,0,0
11/13/2017 10:05,52,68.1,70,63.5,122,65.5,2,0,0
11/13/2017 10:10,62,68.8,82,64.2,144,66.1,2,0,0
11/13/2017 10:15,57,69.1,75,64.5,132,66.4,2,0,0
11/13/2017 10:20,57,69.5,75,64.9,132,66.9,2,0,0
11/13/2017 10:25,60,67.9,80,63.2,140,65.2,2,0,0
11/13/2017 10:30,58,68.6,77,64.1,135,66,2,0,0
11/13/2017 10:35,57,67.7,75,63.1,132,65.1,2,0,0
11/13/2017 10:40,62,66.5,81,61.7,143,63.8,2,0,0
11/13/2017 10:45,61,67.7,80,63.1,141,65.1,2,0,0
11/13/2017 10:50,59,68.4,78,63.9,137,65.8,2,0,0
11/13/2017 10:55,51,68.9,68,64.4,119,66.4,2,0,0
11/13/2017 11:00,51,66.7,69,62,120,64,2,0,0
11/13/2017 11:05,52,67.5,70,62.8,122,64.8,2,0,0
11/13/2017 11:10,47,68.2,64,63.5,111,65.5,2,0,0
11/13/2017 11:15,50,69,68,64.4,118,66.3,2,0,0
11/13/2017 11:20,50,67.6,68,62.9,118,64.9,2,0,0
11/13/2017 11:25,53,67.4,71,62.7,124,64.7,2,0,0
11/13/2017 11:30,52,66.7,71,61.9,123,63.9,2,0,0
11/13/2017 11:35,57,65.5,76,60.7,133,62.7,2,0,0
11/13/2017 11:40,56,67,74,62.3,130,64.3,2,0,0
11/13/2017 11:45,58,66.4,77,61.5,135,63.6,2,0,0
11/13/2017 11:50,54,66.1,73,61.3,127,63.4,2,0,0
11/13/2017 11:55,51,67.8,68,63.1,119,65.1,2,0,0
11/13/2017 12:00,46,67.8,65,63.1,111,65,2,0,0
11/13/2017 12:05,47,67.2,64,62.4,111,64.4,2,0,0
11/13/2017 12:10,47,66.3,66,61.5,113,63.5,2,0,0
11/13/2017 12:15,60,66.4,79,61.6,139,63.7,2,0,0
11/13/2017 12:20,53,66.8,70,62,123,64.1,2,0,0
11/13/2017 12:25,50,67.7,67,62.9,117,65,2,0,0
11/13/2017 12:30,51,67.6,71,62.9,122,64.9,2,0,0
11/13/2017 12:35,47,67.5,65,62.7,112,64.8,2,0,0
11/13/2017 12:40,57,68.3,76,63.6,133,65.6,2,0,0
11/13/2017 12:45,48,67.7,65,63,113,65,2,0,0
11/13/2017 12:50,54,67.2,73,62.5,127,64.5,2,0,0
11/13/2017 12:55,52,66.3,69,61.5,121,63.6,2,0,0
11/13/2017 13:00,55,68.3,73,63.5,128,65.6,2,0,0
11/13/2017 13:05,51,68.7,69,63.9,120,65.9,2,0,0
11/13/2017 13:10,50,68.5,68,63.7,118,65.8,2,0,0
11/13/2017 13:15,56,68.3,73,63.6,129,65.6,2,0,0
11/13/2017 13:20,47,69.3,64,64.6,111,66.6,2,0,0
11/13/2017 13:25,52,68.9,70,64.2,122,66.2,2,0,0
11/13/2017 13:30,45,69.1,63,64.3,108,66.3,2,0,0
11/13/2017 13:35,46,69.1,63,64.4,109,66.4,2,0,0
11/13/2017 13:40,47,69.9,64,65.2,111,67.2,2,0,0
11/13/2017 13:45,53,69.4,71,64.8,124,66.8,2,0,0
11/13/2017 13:50,54,69,72,64.4,126,66.4,2,0,0
11/13/2017 13:55,44,68.5,62,63.8,106,65.8,2,0,0
11/13/2017 14:00,51,69,69,64.3,120,66.3,2,0,0
11/13/2017 14:05,47,67.5,66,62.6,113,64.7,2,0,0
11/13/2017 14:10,47,67.8,63,63,110,65.1,2,0,0
11/13/2017 14:15,56,66,75,61,131,63.2,2,0,0
11/13/2017 14:20,52,66.2,70,61.3,122,63.4,2,0,0
11/13/2017 14:25,47,66,64,61.1,111,63.1,2,0,0
11/13/2017 14:30,48,67.2,65,62.4,113,64.4,2,0,0
11/13/2017 14:35,41,69,58,64.4,99,66.3,2,0,0
11/13/2017 14:40,39,69.1,57,64.4,96,66.3,2,0,0
11/13/2017 14:45,47,68.7,64,63.9,111,65.9,2,0,0
11/13/2017 14:50,44,68.3,62,63.6,106,65.6,2,0,0
11/13/2017 14:55,37,68.8,54,64,91,66,2,0,0
11/13/2017 15:00,45,69.2,62,64.5,107,66.5,2,0,0
11/13/2017 15:05,41,68.5,58,63.7,99,65.7,2,0,0
11/13/2017 15:10,53,67.9,71,63.1,124,65.1,2,0,0
11/13/2017 15:15,45,67.9,62,63.1,107,65.1,2,0,0
11/13/2017 15:20,51,67.8,69,62.9,120,65,2,0,0
11/13/2017 15:25,57,68.6,76,63.8,133,65.9,2,0,0
11/13/2017 15:30,50,69,69,64.3,119,66.3,2,0,0
11/13/2017 15:35,51,70.2,69,65.7,120,67.6,2,0,0
11/13/2017 15:40,61,70,80,65.4,141,67.4,2,0,0
11/13/2017 15:45,63,67.8,82,62.9,145,65.1,2,0,0
11/13/2017 15:50,54,68.4,72,63.6,126,65.6,2,0,0
11/13/2017 15:55,52,67.9,70,63,122,65.1,2,0,0
11/13/2017 16:00,57,68.6,76,63.8,133,65.9,2,0,0
11/13/2017 16:05,53,67.5,72,62.7,125,64.8,2,0,0
11/13/2017 16:10,55,68,73,63.2,128,65.3,2,0,0
11/13/2017 16:15,56,68.7,75,63.9,131,66,2,0,0
11/13/2017 16:20,56,68.2,74,63.5,130,65.5,2,0,0
11/13/2017 16:25,55,67.9,72,63,127,65.1,2,0,0
11/13/2017 16:30,69,67.4,88,62.5,157,64.6,2,0,0
11/13/2017 16:35,65,66,85,61,150,63.2,2,0,0
11/13/2017 16:40,56,65.6,75,60.5,131,62.7,2,0,0
11/13/2017 16:45,54,65.6,72,60.6,126,62.7,2,0,0
11/13/2017 16:50,55,65,73,59.8,128,62,2,0,0
11/13/2017 16:55,49,64.6,67,59.5,116,61.7,2,0,0
11/13/2017 17:00,51,63.8,69,58.6,120,60.9,2,0,0
11/13/2017 17:05,42,64.2,59,59.1,101,61.2,2,0,0
11/13/2017 17:10,47,65.5,65,60.4,112,62.5,2,0,0
11/13/2017 17:15,56,65.2,74,60,130,62.3,2,0,0
11/13/2017 17:20,44,64.5,63,59.3,107,61.4,2,0,0
11/13/2017 17:25,49,63,68,57.7,117,59.9,2,0,0
11/13/2017 17:30,49,57.6,68,51.5,117,54.1,2,0,0
11/13/2017 17:35,48,53.6,66,47.2,114,49.9,2,0,0
11/13/2017 17:40,50,53.2,69,46.7,119,49.4,2,0,0
11/13/2017 17:45,46,50.5,65,43.7,111,46.5,2,0,0
11/13/2017 17:50,46,51.7,65,45.1,111,47.8,2,0,0
11/13/2017 17:55,57,56.7,77,50.6,134,53.2,2,0,0
11/13/2017 18:00,51,59.7,70,53.9,121,56.3,2,0,0
11/13/2017 18:05,50,62.7,69,57.3,119,59.6,2,0,0
11/13/2017 18:10,57,64.1,76,58.9,133,61.1,2,0,0
11/13/2017 18:15,51,65.9,69,60.8,120,63,2,0,0
11/13/2017 18:20,52,67.1,71,62.2,123,64.2,2,0,0
11/13/2017 18:25,50,67,69,62.1,119,64.1,2,0,0
11/13/2017 18:30,51,65.1,70,60,121,62.1,2,0,0
11/13/2017 18:35,43,65.3,60,60.3,103,62.4,2,0,0
11/13/2017 18:40,46,65.8,64,60.7,110,62.8,2,0,0
11/13/2017 18:45,39,66,56,61,95,63.1,2,0,0
11/13/2017 18:50,45,67.1,63,62.2,108,64.3,2,0,0
11/13/2017 18:55,44,68,61,63.3,105,65.3,2,0,0
11/13/2017 19:00,35,68.9,51,64.2,86,66.1,2,0,0
11/13/2017 19:05,29,69,45,64.4,74,66.2,2,0,0
11/13/2017 19:10,38,66.7,55,61.9,93,63.9,2,0,0
11/13/2017 19:15,41,66.5,59,61.7,100,63.7,2,0,0
11/13/2017 19:20,29,67.9,45,63.2,74,65,2,0,0
11/13/2017 19:25,28,68.5,45,63.9,73,65.7,2,0,0
11/13/2017 19:30,33,68.2,49,63.5,82,65.4,2,0,0
11/13/2017 19:35,32,68.1,48,63.4,80,65.3,2,0,0
11/13/2017 19:40,33,68.4,50,63.6,83,65.5,2,0,0
11/13/2017 19:45,31,69.4,47,64.8,78,66.6,2,0,0
11/13/2017 19:50,32,69.7,48,65.1,80,66.9,2,0,0
11/13/2017 19:55,34,69.4,51,64.7,85,66.6,2,0,0
11/13/2017 20:00,24,69.2,40,64.6,64,66.3,2,0,0
11/13/2017 20:05,24,68.9,40,64.2,64,65.9,2,0,0
11/13/2017 20:10,30,69.1,46,64.4,76,66.2,2,0,0
11/13/2017 20:15,28,69.2,44,64.5,72,66.3,2,0,0
11/13/2017 20:20,29,68.2,46,63.5,75,65.3,2,0,0
11/13/2017 20:25,27,68.1,43,63.3,70,65.2,2,0,0
11/13/2017 20:30,17,68.7,33,64,50,65.6,2,0,0
11/13/2017 20:35,27,68.8,44,64.2,71,65.9,2,0,0
11/13/2017 20:40,23,69,39,64.4,62,66.1,2,0,0
11/13/2017 20:45,24,69.1,39,64.5,63,66.3,2,0,0
11/13/2017 20:50,23,69,39,64.4,62,66.1,2,0,0
11/13/2017 20:55,32,67.7,49,62.9,81,64.8,2,0,0
11/13/2017 21:00,33,68.1,49,63.4,82,65.3,2,0,0
11/13/2017 21:05,27,68.8,43,64.2,70,66,2,0,0
11/13/2017 21:10,31,68.9,48,64.2,79,66.1,2,0,0
11/13/2017 21:15,25,67.3,41,62.6,66,64.4,2,0,0
11/13/2017 21:20,28,68.2,45,63.6,73,65.4,2,0,0
11/13/2017 21:25,25,68,41,63.3,66,65.1,2,0,0
11/13/2017 21:30,28,68.6,44,63.9,72,65.7,2,0,0
11/13/2017 21:35,25,68.9,41,64.2,66,66,2,0,0
11/13/2017 21:40,19,69.1,35,64.5,54,66.1,2,0,0
11/13/2017 21:45,22,69.1,38,64.4,60,66.1,2,0,0
11/13/2017 21:50,20,69.2,36,64.6,56,66.2,2,0,0
11/13/2017 21:55,16,69.2,31,64.6,47,66.2,2,0,0
11/13/2017 22:00,18,69.3,34,64.7,52,66.3,2,0,0
11/13/2017 22:05,15,69.3,31,64.7,46,66.2,2,0,0
11/13/2017 22:10,16,69.2,31,64.6,47,66.2,2,0,0
11/13/2017 22:15,25,68.8,41,64.2,66,65.9,2,0,0
11/13/2017 22:20,21,69.1,36,64.5,57,66.2,2,0,0
11/13/2017 22:25,15,69.1,30,64.5,45,66,2,0,0
11/13/2017 22:30,21,69.3,37,64.7,58,66.3,2,0,0
11/13/2017 22:35,22,69.1,38,64.5,60,66.2,2,0,0
11/13/2017 22:40,18,69.1,33,64.4,51,66.1,2,0,0
11/13/2017 22:45,15,69.3,30,64.7,45,66.2,2,0,0
11/13/2017 22:50,15,69.3,31,64.7,46,66.2,2,0,0
11/13/2017 22:55,13,69,29,64.4,42,65.8,2,0,0
11/13/2017 23:00,19,69.2,34,64.6,53,66.3,2,0,0
11/13/2017 23:05,20,68.7,36,64.1,56,65.7,2,0,0
11/13/2017 23:10,13,69,28,64.4,41,65.8,2,0,0
11/13/2017 23:15,17,69.1,32,64.5,49,66.1,2,0,0
11/13/2017 23:20,11,69.3,26,64.7,37,66,2,0,0
11/13/2017 23:25,11,69.3,27,64.7,38,66.1,2,0,0
11/13/2017 23:30,13,69.4,28,64.8,41,66.3,2,0,0
11/13/2017 23:35,12,69.4,28,64.8,40,66.2,2,0,0
11/13/2017 23:40,12,69.1,27,64.5,39,65.9,2,0,0
11/13/2017 23:45,11,69.2,27,64.6,38,65.9,2,0,0
11/13/2017 23:50,12,69.2,28,64.6,40,66,2,0,0
11/13/2017 23:55,14,69.3,29,64.7,43,66.2,2,0,0
11/14/2017 0:00,16,69.3,31,64.7,47,66.3,2,0,0
11/14/2017 0:05,10,69.4,25,64.8,35,66.1,2,0,0
11/14/2017 0:10,9,70.4,9,64.4,18,67.4,2,0,0
11/14/2017 0:15,8,70.4,8,64.4,16,67.4,2,0,0
11/14/2017 0:20,8,70.4,8,64.4,16,67.4,2,0,0
11/14/2017 0:25,7,70.1,7,64.1,14,67.1,2,0,0
11/14/2017 0:30,7,70.3,6,64.3,13,67.5,2,0,0
11/14/2017 0:35,7,70.1,6,64.1,13,67.3,2,0,0
11/14/2017 0:40,6,70.3,6,64.3,12,67.3,2,0,0
11/14/2017 0:45,6,70.2,6,64.2,12,67.2,2,0,0
11/14/2017 0:50,5,70.2,5,64.2,10,67.2,2,0,0
11/14/2017 0:55,5,70.1,5,64.1,10,67.1,2,0,0
11/14/2017 1:00,15,69.3,22,64.7,37,66.6,2,0,0
11/14/2017 1:05,5,70.1,4,64.1,9,67.4,2,0,0
11/14/2017 1:10,5,70.2,4,64.2,9,67.5,2,0,0
11/14/2017 1:15,5,70.2,4,64.2,9,67.5,2,0,0
11/14/2017 1:20,4,70.3,4,64.3,8,67.3,2,0,0
11/14/2017 1:25,4,70,4,64,8,67,2,0,0
11/14/2017 1:30,4,70.3,3,64.3,7,67.7,2,0,0
11/14/2017 1:35,4,70,4,64,8,67,2,0,0
11/14/2017 1:40,4,70.1,4,64.1,8,67.1,2,0,0
11/14/2017 1:45,4,69.9,3,63.9,7,67.3,2,0,0
11/14/2017 1:50,4,69.8,3,63.8,7,67.2,2,0,0
11/14/2017 1:55,4,70,3,64,7,67.4,2,0,0
11/14/2017 2:00,7,69.3,22,64.7,29,65.8,2,0,0
11/14/2017 2:05,15,68.6,22,64,37,65.9,2,0,0
11/14/2017 2:10,4,70,3,64,7,67.4,2,0,0
11/14/2017 2:15,4,70.2,3,64.2,7,67.6,2,0,0
11/14/2017 2:20,3,70.1,3,64.1,6,67.1,2,0,0
11/14/2017 2:25,3,70.1,3,64.1,6,67.1,2,0,0
11/14/2017 2:30,4,70,3,64,7,67.4,2,0,0
11/14/2017 2:35,3,70,3,64,6,67,2,0,0
11/14/2017 2:40,4,70.2,3,64.2,7,67.6,2,0,0
11/14/2017 2:45,4,70,3,64,7,67.4,2,0,0
11/14/2017 2:50,4,70.1,3,64.1,7,67.5,2,0,0
11/14/2017 2:55,3,69.9,3,63.9,6,66.9,2,0,0
11/14/2017 3:00,15,69.3,30,64.7,45,66.3,2,0,0
11/14/2017 3:05,4,70.1,3,64.1,7,67.5,2,0,0
11/14/2017 3:10,4,70,3,64,7,67.4,2,0,0
11/14/2017 3:15,4,70.1,3,64.1,7,67.5,2,0,0
11/14/2017 3:20,4,70.2,3,64.2,7,67.6,2,0,0
11/14/2017 3:25,4,69.9,4,63.9,8,66.9,2,0,0
11/14/2017 3:30,4,69.7,4,63.7,8,66.7,2,0,0
11/14/2017 3:35,5,69.9,4,63.9,9,67.2,2,0,0
11/14/2017 3:40,5,70.2,5,64.2,10,67.2,2,0,0
11/14/2017 3:45,5,70,5,64,10,67,2,0,0
11/14/2017 3:50,6,69.8,5,63.8,11,67.1,2,0,0
11/14/2017 3:55,5,70,5,64,10,67,2,0,0
11/14/2017 4:00,17,69.3,33,64.7,50,66.3,2,0,0
11/14/2017 4:05,21,69.3,37,64.7,58,66.4,2,0,0
11/14/2017 4:10,6,70,6,64,12,67,2,0,0
11/14/2017 4:15,15,69.2,31,64.6,46,66.1,2,0,0
11/14/2017 4:20,8,70.1,8,64.1,16,67.1,2,0,0
11/14/2017 4:25,26,69.3,43,64.7,69,66.5,2,0,0
11/14/2017 4:30,35,68.3,53,63.6,88,65.5,2,0,0
11/14/2017 4:35,11,70.2,10,64.2,21,67.3,2,0,0
11/14/2017 4:40,13,70.2,11,64.2,24,67.5,2,0,0
11/14/2017 4:45,14,70.3,12,64.3,26,67.5,2,0,0
11/14/2017 4:50,15,70.4,13,64.4,28,67.6,2,0,0
11/14/2017 4:55,15,70.2,13,64.2,28,67.4,2,0,0
11/14/2017 5:00,35,68,51,63.3,86,65.2,2,0,0
11/14/2017 5:05,18,70.3,16,64.3,34,67.5,2,0,0
11/14/2017 5:10,49,68.5,68,63.8,117,65.8,2,0,0
11/14/2017 5:15,24,70.4,21,64.4,45,67.6,2,0,0
11/14/2017 5:20,26,70.5,23,64.5,49,67.7,2,0,0
11/14/2017 5:25,80,66.4,103,61.4,183,63.6,2,0,0
11/14/2017 5:30,66,66.7,88,61.8,154,63.9,2,0,0
11/14/2017 5:35,33,70.8,30,64.8,63,67.9,2,0,0
11/14/2017 5:40,36,70.8,32,64.8,68,68,2,0,0
11/14/2017 5:45,40,70.9,36,64.9,76,68.1,2,0,0
11/14/2017 5:50,42,70.8,37,64.8,79,68,2,0,0
11/14/2017 5:55,41,70.7,36,64.7,77,67.9,2,0,0
11/14/2017 6:00,66,70.4,88,65.8,154,67.8,2,0,0
11/14/2017 6:05,42,70,37,64,79,67.2,2,0,0
11/14/2017 6:10,45,69.8,40,63.8,85,67,2,0,0
11/14/2017 6:15,47,69.7,43,63.7,90,66.8,2,0,0
11/14/2017 6:20,48,69.5,44,63.5,92,66.6,2,0,0
11/14/2017 6:25,53,69.4,47,63.4,100,66.6,2,0,0
11/14/2017 6:30,54,69.4,48,63.4,102,66.6,2,0,0
11/14/2017 6:35,58,69.3,52,63.3,110,66.5,2,0,0
11/14/2017 6:40,63,69.2,56,63.2,119,66.4,2,0,0
11/14/2017 6:45,65,69.1,58,63.1,123,66.3,2,0,0
11/14/2017 6:50,65,69.2,59,63.2,124,66.3,2,0,0
11/14/2017 6:55,64,69.3,58,63.3,122,66.4,2,0,0
11/14/2017 7:00,78,69.8,99,65.1,177,67.2,2,0,0
11/14/2017 7:05,67,68.9,61,62.9,128,66,2,0,0
11/14/2017 7:10,84,67.3,107,62.4,191,64.5,2,0,0
11/14/2017 7:15,72,67.3,93,62.4,165,64.5,2,0,0
11/14/2017 7:20,84,66.2,107,61.2,191,63.4,2,0,0
11/14/2017 7:25,96,66.2,121,61.1,217,63.3,2,0,0
11/14/2017 7:30,94,66.8,118,61.8,212,64.1,2,0,0
11/14/2017 7:35,88,65.7,113,60.6,201,62.8,2,0,0
11/14/2017 7:40,94,66.3,118,61.3,212,63.5,2,0,0
11/14/2017 7:45,91,66,115,61,206,63.2,2,0,0
11/14/2017 7:50,84,65.7,107,60.6,191,62.8,2,0,0
11/14/2017 7:55,81,64.7,104,59.5,185,61.8,2,0,0
11/14/2017 8:00,75,65.8,97,60.7,172,62.9,2,0,0
11/14/2017 8:05,69,66.5,91,61.5,160,63.7,2,0,0
11/14/2017 8:10,87,66.2,110,61.2,197,63.4,2,0,0
11/14/2017 8:15,87,64.4,112,59.2,199,61.5,2,0,0
11/14/2017 8:20,83,64.4,107,59.2,190,61.5,2,0,0
11/14/2017 8:25,90,64.4,113,59.2,203,61.5,2,0,0
11/14/2017 8:30,86,63.7,108,58.4,194,60.7,2,0,0
11/14/2017 8:35,93,64.2,117,59,210,61.3,2,0,0
11/14/2017 8:40,89,63.5,113,58.2,202,60.5,2,0,0
11/14/2017 8:45,88,63.6,111,58.4,199,60.7,2,0,0
11/14/2017 8:50,81,63.3,104,58.1,185,60.4,2,0,0
11/14/2017 8:55,84,64.4,106,59.2,190,61.5,2,0,0
11/14/2017 9:00,75,63.8,97,58.5,172,60.8,2,0,0
11/14/2017 9:05,85,65.5,107,60.4,192,62.6,2,0,0
11/14/2017 9:10,85,66.3,109,61.3,194,63.5,2,0,0
11/14/2017 9:15,74,64.8,96,59.7,170,61.9,2,0,0
11/14/2017 9:20,80,65.3,102,60.3,182,62.5,2,0,0
11/14/2017 9:25,63,65.7,83,60.7,146,62.8,2,0,0
11/14/2017 9:30,65,64.7,86,59.7,151,61.8,2,0,0
11/14/2017 9:35,79,64,100,58.9,179,61.2,2,0,0
11/14/2017 9:40,75,64.3,95,59.2,170,61.4,2,0,0
11/14/2017 9:45,69,64.5,90,59.4,159,61.6,2,0,0
11/14/2017 9:50,75,65.6,95,60.5,170,62.7,2,0,0
11/14/2017 9:55,66,66,86,60.9,152,63.1,2,0,0
11/14/2017 10:00,67,66.6,87,61.7,154,63.8,2,0,0
11/14/2017 10:05,64,66.3,84,61.4,148,63.5,2,0,0
11/14/2017 10:10,75,66.9,96,62.1,171,64.2,2,0,0
11/14/2017 10:15,62,66.8,82,62,144,64.1,2,0,0
11/14/2017 10:20,63,68,83,63.3,146,65.3,2,0,0
11/14/2017 10:25,56,68,73,63.3,129,65.3,2,0,0
11/14/2017 10:30,42,68.3,60,63.6,102,65.5,2,0,0
11/14/2017 10:35,55,67.5,73,62.7,128,64.8,2,0,0
11/14/2017 10:40,54,68.2,73,63.5,127,65.5,2,0,0
11/14/2017 10:45,42,68.4,60,63.7,102,65.7,2,0,0
11/14/2017 10:50,58,67,78,62.3,136,64.3,2,0,0
11/14/2017 10:55,46,65.1,64,60.2,110,62.2,2,0,0
11/14/2017 11:00,48,65.4,66,60.6,114,62.6,2,0,0
11/14/2017 11:05,45,67.3,63,62.6,108,64.6,2,0,0
11/14/2017 11:10,50,67.6,68,62.8,118,64.8,2,0,0
11/14/2017 11:15,53,68.3,71,63.6,124,65.6,2,0,0
11/14/2017 11:20,52,68.7,70,64.1,122,66,2,0,0
11/14/2017 11:25,48,68.1,65,63.3,113,65.3,2,0,0
11/14/2017 11:30,56,67,75,62.2,131,64.3,2,0,0
11/14/2017 11:35,49,67.5,67,62.8,116,64.8,2,0,0
11/14/2017 11:40,61,66.9,80,62.2,141,64.3,2,0,0
11/14/2017 11:45,53,68.5,72,64,125,65.9,2,0,0
11/14/2017 11:50,51,69,68,64.5,119,66.4,2,0,0
11/14/2017 11:55,41,68.9,58,64.3,99,66.2,2,0,0
11/14/2017 12:00,50,69,68,64.3,118,66.3,2,0,0
11/14/2017 12:05,52,67.8,70,63,122,65.1,2,0,0
11/14/2017 12:10,49,68.8,67,64,116,66.1,2,0,0
11/14/2017 12:15,54,70.5,71,65.9,125,67.9,2,0,0
11/14/2017 12:20,49,69.5,66,64.9,115,66.9,2,0,0
11/14/2017 12:25,55,69.1,74,64.4,129,66.4,2,0,0
11/14/2017 12:30,51,69.2,68,64.6,119,66.6,2,0,0
11/14/2017 12:35,52,68.5,71,63.8,123,65.8,2,0,0
11/14/2017 12:40,57,68.5,75,63.6,132,65.7,2,0,0
11/14/2017 12:45,48,68.4,66,63.6,114,65.6,2,0,0
11/14/2017 12:50,58,68.4,76,63.7,134,65.7,2,0,0
11/14/2017 12:55,47,69.9,65,65.2,112,67.2,2,0,0
11/14/2017 13:00,50,70.1,68,65.4,118,67.4,2,0,0
11/14/2017 13:05,47,69.5,64,64.8,111,66.8,2,0,0
11/14/2017 13:10,51,69.1,68,64.5,119,66.5,2,0,0
11/14/2017 13:15,51,68.4,69,63.6,120,65.7,2,0,0
11/14/2017 13:20,54,67.6,71,62.8,125,64.9,2,0,0
11/14/2017 13:25,54,68.1,72,63.3,126,65.3,2,0,0
11/14/2017 13:30,49,67.5,66,62.6,115,64.7,2,0,0
11/14/2017 13:35,48,67.6,66,62.7,114,64.8,2,0,0
11/14/2017 13:40,54,67.5,72,62.7,126,64.7,2,0,0
11/14/2017 13:45,49,69.6,66,64.9,115,66.9,2,0,0
11/14/2017 13:50,55,69.4,73,64.7,128,66.7,2,0,0
11/14/2017 13:55,52,69.7,70,65,122,67,2,0,0
11/14/2017 14:00,55,69.3,73,64.7,128,66.7,2,0,0
11/14/2017 14:05,58,68.7,76,64,134,66,2,0,0
11/14/2017 14:10,52,68.3,71,63.6,123,65.6,2,0,0
11/14/2017 14:15,56,68.6,74,63.9,130,65.9,2,0,0
11/14/2017 14:20,50,68.4,69,63.7,119,65.7,2,0,0
11/14/2017 14:25,49,67.8,67,63,116,65,2,0,0
11/14/2017 14:30,44,69.8,61,65.1,105,67.1,2,0,0
11/14/2017 14:35,54,69.2,71,64.5,125,66.5,2,0,0
11/14/2017 14:40,55,69.7,74,65.1,129,67,2,0,0
11/14/2017 14:45,47,68.3,65,63.5,112,65.5,2,0,0
11/14/2017 14:50,46,69.4,64,64.7,110,66.7,2,0,0
11/14/2017 14:55,47,70.2,64,65.6,111,67.6,2,0,0
11/14/2017 15:00,50,69.5,68,64.8,118,66.8,2,0,0
11/14/2017 15:05,48,67.4,67,62.6,115,64.6,2,0,0
11/14/2017 15:10,51,67.1,69,62.2,120,64.3,2,0,0
11/14/2017 15:15,52,68.3,70,63.6,122,65.6,2,0,0
11/14/2017 15:20,59,68.6,78,63.8,137,65.9,2,0,0
11/14/2017 15:25,54,69.3,71,64.6,125,66.6,2,0,0
11/14/2017 15:30,59,68.5,76,63.8,135,65.8,2,0,0
11/14/2017 15:35,69,69.2,88,64.5,157,66.6,2,0,0
11/14/2017 15:40,66,68.2,85,63.5,151,65.5,2,0,0
11/14/2017 15:45,72,67.7,93,62.9,165,65,2,0,0
11/14/2017 15:50,61,67.7,79,62.9,140,65,2,0,0
11/14/2017 15:55,75,68,94,63.2,169,65.3,2,0,0
11/14/2017 16:00,64,68.4,83,63.7,147,65.7,2,0,0
11/14/2017 16:05,68,67.5,87,62.7,155,64.8,2,0,0
11/14/2017 16:10,59,68.4,78,63.7,137,65.8,2,0,0
11/14/2017 16:15,58,67.7,77,62.9,135,65,2,0,0
11/14/2017 16:20,68,67.4,88,62.5,156,64.6,2,0,0
11/14/2017 16:25,50,68.5,69,63.7,119,65.7,2,0,0
11/14/2017 16:30,51,67.2,70,62.2,121,64.3,2,0,0
11/14/2017 16:35,54,62.9,73,57.6,127,59.9,2,0,0
11/14/2017 16:40,47,65.3,65,60.1,112,62.3,2,0,0
11/14/2017 16:45,51,65.4,70,60.3,121,62.5,2,0,0
11/14/2017 16:50,52,64.7,71,59.4,123,61.6,2,0,0
11/14/2017 16:55,46,66.3,64,61.2,110,63.4,2,0,0
11/14/2017 17:00,48,67.5,66,62.6,114,64.7,2,0,0
11/14/2017 17:05,56,66.7,75,61.8,131,63.9,2,0,0
11/14/2017 17:10,52,68.3,70,63.5,122,65.5,2,0,0
11/14/2017 17:15,59,68.3,78,63.5,137,65.5,2,0,0
11/14/2017 17:20,53,67.8,72,63,125,65,2,0,0
11/14/2017 17:25,51,63.1,70,57.8,121,60,2,0,0
11/14/2017 17:30,50,58.4,69,52.5,119,55,2,0,0
11/14/2017 17:35,51,52.5,70,46,121,48.7,2,0,0
11/14/2017 17:40,44,48.6,63,41.7,107,44.6,2,0,0
11/14/2017 17:45,56,56.3,74,50.2,130,52.8,2,0,0
11/14/2017 17:50,57,61.1,76,55.5,133,57.9,2,0,0
11/14/2017 17:55,56,59.5,76,53.7,132,56.1,2,0,0
11/14/2017 18:00,45,52.5,62,45.9,107,48.6,2,0,0
11/14/2017 18:05,47,48.3,66,41.2,113,44.2,2,0,0
11/14/2017 18:10,44,50.1,63,43.3,107,46.1,2,0,0
11/14/2017 18:15,42,49.3,60,42.4,102,45.3,2,0,0
11/14/2017 18:20,42,49.5,60,42.7,102,45.5,2,0,0
11/14/2017 18:25,36,46.7,53,39.5,89,42.5,2,0,0
11/14/2017 18:30,34,39.3,50,31.3,84,34.5,2,0,0
11/14/2017 18:35,30,40.9,46,33.1,76,36.2,2,0,0
11/14/2017 18:40,36,40.9,53,33.1,89,36.3,2,0,0
11/14/2017 18:45,27,44.1,45,36.7,72,39.5,2,0,0
11/14/2017 18:50,36,51.5,53,44.9,89,47.6,2,0,0
11/14/2017 18:55,25,59.9,41,54.3,66,56.4,2,0,0
11/14/2017 19:00,32,63.6,49,58.3,81,60.4,2,0,0
11/14/2017 19:05,32,65.9,49,60.9,81,62.9,2,0,0
11/14/2017 19:10,40,65.9,57,61.1,97,63.1,2,0,0
11/14/2017 19:15,32,67.1,48,62.3,80,64.2,2,0,0
11/14/2017 19:20,42,67.6,59,62.9,101,64.8,2,0,0
11/14/2017 19:25,43,67.6,61,62.9,104,64.8,2,0,0
11/14/2017 19:30,43,67.8,60,63,103,65,2,0,0
11/14/2017 19:35,43,68.2,60,63.4,103,65.4,2,0,0
11/14/2017 19:40,36,67.3,52,62.5,88,64.5,2,0,0
11/14/2017 19:45,39,67.6,56,62.9,95,64.8,2,0,0
11/14/2017 19:50,40,68.8,57,64.1,97,66,2,0,0
11/14/2017 19:55,30,68.6,46,63.9,76,65.8,2,0,0
11/14/2017 20:00,31,68.7,47,64.1,78,65.9,2,0,0
11/14/2017 20:05,34,69.2,51,64.5,85,66.4,2,0,0
11/14/2017 20:10,28,69.2,44,64.5,72,66.3,2,0,0
11/14/2017 20:15,33,67.8,49,63.1,82,65,2,0,0
11/14/2017 20:20,25,68.7,40,64,65,65.8,2,0,0
11/14/2017 20:25,34,68.6,52,64,86,65.8,2,0,0
11/14/2017 20:30,30,69.3,46,64.7,76,66.5,2,0,0
11/14/2017 20:35,25,69.3,41,64.7,66,66.5,2,0,0
11/14/2017 20:40,34,68.5,50,63.8,84,65.7,2,0,0
11/14/2017 20:45,27,69.2,43,64.5,70,66.3,2,0,0
11/14/2017 20:50,34,69.3,50,64.7,84,66.5,2,0,0
11/14/2017 20:55,31,69.1,47,64.5,78,66.3,2,0,0
11/14/2017 21:00,27,69.3,43,64.7,70,66.5,2,0,0
11/14/2017 21:05,25,68.9,41,64.2,66,66,2,0,0
11/14/2017 21:10,28,68.5,44,63.9,72,65.7,2,0,0
11/14/2017 21:15,32,69,49,64.4,81,66.2,2,0,0
11/14/2017 21:20,25,69.3,41,64.7,66,66.4,2,0,0
11/14/2017 21:25,30,69,46,64.4,76,66.2,2,0,0
11/14/2017 21:30,27,69.3,44,64.7,71,66.5,2,0,0
11/14/2017 21:35,21,69.3,37,64.7,58,66.4,2,0,0
11/14/2017 21:40,27,69.6,43,65,70,66.8,2,0,0
11/14/2017 21:45,20,69.5,37,64.9,57,66.5,2,0,0
11/14/2017 21:50,15,69.4,31,64.8,46,66.3,2,0,0
11/14/2017 21:55,20,69.3,36,64.7,56,66.3,2,0,0
11/14/2017 22:00,17,69.4,32,64.8,49,66.4,2,0,0
11/14/2017 22:05,20,69.5,36,64.9,56,66.6,2,0,0
11/14/2017 22:10,31,68.2,47,63.5,78,65.4,2,0,0
11/14/2017 22:15,20,68.7,36,64.1,56,65.7,2,0,0
11/14/2017 22:20,19,69.1,35,64.5,54,66.1,2,0,0
11/14/2017 22:25,20,69.2,36,64.6,56,66.3,2,0,0
11/14/2017 22:30,17,69.2,33,64.5,50,66.1,2,0,0
11/14/2017 22:35,17,69.1,33,64.4,50,66,2,0,0
11/14/2017 22:40,20,68.6,36,64,56,65.6,2,0,0
11/14/2017 22:45,18,68.8,34,64.2,52,65.8,2,0,0
11/14/2017 22:50,18,69.2,34,64.5,52,66.1,2,0,0
11/14/2017 22:55,18,69.4,33,64.7,51,66.4,2,0,0
11/14/2017 23:00,14,69.2,30,64.6,44,66,2,0,0
11/14/2017 23:05,19,69.5,35,64.9,54,66.5,2,0,0
11/14/2017 23:10,14,69,30,64.3,44,65.8,2,0,0
11/14/2017 23:15,14,69.1,29,64.4,43,66,2,0,0
11/14/2017 23:20,11,69.2,27,64.6,38,65.9,2,0,0
11/14/2017 23:25,9,69.3,25,64.6,34,65.8,2,0,0
11/14/2017 23:30,10,69.3,25,64.7,35,66,2,0,0
11/14/2017 23:35,16,69.3,32,64.7,48,66.2,2,0,0
11/14/2017 23:40,15,68.9,30,64.3,45,65.9,2,0,0
11/14/2017 23:45,12,69.1,27,64.5,39,65.9,2,0,0
11/14/2017 23:50,11,69,27,64.4,38,65.8,2,0,0
11/14/2017 23:55,13,69.1,28,64.5,41,66,2,0,0
11/15/2017 0:00,12,69.3,27,64.7,39,66.2,2,0,0
11/15/2017 0:05,15,69.3,30,64.7,45,66.3,2,0,0
11/15/2017 0:10,11,69.1,26,64.5,37,65.9,2,0,0
11/15/2017 0:15,10,69.2,26,64.6,36,65.9,2,0,0
11/15/2017 0:20,6,69.3,21,64.7,27,65.8,2,0,0
11/15/2017 0:25,9,69.4,24,64.8,33,66,2,0,0
11/15/2017 0:30,7,69.3,23,64.7,30,65.8,2,0,0
11/15/2017 0:35,9,69.4,24,64.8,33,66.1,2,0,0
11/15/2017 0:40,11,69.4,21,64.8,32,66.4,2,0,0
11/15/2017 0:45,7,69.4,22,64.8,29,65.9,2,0,0
11/15/2017 0:50,8,69.3,23,64.7,31,65.9,2,0,0
11/15/2017 0:55,5,69.4,20,64.8,25,65.7,2,0,0
11/15/2017 1:00,4,69.3,19,64.7,23,65.5,2,0,0
11/15/2017 1:05,7,69.3,22,64.7,29,65.8,2,0,0
11/15/2017 1:10,7,69.3,22,64.7,29,65.8,2,0,0
11/15/2017 1:15,13,69.3,21,64.7,34,66.5,2,0,0
11/15/2017 1:20,5,69.3,21,64.7,26,65.6,2,0,0
11/15/2017 1:25,5,69.3,20,64.7,25,65.7,2,0,0
11/15/2017 1:30,6,69.2,22,64.5,28,65.5,2,0,0
11/15/2017 1:35,9,69.2,24,64.5,33,65.8,2,0,0
11/15/2017 1:40,9,69.3,24,64.7,33,66,2,0,0
11/15/2017 1:45,4,69.3,19,64.7,23,65.5,2,0,0
11/15/2017 1:50,9,69.3,24,64.7,33,65.9,2,0,0
11/15/2017 1:55,6,69.3,21,64.7,27,65.7,2,0,0
11/15/2017 2:00,7,69.3,22,64.7,29,65.8,2,0,0
11/15/2017 2:05,5,69.3,20,64.7,25,65.7,2,0,0
11/15/2017 2:10,7,69.4,22,64.8,29,65.9,2,0,0
11/15/2017 2:15,6,69.1,21,64.4,27,65.5,2,0,0
11/15/2017 2:20,7,69.1,22,64.5,29,65.6,2,0,0
11/15/2017 2:25,8,69.2,23,64.6,31,65.8,2,0,0
11/15/2017 2:30,7,69.3,22,64.7,29,65.8,2,0,0
11/15/2017 2:35,10,69,25,64.4,35,65.7,2,0,0
11/15/2017 2:40,10,69.2,25,64.6,35,65.9,2,0,0
11/15/2017 2:45,8,69.3,23,64.7,31,65.9,2,0,0
11/15/2017 2:50,10,69.2,25,64.6,35,65.9,2,0,0
11/15/2017 2:55,9,69.3,24,64.7,33,66,2,0,0
11/15/2017 3:00,11,69.3,27,64.7,38,66,2,0,0
11/15/2017 3:05,13,69.5,28,64.9,41,66.3,2,0,0
11/15/2017 3:10,10,69.2,25,64.5,35,65.9,2,0,0
11/15/2017 3:15,12,69.2,28,64.5,40,65.9,2,0,0
11/15/2017 3:20,10,69.3,25,64.7,35,66,2,0,0
11/15/2017 3:25,11,69.4,27,64.8,38,66.1,2,0,0
11/15/2017 3:30,10,69.2,25,64.6,35,65.9,2,0,0
11/15/2017 3:35,12,68.4,28,63.7,40,65.1,2,0,0
11/15/2017 3:40,15,68.5,31,63.9,46,65.4,2,0,0
11/15/2017 3:45,15,68.9,31,64.2,46,65.8,2,0,0
11/15/2017 3:50,14,69.2,31,64.6,45,66.1,2,0,0
11/15/2017 3:55,16,69.2,31,64.6,47,66.2,2,0,0
11/15/2017 4:00,17,69.5,33,64.9,50,66.4,2,0,0
11/15/2017 4:05,19,69.4,35,64.8,54,66.4,2,0,0
11/15/2017 4:10,20,69.3,36,64.6,56,66.3,2,0,0
11/15/2017 4:15,19,69.4,35,64.7,54,66.4,2,0,0
11/15/2017 4:20,18,69.4,34,64.7,52,66.3,2,0,0
11/15/2017 4:25,28,69.6,44,65,72,66.8,2,0,0
11/15/2017 4:30,24,69.2,40,64.6,64,66.3,2,0,0
11/15/2017 4:35,24,69,40,64.4,64,66.1,2,0,0
11/15/2017 4:40,37,69.7,55,65.1,92,66.9,2,0,0
11/15/2017 4:45,35,69.1,53,64.5,88,66.3,2,0,0
11/15/2017 4:50,37,68.8,55,64.2,92,66,2,0,0
11/15/2017 4:55,34,69.4,52,64.8,86,66.7,2,0,0
11/15/2017 5:00,45,67.5,64,62.8,109,64.7,2,0,0
11/15/2017 5:05,50,69.6,69,65,119,67,2,0,0
11/15/2017 5:10,44,67.6,64,62.9,108,64.8,2,0,0
11/15/2017 5:15,50,68.4,69,63.7,119,65.7,2,0,0
11/15/2017 5:20,68,67.8,89,63.1,157,65.1,2,0,0
11/15/2017 5:25,60,68,80,63.3,140,65.3,2,0,0
11/15/2017 5:30,53,67.7,74,62.8,127,64.9,2,0,0
11/15/2017 5:35,62,67.5,83,62.7,145,64.8,2,0,0
11/15/2017 5:40,66,68,88,63.2,154,65.3,2,0,0
11/15/2017 5:45,70,68.5,92,63.7,162,65.8,2,0,0
11/15/2017 5:50,68,68,90,63.2,158,65.3,2,0,0
11/15/2017 5:55,66,68.7,87,64,153,66,2,0,0
11/15/2017 6:00,62,68.6,83,63.8,145,65.9,2,0,0
11/15/2017 6:05,54,67.6,74,62.8,128,64.8,2,0,0
11/15/2017 6:10,62,66.7,83,61.8,145,63.9,2,0,0
11/15/2017 6:15,64,67.7,87,62.8,151,64.9,2,0,0
11/15/2017 6:20,64,68,87,63.1,151,65.2,2,0,0
11/15/2017 6:25,64,68.9,86,64.2,150,66.2,2,0,0
11/15/2017 6:30,63,68.2,84,63.3,147,65.4,2,0,0
11/15/2017 6:35,71,67.6,94,62.7,165,64.8,2,0,0
11/15/2017 6:40,72,66.9,94,61.9,166,64.1,2,0,0
11/15/2017 6:45,74,66.8,97,61.8,171,64,2,0,0
11/15/2017 6:50,73,68,95,63.2,168,65.3,2,0,0
11/15/2017 6:55,79,68.2,102,63.4,181,65.5,2,0,0
11/15/2017 7:00,72,67.8,95,62.9,167,65,2,0,0
11/15/2017 7:05,75,67.6,99,62.7,174,64.8,2,0,0
11/15/2017 7:10,78,67,100,62,178,64.2,2,0,0
11/15/2017 7:15,82,66.8,105,61.8,187,64,2,0,0
11/15/2017 7:20,87,67.5,111,62.6,198,64.7,2,0,0
11/15/2017 7:25,83,66.8,107,61.8,190,64,2,0,0
11/15/2017 7:30,84,66.1,108,61.1,192,63.3,2,0,0
11/15/2017 7:35,79,66.6,102,61.6,181,63.8,2,0,0
11/15/2017 7:40,89,66.5,113,61.5,202,63.7,2,0,0
11/15/2017 7:45,91,65.8,115,60.8,206,63,2,0,0
11/15/2017 7:50,83,66.5,107,61.5,190,63.7,2,0,0
11/15/2017 7:55,78,67.2,102,62.2,180,64.4,2,0,0
11/15/2017 8:00,69,67.1,91,62.2,160,64.3,2,0,0
11/15/2017 8:05,76,67.5,97,62.6,173,64.7,2,0,0
11/15/2017 8:10,87,64.6,112,59.5,199,61.7,2,0,0
11/15/2017 8:15,86,64,109,58.8,195,61.1,2,0,0
11/15/2017 8:20,81,64.8,105,59.7,186,61.9,2,0,0
11/15/2017 8:25,74,65,95,59.8,169,62.1,2,0,0
11/15/2017 8:30,82,64.7,104,59.6,186,61.9,2,0,0
11/15/2017 8:35,82,65.3,104,60.2,186,62.4,2,0,0
11/15/2017 8:40,85,64.9,108,59.7,193,62,2,0,0
11/15/2017 8:45,84,64.2,106,59,190,61.3,2,0,0
11/15/2017 8:50,78,66.1,100,61,178,63.3,2,0,0
11/15/2017 8:55,77,65.7,99,60.6,176,62.8,2,0,0
11/15/2017 9:00,87,65.4,110,60.3,197,62.6,2,0,0
11/15/2017 9:05,81,63.9,104,58.8,185,61,2,0,0
11/15/2017 9:10,75,64.3,96,59.3,171,61.5,2,0,0
11/15/2017 9:15,81,64.7,103,59.7,184,61.9,2,0,0
11/15/2017 9:20,66,66,87,61.1,153,63.2,2,0,0
11/15/2017 9:25,66,66,87,61.1,153,63.3,2,0,0
11/15/2017 9:30,70,66.1,91,61.2,161,63.3,2,0,0
11/15/2017 9:35,61,67,81,62.2,142,64.2,2,0,0
11/15/2017 9:40,71,66.5,92,61.7,163,63.8,2,0,0
11/15/2017 9:45,75,63.6,97,58.4,172,60.7,2,0,0
11/15/2017 9:50,80,63.3,101,58.1,181,60.4,2,0,0
11/15/2017 9:55,83,63,105,57.7,188,60,2,0,0
11/15/2017 10:00,80,64.9,101,59.8,181,62,2,0,0
11/15/2017 10:05,68,65.1,88,60.1,156,62.3,2,0,0
11/15/2017 10:10,56,65.5,75,60.6,131,62.7,2,0,0
11/15/2017 10:15,68,65.8,88,60.9,156,63,2,0,0
11/15/2017 10:20,61,66.5,81,61.6,142,63.7,2,0,0
11/15/2017 10:25,64,65.6,84,60.6,148,62.8,2,0,0
11/15/2017 10:30,67,66.6,86,61.8,153,63.9,2,0,0
11/15/2017 10:35,72,66.6,92,61.8,164,63.9,2,0,0
11/15/2017 10:40,67,65.8,87,60.9,154,63,2,0,0
11/15/2017 10:45,67,64.3,87,59.3,154,61.5,2,0,0
11/15/2017 10:50,64,65.5,84,60.6,148,62.7,2,0,0
11/15/2017 10:55,53,66.4,71,61.5,124,63.6,2,0,0
11/15/2017 11:00,55,66.9,74,62.1,129,64.1,2,0,0
11/15/2017 11:05,48,67.5,66,62.7,114,64.7,2,0,0
11/15/2017 11:10,57,67.7,75,63,132,65.1,2,0,0
11/15/2017 11:15,57,67.9,75,63.2,132,65.2,2,0,0
11/15/2017 11:20,47,67.6,65,62.8,112,64.8,2,0,0
11/15/2017 11:25,58,67,77,62.3,135,64.3,2,0,0
11/15/2017 11:30,48,66.8,66,62,114,64,2,0,0
11/15/2017 11:35,55,67.8,72,63,127,65.1,2,0,0
11/15/2017 11:40,57,67,76,62.3,133,64.3,2,0,0
11/15/2017 11:45,58,66.9,77,62.1,135,64.2,2,0,0
11/15/2017 11:50,48,68.7,66,64.1,114,66,2,0,0
11/15/2017 11:55,58,67.5,76,62.9,134,64.9,2,0,0
11/15/2017 12:00,46,68.3,64,63.6,110,65.6,2,0,0
11/15/2017 12:05,56,67.3,75,62.6,131,64.6,2,0,0
11/15/2017 12:10,50,67.7,69,63,119,65,2,0,0
11/15/2017 12:15,49,67.8,67,63.1,116,65.1,2,0,0
11/15/2017 12:20,41,69.1,58,64.5,99,66.4,2,0,0
11/15/2017 12:25,49,70.3,67,65.8,116,67.7,2,0,0
11/15/2017 12:30,47,69,64,64.3,111,66.3,2,0,0
11/15/2017 12:35,63,67.5,83,62.8,146,64.8,2,0,0
11/15/2017 12:40,41,68.9,58,64.2,99,66.1,2,0,0
11/15/2017 12:45,52,68.1,70,63.4,122,65.4,2,0,0
11/15/2017 12:50,46,68.1,64,63.3,110,65.3,2,0,0
11/15/2017 12:55,45,69.1,63,64.4,108,66.3,2,0,0
11/15/2017 13:00,51,68.9,69,64.2,120,66.2,2,0,0
11/15/2017 13:05,42,69.4,59,64.7,101,66.6,2,0,0
11/15/2017 13:10,57,67.4,76,62.5,133,64.6,2,0,0
11/15/2017 13:15,49,68.7,68,63.9,117,65.9,2,0,0
11/15/2017 13:20,43,67.7,61,62.9,104,64.9,2,0,0
11/15/2017 13:25,58,68.8,76,64,134,66.1,2,0,0
11/15/2017 13:30,53,70.3,71,65.8,124,67.7,2,0,0
11/15/2017 13:35,41,70.8,58,66.3,99,68.2,2,0,0
11/15/2017 13:40,51,70,69,65.4,120,67.4,2,0,0
11/15/2017 13:45,56,69.4,75,64.8,131,66.8,2,0,0
11/15/2017 13:50,48,69,65,64.4,113,66.3,2,0,0
11/15/2017 13:55,50,69.2,68,64.6,118,66.6,2,0,0
11/15/2017 14:00,49,69.3,67,64.6,116,66.6,2,0,0
11/15/2017 14:05,53,69.2,71,64.5,124,66.5,2,0,0
11/15/2017 14:10,45,68.7,63,64,108,65.9,2,0,0
11/15/2017 14:15,43,68.4,59,63.7,102,65.7,2,0,0
11/15/2017 14:20,51,68.6,69,63.9,120,65.9,2,0,0
11/15/2017 14:25,44,69.2,60,64.5,104,66.5,2,0,0
11/15/2017 14:30,40,68.5,58,63.7,98,65.6,2,0,0
11/15/2017 14:35,53,68.9,70,64.2,123,66.2,2,0,0
11/15/2017 14:40,42,67.8,59,63,101,65,2,0,0
11/15/2017 14:45,54,68.1,71,63.4,125,65.4,2,0,0
11/15/2017 14:50,44,67.1,62,62.3,106,64.3,2,0,0
11/15/2017 14:55,52,67.6,70,62.9,122,64.9,2,0,0
11/15/2017 15:00,41,69.1,58,64.5,99,66.4,2,0,0
11/15/2017 15:05,50,69,67,64.3,117,66.3,2,0,0
11/15/2017 15:10,52,69,70,64.4,122,66.3,2,0,0
11/15/2017 15:15,48,68.7,66,64,114,66,2,0,0
11/15/2017 15:20,54,69.3,71,64.6,125,66.6,2,0,0
11/15/2017 15:25,51,68.1,70,63.3,121,65.3,2,0,0
11/15/2017 15:30,50,69.2,69,64.5,119,66.5,2,0,0
11/15/2017 15:35,54,68.2,73,63.4,127,65.4,2,0,0
11/15/2017 15:40,64,67.8,84,63,148,65.1,2,0,0
11/15/2017 15:45,64,68.5,83,63.7,147,65.8,2,0,0
11/15/2017 15:50,44,69.6,61,65,105,67,2,0,0
11/15/2017 15:55,53,71.1,71,66.6,124,68.5,2,0,0
11/15/2017 16:00,61,70.9,79,66.4,140,68.4,2,0,0
11/15/2017 16:05,65,70.4,85,65.9,150,67.8,2,0,0
11/15/2017 16:10,54,69,73,64.4,127,66.4,2,0,0
11/15/2017 16:15,67,68.7,86,64,153,66,2,0,0
11/15/2017 16:20,72,66.9,92,62,164,64.1,2,0,0
11/15/2017 16:25,50,66.8,69,61.9,119,64,2,0,0
11/15/2017 16:30,56,68.2,75,63.5,131,65.5,2,0,0
11/15/2017 16:35,63,65.1,82,60.1,145,62.3,2,0,0
11/15/2017 16:40,53,62.2,71,56.8,124,59.1,2,0,0
11/15/2017 16:45,51,60,69,54.4,120,56.8,2,0,0
11/15/2017 16:50,55,53.3,74,47,129,49.6,2,0,0
11/15/2017 16:55,55,50.7,74,44.1,129,46.9,2,0,0
11/15/2017 17:00,46,55.9,64,49.9,110,52.4,2,0,0
11/15/2017 17:05,43,61.4,61,55.8,104,58.1,2,0,0
11/15/2017 17:10,41,62.3,59,56.9,100,59.1,2,0,0
11/15/2017 17:15,46,58.7,65,53,111,55.4,2,0,0
11/15/2017 17:20,38,56,56,49.8,94,52.3,2,0,0
11/15/2017 17:25,50,55.2,68,49,118,51.6,2,0,0
11/15/2017 17:30,43,54.9,61,48.7,104,51.3,2,0,0
11/15/2017 17:35,37,53.6,54,47.2,91,49.8,2,0,0
11/15/2017 17:40,28,55.4,45,49.2,73,51.6,2,0,0
11/15/2017 17:45,42,56.3,59,50.2,101,52.8,2,0,0
11/15/2017 17:50,31,60.4,48,54.7,79,56.9,2,0,0
11/15/2017 17:55,39,63.7,56,58.5,95,60.6,2,0,0
11/15/2017 18:00,36,65,54,60,90,62,2,0,0
11/15/2017 18:05,31,66.3,47,61.4,78,63.3,2,0,0
11/15/2017 18:10,35,66.5,52,61.6,87,63.5,2,0,0
11/15/2017 18:15,42,66.9,59,62,101,64,2,0,0
11/15/2017 18:20,35,66.5,52,61.6,87,63.5,2,0,0
11/15/2017 18:25,39,67.1,56,62.3,95,64.3,2,0,0
11/15/2017 18:30,48,66.8,65,62,113,64,2,0,0
11/15/2017 18:35,34,66.2,52,61.3,86,63.3,2,0,0
11/15/2017 18:40,47,66.3,65,61.4,112,63.5,2,0,0
11/15/2017 18:45,36,67.8,52,63.1,88,65,2,0,0
11/15/2017 18:50,36,68.8,52,64.2,88,66.1,2,0,0
11/15/2017 18:55,41,69,57,64.4,98,66.3,2,0,0
11/15/2017 19:00,34,68.8,51,64.1,85,66,2,0,0
11/15/2017 19:05,41,68.2,59,63.5,100,65.4,2,0,0
11/15/2017 19:10,38,69.1,54,64.4,92,66.4,2,0,0
11/15/2017 19:15,36,68.4,53,63.7,89,65.6,2,0,0
11/15/2017 19:20,42,68.9,59,64.2,101,66.1,2,0,0
11/15/2017 19:25,37,67.2,54,62.4,91,64.3,2,0,0
11/15/2017 19:30,48,66.5,65,61.5,113,63.6,2,0,0
11/15/2017 19:35,34,67.3,51,62.4,85,64.4,2,0,0
11/15/2017 19:40,35,68.2,52,63.4,87,65.3,2,0,0
11/15/2017 19:45,33,67.5,49,62.7,82,64.6,2,0,0
11/15/2017 19:50,33,67.6,49,62.9,82,64.8,2,0,0
11/15/2017 19:55,31,68,47,63.2,78,65.1,2,0,0
11/15/2017 20:00,28,67.6,44,62.9,72,64.7,2,0,0
11/15/2017 20:05,27,68.2,43,63.6,70,65.4,2,0,0
11/15/2017 20:10,22,68.7,38,64,60,65.7,2,0,0
11/15/2017 20:15,33,68.3,49,63.6,82,65.5,2,0,0
11/15/2017 20:20,32,68.3,48,63.6,80,65.5,2,0,0
11/15/2017 20:25,36,67,53,62.1,89,64.1,2,0,0
11/15/2017 20:30,28,67.7,45,63,73,64.8,2,0,0
11/15/2017 20:35,29,67.8,46,63,75,64.8,2,0,0
11/15/2017 20:40,30,68,47,63.2,77,65.1,2,0,0
11/15/2017 20:45,32,67.8,48,63.1,80,65,2,0,0
11/15/2017 20:50,27,67.2,43,62.4,70,64.2,2,0,0
11/15/2017 20:55,32,66,48,61.1,80,63.1,2,0,0
11/15/2017 21:00,30,66.5,46,61.6,76,63.6,2,0,0
11/15/2017 21:05,33,63.9,50,58.8,83,60.8,2,0,0
11/15/2017 21:10,28,64.9,44,60,72,61.9,2,0,0
11/15/2017 21:15,26,66,42,61.2,68,63,2,0,0
11/15/2017 21:20,27,66,42,61.1,69,63,2,0,0
11/15/2017 21:25,22,66.8,38,62,60,63.7,2,0,0
11/15/2017 21:30,30,66.5,46,61.6,76,63.5,2,0,0
11/15/2017 21:35,34,64.7,50,59.7,84,61.7,2,0,0
11/15/2017 21:40,27,65.8,43,60.9,70,62.8,2,0,0
11/15/2017 21:45,26,66.9,42,62.1,68,63.9,2,0,0
11/15/2017 21:50,18,67.7,34,62.9,52,64.6,2,0,0
11/15/2017 21:55,31,67.7,47,63,78,64.9,2,0,0
11/15/2017 22:00,24,68.2,40,63.5,64,65.3,2,0,0
11/15/2017 22:05,25,67.8,41,63,66,64.8,2,0,0
11/15/2017 22:10,18,67.9,33,63.1,51,64.8,2,0,0
11/15/2017 22:15,27,67.6,43,62.9,70,64.7,2,0,0
11/15/2017 22:20,25,67.9,41,63.1,66,64.9,2,0,0
11/15/2017 22:25,28,67.4,44,62.6,72,64.5,2,0,0
11/15/2017 22:30,23,68.2,39,63.5,62,65.3,2,0,0
11/15/2017 22:35,19,68.5,34,63.9,53,65.5,2,0,0
11/15/2017 22:40,22,68.5,37,63.9,59,65.6,2,0,0
11/15/2017 22:45,25,68.8,40,64.2,65,66,2,0,0
11/15/2017 22:50,17,69.1,32,64.5,49,66.1,2,0,0
11/15/2017 22:55,20,68.9,35,64.3,55,66,2,0,0
11/15/2017 23:00,19,69.1,35,64.4,54,66.1,2,0,0
11/15/2017 23:05,16,68.8,31,64.1,47,65.7,2,0,0
11/15/2017 23:10,19,68.5,34,63.8,53,65.5,2,0,0
11/15/2017 23:15,16,68.3,31,63.6,47,65.2,2,0,0
11/15/2017 23:20,12,68.6,27,63.9,39,65.3,2,0,0
11/15/2017 23:25,16,68.4,31,63.7,47,65.3,2,0,0
11/15/2017 23:30,13,68.6,29,63.9,42,65.4,2,0,0
11/15/2017 23:35,16,68.2,31,63.5,47,65.1,2,0,0
11/15/2017 23:40,18,67.9,33,63.2,51,64.9,2,0,0
11/15/2017 23:45,12,68.4,27,63.7,39,65.1,2,0,0
11/15/2017 23:50,13,68.5,29,63.9,42,65.3,2,0,0
11/15/2017 23:55,15,67.9,30,63.2,45,64.8,2,0,0
11/16/2017 0:00,13,69.3,29,64.7,42,66.2,2,0,0
11/16/2017 0:05,8,69.2,23,64.6,31,65.8,2,0,0
11/16/2017 0:10,10,69,25,64.4,35,65.7,2,0,0
11/16/2017 0:15,10,69,26,64.3,36,65.6,2,0,0
11/16/2017 0:20,11,68.8,26,64.1,37,65.5,2,0,0
11/16/2017 0:25,17,68.9,23,64.2,40,66.2,2,0,0
11/16/2017 0:30,10,68.8,25,64.2,35,65.5,2,0,0
11/16/2017 0:35,12,68.5,27,63.9,39,65.3,2,0,0
11/16/2017 0:40,7,68.8,22,64.2,29,65.3,2,0,0
11/16/2017 0:45,8,69,24,64.4,32,65.6,2,0,0
11/16/2017 0:50,7,69.1,23,64.5,30,65.6,2,0,0
11/16/2017 0:55,8,69.1,23,64.5,31,65.7,2,0,0
11/16/2017 1:00,9,68.8,24,64.1,33,65.4,2,0,0
11/16/2017 1:05,7,69.1,22,64.4,29,65.5,2,0,0
11/16/2017 1:10,7,68.9,22,64.3,29,65.4,2,0,0
11/16/2017 1:15,5,69.2,21,64.5,26,65.4,2,0,0
11/16/2017 1:20,7,69.1,22,64.5,29,65.6,2,0,0
11/16/2017 1:25,9,69.2,24,64.6,33,65.8,2,0,0
11/16/2017 1:30,9,69.1,24,64.5,33,65.8,2,0,0
11/16/2017 1:35,9,69,24,64.3,33,65.6,2,0,0
11/16/2017 1:40,8,69.1,23,64.4,31,65.6,2,0,0
11/16/2017 1:45,8,69.2,23,64.5,31,65.7,2,0,0
11/16/2017 1:50,6,69,21,64.4,27,65.4,2,0,0
11/16/2017 1:55,6,68.9,21,64.3,27,65.3,2,0,0
11/16/2017 2:00,8,69,23,64.4,31,65.6,2,0,0
11/16/2017 2:05,8,69.1,23,64.4,31,65.6,2,0,0
11/16/2017 2:10,7,69.2,22,64.5,29,65.7,2,0,0
11/16/2017 2:15,7,68.9,22,64.3,29,65.4,2,0,0
11/16/2017 2:20,6,69,21,64.4,27,65.4,2,0,0
11/16/2017 2:25,5,69.1,20,64.5,25,65.4,2,0,0
11/16/2017 2:30,10,69.1,25,64.4,35,65.8,2,0,0
11/16/2017 2:35,9,69,24,64.4,33,65.6,2,0,0
11/16/2017 2:40,10,68.9,25,64.2,35,65.5,2,0,0
11/16/2017 2:45,11,69,26,64.3,37,65.7,2,0,0
11/16/2017 2:50,10,69,25,64.4,35,65.7,2,0,0
11/16/2017 2:55,12,68.3,28,63.6,40,65,2,0,0
11/16/2017 3:00,9,68.6,24,63.9,33,65.2,2,0,0
11/16/2017 3:05,13,68.8,28,64.2,41,65.7,2,0,0
11/16/2017 3:10,11,69.1,26,64.5,37,65.8,2,0,0
11/16/2017 3:15,13,67.8,28,63.1,41,64.6,2,0,0
11/16/2017 3:20,11,68.6,27,64,38,65.3,2,0,0
11/16/2017 3:25,13,68.5,29,63.9,42,65.3,2,0,0
11/16/2017 3:30,9,68.7,24,64.1,33,65.4,2,0,0
11/16/2017 3:35,13,68.5,28,63.8,41,65.3,2,0,0
11/16/2017 3:40,13,68.5,28,63.9,41,65.3,2,0,0
11/16/2017 3:45,14,68.2,29,63.6,43,65.1,2,0,0
11/16/2017 3:50,14,68.5,30,63.8,44,65.3,2,0,0
11/16/2017 3:55,16,68,31,63.3,47,64.9,2,0,0
11/16/2017 4:00,12,68.6,28,63.9,40,65.3,2,0,0
11/16/2017 4:05,23,67.4,39,62.6,62,64.4,2,0,0
11/16/2017 4:10,21,67.5,36,62.8,57,64.5,2,0,0
11/16/2017 4:15,22,67.9,38,63.1,60,64.9,2,0,0
11/16/2017 4:20,25,67.5,41,62.7,66,64.5,2,0,0
11/16/2017 4:25,22,68.2,38,63.5,60,65.2,2,0,0
11/16/2017 4:30,28,68.3,44,63.6,72,65.4,2,0,0
11/16/2017 4:35,29,68.3,46,63.6,75,65.4,2,0,0
11/16/2017 4:40,31,66.9,48,62.1,79,64,2,0,0
11/16/2017 4:45,39,66.9,57,62.1,96,64,2,0,0
11/16/2017 4:50,35,67.6,52,62.8,87,64.7,2,0,0
11/16/2017 4:55,32,67.7,49,62.9,81,64.8,2,0,0
11/16/2017 5:00,34,67.7,52,62.9,86,64.8,2,0,0
11/16/2017 5:05,34,67.9,51,63.1,85,65,2,0,0
11/16/2017 5:10,45,65.1,63,60,108,62.1,2,0,0
11/16/2017 5:15,40,65.8,57,60.8,97,62.9,2,0,0
11/16/2017 5:20,52,63.9,72,58.7,124,60.9,2,0,0
11/16/2017 5:25,51,63,70,57.7,121,59.9,2,0,0
11/16/2017 5:30,52,63,71,57.6,123,59.9,2,0,0
11/16/2017 5:35,46,61.6,64,56.1,110,58.4,2,0,0
11/16/2017 5:40,56,60.9,75,55.3,131,57.7,2,0,0
11/16/2017 5:45,51,60.7,70,55.2,121,57.5,2,0,0
11/16/2017 5:50,62,59.7,82,54,144,56.5,2,0,0
11/16/2017 5:55,50,60.4,69,54.7,119,57.1,2,0,0
11/16/2017 6:00,56,59.2,76,53.4,132,55.9,2,0,0
11/16/2017 6:05,51,59.3,71,53.5,122,55.9,2,0,0
11/16/2017 6:10,56,59.3,75,53.5,131,56,2,0,0
11/16/2017 6:15,55,58.3,74,52.4,129,55,2,0,0
11/16/2017 6:20,59,58.4,80,52.5,139,55,2,0,0
11/16/2017 6:25,50,57.4,69,51.4,119,53.9,2,0,0
11/16/2017 6:30,64,58.1,85,52.1,149,54.7,2,0,0
11/16/2017 6:35,66,58.8,87,52.8,153,55.4,2,0,0
11/16/2017 6:40,83,58.3,107,52.4,190,55,2,0,0
11/16/2017 6:45,77,59,99,53.1,176,55.6,2,0,0
11/16/2017 6:50,71,59.7,93,53.9,164,56.4,2,0,0
11/16/2017 6:55,72,60.3,94,54.5,166,57,2,0,0
11/16/2017 7:00,70,59.8,92,54,162,56.5,2,0,0
11/16/2017 7:05,72,61.5,95,55.9,167,58.3,2,0,0
11/16/2017 7:10,75,61.8,98,56.3,173,58.7,2,0,0
11/16/2017 7:15,74,62.9,96,57.5,170,59.8,2,0,0
11/16/2017 7:20,74,62.7,95,57.1,169,59.6,2,0,0
11/16/2017 7:25,70,62.5,91,57,161,59.4,2,0,0
11/16/2017 7:30,79,62.1,100,56.6,179,59,2,0,0
11/16/2017 7:35,75,62.9,97,57.5,172,59.9,2,0,0
11/16/2017 7:40,77,63.2,99,57.8,176,60.2,2,0,0
11/16/2017 7:45,87,63.4,111,58.1,198,60.4,2,0,0
11/16/2017 7:50,86,64.3,110,59,196,61.3,2,0,0
11/16/2017 7:55,80,63.3,102,57.9,182,60.2,2,0,0
11/16/2017 8:00,71,62.1,93,56.7,164,59,2,0,0
11/16/2017 8:05,79,62.8,102,57.4,181,59.8,2,0,0
11/16/2017 8:10,77,62.4,100,57,177,59.3,2,0,0
11/16/2017 8:15,79,62.1,102,56.6,181,59,2,0,0
11/16/2017 8:20,80,63.1,102,57.7,182,60.1,2,0,0
11/16/2017 8:25,74,62.6,96,57.1,170,59.5,2,0,0
11/16/2017 8:30,78,62,100,56.5,178,58.9,2,0,0
11/16/2017 8:35,69,61.4,90,55.8,159,58.3,2,0,0
11/16/2017 8:40,79,61.1,101,55.4,180,57.9,2,0,0
11/16/2017 8:45,82,61.9,104,56.3,186,58.8,2,0,0
11/16/2017 8:50,80,62,103,56.5,183,58.9,2,0,0
11/16/2017 8:55,72,61.7,94,56.2,166,58.6,2,0,0
11/16/2017 9:00,75,61.1,97,55.5,172,58,2,0,0
11/16/2017 9:05,74,61.6,94,56.1,168,58.5,2,0,0
11/16/2017 9:10,71,60.8,92,55.3,163,57.7,2,0,0
11/16/2017 9:15,64,62.5,84,57.1,148,59.4,2,0,0
11/16/2017 9:20,60,62.5,80,57.1,140,59.4,2,0,0
11/16/2017 9:25,53,63,73,57.7,126,59.9,2,0,0
11/16/2017 9:30,70,62.7,90,57.3,160,59.7,2,0,0
11/16/2017 9:35,70,63.2,90,57.9,160,60.2,2,0,0
11/16/2017 9:40,63,61.9,82,56.4,145,58.8,2,0,0
11/16/2017 9:45,62,61.3,82,55.7,144,58.1,2,0,0
11/16/2017 9:50,64,62.4,84,57,148,59.3,2,0,0
11/16/2017 9:55,67,63.3,88,58,155,60.3,2,0,0
11/16/2017 10:00,65,61.7,85,56.2,150,58.6,2,0,0
11/16/2017 10:05,56,62.6,75,57.2,131,59.5,2,0,0
11/16/2017 10:10,54,61.8,72,56.3,126,58.7,2,0,0
11/16/2017 10:15,64,58.4,84,52.6,148,55.1,2,0,0
11/16/2017 10:20,57,58.7,76,52.9,133,55.4,2,0,0
11/16/2017 10:25,51,57,72,51,123,53.5,2,0,0
11/16/2017 10:30,43,57.3,61,51.3,104,53.8,2,0,0
11/16/2017 10:35,83,55,105,48.8,188,51.5,2,0,0
11/16/2017 10:40,61,58.5,80,52.7,141,55.2,2,0,0
11/16/2017 10:45,62,59.5,82,53.9,144,56.3,2,0,0
11/16/2017 10:50,56,61.8,74,56.4,130,58.7,2,0,0
11/16/2017 10:55,55,62.8,73,57.4,128,59.7,2,0,0
11/16/2017 11:00,53,63.3,71,58,124,60.3,2,0,0
11/16/2017 11:05,63,62.5,81,57.2,144,59.5,2,0,0
11/16/2017 11:10,63,62.6,82,57.2,145,59.6,2,0,0
11/16/2017 11:15,57,62.3,76,56.9,133,59.2,2,0,0
11/16/2017 11:20,56,62.5,74,57.1,130,59.4,2,0,0
11/16/2017 11:25,63,62.4,81,57.1,144,59.4,2,0,0
11/16/2017 11:30,62,61.8,81,56.4,143,58.7,2,0,0
11/16/2017 11:35,61,61.7,79,56.3,140,58.7,2,0,0
11/16/2017 11:40,57,63.3,75,58,132,60.3,2,0,0
11/16/2017 11:45,61,63.8,80,58.6,141,60.9,2,0,0
11/16/2017 11:50,50,63.8,67,58.7,117,60.9,2,0,0
11/16/2017 11:55,56,64,74,58.7,130,61,2,0,0
11/16/2017 12:00,55,63.7,75,58.4,130,60.7,2,0,0
11/16/2017 12:05,58,62.7,77,57.4,135,59.7,2,0,0
11/16/2017 12:10,53,63.9,71,58.7,124,60.9,2,0,0
11/16/2017 12:15,51,63.7,69,58.5,120,60.7,2,0,0
11/16/2017 12:20,53,64,72,58.9,125,61.1,2,0,0
11/16/2017 12:25,46,63.2,64,58,110,60.2,2,0,0
11/16/2017 12:30,45,63.5,62,58.3,107,60.5,2,0,0
11/16/2017 12:35,50,63.1,67,57.8,117,60,2,0,0
11/16/2017 12:40,58,63.2,76,57.9,134,60.2,2,0,0
11/16/2017 12:45,54,63.2,72,57.9,126,60.1,2,0,0
11/16/2017 12:50,50,63.3,66,58.1,116,60.3,2,0,0
11/16/2017 12:55,46,62,63,56.7,109,58.9,2,0,0
11/16/2017 13:00,47,62.5,64,57.2,111,59.4,2,0,0
11/16/2017 13:05,39,63.2,57,57.9,96,60.1,2,0,0
11/16/2017 13:10,39,61.6,56,56.2,95,58.4,2,0,0
11/16/2017 13:15,44,62.2,61,56.8,105,59.1,2,0,0
11/16/2017 13:20,44,61.5,62,56,106,58.3,2,0,0
11/16/2017 13:25,37,61.9,54,56.5,91,58.7,2,0,0
11/16/2017 13:30,41,63,58,57.7,99,59.9,2,0,0
11/16/2017 13:35,63,68,56,62.2,119,65.3,2,0,0
11/16/2017 13:40,64,67.8,58,62,122,65,2,0,0
11/16/2017 13:45,65,67.9,58,62.1,123,65.2,2,0,0
11/16/2017 13:50,42,67.6,58,62.9,100,64.9,2,0,0
11/16/2017 13:55,43,65.6,61,60.7,104,62.7,2,0,0
11/16/2017 14:00,41,64.8,59,59.8,100,61.8,2,0,0
11/16/2017 14:05,39,64.1,56,59.1,95,61.1,2,0,0
11/16/2017 14:10,40,63.7,57,58.6,97,60.7,2,0,0
11/16/2017 14:15,37,65.3,55,60.4,92,62.4,2,0,0
11/16/2017 14:20,48,65.3,65,60.2,113,62.4,2,0,0
11/16/2017 14:25,59,65.8,76,60.8,135,63,2,0,0
11/16/2017 14:30,50,65.5,67,60.5,117,62.6,2,0,0
11/16/2017 14:35,50,65,68,60,118,62.1,2,0,0
11/16/2017 14:40,44,65.8,61,60.8,105,62.9,2,0,0
11/16/2017 14:45,49,65.2,67,60.2,116,62.3,2,0,0
11/16/2017 14:50,51,65.5,68,60.5,119,62.6,2,0,0
11/16/2017 14:55,48,66.7,65,61.8,113,63.9,2,0,0
11/16/2017 15:00,53,66.8,70,62,123,64,2,0,0
11/16/2017 15:05,53,65.6,70,60.6,123,62.8,2,0,0
11/16/2017 15:10,52,65.1,70,60,122,62.2,2,0,0
11/16/2017 15:15,61,65.3,80,60.2,141,62.4,2,0,0
11/16/2017 15:20,65,65.6,84,60.5,149,62.8,2,0,0
11/16/2017 15:25,74,64.4,95,59.1,169,61.4,2,0,0
11/16/2017 15:30,62,60.4,81,54.7,143,57.2,2,0,0
11/16/2017 15:35,56,57.6,74,51.7,130,54.2,2,0,0
11/16/2017 15:40,61,58.8,81,52.9,142,55.4,2,0,0
11/16/2017 15:45,52,57.1,71,51.1,123,53.6,2,0,0
11/16/2017 15:50,57,54.9,75,48.7,132,51.4,2,0,0
11/16/2017 15:55,50,55.1,68,48.9,118,51.5,2,0,0
11/16/2017 16:00,40,57.8,57,51.9,97,54.4,2,0,0
11/16/2017 16:05,47,59.5,65,53.8,112,56.2,2,0,0
11/16/2017 16:10,48,60,66,54.3,114,56.7,2,0,0
11/16/2017 16:15,46,60.5,63,55,109,57.3,2,0,0
11/16/2017 16:20,46,61.1,64,55.6,110,57.9,2,0,0
11/16/2017 16:25,38,64.1,55,59,93,61.1,2,0,0
11/16/2017 16:30,34,65.2,51,60.2,85,62.2,2,0,0
11/16/2017 16:35,39,65.7,56,60.7,95,62.8,2,0,0
11/16/2017 16:40,56,65.4,75,60.4,131,62.5,2,0,0
11/16/2017 16:45,46,63.3,64,58,110,60.3,2,0,0
11/16/2017 16:50,42,63.3,60,57.9,102,60.1,2,0,0
11/16/2017 16:55,44,63.2,62,57.7,106,60,2,0,0
11/16/2017 17:00,51,61.1,69,55.5,120,57.9,2,0,0
11/16/2017 17:05,42,62.3,60,56.8,102,59.1,2,0,0
11/16/2017 17:10,49,57.4,67,51.4,116,53.9,2,0,0
11/16/2017 17:15,41,54.6,59,48.4,100,50.9,2,0,0
11/16/2017 17:20,41,52.9,59,46.4,100,49,2,0,0
11/16/2017 17:25,48,49.6,67,42.7,115,45.6,2,0,0
11/16/2017 17:30,45,46.4,63,39.2,108,42.2,2,0,0
11/16/2017 17:35,39,48,56,41.1,95,43.9,2,0,0
11/16/2017 17:40,47,54,65,47.8,112,50.4,2,0,0
11/16/2017 17:45,34,58.3,52,52.5,86,54.8,2,0,0
11/16/2017 17:50,37,61.4,54,55.9,91,58.1,2,0,0
11/16/2017 17:55,45,63.2,63,57.8,108,60,2,0,0
11/16/2017 18:00,40,65.5,57,60.5,97,62.5,2,0,0
11/16/2017 18:05,50,63.6,68,58.3,118,60.6,2,0,0
11/16/2017 18:10,50,63.6,67,58.3,117,60.6,2,0,0
11/16/2017 18:15,44,64.2,61,59.1,105,61.2,2,0,0
11/16/2017 18:20,32,65.1,50,60,82,62,2,0,0
11/16/2017 18:25,32,67.6,48,62.8,80,64.7,2,0,0
11/16/2017 18:30,36,67.6,53,62.8,89,64.7,2,0,0
11/16/2017 18:35,36,67,52,62.2,88,64.2,2,0,0
11/16/2017 18:40,28,67.6,45,62.8,73,64.6,2,0,0
11/16/2017 18:45,38,67,56,62.2,94,64.1,2,0,0
11/16/2017 18:50,35,67,52,62.2,87,64.1,2,0,0
11/16/2017 18:55,31,68.1,48,63.4,79,65.3,2,0,0
11/16/2017 19:00,27,68.6,44,63.9,71,65.7,2,0,0
11/16/2017 19:05,49,67.2,66,62.3,115,64.4,2,0,0
11/16/2017 19:10,38,67.9,55,63.1,93,65,2,0,0
11/16/2017 19:15,46,67.4,63,62.6,109,64.7,2,0,0
11/16/2017 19:20,37,66.7,55,61.8,92,63.8,2,0,0
11/16/2017 19:25,42,66.7,58,61.8,100,63.9,2,0,0
11/16/2017 19:30,40,66.6,58,61.7,98,63.7,2,0,0
11/16/2017 19:35,35,67.9,51,63.2,86,65.1,2,0,0
11/16/2017 19:40,37,66.9,54,62,91,64,2,0,0
11/16/2017 19:45,37,67.9,55,63,92,64.9,2,0,0
11/16/2017 19:50,35,68.8,50,64,85,66,2,0,0
11/16/2017 19:55,30,68.5,46,63.8,76,65.7,2,0,0
11/16/2017 20:00,32,69,49,64.4,81,66.2,2,0,0
11/16/2017 20:05,35,69.1,52,64.4,87,66.3,2,0,0
11/16/2017 20:10,38,69,55,64.4,93,66.3,2,0,0
11/16/2017 20:15,32,68.3,48,63.6,80,65.5,2,0,0
11/16/2017 20:20,43,68.7,60,64,103,66,2,0,0
11/16/2017 20:25,36,67.8,52,63,88,65,2,0,0
11/16/2017 20:30,29,67.7,46,62.9,75,64.8,2,0,0
11/16/2017 20:35,33,67.6,49,62.8,82,64.7,2,0,0
11/16/2017 20:40,31,68.2,46,63.5,77,65.4,2,0,0
11/16/2017 20:45,23,68.4,39,63.7,62,65.5,2,0,0
11/16/2017 20:50,39,68.5,56,63.8,95,65.8,2,0,0
11/16/2017 20:55,29,69.3,45,64.6,74,66.4,2,0,0
11/16/2017 21:00,32,69.4,47,64.8,79,66.7,2,0,0
11/16/2017 21:05,28,69,45,64.3,73,66.1,2,0,0
11/16/2017 21:10,29,68.8,45,64.1,74,66,2,0,0
11/16/2017 21:15,32,68.5,48,63.8,80,65.7,2,0,0
11/16/2017 21:20,31,69,47,64.3,78,66.1,2,0,0
11/16/2017 21:25,29,68.1,46,63.4,75,65.2,2,0,0
11/16/2017 21:30,24,68,40,63.3,64,65.1,2,0,0
11/16/2017 21:35,27,68.3,43,63.6,70,65.4,2,0,0
11/16/2017 21:40,24,68.7,39,64.1,63,65.8,2,0,0
11/16/2017 21:45,25,69,41,64.4,66,66.1,2,0,0
11/16/2017 21:50,23,68.9,40,64.2,63,66,2,0,0
11/16/2017 21:55,24,68.9,39,64.3,63,66.1,2,0,0
11/16/2017 22:00,27,68.5,43,63.8,70,65.6,2,0,0
11/16/2017 22:05,23,68.4,40,63.7,63,65.4,2,0,0
11/16/2017 22:10,23,68.6,39,64,62,65.7,2,0,0
11/16/2017 22:15,19,68.5,35,63.9,54,65.5,2,0,0
11/16/2017 22:20,23,68.4,38,63.7,61,65.5,2,0,0
11/16/2017 22:25,20,68.4,36,63.7,56,65.4,2,0,0
11/16/2017 22:30,25,68.6,41,64,66,65.7,2,0,0
11/16/2017 22:35,21,68.8,37,64.2,58,65.9,2,0,0
11/16/2017 22:40,17,69,33,64.4,50,66,2,0,0
11/16/2017 22:45,18,68.5,34,63.9,52,65.5,2,0,0
11/16/2017 22:50,20,68.4,35,63.7,55,65.4,2,0,0
11/16/2017 22:55,16,68.7,32,64.1,48,65.6,2,0,0
11/16/2017 23:00,20,68.6,36,63.9,56,65.6,2,0,0
11/16/2017 23:05,16,68.5,32,63.9,48,65.4,2,0,0
11/16/2017 23:10,17,68.9,33,64.2,50,65.8,2,0,0
11/16/2017 23:15,20,69.2,36,64.6,56,66.2,2,0,0
11/16/2017 23:20,15,69.1,31,64.5,46,66,2,0,0
11/16/2017 23:25,16,69.1,31,64.4,47,66,2,0,0
11/16/2017 23:30,17,69.2,32,64.5,49,66.2,2,0,0
11/16/2017 23:35,16,69.1,32,64.5,48,66,2,0,0
11/16/2017 23:40,16,68.7,32,64,48,65.6,2,0,0
11/16/2017 23:45,16,69,32,64.3,48,65.9,2,0,0
11/16/2017 23:50,14,69,29,64.4,43,65.9,2,0,0
11/16/2017 23:55,12,69.1,27,64.5,39,65.9,2,0,0
11/17/2017 0:00,9,69.3,25,64.7,34,66,2,0,0
11/17/2017 0:05,12,69.3,27,64.7,39,66.1,2,0,0
11/17/2017 0:10,13,69,28,64.4,41,65.9,2,0,0
11/17/2017 0:15,9,69.2,24,64.5,33,65.8,2,0,0
11/17/2017 0:20,8,68.9,23,64.3,31,65.5,2,0,0
11/17/2017 0:25,9,69,24,64.3,33,65.6,2,0,0
11/17/2017 0:30,18,69.1,24,64.5,42,66.5,2,0,0
11/17/2017 0:35,11,68.8,27,64.1,38,65.5,2,0,0
11/17/2017 0:40,9,69.1,24,64.4,33,65.7,2,0,0
11/17/2017 0:45,7,69.1,23,64.5,30,65.5,2,0,0
11/17/2017 0:50,10,68.9,25,64.2,35,65.6,2,0,0
11/17/2017 0:55,7,68.6,23,64,30,65.1,2,0,0
11/17/2017 1:00,18,69,24,64.4,42,66.3,2,0,0
11/17/2017 1:05,10,68.8,25,64.2,35,65.5,2,0,0
11/17/2017 1:10,8,69.2,24,64.5,32,65.7,2,0,0
11/17/2017 1:15,7,69.3,23,64.7,30,65.7,2,0,0
11/17/2017 1:20,7,69.2,22,64.5,29,65.7,2,0,0
11/17/2017 1:25,5,69.4,20,64.8,25,65.7,2,0,0
11/17/2017 1:30,8,69.3,23,64.7,31,65.9,2,0,0
11/17/2017 1:35,12,69,27,64.4,39,65.8,2,0,0
11/17/2017 1:40,7,69.2,22,64.5,29,65.7,2,0,0
11/17/2017 1:45,7,69.1,23,64.4,30,65.5,2,0,0
11/17/2017 1:50,9,69.2,24,64.6,33,65.9,2,0,0
11/17/2017 1:55,8,69.2,23,64.6,31,65.8,2,0,0
11/17/2017 2:00,4,69.3,20,64.7,24,65.5,2,0,0
11/17/2017 2:05,9,69.3,25,64.7,34,65.9,2,0,0
11/17/2017 2:10,9,69.3,24,64.7,33,66,2,0,0
11/17/2017 2:15,8,69.3,24,64.7,32,65.8,2,0,0
11/17/2017 2:20,9,69.3,24,64.7,33,65.9,2,0,0
11/17/2017 2:25,9,69.3,24,64.7,33,66,2,0,0
11/17/2017 2:30,8,69.3,24,64.7,32,65.9,2,0,0
11/17/2017 2:35,7,69.4,22,64.8,29,65.9,2,0,0
11/17/2017 2:40,8,69.4,23,64.8,31,66,2,0,0
11/17/2017 2:45,10,69.4,25,64.8,35,66.2,2,0,0
11/17/2017 2:50,10,69.4,25,64.8,35,66.2,2,0,0
11/17/2017 2:55,9,69.4,24,64.8,33,66.1,2,0,0
11/17/2017 3:00,11,69.3,26,64.7,37,66.1,2,0,0
11/17/2017 3:05,10,69.3,26,64.7,36,66,2,0,0
11/17/2017 3:10,9,69.1,24,64.5,33,65.8,2,0,0
11/17/2017 3:15,12,69.2,27,64.6,39,66,2,0,0
11/17/2017 3:20,10,69.3,26,64.7,36,65.9,2,0,0
11/17/2017 3:25,15,69.4,30,64.8,45,66.3,2,0,0
11/17/2017 3:30,10,69.1,25,64.5,35,65.8,2,0,0
11/17/2017 3:35,11,69.4,27,64.8,38,66.1,2,0,0
11/17/2017 3:40,15,69.2,31,64.6,46,66.1,2,0,0
11/17/2017 3:45,15,69.3,31,64.7,46,66.2,2,0,0
11/17/2017 3:50,19,69.4,35,64.8,54,66.4,2,0,0
11/17/2017 3:55,15,69.1,30,64.5,45,66,2,0,0
11/17/2017 4:00,12,69.3,27,64.7,39,66.1,2,0,0
11/17/2017 4:05,16,69.2,32,64.6,48,66.2,2,0,0
11/17/2017 4:10,17,69,33,64.4,50,65.9,2,0,0
11/17/2017 4:15,24,68.8,41,64.1,65,65.8,2,0,0
11/17/2017 4:20,22,69.3,39,64.7,61,66.3,2,0,0
11/17/2017 4:25,28,68.8,44,64.2,72,66,2,0,0
11/17/2017 4:30,21,68.4,38,63.8,59,65.4,2,0,0
11/17/2017 4:35,34,69.1,52,64.5,86,66.3,2,0,0
11/17/2017 4:40,33,69.4,51,64.8,84,66.6,2,0,0
11/17/2017 4:45,35,69.2,52,64.6,87,66.4,2,0,0
11/17/2017 4:50,43,69.7,62,65.1,105,67,2,0,0
11/17/2017 4:55,32,70.1,49,65.5,81,67.3,2,0,0
11/17/2017 5:00,38,68.9,56,64.1,94,66.1,2,0,0
11/17/2017 5:05,45,69.8,64,65.2,109,67.1,2,0,0
11/17/2017 5:10,41,69.3,61,64.6,102,66.5,2,0,0
11/17/2017 5:15,48,68.8,69,64.1,117,66.1,2,0,0
11/17/2017 5:20,47,67.8,67,63,114,65,2,0,0
11/17/2017 5:25,55,69,75,64.3,130,66.3,2,0,0
11/17/2017 5:30,57,68.6,77,63.8,134,65.8,2,0,0
11/17/2017 5:35,56,68.3,76,63.5,132,65.5,2,0,0
11/17/2017 5:40,60,66.6,82,61.7,142,63.7,2,0,0
11/17/2017 5:45,63,67.8,85,63,148,65,2,0,0
11/17/2017 5:50,65,67.7,86,62.9,151,64.9,2,0,0
11/17/2017 5:55,55,68.7,76,64,131,66,2,0,0
11/17/2017 6:00,56,67,76,62,132,64.1,2,0,0
11/17/2017 6:05,56,66.7,77,61.7,133,63.8,2,0,0
11/17/2017 6:10,57,64.9,79,59.7,136,61.9,2,0,0
11/17/2017 6:15,59,66.2,79,61.1,138,63.3,2,0,0
11/17/2017 6:20,73,66,94,60.9,167,63.2,2,0,0
11/17/2017 6:25,67,66,89,60.8,156,63,2,0,0
11/17/2017 6:30,70,66.7,92,61.7,162,63.8,2,0,0
11/17/2017 6:35,72,66.9,93,61.8,165,64,2,0,0
11/17/2017 6:40,75,65,98,59.8,173,62,2,0,0
11/17/2017 6:45,82,65.3,104,60.1,186,62.4,2,0,0
11/17/2017 6:50,75,66,97,60.9,172,63.2,2,0,0
11/17/2017 6:55,68,67.6,90,62.6,158,64.8,2,0,0
11/17/2017 7:00,66,67.5,88,62.6,154,64.7,2,0,0
11/17/2017 7:05,77,67.2,100,62.2,177,64.4,2,0,0
11/17/2017 7:10,82,66.7,105,61.8,187,63.9,2,0,0
11/17/2017 7:15,75,66.3,97,61.3,172,63.4,2,0,0
11/17/2017 7:20,79,65.8,102,60.7,181,63,2,0,0
11/17/2017 7:25,79,65.1,101,59.9,180,62.2,2,0,0
11/17/2017 7:30,90,65.3,114,60.2,204,62.4,2,0,0
11/17/2017 7:35,96,65.1,120,59.9,216,62.2,2,0,0
11/17/2017 7:40,80,65.6,104,60.5,184,62.7,2,0,0
11/17/2017 7:45,81,66.4,104,61.3,185,63.6,2,0,0
11/17/2017 7:50,77,66,100,60.9,177,63.1,2,0,0
11/17/2017 7:55,72,65.3,94,60.2,166,62.4,2,0,0
11/17/2017 8:00,72,66.7,95,61.7,167,63.9,2,0,0
11/17/2017 8:05,70,66.5,91,61.5,161,63.6,2,0,0
11/17/2017 8:10,67,66.9,87,61.9,154,64.1,2,0,0
11/17/2017 8:15,72,67.7,93,62.8,165,64.9,2,0,0
11/17/2017 8:20,74,66,97,61,171,63.2,2,0,0
11/17/2017 8:25,77,66.4,99,61.3,176,63.5,2,0,0
11/17/2017 8:30,76,65,98,59.9,174,62.1,2,0,0
11/17/2017 8:35,79,64.4,101,59.2,180,61.5,2,0,0
11/17/2017 8:40,72,65,94,59.9,166,62.1,2,0,0
11/17/2017 8:45,73,65.3,94,60.3,167,62.5,2,0,0
11/17/2017 8:50,73,65.5,94,60.5,167,62.7,2,0,0
11/17/2017 8:55,76,66.1,98,61.1,174,63.2,2,0,0
11/17/2017 9:00,75,66.5,97,61.5,172,63.6,2,0,0
11/17/2017 9:05,82,66.7,104,61.7,186,63.9,2,0,0
11/17/2017 9:10,63,66.6,83,61.6,146,63.7,2,0,0
11/17/2017 9:15,74,66.9,95,61.9,169,64.1,2,0,0
11/17/2017 9:20,78,66.8,99,61.9,177,64.1,2,0,0
11/17/2017 9:25,66,67.3,85,62.4,151,64.6,2,0,0
11/17/2017 9:30,66,67.4,86,62.5,152,64.7,2,0,0
11/17/2017 9:35,66,66.5,85,61.5,151,63.7,2,0,0
11/17/2017 9:40,79,66.3,100,61.3,179,63.5,2,0,0
11/17/2017 9:45,70,65.4,91,60.4,161,62.5,2,0,0
11/17/2017 9:50,67,63.9,87,58.7,154,61,2,0,0
11/17/2017 9:55,64,63.8,83,58.6,147,60.8,2,0,0
11/17/2017 10:00,64,65.1,84,60,148,62.2,2,0,0
11/17/2017 10:05,64,65.5,83,60.4,147,62.7,2,0,0
11/17/2017 10:10,72,65.5,93,60.4,165,62.6,2,0,0
11/17/2017 10:15,62,64.9,82,59.9,144,62,2,0,0
11/17/2017 10:20,64,66.1,84,61.3,148,63.4,2,0,0
11/17/2017 10:25,65,67.1,84,62.4,149,64.4,2,0,0
11/17/2017 10:30,59,68.3,78,63.7,137,65.7,2,0,0
11/17/2017 10:35,57,68.4,75,63.8,132,65.8,2,0,0
11/17/2017 10:40,64,68.1,83,63.4,147,65.4,2,0,0
11/17/2017 10:45,65,67.9,85,63.3,150,65.3,2,0,0
11/17/2017 10:50,63,68.6,81,64,144,66,2,0,0
11/17/2017 10:55,65,68.1,83,63.4,148,65.4,2,0,0
11/17/2017 11:00,65,68.1,85,63.4,150,65.4,2,0,0
11/17/2017 11:05,50,67.5,67,62.8,117,64.8,2,0,0
11/17/2017 11:10,60,66.8,79,62,139,64.1,2,0,0
11/17/2017 11:15,60,65.7,79,60.8,139,62.9,2,0,0
11/17/2017 11:20,65,65.8,86,61,151,63.1,2,0,0
11/17/2017 11:25,64,66.8,84,62,148,64.1,2,0,0
11/17/2017 11:30,61,66.8,80,62,141,64.1,2,0,0
11/17/2017 11:35,67,66.8,87,62,154,64.1,2,0,0
11/17/2017 11:40,62,66.6,82,61.8,144,63.8,2,0,0
11/17/2017 11:45,65,67,85,62.2,150,64.3,2,0,0
11/17/2017 11:50,66,67.1,86,62.3,152,64.4,2,0,0
11/17/2017 11:55,55,68.1,74,63.4,129,65.4,2,0,0
11/17/2017 12:00,52,67.8,70,63,122,65,2,0,0
11/17/2017 12:05,55,67.7,72,63,127,65.1,2,0,0
11/17/2017 12:10,56,68,75,63.3,131,65.3,2,0,0
11/17/2017 12:15,64,68.2,82,63.5,146,65.6,2,0,0
11/17/2017 12:20,48,67,66,62.2,114,64.2,2,0,0
11/17/2017 12:25,64,67.9,84,63.2,148,65.3,2,0,0
11/17/2017 12:30,61,67.7,80,63,141,65.1,2,0,0
11/17/2017 12:35,55,68.6,74,63.9,129,65.9,2,0,0
11/17/2017 12:40,54,68.4,72,63.6,126,65.7,2,0,0
11/17/2017 12:45,52,68.8,69,64.1,121,66.1,2,0,0
11/17/2017 12:50,55,68.8,73,64.2,128,66.2,2,0,0
11/17/2017 12:55,58,68.3,76,63.7,134,65.7,2,0,0
11/17/2017 13:00,50,68,67,63.4,117,65.4,2,0,0
11/17/2017 13:05,50,68,68,63.4,118,65.3,2,0,0
11/17/2017 13:10,48,66.2,67,61.4,115,63.4,2,0,0
11/17/2017 13:15,49,68.4,67,63.8,116,65.8,2,0,0
11/17/2017 13:20,41,67.1,58,62.5,99,64.4,2,0,0
11/17/2017 13:25,51,68.9,69,64.3,120,66.2,2,0,0
11/17/2017 13:30,43,69.2,60,64.6,103,66.5,2,0,0
11/17/2017 13:35,55,69.6,72,64.9,127,66.9,2,0,0
11/17/2017 13:40,50,70.6,67,66,117,68,2,0,0
11/17/2017 13:45,54,68.9,72,64.2,126,66.2,2,0,0
11/17/2017 13:50,55,68.5,74,63.9,129,65.9,2,0,0
11/17/2017 13:55,49,69.7,67,65.1,116,67,2,0,0
11/17/2017 14:00,52,67.7,71,62.9,123,64.9,2,0,0
11/17/2017 14:05,58,67.2,76,62.4,134,64.5,2,0,0
11/17/2017 14:10,53,66.5,71,61.6,124,63.7,2,0,0
11/17/2017 14:15,53,66.6,72,61.6,125,63.7,2,0,0
11/17/2017 14:20,51,67.2,69,62.3,120,64.3,2,0,0
11/17/2017 14:25,43,67.8,60,62.9,103,65,2,0,0
11/17/2017 14:30,55,68.5,73,63.8,128,65.8,2,0,0
11/17/2017 14:35,56,67.9,74,63.1,130,65.2,2,0,0
11/17/2017 14:40,53,68.2,71,63.4,124,65.4,2,0,0
11/17/2017 14:45,48,68.4,66,63.6,114,65.6,2,0,0
11/17/2017 14:50,51,69,69,64.3,120,66.3,2,0,0
11/17/2017 14:55,56,68.3,74,63.5,130,65.6,2,0,0
11/17/2017 15:00,56,68.1,73,63.3,129,65.4,2,0,0
11/17/2017 15:05,54,68.3,72,63.5,126,65.6,2,0,0
11/17/2017 15:10,48,67.6,67,62.8,115,64.8,2,0,0
11/17/2017 15:15,63,68.1,81,63.3,144,65.4,2,0,0
11/17/2017 15:20,55,69.6,73,64.9,128,66.9,2,0,0
11/17/2017 15:25,55,68.4,75,63.6,130,65.6,2,0,0
11/17/2017 15:30,61,67.8,80,62.9,141,65,2,0,0
11/17/2017 15:35,49,65.3,68,60.2,117,62.3,2,0,0
11/17/2017 15:40,50,59.7,69,54,119,56.4,2,0,0
11/17/2017 15:45,56,60.5,74,54.8,130,57.3,2,0,0
11/17/2017 15:50,58,61.8,78,56.3,136,58.6,2,0,0
11/17/2017 15:55,53,64.6,71,59.4,124,61.6,2,0,0
11/17/2017 16:00,48,65.7,66,60.7,114,62.8,2,0,0
11/17/2017 16:05,51,65.2,70,60,121,62.2,2,0,0
11/17/2017 16:10,51,64.6,70,59.5,121,61.6,2,0,0
11/17/2017 16:15,43,66,61,61,104,63.1,2,0,0
11/17/2017 16:20,46,66.4,64,61.5,110,63.5,2,0,0
11/17/2017 16:25,46,67.5,65,62.7,111,64.7,2,0,0
11/17/2017 16:30,50,68.2,67,63.4,117,65.4,2,0,0
11/17/2017 16:35,59,69.1,78,64.4,137,66.5,2,0,0
11/17/2017 16:40,52,68.1,70,63.4,122,65.4,2,0,0
11/17/2017 16:45,49,66.5,67,61.6,116,63.7,2,0,0
11/17/2017 16:50,47,66.3,66,61.4,113,63.4,2,0,0
11/17/2017 16:55,51,64,69,58.7,120,61,2,0,0
11/17/2017 17:00,49,56.4,67,50.3,116,52.9,2,0,0
11/17/2017 17:05,57,46.6,75,39.4,132,42.5,2,0,0
11/17/2017 17:10,61,38.8,81,30.8,142,34.2,2,0,0
11/17/2017 17:15,60,34.6,79,26.2,139,29.8,2,0,0
11/17/2017 17:20,58,33.5,77,25,135,28.7,2,0,0
11/17/2017 17:25,49,30.9,68,22.1,117,25.8,2,0,0
11/17/2017 17:30,54,29.8,72,20.9,126,24.7,2,0,0
11/17/2017 17:35,50,29.3,69,20.4,119,24.1,2,0,0
11/17/2017 17:40,52,29.1,70,20.1,122,24,2,0,0
11/17/2017 17:45,53,33.7,72,25.1,125,28.7,2,0,0
11/17/2017 17:50,55,40.2,73,32.3,128,35.7,2,0,0
11/17/2017 17:55,44,43.7,62,36.3,106,39.4,2,0,0
11/17/2017 18:00,39,45.5,58,38.2,97,41.1,2,0,0
11/17/2017 18:05,33,51.1,51,44.4,84,47.1,2,0,0
11/17/2017 18:10,38,52,56,45.4,94,48,2,0,0
11/17/2017 18:15,40,57.2,58,51.2,98,53.7,2,0,0
11/17/2017 18:20,48,61.4,67,55.9,115,58.2,2,0,0
11/17/2017 18:25,50,65.2,68,60.1,118,62.3,2,0,0
11/17/2017 18:30,45,66.2,63,61.3,108,63.3,2,0,0
11/17/2017 18:35,49,67,68,62.1,117,64.2,2,0,0
11/17/2017 18:40,53,67.4,70,62.6,123,64.7,2,0,0
11/17/2017 18:45,51,67.5,68,62.7,119,64.8,2,0,0
11/17/2017 18:50,50,68.9,67,64.2,117,66.2,2,0,0
11/17/2017 18:55,44,68.1,61,63.4,105,65.4,2,0,0
11/17/2017 19:00,58,67.9,76,63.2,134,65.2,2,0,0
11/17/2017 19:05,53,67.4,70,62.5,123,64.6,2,0,0
11/17/2017 19:10,52,68.3,70,63.5,122,65.6,2,0,0
11/17/2017 19:15,45,67.2,62,62.4,107,64.4,2,0,0
11/17/2017 19:20,51,68.1,69,63.4,120,65.4,2,0,0
11/17/2017 19:25,47,68.5,64,63.7,111,65.7,2,0,0
11/17/2017 19:30,54,68.3,72,63.6,126,65.6,2,0,0
11/17/2017 19:35,53,67.8,72,63,125,65,2,0,0
11/17/2017 19:40,42,67.8,59,63,101,65,2,0,0
11/17/2017 19:45,46,69.3,64,64.6,110,66.5,2,0,0
11/17/2017 19:50,44,69.3,62,64.7,106,66.6,2,0,0
11/17/2017 19:55,45,69.3,63,64.6,108,66.6,2,0,0
11/17/2017 20:00,35,68.6,51,63.9,86,65.8,2,0,0
11/17/2017 20:05,45,67.8,61,63,106,65.1,2,0,0
11/17/2017 20:10,43,68.5,60,63.8,103,65.8,2,0,0
11/17/2017 20:15,46,68.8,64,64.1,110,66.1,2,0,0
11/17/2017 20:20,39,68.9,56,64.2,95,66.1,2,0,0
11/17/2017 20:25,36,68.3,53,63.5,89,65.5,2,0,0
11/17/2017 20:30,44,68,61,63.2,105,65.2,2,0,0
11/17/2017 20:35,33,68.9,49,64.2,82,66.1,2,0,0
11/17/2017 20:40,42,69,58,64.4,100,66.3,2,0,0
11/17/2017 20:45,38,69,54,64.4,92,66.3,2,0,0
11/17/2017 20:50,37,69,54,64.3,91,66.2,2,0,0
11/17/2017 20:55,36,69.6,52,65,88,66.9,2,0,0
11/17/2017 21:00,36,69.1,52,64.5,88,66.4,2,0,0
11/17/2017 21:05,39,68.3,56,63.5,95,65.5,2,0,0
11/17/2017 21:10,34,68.8,50,64.2,84,66,2,0,0
11/17/2017 21:15,38,67.5,55,62.8,93,64.7,2,0,0
11/17/2017 21:20,34,67.5,50,62.8,84,64.7,2,0,0
11/17/2017 21:25,35,68.3,52,63.6,87,65.5,2,0,0
11/17/2017 21:30,33,68.4,49,63.7,82,65.6,2,0,0
11/17/2017 21:35,33,67.3,50,62.5,83,64.4,2,0,0
11/17/2017 21:40,32,68.1,47,63.4,79,65.3,2,0,0
11/17/2017 21:45,31,68.8,47,64.1,78,66,2,0,0
11/17/2017 21:50,41,69.4,57,64.8,98,66.7,2,0,0
11/17/2017 21:55,32,69.5,48,64.9,80,66.7,2,0,0
11/17/2017 22:00,28,69.7,44,65,72,66.8,2,0,0
11/17/2017 22:05,30,69.3,46,64.7,76,66.5,2,0,0
11/17/2017 22:10,31,69.5,47,64.9,78,66.8,2,0,0
11/17/2017 22:15,31,69.1,48,64.5,79,66.3,2,0,0
11/17/2017 22:20,27,69.3,42,64.6,69,66.4,2,0,0
11/17/2017 22:25,25,69.4,41,64.8,66,66.5,2,0,0
11/17/2017 22:30,26,69,42,64.3,68,66.1,2,0,0
11/17/2017 22:35,34,69,51,64.3,85,66.2,2,0,0
11/17/2017 22:40,23,69.1,38,64.5,61,66.2,2,0,0
11/17/2017 22:45,27,69.2,43,64.6,70,66.4,2,0,0
11/17/2017 22:50,19,69.3,35,64.7,54,66.3,2,0,0
11/17/2017 22:55,23,69.2,40,64.6,63,66.3,2,0,0
11/17/2017 23:00,25,69.4,41,64.8,66,66.6,2,0,0
11/17/2017 23:05,23,69.3,39,64.7,62,66.4,2,0,0
11/17/2017 23:10,21,68.9,37,64.2,58,65.9,2,0,0
11/17/2017 23:15,19,69.1,35,64.5,54,66.1,2,0,0
11/17/2017 23:20,20,69.2,36,64.6,56,66.2,2,0,0
11/17/2017 23:25,14,69.3,29,64.7,43,66.2,2,0,0
11/17/2017 23:30,15,69.2,30,64.6,45,66.1,2,0,0
11/17/2017 23:35,19,69.1,35,64.5,54,66.1,2,0,0
11/17/2017 23:40,18,69.2,34,64.6,52,66.2,2,0,0
11/17/2017 23:45,19,69.1,34,64.5,53,66.2,2,0,0
11/17/2017 23:50,21,69.1,36,64.5,57,66.2,2,0,0
11/17/2017 23:55,18,69.2,34,64.6,52,66.2,2,0,0
11/18/2017 0:00,15,69.3,30,64.7,45,66.3,2,0,0
11/18/2017 0:05,18,69.3,34,64.7,52,66.3,2,0,0
11/18/2017 0:10,15,69.3,31,64.7,46,66.2,2,0,0
11/18/2017 0:15,16,69.4,32,64.8,48,66.4,2,0,0
11/18/2017 0:20,14,69.4,29,64.8,43,66.3,2,0,0
11/18/2017 0:25,17,69.5,32,64.9,49,66.5,2,0,0
11/18/2017 0:30,16,69.5,31,64.9,47,66.5,2,0,0
11/18/2017 0:35,14,69.2,29,64.6,43,66.1,2,0,0
11/18/2017 0:40,11,69.2,26,64.6,37,66,2,0,0
11/18/2017 0:45,13,69.3,28,64.7,41,66.1,2,0,0
11/18/2017 0:50,15,69.1,30,64.5,45,66,2,0,0
11/18/2017 0:55,10,69.1,25,64.5,35,65.8,2,0,0
11/18/2017 1:00,9,69.1,24,64.5,33,65.8,2,0,0
11/18/2017 1:05,9,69.3,24,64.7,33,66,2,0,0
11/18/2017 1:10,10,69.3,25,64.7,35,66,2,0,0
11/18/2017 1:15,8,69.3,23,64.7,31,65.9,2,0,0
11/18/2017 1:20,12,69.4,28,64.8,40,66.2,2,0,0
11/18/2017 1:25,12,69.4,27,64.8,39,66.2,2,0,0
11/18/2017 1:30,11,69.5,26,64.9,37,66.3,2,0,0
11/18/2017 1:35,15,69.1,30,64.5,45,66,2,0,0
11/18/2017 1:40,6,69.2,21,64.6,27,65.6,2,0,0
11/18/2017 1:45,12,69.3,27,64.7,39,66.1,2,0,0
11/18/2017 1:50,9,69.3,24,64.7,33,66,2,0,0
11/18/2017 1:55,7,69.3,23,64.7,30,65.7,2,0,0
11/18/2017 2:00,10,69.4,25,64.8,35,66.1,2,0,0
11/18/2017 2:05,8,69.4,24,64.8,32,65.9,2,0,0
11/18/2017 2:10,7,69.4,23,64.8,30,65.9,2,0,0
11/18/2017 2:15,10,69.4,25,64.8,35,66.2,2,0,0
11/18/2017 2:20,11,69.4,26,64.8,37,66.2,2,0,0
11/18/2017 2:25,9,69.4,24,64.7,33,66,2,0,0
11/18/2017 2:30,9,69.3,24,64.7,33,66,2,0,0
11/18/2017 2:35,10,69.4,25,64.8,35,66.1,2,0,0
11/18/2017 2:40,9,69.5,24,64.9,33,66.1,2,0,0
11/18/2017 2:45,10,69.5,25,65,35,66.3,2,0,0
11/18/2017 2:50,6,69.5,21,64.9,27,65.9,2,0,0
11/18/2017 2:55,11,69.5,27,64.9,38,66.2,2,0,0
11/18/2017 3:00,7,69,22,64.4,29,65.5,2,0,0
11/18/2017 3:05,12,69.2,27,64.6,39,66,2,0,0
11/18/2017 3:10,9,69.2,24,64.6,33,65.9,2,0,0
11/18/2017 3:15,8,69.2,23,64.6,31,65.8,2,0,0
11/18/2017 3:20,9,69.4,24,64.8,33,66,2,0,0
11/18/2017 3:25,9,69.2,25,64.5,34,65.8,2,0,0
11/18/2017 3:30,9,69.1,24,64.4,33,65.7,2,0,0
11/18/2017 3:35,12,69.2,27,64.5,39,66,2,0,0
11/18/2017 3:40,11,69.3,27,64.7,38,66,2,0,0
11/18/2017 3:45,14,69.3,29,64.7,43,66.2,2,0,0
11/18/2017 3:50,15,69.3,31,64.6,46,66.1,2,0,0
11/18/2017 3:55,11,69.3,27,64.7,38,66,2,0,0
11/18/2017 4:00,14,69.4,30,64.7,44,66.2,2,0,0
11/18/2017 4:05,17,69.4,32,64.8,49,66.4,2,0,0
11/18/2017 4:10,14,69.3,30,64.7,44,66.1,2,0,0
11/18/2017 4:15,11,69.2,27,64.6,38,66,2,0,0
11/18/2017 4:20,16,69.3,32,64.7,48,66.2,2,0,0
11/18/2017 4:25,20,69.3,36,64.7,56,66.3,2,0,0
11/18/2017 4:30,16,69.1,31,64.5,47,66.1,2,0,0
11/18/2017 4:35,19,69.2,35,64.6,54,66.2,2,0,0
11/18/2017 4:40,23,69.4,40,64.8,63,66.5,2,0,0
11/18/2017 4:45,9,69.4,25,64.8,34,66,2,0,0
11/18/2017 4:50,16,69.5,32,64.9,48,66.4,2,0,0
11/18/2017 4:55,19,69.5,34,64.9,53,66.5,2,0,0
11/18/2017 5:00,18,69.3,34,64.7,52,66.3,2,0,0
11/18/2017 5:05,18,69.4,33,64.8,51,66.5,2,0,0
11/18/2017 5:10,19,69.2,35,64.6,54,66.2,2,0,0
11/18/2017 5:15,18,68.8,34,64.1,52,65.7,2,0,0
11/18/2017 5:20,20,68.9,36,64.3,56,66,2,0,0
11/18/2017 5:25,20,68.9,37,64.3,57,65.9,2,0,0
11/18/2017 5:30,24,69.3,41,64.7,65,66.4,2,0,0
11/18/2017 5:35,22,69.3,37,64.7,59,66.4,2,0,0
11/18/2017 5:40,18,68.6,33,63.9,51,65.6,2,0,0
11/18/2017 5:45,16,68.9,32,64.3,48,65.9,2,0,0
11/18/2017 5:50,20,67.8,37,63.1,57,64.8,2,0,0
11/18/2017 5:55,20,68.4,36,63.8,56,65.4,2,0,0
11/18/2017 6:00,15,69,32,64.4,47,65.9,2,0,0
11/18/2017 6:05,17,68.8,33,64.2,50,65.8,2,0,0
11/18/2017 6:10,13,69.1,29,64.4,42,65.9,2,0,0
11/18/2017 6:15,13,69.2,29,64.6,42,66,2,0,0
11/18/2017 6:20,18,69.4,34,64.8,52,66.4,2,0,0
11/18/2017 6:25,14,69.4,30,64.8,44,66.3,2,0,0
11/18/2017 6:30,25,69.1,42,64.4,67,66.1,2,0,0
11/18/2017 6:35,27,69.3,44,64.6,71,66.4,2,0,0
11/18/2017 6:40,33,69.4,51,64.8,84,66.6,2,0,0
11/18/2017 6:45,31,69,48,64.3,79,66.1,2,0,0
11/18/2017 6:50,35,69.2,52,64.6,87,66.4,2,0,0
11/18/2017 6:55,25,69.5,41,64.9,66,66.7,2,0,0
11/18/2017 7:00,27,69.6,44,65,71,66.8,2,0,0
11/18/2017 7:05,36,68.9,54,64.3,90,66.2,2,0,0
11/18/2017 7:10,27,69.3,43,64.8,70,66.5,2,0,0
11/18/2017 7:15,34,69.4,51,64.8,85,66.6,2,0,0
11/18/2017 7:20,23,69.7,39,65.1,62,66.8,2,0,0
11/18/2017 7:25,38,70,55,65.5,93,67.3,2,0,0
11/18/2017 7:30,32,70,49,65.5,81,67.2,2,0,0
11/18/2017 7:35,28,69.6,44,65,72,66.7,2,0,0
11/18/2017 7:40,46,69.5,64,65,110,66.9,2,0,0
11/18/2017 7:45,42,69.7,60,65.1,102,67,2,0,0
11/18/2017 7:50,31,69.7,49,65.1,80,66.9,2,0,0
11/18/2017 7:55,29,68.5,46,63.8,75,65.6,2,0,0
11/18/2017 8:00,38,69.4,55,64.8,93,66.6,2,0,0
11/18/2017 8:05,32,69.4,50,64.8,82,66.6,2,0,0
11/18/2017 8:10,37,69.8,54,65.2,91,67.1,2,0,0
11/18/2017 8:15,30,69.7,46,65.1,76,66.9,2,0,0
11/18/2017 8:20,41,69.8,58,65.2,99,67.1,2,0,0
11/18/2017 8:25,34,69.8,51,65.3,85,67.1,2,0,0
11/18/2017 8:30,49,68.8,68,64.2,117,66.1,2,0,0
11/18/2017 8:35,33,69.3,50,64.7,83,66.5,2,0,0
11/18/2017 8:40,34,69,51,64.4,85,66.2,2,0,0
11/18/2017 8:45,41,69.2,58,64.6,99,66.5,2,0,0
11/18/2017 8:50,44,69.3,61,64.7,105,66.6,2,0,0
11/18/2017 8:55,49,69.1,67,64.4,116,66.4,2,0,0
11/18/2017 9:00,48,69.6,64,64.9,112,66.9,2,0,0
11/18/2017 9:05,33,68.5,50,63.8,83,65.7,2,0,0
11/18/2017 9:10,39,69.4,57,64.8,96,66.7,2,0,0
11/18/2017 9:15,42,69.3,59,64.7,101,66.6,2,0,0
11/18/2017 9:20,38,69.8,56,65.2,94,67,2,0,0
11/18/2017 9:25,56,68.9,75,64.1,131,66.1,2,0,0
11/18/2017 9:30,56,68.2,75,63.5,131,65.5,2,0,0
11/18/2017 9:35,56,68.8,76,64.1,132,66.1,2,0,0
11/18/2017 9:40,53,68.8,72,64,125,66,2,0,0
11/18/2017 9:45,35,69.1,52,64.4,87,66.3,2,0,0
11/18/2017 9:50,37,69.5,55,64.9,92,66.7,2,0,0
11/18/2017 9:55,46,69.7,64,65.1,110,67.1,2,0,0
11/18/2017 10:00,57,69.5,75,64.9,132,66.9,2,0,0
11/18/2017 10:05,38,69,56,64.3,94,66.2,2,0,0
11/18/2017 10:10,46,68.5,64,63.7,110,65.7,2,0,0
11/18/2017 10:15,59,68.4,78,63.6,137,65.7,2,0,0
11/18/2017 10:20,66,67,86,62.1,152,64.2,2,0,0
11/18/2017 10:25,51,68.5,69,63.7,120,65.7,2,0,0
11/18/2017 10:30,61,68.5,80,63.8,141,65.8,2,0,0
11/18/2017 10:35,65,68.3,85,63.6,150,65.6,2,0,0
11/18/2017 10:40,60,69,79,64.3,139,66.3,2,0,0
11/18/2017 10:45,61,66.7,81,61.9,142,64,2,0,0
11/18/2017 10:50,57,67.2,75,62.4,132,64.5,2,0,0
11/18/2017 10:55,67,67.2,87,62.4,154,64.5,2,0,0
11/18/2017 11:00,66,68.3,84,63.5,150,65.6,2,0,0
11/18/2017 11:05,71,68.6,92,63.8,163,65.9,2,0,0
11/18/2017 11:10,77,68.2,98,63.5,175,65.6,2,0,0
11/18/2017 11:15,69,68.8,88,64.1,157,66.2,2,0,0
11/18/2017 11:20,80,68,102,63.2,182,65.3,2,0,0
11/18/2017 11:25,77,68.2,98,63.5,175,65.6,2,0,0
11/18/2017 11:30,74,68.9,94,64.2,168,66.3,2,0,0
11/18/2017 11:35,74,68.8,95,64.1,169,66.2,2,0,0
11/18/2017 11:40,81,68.7,101,64,182,66.1,2,0,0
11/18/2017 11:45,76,65.9,96,60.9,172,63.1,2,0,0
11/18/2017 11:50,81,66,103,61.1,184,63.3,2,0,0
11/18/2017 11:55,78,67.3,99,62.5,177,64.6,2,0,0
11/18/2017 12:00,69,67.4,90,62.6,159,64.7,2,0,0
11/18/2017 12:05,72,67.9,90,63.2,162,65.3,2,0,0
11/18/2017 12:10,70,68.2,89,63.4,159,65.5,2,0,0
11/18/2017 12:15,63,68,82,63.2,145,65.3,2,0,0
11/18/2017 12:20,74,67.8,93,63,167,65.1,2,0,0
11/18/2017 12:25,74,68.2,94,63.5,168,65.6,2,0,0
11/18/2017 12:30,72,67.7,92,62.8,164,65,2,0,0
11/18/2017 12:35,86,66.8,108,61.9,194,64.1,2,0,0
11/18/2017 12:40,73,66.4,94,61.5,167,63.6,2,0,0
11/18/2017 12:45,62,66.8,82,61.8,144,64,2,0,0
11/18/2017 12:50,63,66.8,82,61.9,145,64,2,0,0
11/18/2017 12:55,57,68.3,76,63.6,133,65.6,2,0,0
11/18/2017 13:00,59,67.5,78,62.7,137,64.8,2,0,0
11/18/2017 13:05,57,67.2,76,62.4,133,64.4,2,0,0
11/18/2017 13:10,61,66.4,80,61.5,141,63.6,2,0,0
11/18/2017 13:15,60,67,80,62.2,140,64.3,2,0,0
11/18/2017 13:20,71,68,91,63.2,162,65.3,2,0,0
11/18/2017 13:25,62,69.3,80,64.7,142,66.7,2,0,0
11/18/2017 13:30,65,67.7,84,63,149,65,2,0,0
11/18/2017 13:35,64,66.9,83,62.2,147,64.2,2,0,0
11/18/2017 13:40,67,67.6,87,62.9,154,64.9,2,0,0
11/18/2017 13:45,70,67.7,91,63,161,65,2,0,0
11/18/2017 13:50,54,68.2,71,63.5,125,65.5,2,0,0
11/18/2017 13:55,67,68.5,87,63.8,154,65.8,2,0,0
11/18/2017 14:00,59,68.4,77,63.7,136,65.7,2,0,0
11/18/2017 14:05,65,68.5,84,63.8,149,65.8,2,0,0
11/18/2017 14:10,62,68.7,80,64,142,66,2,0,0
11/18/2017 14:15,60,68,79,63.3,139,65.3,2,0,0
11/18/2017 14:20,75,68.1,95,63.4,170,65.5,2,0,0
11/18/2017 14:25,65,67.9,85,63.2,150,65.2,2,0,0
11/18/2017 14:30,75,68.4,95,63.7,170,65.7,2,0,0
11/18/2017 14:35,61,68.1,80,63.4,141,65.4,2,0,0
11/18/2017 14:40,69,68,87,63.2,156,65.4,2,0,0
11/18/2017 14:45,60,68.6,79,63.9,139,65.9,2,0,0
11/18/2017 14:50,61,68.5,81,63.8,142,65.8,2,0,0
11/18/2017 14:55,71,68.5,90,63.8,161,65.9,2,0,0
11/18/2017 15:00,65,68.6,84,63.9,149,66,2,0,0
11/18/2017 15:05,63,69,82,64.3,145,66.3,2,0,0
11/18/2017 15:10,51,67.9,69,63.1,120,65.1,2,0,0
11/18/2017 15:15,63,68,81,63.3,144,65.4,2,0,0
11/18/2017 15:20,44,67.8,63,63,107,65,2,0,0
11/18/2017 15:25,51,68.2,69,63.5,120,65.5,2,0,0
11/18/2017 15:30,56,68.2,74,63.5,130,65.6,2,0,0
11/18/2017 15:35,55,68.8,73,64.2,128,66.2,2,0,0
11/18/2017 15:40,54,68.3,72,63.6,126,65.6,2,0,0
11/18/2017 15:45,57,69.3,75,64.7,132,66.7,2,0,0
11/18/2017 15:50,70,68.9,91,64.2,161,66.3,2,0,0
11/18/2017 15:55,77,68.5,96,63.8,173,65.9,2,0,0
11/18/2017 16:00,64,68.9,83,64.3,147,66.3,2,0,0
11/18/2017 16:05,56,68.1,74,63.4,130,65.4,2,0,0
11/18/2017 16:10,67,68.2,86,63.5,153,65.5,2,0,0
11/18/2017 16:15,55,69.1,72,64.5,127,66.5,2,0,0
11/18/2017 16:20,64,69.1,84,64.4,148,66.5,2,0,0
11/18/2017 16:25,67,68.9,86,64.2,153,66.3,2,0,0
11/18/2017 16:30,65,68.7,84,64,149,66.1,2,0,0
11/18/2017 16:35,62,68.5,81,63.8,143,65.8,2,0,0
11/18/2017 16:40,67,67.7,87,62.9,154,65,2,0,0
11/18/2017 16:45,54,68.3,72,63.6,126,65.6,2,0,0
11/18/2017 16:50,58,68.7,77,64,135,66,2,0,0
11/18/2017 16:55,63,68.6,82,63.9,145,66,2,0,0
11/18/2017 17:00,50,68.7,68,64.1,118,66.1,2,0,0
11/18/2017 17:05,58,68,76,63.3,134,65.3,2,0,0
11/18/2017 17:10,60,67.9,79,63.2,139,65.3,2,0,0
11/18/2017 17:15,54,67.7,71,63,125,65,2,0,0
11/18/2017 17:20,55,67,73,62.2,128,64.3,2,0,0
11/18/2017 17:25,60,67.5,79,62.7,139,64.7,2,0,0
11/18/2017 17:30,61,66.9,80,62.1,141,64.2,2,0,0
11/18/2017 17:35,55,65.7,73,60.7,128,62.9,2,0,0
11/18/2017 17:40,68,65.9,88,60.9,156,63.1,2,0,0
11/18/2017 17:45,47,66.7,65,61.8,112,63.9,2,0,0
11/18/2017 17:50,74,65.8,94,60.7,168,62.9,2,0,0
11/18/2017 17:55,66,66.1,86,61.1,152,63.2,2,0,0
11/18/2017 18:00,63,66.4,82,61.5,145,63.6,2,0,0
11/18/2017 18:05,62,66,80,61,142,63.2,2,0,0
11/18/2017 18:10,61,66.4,80,61.5,141,63.6,2,0,0
11/18/2017 18:15,50,67.3,68,62.5,118,64.6,2,0,0
11/18/2017 18:20,54,67.8,71,63.1,125,65.1,2,0,0
11/18/2017 18:25,52,67.1,70,62.3,122,64.4,2,0,0
11/18/2017 18:30,63,67.1,82,62.3,145,64.4,2,0,0
11/18/2017 18:35,60,67.1,79,62.3,139,64.4,2,0,0
11/18/2017 18:40,54,66.9,72,62.1,126,64.2,2,0,0
11/18/2017 18:45,45,66.6,63,61.7,108,63.8,2,0,0
11/18/2017 18:50,51,68.1,69,63.4,120,65.4,2,0,0
11/18/2017 18:55,55,67.5,73,62.8,128,64.8,2,0,0
11/18/2017 19:00,52,67.8,70,63.1,122,65.1,2,0,0
11/18/2017 19:05,50,68.8,68,64.2,118,66.1,2,0,0
11/18/2017 19:10,42,69.1,59,64.4,101,66.3,2,0,0
11/18/2017 19:15,49,69.2,67,64.5,116,66.5,2,0,0
11/18/2017 19:20,53,69.5,70,64.9,123,66.9,2,0,0
11/18/2017 19:25,44,69,61,64.4,105,66.4,2,0,0
11/18/2017 19:30,40,69.4,57,64.8,97,66.7,2,0,0
11/18/2017 19:35,46,69.4,63,64.8,109,66.7,2,0,0
11/18/2017 19:40,39,69.8,55,65.2,94,67.1,2,0,0
11/18/2017 19:45,40,69.7,57,65.1,97,67,2,0,0
11/18/2017 19:50,38,69,55,64.4,93,66.3,2,0,0
11/18/2017 19:55,39,68.6,56,63.9,95,65.9,2,0,0
11/18/2017 20:00,34,69,50,64.3,84,66.2,2,0,0
11/18/2017 20:05,37,69.5,53,64.9,90,66.8,2,0,0
11/18/2017 20:10,37,69.7,53,65.1,90,67,2,0,0
11/18/2017 20:15,31,69.8,48,65.2,79,67,2,0,0
11/18/2017 20:20,37,69.2,54,64.7,91,66.5,2,0,0
11/18/2017 20:25,32,69.6,49,65,81,66.8,2,0,0
11/18/2017 20:30,31,69.8,47,65.2,78,67,2,0,0
11/18/2017 20:35,34,70.1,50,65.6,84,67.4,2,0,0
11/18/2017 20:40,35,70.5,51,65.9,86,67.8,2,0,0
11/18/2017 20:45,29,70.3,46,65.8,75,67.5,2,0,0
11/18/2017 20:50,31,69.7,48,65.1,79,66.9,2,0,0
11/18/2017 20:55,38,70.2,55,65.6,93,67.5,2,0,0
11/18/2017 21:00,30,69.7,46,65.2,76,67,2,0,0
11/18/2017 21:05,30,69.4,46,64.8,76,66.6,2,0,0
11/18/2017 21:10,33,69,50,64.3,83,66.1,2,0,0
11/18/2017 21:15,33,69.3,49,64.7,82,66.5,2,0,0
11/18/2017 21:20,34,69.2,49,64.6,83,66.5,2,0,0
11/18/2017 21:25,31,68.8,47,64.2,78,66,2,0,0
11/18/2017 21:30,36,69.1,52,64.5,88,66.4,2,0,0
11/18/2017 21:35,34,69.1,51,64.4,85,66.3,2,0,0
11/18/2017 21:40,32,69,48,64.4,80,66.2,2,0,0
11/18/2017 21:45,38,69.2,54,64.5,92,66.5,2,0,0
11/18/2017 21:50,28,69.1,44,64.4,72,66.2,2,0,0
11/18/2017 21:55,26,68.3,41,63.6,67,65.4,2,0,0
11/18/2017 22:00,33,69.3,49,64.7,82,66.6,2,0,0
11/18/2017 22:05,32,69.4,48,64.8,80,66.7,2,0,0
11/18/2017 22:10,29,69.2,45,64.5,74,66.3,2,0,0
11/18/2017 22:15,24,69,40,64.4,64,66.1,2,0,0
11/18/2017 22:20,30,69,45,64.3,75,66.2,2,0,0
11/18/2017 22:25,30,69.2,46,64.5,76,66.3,2,0,0
11/18/2017 22:30,36,68.8,52,64.1,88,66,2,0,0
11/18/2017 22:35,33,68.9,50,64.2,83,66.1,2,0,0
11/18/2017 22:40,23,68.9,38,64.3,61,66,2,0,0
11/18/2017 22:45,26,69.1,42,64.5,68,66.3,2,0,0
11/18/2017 22:50,24,68.7,40,64.1,64,65.8,2,0,0
11/18/2017 22:55,23,68.7,39,64,62,65.8,2,0,0
11/18/2017 23:00,24,69.2,40,64.6,64,66.3,2,0,0
11/18/2017 23:05,24,69.3,40,64.7,64,66.4,2,0,0
11/18/2017 23:10,27,69.1,43,64.5,70,66.3,2,0,0
11/18/2017 23:15,26,69.3,42,64.7,68,66.4,2,0,0
11/18/2017 23:20,24,68.9,40,64.3,64,66,2,0,0
11/18/2017 23:25,24,69.2,40,64.6,64,66.3,2,0,0
11/18/2017 23:30,21,69.2,36,64.5,57,66.2,2,0,0
11/18/2017 23:35,21,69.2,36,64.6,57,66.3,2,0,0
11/18/2017 23:40,21,69.4,37,64.8,58,66.4,2,0,0
11/18/2017 23:45,20,69.5,36,64.9,56,66.5,2,0,0
11/18/2017 23:50,20,69.2,35,64.6,55,66.3,2,0,0
11/18/2017 23:55,21,69.3,36,64.7,57,66.4,2,0,0
11/19/2017 0:00,13,69.3,29,64.7,42,66.2,2,0,0
11/19/2017 0:05,16,69.2,32,64.6,48,66.2,2,0,0
11/19/2017 0:10,15,69.3,30,64.7,45,66.2,2,0,0
11/19/2017 0:15,14,69.2,29,64.6,43,66.1,2,0,0
11/19/2017 0:20,16,69.3,32,64.7,48,66.3,2,0,0
11/19/2017 0:25,11,69.3,26,64.7,37,66.1,2,0,0
11/19/2017 0:30,12,69.3,27,64.7,39,66.1,2,0,0
11/19/2017 0:35,12,69.3,27,64.7,39,66.1,2,0,0
11/19/2017 0:40,11,69.2,26,64.6,37,66,2,0,0
11/19/2017 0:45,11,69.3,27,64.7,38,66.1,2,0,0
11/19/2017 0:50,14,69.5,29,64.9,43,66.4,2,0,0
11/19/2017 0:55,12,69.4,27,64.8,39,66.2,2,0,0
11/19/2017 1:00,12,69.4,27,64.8,39,66.2,2,0,0
11/19/2017 1:05,9,69.3,24,64.7,33,66,2,0,0
11/19/2017 1:10,9,69.1,24,64.5,33,65.7,2,0,0
11/19/2017 1:15,9,69.1,25,64.5,34,65.7,2,0,0
11/19/2017 1:20,7,69.2,22,64.6,29,65.7,2,0,0
11/19/2017 1:25,8,69.3,24,64.7,32,65.8,2,0,0
11/19/2017 1:30,13,69.3,28,64.7,41,66.1,2,0,0
11/19/2017 1:35,10,69,25,64.3,35,65.6,2,0,0
11/19/2017 1:40,10,69.1,25,64.5,35,65.8,2,0,0
11/19/2017 1:45,12,68.9,21,64.3,33,66,2,0,0
11/19/2017 1:50,9,69.1,24,64.5,33,65.8,2,0,0
11/19/2017 1:55,6,69.2,21,64.6,27,65.6,2,0,0
11/19/2017 2:00,11,69.3,27,64.7,38,66,2,0,0
11/19/2017 2:05,10,69.3,25,64.7,35,66,2,0,0
11/19/2017 2:10,7,69.3,22,64.7,29,65.8,2,0,0
11/19/2017 2:15,10,69.3,26,64.7,36,66,2,0,0
11/19/2017 2:20,9,69.4,24,64.8,33,66,2,0,0
11/19/2017 2:25,10,69.4,25,64.8,35,66.1,2,0,0
11/19/2017 2:30,12,69.5,21,65,33,66.6,2,0,0
11/19/2017 2:35,10,69.5,25,64.9,35,66.2,2,0,0
11/19/2017 2:40,9,69.4,24,64.8,33,66.1,2,0,0
11/19/2017 2:45,9,69.5,24,64.9,33,66.1,2,0,0
11/19/2017 2:50,7,69.4,22,64.8,29,65.9,2,0,0
11/19/2017 2:55,5,69.3,21,64.7,26,65.6,2,0,0
11/19/2017 3:00,15,69.3,22,64.7,37,66.6,2,0,0
11/19/2017 3:05,8,69.4,24,64.8,32,65.9,2,0,0
11/19/2017 3:10,7,69.4,22,64.8,29,65.9,2,0,0
11/19/2017 3:15,8,69.3,23,64.7,31,65.8,2,0,0
11/19/2017 3:20,5,69.3,21,64.7,26,65.6,2,0,0
11/19/2017 3:25,8,69.4,24,64.8,32,65.9,2,0,0
11/19/2017 3:30,8,69.4,24,64.8,32,65.9,2,0,0
11/19/2017 3:35,8,69.2,24,64.5,32,65.7,2,0,0
11/19/2017 3:40,6,69.3,21,64.7,27,65.7,2,0,0
11/19/2017 3:45,10,69.2,26,64.6,36,65.9,2,0,0
11/19/2017 3:50,8,69.3,23,64.7,31,65.9,2,0,0
11/19/2017 3:55,7,69.4,22,64.8,29,65.9,2,0,0
11/19/2017 4:00,8,69.4,24,64.8,32,66,2,0,0
11/19/2017 4:05,8,69.4,23,64.8,31,66,2,0,0
11/19/2017 4:10,7,69.3,22,64.7,29,65.8,2,0,0
11/19/2017 4:15,11,69.3,26,64.7,37,66.1,2,0,0
11/19/2017 4:20,10,69.3,25,64.7,35,66,2,0,0
11/19/2017 4:25,13,69.4,29,64.8,42,66.2,2,0,0
11/19/2017 4:30,16,69.4,31,64.8,47,66.4,2,0,0
11/19/2017 4:35,13,69.4,29,64.8,42,66.3,2,0,0
11/19/2017 4:40,19,69.5,34,64.9,53,66.5,2,0,0
11/19/2017 4:45,14,69.4,30,64.8,44,66.2,2,0,0
11/19/2017 4:50,13,69.5,28,64.9,41,66.4,2,0,0
11/19/2017 4:55,12,69.5,28,64.9,40,66.3,2,0,0
11/19/2017 5:00,16,69.4,32,64.8,48,66.4,2,0,0
11/19/2017 5:05,15,69.4,31,64.8,46,66.3,2,0,0
11/19/2017 5:10,15,69.3,31,64.7,46,66.2,2,0,0
11/19/2017 5:15,14,69.3,30,64.7,44,66.1,2,0,0
11/19/2017 5:20,15,69.2,30,64.6,45,66.2,2,0,0
11/19/2017 5:25,14,69.3,30,64.7,44,66.2,2,0,0
11/19/2017 5:30,19,69.2,34,64.5,53,66.2,2,0,0
11/19/2017 5:35,21,69.7,36,65.1,57,66.8,2,0,0
11/19/2017 5:40,18,69.5,34,64.9,52,66.5,2,0,0
11/19/2017 5:45,14,69.5,30,65,44,66.4,2,0,0
11/19/2017 5:50,13,69.5,28,65,41,66.4,2,0,0
11/19/2017 5:55,11,69.5,27,64.9,38,66.3,2,0,0
11/19/2017 6:00,13,69.5,28,64.9,41,66.3,2,0,0
11/19/2017 6:05,19,69.4,34,64.8,53,66.5,2,0,0
11/19/2017 6:10,17,69.3,32,64.7,49,66.3,2,0,0
11/19/2017 6:15,13,69,29,64.4,42,65.9,2,0,0
11/19/2017 6:20,13,69.2,29,64.5,42,66,2,0,0
11/19/2017 6:25,15,69.2,30,64.6,45,66.1,2,0,0
11/19/2017 6:30,14,69.2,30,64.5,44,66,2,0,0
11/19/2017 6:35,19,68.7,35,64.1,54,65.7,2,0,0
11/19/2017 6:40,20,69,36,64.4,56,66,2,0,0
11/19/2017 6:45,16,69.1,32,64.5,48,66.1,2,0,0
11/19/2017 6:50,21,69.2,38,64.6,59,66.3,2,0,0
11/19/2017 6:55,20,69.4,36,64.8,56,66.4,2,0,0
11/19/2017 7:00,20,69.1,37,64.5,57,66.1,2,0,0
11/19/2017 7:05,24,69.1,40,64.5,64,66.2,2,0,0
11/19/2017 7:10,19,69.3,35,64.7,54,66.3,2,0,0
11/19/2017 7:15,26,69.5,42,64.9,68,66.6,2,0,0
11/19/2017 7:20,22,69.2,37,64.6,59,66.3,2,0,0
11/19/2017 7:25,25,69.3,41,64.7,66,66.4,2,0,0
11/19/2017 7:30,22,69.2,38,64.6,60,66.3,2,0,0
11/19/2017 7:35,30,69.3,47,64.7,77,66.5,2,0,0
11/19/2017 7:40,25,69.6,41,65,66,66.7,2,0,0
11/19/2017 7:45,35,69.7,51,65.1,86,67,2,0,0
11/19/2017 7:50,30,69.6,47,65,77,66.8,2,0,0
11/19/2017 7:55,29,69.5,46,64.9,75,66.7,2,0,0
11/19/2017 8:00,30,69.5,46,64.9,76,66.7,2,0,0
11/19/2017 8:05,33,69.6,49,65,82,66.9,2,0,0
11/19/2017 8:10,29,69.3,45,64.7,74,66.5,2,0,0
11/19/2017 8:15,29,68.6,45,64,74,65.8,2,0,0
11/19/2017 8:20,30,69,46,64.4,76,66.2,2,0,0
11/19/2017 8:25,32,69.4,48,64.8,80,66.7,2,0,0
11/19/2017 8:30,26,69.1,42,64.5,68,66.3,2,0,0
11/19/2017 8:35,32,69.4,48,64.8,80,66.6,2,0,0
11/19/2017 8:40,31,69.2,47,64.6,78,66.4,2,0,0
11/19/2017 8:45,35,69.2,53,64.5,88,66.4,2,0,0
11/19/2017 8:50,36,69.4,52,64.8,88,66.7,2,0,0
11/19/2017 8:55,31,69.7,48,65.2,79,67,2,0,0
11/19/2017 9:00,35,69.3,52,64.8,87,66.6,2,0,0
11/19/2017 9:05,36,69.1,52,64.5,88,66.4,2,0,0
11/19/2017 9:10,33,69.2,49,64.6,82,66.4,2,0,0
11/19/2017 9:15,42,68.5,59,63.8,101,65.8,2,0,0
11/19/2017 9:20,44,69.4,61,64.7,105,66.7,2,0,0
11/19/2017 9:25,36,69.3,54,64.6,90,66.5,2,0,0
11/19/2017 9:30,44,68.3,60,63.6,104,65.6,2,0,0
11/19/2017 9:35,46,68.6,63,63.9,109,65.9,2,0,0
11/19/2017 9:40,47,68.4,65,63.7,112,65.6,2,0,0
11/19/2017 9:45,51,68.6,69,63.8,120,65.9,2,0,0
11/19/2017 9:50,56,68.5,74,63.8,130,65.8,2,0,0
11/19/2017 9:55,49,69,67,64.4,116,66.4,2,0,0
11/19/2017 10:00,49,69.6,67,65,116,66.9,2,0,0
11/19/2017 10:05,48,68.7,65,64,113,66,2,0,0
11/19/2017 10:10,57,68.4,76,63.6,133,65.7,2,0,0
11/19/2017 10:15,40,69,57,64.3,97,66.2,2,0,0
11/19/2017 10:20,56,68.6,74,63.8,130,65.9,2,0,0
11/19/2017 10:25,50,68.3,69,63.5,119,65.5,2,0,0
11/19/2017 10:30,54,69.3,72,64.7,126,66.7,2,0,0
11/19/2017 10:35,60,69.4,79,64.8,139,66.8,2,0,0
11/19/2017 10:40,68,68.9,88,64.3,156,66.3,2,0,0
11/19/2017 10:45,62,69.4,81,64.8,143,66.8,2,0,0
11/19/2017 10:50,62,69.1,81,64.5,143,66.5,2,0,0
11/19/2017 10:55,59,69.7,78,65.1,137,67.1,2,0,0
11/19/2017 11:00,59,68.9,78,64.3,137,66.3,2,0,0
11/19/2017 11:05,49,68.8,66,64.1,115,66.1,2,0,0
11/19/2017 11:10,61,68.5,80,63.8,141,65.8,2,0,0
11/19/2017 11:15,64,68.7,83,64.1,147,66.1,2,0,0
11/19/2017 11:20,69,69.3,88,64.7,157,66.7,2,0,0
11/19/2017 11:25,63,68.7,80,64.1,143,66.1,2,0,0
11/19/2017 11:30,62,69,81,64.4,143,66.4,2,0,0
11/19/2017 11:35,56,68.5,74,63.9,130,65.9,2,0,0
11/19/2017 11:40,67,69.2,86,64.6,153,66.6,2,0,0
11/19/2017 11:45,70,67.8,90,63.1,160,65.1,2,0,0
11/19/2017 11:50,71,67.7,90,63,161,65.1,2,0,0
11/19/2017 11:55,76,67.2,96,62.4,172,64.6,2,0,0
11/19/2017 12:00,79,67.8,100,63,179,65.1,2,0,0
11/19/2017 12:05,66,68.9,86,64.3,152,66.3,2,0,0
11/19/2017 12:10,71,69.6,90,65,161,67,2,0,0
11/19/2017 12:15,69,69.3,88,64.7,157,66.7,2,0,0
11/19/2017 12:20,67,69.2,85,64.6,152,66.6,2,0,0
11/19/2017 12:25,67,68.5,86,63.8,153,65.9,2,0,0
11/19/2017 12:30,72,68.3,92,63.6,164,65.7,2,0,0
11/19/2017 12:35,68,68.1,87,63.4,155,65.5,2,0,0
11/19/2017 12:40,74,68.1,93,63.3,167,65.4,2,0,0
11/19/2017 12:45,65,68,84,63.4,149,65.4,2,0,0
11/19/2017 12:50,73,68.5,94,63.8,167,65.8,2,0,0
11/19/2017 12:55,63,68.5,82,63.8,145,65.8,2,0,0
11/19/2017 13:00,76,68.8,96,64.1,172,66.2,2,0,0
11/19/2017 13:05,78,68.4,98,63.6,176,65.7,2,0,0
11/19/2017 13:10,58,69,76,64.4,134,66.4,2,0,0
11/19/2017 13:15,56,68.5,74,63.7,130,65.8,2,0,0
11/19/2017 13:20,70,68,89,63.3,159,65.3,2,0,0
11/19/2017 13:25,62,67.8,81,63.1,143,65.2,2,0,0
11/19/2017 13:30,63,68.3,83,63.6,146,65.6,2,0,0
11/19/2017 13:35,56,69,74,64.3,130,66.3,2,0,0
11/19/2017 13:40,55,69.1,75,64.5,130,66.4,2,0,0
11/19/2017 13:45,67,68.5,86,63.8,153,65.9,2,0,0
11/19/2017 13:50,65,69.2,83,64.7,148,66.7,2,0,0
11/19/2017 13:55,55,69.4,73,64.9,128,66.8,2,0,0
11/19/2017 14:00,52,69.2,69,64.6,121,66.5,2,0,0
11/19/2017 14:05,60,69.6,78,65,138,67,2,0,0
11/19/2017 14:10,61,69,78,64.4,139,66.4,2,0,0
11/19/2017 14:15,50,68.9,67,64.3,117,66.3,2,0,0
11/19/2017 14:20,60,69.2,78,64.7,138,66.7,2,0,0
11/19/2017 14:25,48,69.1,65,64.5,113,66.5,2,0,0
11/19/2017 14:30,48,69.5,65,64.9,113,66.9,2,0,0
11/19/2017 14:35,50,69.6,67,65,117,67,2,0,0
11/19/2017 14:40,54,69.1,73,64.5,127,66.4,2,0,0
11/19/2017 14:45,53,69.1,71,64.5,124,66.4,2,0,0
11/19/2017 14:50,54,69.1,72,64.4,126,66.4,2,0,0
11/19/2017 14:55,56,68.8,74,64.1,130,66.1,2,0,0
11/19/2017 15:00,47,68.8,64,64.1,111,66.1,2,0,0
11/19/2017 15:05,53,68.2,70,63.5,123,65.5,2,0,0
11/19/2017 15:10,47,67.8,64,63.1,111,65.1,2,0,0
11/19/2017 15:15,54,67.6,72,62.8,126,64.8,2,0,0
11/19/2017 15:20,57,68,74,63.3,131,65.4,2,0,0
11/19/2017 15:25,47,68.8,63,64.2,110,66.2,2,0,0
11/19/2017 15:30,58,68.6,77,64,135,66,2,0,0
11/19/2017 15:35,57,68.7,76,64.1,133,66.1,2,0,0
11/19/2017 15:40,58,68.5,77,63.8,135,65.8,2,0,0
11/19/2017 15:45,57,68.5,75,63.9,132,65.9,2,0,0
11/19/2017 15:50,60,68.3,78,63.6,138,65.6,2,0,0
11/19/2017 15:55,64,69.2,83,64.6,147,66.6,2,0,0
11/19/2017 16:00,60,68.7,79,64,139,66,2,0,0
11/19/2017 16:05,61,68.7,79,64,140,66,2,0,0
11/19/2017 16:10,60,69.2,78,64.6,138,66.6,2,0,0
11/19/2017 16:15,56,68,75,63.3,131,65.3,2,0,0
11/19/2017 16:20,66,67.9,85,63.1,151,65.2,2,0,0
11/19/2017 16:25,66,68.8,85,64.1,151,66.1,2,0,0
11/19/2017 16:30,62,68.5,80,63.8,142,65.8,2,0,0
11/19/2017 16:35,57,67.9,75,63.2,132,65.2,2,0,0
11/19/2017 16:40,49,68.4,66,63.7,115,65.7,2,0,0
11/19/2017 16:45,48,67.9,65,63.2,113,65.2,2,0,0
11/19/2017 16:50,60,68.3,78,63.6,138,65.6,2,0,0
11/19/2017 16:55,48,68.2,65,63.5,113,65.5,2,0,0
11/19/2017 17:00,46,68.6,63,63.9,109,65.9,2,0,0
11/19/2017 17:05,49,68.5,67,63.8,116,65.8,2,0,0
11/19/2017 17:10,55,68.4,73,63.7,128,65.7,2,0,0
11/19/2017 17:15,58,68.3,75,63.6,133,65.7,2,0,0
11/19/2017 17:20,61,67.2,80,62.5,141,64.5,2,0,0
11/19/2017 17:25,47,67.8,65,63.1,112,65.1,2,0,0
11/19/2017 17:30,55,67.5,73,62.7,128,64.8,2,0,0
11/19/2017 17:35,52,67.4,70,62.6,122,64.7,2,0,0
11/19/2017 17:40,57,67.9,75,63.2,132,65.2,2,0,0
11/19/2017 17:45,58,68,76,63.3,134,65.4,2,0,0
11/19/2017 17:50,51,68.2,68,63.5,119,65.5,2,0,0
11/19/2017 17:55,47,67,64,62.2,111,64.2,2,0,0
11/19/2017 18:00,47,68.3,65,63.6,112,65.5,2,0,0
11/19/2017 18:05,50,68.4,67,63.7,117,65.7,2,0,0
11/19/2017 18:10,50,68.3,68,63.6,118,65.6,2,0,0
11/19/2017 18:15,50,68.5,68,63.8,118,65.7,2,0,0
11/19/2017 18:20,47,69,66,64.4,113,66.3,2,0,0
11/19/2017 18:25,48,66.9,65,62,113,64.1,2,0,0
11/19/2017 18:30,48,66.9,65,62,113,64.1,2,0,0
11/19/2017 18:35,50,68,67,63.2,117,65.2,2,0,0
11/19/2017 18:40,41,68.7,58,64,99,65.9,2,0,0
11/19/2017 18:45,47,68.9,65,64.2,112,66.2,2,0,0
11/19/2017 18:50,49,68.8,67,64.1,116,66,2,0,0
11/19/2017 18:55,54,69,71,64.4,125,66.4,2,0,0
11/19/2017 19:00,48,69.3,65,64.7,113,66.6,2,0,0
11/19/2017 19:05,43,69.6,61,65,104,66.9,2,0,0
11/19/2017 19:10,47,69.7,65,65.1,112,67.1,2,0,0
11/19/2017 19:15,49,69.5,66,64.9,115,66.8,2,0,0
11/19/2017 19:20,40,69.4,57,64.8,97,66.7,2,0,0
11/19/2017 19:25,40,69,57,64.4,97,66.3,2,0,0
11/19/2017 19:30,41,69.9,58,65.4,99,67.3,2,0,0
11/19/2017 19:35,35,69.8,52,65.3,87,67.1,2,0,0
11/19/2017 19:40,42,69.5,59,64.9,101,66.8,2,0,0
11/19/2017 19:45,34,69.6,50,65,84,66.9,2,0,0
11/19/2017 19:50,42,69.3,60,64.7,102,66.6,2,0,0
11/19/2017 19:55,34,69.2,50,64.5,84,66.4,2,0,0
11/19/2017 20:00,36,69.5,53,64.9,89,66.7,2,0,0
11/19/2017 20:05,31,69.8,47,65.3,78,67.1,2,0,0
11/19/2017 20:10,31,69.7,48,65.1,79,66.9,2,0,0
11/19/2017 20:15,34,70,50,65.5,84,67.3,2,0,0
11/19/2017 20:20,23,69.8,39,65.2,62,66.9,2,0,0
11/19/2017 20:25,24,68.8,39,64.1,63,65.9,2,0,0
11/19/2017 20:30,28,69.2,44,64.6,72,66.4,2,0,0
11/19/2017 20:35,26,69.4,42,64.8,68,66.6,2,0,0
11/19/2017 20:40,32,69.4,48,64.8,80,66.6,2,0,0
11/19/2017 20:45,25,67.6,41,62.9,66,64.7,2,0,0
11/19/2017 20:50,27,68.1,43,63.4,70,65.2,2,0,0
11/19/2017 20:55,21,69,37,64.3,58,66,2,0,0
11/19/2017 21:00,23,69.2,39,64.6,62,66.3,2,0,0
11/19/2017 21:05,22,68.1,38,63.5,60,65.2,2,0,0
11/19/2017 21:10,26,68.7,42,64.1,68,65.9,2,0,0
11/19/2017 21:15,22,69,37,64.3,59,66.1,2,0,0
11/19/2017 21:20,24,69.4,40,64.8,64,66.5,2,0,0
11/19/2017 21:25,24,68.9,40,64.3,64,66,2,0,0
11/19/2017 21:30,17,69.1,34,64.5,51,66,2,0,0
11/19/2017 21:35,22,69.2,38,64.5,60,66.2,2,0,0
11/19/2017 21:40,24,69.4,40,64.8,64,66.5,2,0,0
11/19/2017 21:45,25,69.4,41,64.8,66,66.6,2,0,0
11/19/2017 21:50,18,69.4,34,64.7,52,66.3,2,0,0
11/19/2017 21:55,23,69.6,39,65,62,66.7,2,0,0
11/19/2017 22:00,25,69.5,40,64.9,65,66.7,2,0,0
11/19/2017 22:05,17,69.4,32,64.8,49,66.4,2,0,0
11/19/2017 22:10,18,69.3,34,64.7,52,66.3,2,0,0
11/19/2017 22:15,18,69.4,33,64.8,51,66.4,2,0,0
11/19/2017 22:20,18,69.2,34,64.6,52,66.2,2,0,0
11/19/2017 22:25,16,69.4,32,64.8,48,66.3,2,0,0
11/19/2017 22:30,16,69.4,32,64.8,48,66.4,2,0,0
11/19/2017 22:35,21,69.4,37,64.7,58,66.4,2,0,0
11/19/2017 22:40,17,69.2,32,64.6,49,66.2,2,0,0
11/19/2017 22:45,17,69.3,33,64.7,50,66.3,2,0,0
11/19/2017 22:50,18,69.4,33,64.8,51,66.5,2,0,0
11/19/2017 22:55,13,69.3,28,64.7,41,66.2,2,0,0
11/19/2017 23:00,15,69.4,30,64.8,45,66.3,2,0,0
11/19/2017 23:05,17,69.4,32,64.8,49,66.4,2,0,0
11/19/2017 23:10,14,69.3,30,64.7,44,66.2,2,0,0
11/19/2017 23:15,13,69.4,28,64.8,41,66.3,2,0,0
11/19/2017 23:20,15,69.4,30,64.8,45,66.3,2,0,0
11/19/2017 23:25,14,69.4,29,64.8,43,66.3,2,0,0
11/19/2017 23:30,13,69.4,28,64.8,41,66.3,2,0,0
11/19/2017 23:35,16,69.3,31,64.7,47,66.3,2,0,0
11/19/2017 23:40,19,69.3,34,64.7,53,66.3,2,0,0
11/19/2017 23:45,17,68.9,33,64.2,50,65.8,2,0,0
11/19/2017 23:50,17,69,33,64.4,50,66,2,0,0
11/19/2017 23:55,13,69.1,28,64.5,41,65.9,2,0,0
